time,subj_course_id,sec_code,sec_id,prof,available,waitlist,total,enrolled_ct
1681903496938,ANSC 105GS,A00,258289,Staff,0,0,0,0
1681903497967,ANSC 125GS,A00,258295,Staff,0,0,0,0
1681903498999,ANSC 150,A00,258267,Staff,30,0,40,10
1681903500024,ANSC 190GS,A00,258280,Staff,0,0,0,0
1681903501050,ANTH 1,A00,258264,Staff,38,0,40,2
1681903502079,ANTH 2,A01,258259,Staff,72,0,76,4
1681903503108,ANTH 23,A01,258228,Staff,36,0,40,4
1681903504141,ANTH 101,A01,258236,Staff,39,0,40,1
1681903505169,ANTH 102,A00,258272,Staff,59,0,60,1
1681903506197,ANTH 105,A00,258244,Staff,31,0,35,4
1681903507227,BENG 130,A00,253975,Staff,38,0,40,2
1681903508256,BIBC 102,A01,191866,Flagg; Matthew Paul,19,0,32,13
1681903508256,BIBC 102,A02,191867,Flagg; Matthew Paul,22,0,32,10
1681903508256,BIBC 102,A03,191868,Flagg; Matthew Paul,30,0,32,2
1681903508256,BIBC 102,A04,191936,Flagg; Matthew Paul,26,0,32,6
1681903508256,BIBC 102,A05,191937,Flagg; Matthew Paul,11,0,32,21
1681903509288,BICD 100,A01,191939,Cooper; Andrew Michael,28,0,32,4
1681903509288,BICD 100,A02,191940,Cooper; Andrew Michael,32,0,32,0
1681903509288,BICD 100,A03,191941,Cooper; Andrew Michael,32,0,32,0
1681903509288,BICD 100,A04,191942,Cooper; Andrew Michael,32,0,32,0
1681903509288,BICD 100,A05,191943,Cooper; Andrew Michael,32,0,32,0
1681903510317,BIEB 126,A01,191945,Cleland; Elsa Eleanor,1,0,32,31
1681903510317,BIEB 126,A02,191946,Cleland; Elsa Eleanor,28,0,32,4
1681903510317,BIEB 126,A03,191947,Cleland; Elsa Eleanor,29,0,32,3
1681903510317,BIEB 126,A04,191948,Cleland; Elsa Eleanor,23,0,32,9
1681903510317,BIEB 126,A05,191996,Cleland; Elsa Eleanor,28,0,32,4
1681903511346,BIEB 136GS,A00,191997,Shurin; Jonathan & Holway; David A.,0,0,0,0
1681903512377,BIEB 137GS,A01,191999,Shurin; Jonathan & Holway; David A.,0,0,0,0
1681903513410,BILD 1,A01,205385,Staff,31,0,32,1
1681903513410,BILD 1,A02,205386,Staff,30,0,32,2
1681903513410,BILD 1,A03,205387,Staff,32,0,32,0
1681903513410,BILD 1,A04,205388,Staff,28,0,32,4
1681903514444,BILD 2,A01,191774,Staff,28,0,32,4
1681903514444,BILD 2,A02,191775,Staff,30,0,32,2
1681903514444,BILD 2,A03,191777,Staff,30,0,32,2
1681903514444,BILD 2,A04,191856,Staff,31,0,32,1
1681903514444,BILD 2,A05,191857,Staff,32,0,32,0
1681903514444,BILD 2,A06,191858,Staff,32,0,32,0
1681903514444,BILD 2,A07,191859,Staff,31,0,32,1
1681903515472,BILD 3,A01,205391,Staff,29,0,32,3
1681903515472,BILD 3,A02,205393,Staff,32,0,32,0
1681903515472,BILD 3,A03,205394,Staff,28,0,32,4
1681903515472,BILD 3,A04,205395,Staff,32,0,32,0
1681903516497,BILD 20,A01,191861,Staff,32,0,32,0
1681903516497,BILD 20,A02,191862,Staff,32,0,32,0
1681903517522,BILD 30,A01,191864,Staff,31,0,32,1
1681903518550,BIMM 100,A01,192019,Staff,0,0,32,32
1681903518550,BIMM 100,A02,192020,Staff,23,0,32,9
1681903518550,BIMM 100,A03,192035,Staff,22,0,32,10
1681903519588,BIMM 110,A01,192037,Tat; John,0,0,32,32
1681903519588,BIMM 110,A02,192038,Tat; John,10,0,32,22
1681903520615,BIMM 120,A01,192040,Pickett; Brooke Elizabeth,2,0,32,30
1681903520615,BIMM 120,A02,192041,Pickett; Brooke Elizabeth,16,0,32,16
1681903520615,BIMM 120,A03,192042,Pickett; Brooke Elizabeth,16,0,32,16
1681903521643,BIPN 100,A01,192044,Armour; Jon Christopher,26,0,32,6
1681903521643,BIPN 100,A02,192059,Armour; Jon Christopher,30,0,32,2
1681903521643,BIPN 100,A03,192064,Armour; Jon Christopher,31,0,32,1
1681903521643,BIPN 100,A04,192073,Armour; Jon Christopher,28,0,32,4
1681903522677,BIPN 148,A01,205411,Leutgeb; Jill K.,16,0,32,16
1681903522677,BIPN 148,A02,205412,Leutgeb; Jill K.,31,0,32,1
1681903522677,BIPN 148,A03,205413,Leutgeb; Jill K.,30,0,32,2
1681903522677,BIPN 148,A04,205414,Leutgeb; Jill K.,30,0,32,2
1681903523705,BIPN 160,A01,192115,Marino; Marc J,19,0,32,13
1681903523705,BIPN 160,A02,192148,Marino; Marc J,27,0,32,5
1681903523705,BIPN 160,A03,192158,Marino; Marc J,31,0,32,1
1681903523705,BIPN 160,A04,192190,Marino; Marc J,32,0,32,0
1681903523705,BIPN 160,A05,192287,Marino; Marc J,32,0,32,0
1681903523705,BIPN 160,A06,192288,Marino; Marc J,32,0,32,0
1681903524734,BIPN 194,A00,206038,Staff,28,0,32,4
1681903525761,BISP 194,A00,192289,Leutgeb; Stefan,13,0,32,19
1681903525761,BISP 194,B00,245332,Nieh; James Charles,27,0,32,5
1681903526788,CAT 124,A01,202247,Staff,15,0,15,0
1681903527819,CAT 125,A00,202248,Staff,19,0,20,1
1681903527819,CAT 125,B00,202253,Staff,20,0,20,0
1681903527819,CAT 125,C00,202257,Staff,19,0,20,1
1681903528848,CAT 125GS,A01,202273,Bronstein; Phoebe Malan,20,0,20,0
1681903529878,CAT 125R,A00,202284,Staff,17,0,20,3
1681903529878,CAT 125R,C00,202286,Staff,10,0,20,10
1681903529878,CAT 125R,D00,202291,Staff,18,0,20,2
1681903529878,CAT 125R,E00,202295,Staff,13,0,20,7
1681903529878,CAT 125R,F00,202302,Staff,12,0,20,8
1681903530911,CENG 100,A00,204724,Opatkiewicz; Justin Paul,25,0,25,0
1681903531939,CGS 2A,A01,180420,Staff,31,0,36,5
1681903532969,CGS 101,A00,180421,Staff,16,0,20,4
1681903533997,CGS 112,A00,180422,Staff,10,0,16,6
1681903535028,CGS 113,A00,180423,Staff,18,0,20,2
1681903536058,CGS 137,A00,180424,Staff,12,0,12,0
1681903537086,CGS 147,A00,180425,Staff,10,0,10,0
1681903538114,CHEM 6A,A01,179556,Staff,97,0,100,3
1681903538114,CHEM 6A,A02,179558,Staff,0,0,0,0
1681903539140,CHEM 6B,A01,179560,Staff,100,0,100,0
1681903540172,CHEM 6C,A01,179565,Jazzar; Rodolphe,95,0,100,5
1681903541203,CHEM 7L,A01,179586,Schurmeier; Kimberly,13,0,24,11
1681903541203,CHEM 7L,A02,179587,Schurmeier; Kimberly,23,0,24,1
1681903541203,CHEM 7L,A03,179590,Schurmeier; Kimberly,22,0,24,2
1681903541203,CHEM 7L,A04,179591,Schurmeier; Kimberly,22,0,24,2
1681903541203,CHEM 7L,B01,179598,Schurmeier; Kimberly,17,0,24,7
1681903541203,CHEM 7L,B02,179599,Schurmeier; Kimberly,24,0,24,0
1681903541203,CHEM 7L,B03,179606,Schurmeier; Kimberly,23,0,24,1
1681903541203,CHEM 7L,B04,179607,Schurmeier; Kimberly,23,0,24,1
1681903542229,CHEM 11,A01,179609,Stallings; Dontarie M,88,0,100,12
1681903543260,CHEM 40A,A01,179621,Staff,41,0,50,9
1681903543260,CHEM 40A,A02,179622,Staff,47,0,50,3
1681903544294,CHEM 40B,A01,179630,Weizman; Haim,48,0,50,2
1681903544294,CHEM 40B,A02,179631,Weizman; Haim,45,0,50,5
1681903545321,CHEM 41A,A01,179660,Klosterman; Jeremy K,93,0,100,7
1681903546358,CHEM 43A,A01,179683,Klosterman; Jeremy K,0,0,24,24
1681903546358,CHEM 43A,A02,179688,Klosterman; Jeremy K,14,0,24,10
1681903546358,CHEM 43A,A03,179689,Klosterman; Jeremy K,20,0,24,4
1681903546358,CHEM 43A,A04,179691,Klosterman; Jeremy K,18,0,24,6
1681903547395,CHEM 114A,A01,179693,Stallings; Dontarie M,77,0,100,23
1681903548434,CHEM 143B,A01,179698,Weizman; Haim,17,0,24,7
1681903548434,CHEM 143B,A02,179700,Weizman; Haim,24,0,24,0
1681903549462,CHIN 169A,A00,179701,Wang; Xiao,20,0,20,0
1681903550492,COGS 2,A01,179750,Boyle; Mary E. T.,17,0,30,13
1681903551525,COGS 9,A01,179759,Jones; Cameron Robert,43,0,50,7
1681903552557,COGS 14A,A01,179854,Staff,18,0,50,32
1681903553585,COGS 14B,A01,179856,Staff,54,0,60,6
1681903554613,COGS 17,A01,179874,Staff,71,0,75,4
1681903555638,COGS 18,A01,179884,Staff,63,0,80,17
1681903556667,COGS 100,A01,179886,Staff,40,0,60,20
1681903557695,COGS 101B,A01,179892,Staff,1,0,30,29
1681903558724,COGS 101C,A01,179894,Staff,28,0,30,2
1681903559755,COGS 107A,A01,179896,Boyle; Mary E. T.,31,0,40,9
1681903560781,COGS 108,A01,179898,Simpkins; Charles Alexander,0,17,60,60
1681903561809,COGS 109,A01,179900,Staff,34,0,40,6
1681903562838,COGS 118A,A01,179946,Staff,9,0,40,31
1681903563866,COGS 153,A00,179978,Staff,1,0,30,29
1681903564913,COGS 156,A01,179981,Staff,27,0,30,3
1681903566973,COGS 172,A01,179987,Staff,13,0,30,17
1681903569028,COGS 186,A01,179991,Staff,13,0,30,17
1681903570056,COMM 10,A01,180001,Staff,15,0,25,10
1681903570056,COMM 10,A02,180004,Staff,20,0,25,5
1681903571089,COMM 100A,A01,180016,Staff,18,0,25,7
1681903571089,COMM 100A,A02,180020,Staff,24,0,25,1
1681903572123,COMM 101T,A00,180029,Halm; Gavin Patrick,23,0,35,12
1681903573148,COMM 106V,A00,180043,Staff,34,0,35,1
1681903574179,COMM 109P,A00,180044,Staff,31,0,35,4
1681903575206,COMM 113T,A00,180045,Havis; Allan,37,0,45,8
1681903576233,COMM 132,A00,180046,McKenna; Denise,23,0,30,7
1681903577265,COMM 143,A00,180047,Staff,19,0,30,11
1681903578294,COMM 190,A00,180048,Conner; Thomas Hartnell,20,0,23,3
1681903579330,CSE 8A,A50,180053,Cao; Yingjun,25,0,50,25
1681903579330,CSE 8A,B50,180180,Staff,50,0,50,0
1681903580366,CSE 11,A01,180190,Cao; Yingjun,31,0,50,19
1681903581398,CSE 20,A01,180192,Briones; Jor-el Thomas Caparas,23,0,30,7
1681903582426,CSE 21,A01,194538,Briones; Jor-el Thomas Caparas,50,0,60,10
1681903583451,CSE 30,A01,180324,Eldon; John,79,0,100,21
1681903584477,CSE 101,A01,201353,Staff,0,20,40,40
1681903585505,CSE 134B,A01,180326,Powell; Thomas Allan,74,0,100,26
1681903586530,CSE 140,A01,180328,Staff,46,0,75,29
1681903587555,CSE 140L,A01,180344,Eldon; John,69,0,100,31
1681903588586,CSE 150A,A01,180411,Staff,0,7,50,50
1681903589610,CSE 151A,A01,180414,Staff,0,6,50,50
1681903590641,CSE 175,A01,222521,Kumar; Rakesh,50,0,50,0
1681903591670,CSE 190,A00,201419,Staff,45,0,49,4
1681903592702,CSS 1,A01,194536,Staff,38,0,50,12
1681903593735,DSC 30,A01,202385,Staff,48,0,50,2
1681903594760,DSC 40A,A01,202387,Albuyeh; Rod,50,0,50,0
1681903595786,DSC 190,A01,202389,Silberman; Jack,21,0,21,0
1681903596909,DSGN 100,A01,179993,Staff,16,0,30,14
1681903597944,ECE 65,A50,180708,Staff,10,0,20,10
1681903597944,ECE 65,A51,180739,Staff,19,0,20,1
1681903598971,ECON 1,A01,180427,Famulari; Melissa,67,0,70,3
1681903599997,ECON 2,A01,180450,Levkoff; Steven B.,64,0,70,6
1681903601023,ECON 4,A01,203351,Anderson; John Charles,7,0,10,3
1681903602057,ECON 100A,A01,180472,Famulari; Melissa,65,0,70,5
1681903603089,ECON 120A,A01,180549,Staff,64,0,70,6
1681903604120,ECON 120B,A01,180655,Ma; Xinwei,46,0,70,24
1681903605147,ECON 129,A00,203333,Eckert; Fabian Paul,15,0,35,20
1681903606180,ECON 131,A00,180656,Staff,10,0,35,25
1681903607211,ECON 172B,A01,180672,Levkoff; Steven B.,32,0,35,3
1681903608241,ECON 178,A01,203342,Zhu; Ying,11,0,35,24
1681903609269,EDS 108GS,A00,202383,Wishard Guerra; Alison G.,20,0,20,0
1681903610299,EDS 111GS,A00,202347,Wishard Guerra; Alison G.,20,0,20,0
1681903611327,EDS 112,A01,202323,Staff,56,0,60,4
1681903612356,EDS 113,A00,202340,Staff,33,0,35,2
1681903613381,EDS 118,A00,201231,Staff,20,0,30,10
1681903614412,EDS 119,A00,204994,Staff,8,0,10,2
1681903615449,EDS 124BR,A00,202324,Eguchi; Emi,5,0,25,20
1681903616475,EDS 126,A01,203208,Jones; Makeba,26,0,30,4
1681903617503,EDS 135,A01,202333,Staff,18,0,20,2
1681903618531,EDS 180,A00,202311,Staff,47,0,50,3
1681903619556,ERC 190GS,A01,253747,Staff,28,0,28,0
1681903620588,ETHN 104,A00,180742,Staff,24,0,35,11
1681903621618,ETHN 118,A00,180745,Staff,28,0,35,7
1681903622642,ETHN 127,A00,180747,Staff,12,0,16,4
1681903623671,ETHN 137,A00,180880,Staff,12,0,12,0
1681903624695,ETHN 147,A00,180890,Staff,8,0,10,2
1681903625722,ETHN 154,A00,180891,Staff,7,0,8,1
1681903626749,ETHN 168,A00,180892,Staff,9,0,10,1
1681903627786,GLBH 20,A00,201051,Hannah; Seth Donal,0,1,0,1
1681903628819,GLBH 111,A01,209338,Burgos; Jose L.,0,0,0,0
1681903629845,GLBH 150,A00,258300,Staff,0,3,0,0
1681903630871,GLBH 181,A00,201207,Staff,15,0,40,25
1681903631902,HIEU 109,A00,180898,Staff,20,0,20,0
1681903632930,HIEU 111,A00,180899,Staff,1,0,20,19
1681903633958,HIEU 124,A00,180900,Staff,18,0,20,2
1681903634989,HILA 122,A00,180901,Staff,18,0,20,2
1681903636021,HILA 132,A00,180902,Vitz; Matthew,2,0,20,18
1681903637054,HILD 10,A01,180896,Staff,15,0,20,5
1681903638080,HILD 30GS,A00,180897,Edington; Claire Ellen,0,0,0,0
1681903639106,HISC 105,A00,180903,Staff,20,0,20,0
1681903640133,HISC 117,A00,180904,Staff,11,0,20,9
1681903641160,HIUS 108B,A00,181005,Staff,18,0,20,2
1681903642191,HIUS 113,A00,181093,Staff,4,0,20,16
1681903643224,HUM 3,A01,181190,Patterson; Patrick H.,40,0,50,10
1681903643224,HUM 3,B01,181195,Staff,47,0,50,3
1681903644254,HUM 3GS,A00,181196,Herbst; Matthew,0,0,0,0
1681903645289,HUM 4,A01,181227,West; Geoffrey Scott,34,0,50,16
1681903645289,HUM 4,B01,181282,Staff,43,0,50,7
1681903646318,HUM 4GS,A00,181377,Lyon; Antony J.,0,0,0,0
1681903647357,HUM 5,A01,181536,Zavodny; Tatiana Sophia,31,0,50,19
1681903647357,HUM 5,B01,181908,Staff,36,0,50,14
1681903648382,INTL 190,A00,181909,Segui; Alan S,0,0,0,6
1681903648382,INTL 190,B00,181961,Segui; Alan S,0,0,0,7
1681903649413,JAPN 20AR,A01,182113,Ross; Kayoko F,15,0,20,5
1681903650441,LATI 50,A01,202391,Martin-Cabrera; Luis,19,0,30,11
1681903650441,LATI 50,A02,202392,Martin-Cabrera; Luis,26,0,30,4
1681903651480,LATI 180,A00,202393,Kokinis; Troy Andreas,25,0,25,0
1681903652509,LIFR 1A,A00,182119,Staff,14,0,14,0
1681903653541,LIFR 1AX,A00,182324,Staff,14,0,14,0
1681903654573,LIFR 1B,A00,182259,Staff,14,0,14,0
1681903655599,LIFR 1BX,A00,182273,Staff,14,0,14,0
1681903656629,LIGN 8,A00,182330,Staff,137,0,150,13
1681903657662,LIGN 9GS,A00,182362,Staff,20,0,20,0
1681903658690,LIGN 119,A00,204992,Takahashi; Maho,12,0,15,3
1681903659718,LIGN 130,A01,182384,Staff,47,0,50,3
1681903660746,LIGN 149GS,A00,182390,Staff,20,0,20,0
1681903661778,LIGN 170,A00,182404,Staff,24,0,30,6
1681903662810,LISP 1D,A00,182281,Staff,7,0,14,7
1681903662810,LISP 1D,B00,182287,Staff,14,0,14,0
1681903662810,LISP 1D,C00,182295,Staff,11,0,14,3
1681903662810,LISP 1D,D00,182301,Staff,14,0,14,0
1681903663838,LISP 1DX,A00,182309,Staff,20,0,28,8
1681903663838,LISP 1DX,B00,182316,Staff,26,0,28,2
1681903664869,LTAF 120GS,A00,182412,Zhiri; Oumelbanine,20,0,20,0
1681903665901,LTCS 172GS,A00,182437,Bronstein; Phoebe Malan,20,0,20,0
1681903666933,LTEA 138,A00,182457,Staff,23,0,40,17
1681903667963,LTEN 114,A01,182490,Staff,23,0,25,2
1681903668991,LTEN 130GS,A00,182491,Lyon; Antony J.,20,0,20,0
1681903670033,LTEN 169,A00,182493,Cuong; Marisol,20,0,25,5
1681903671058,LTEN 178,A00,182501,Staff,14,0,15,1
1681903672086,LTEN 181,A00,182515,Staff,22,0,25,3
1681903673117,LTEN 185GS,A00,197655,Forbes; Camille,20,0,20,0
1681903674146,LTSP 100B,A00,202208,Bessett; Ryan Matthew,24,0,25,1
1681903675178,LTWL 100,A00,182516,Myerston Santana; Jacobo,23,0,30,7
1681903676205,LTWR 100GS,A00,182518,Forbes; Camille,20,0,20,0
1681903677232,LTWR 102,A00,182522,Staff,15,0,15,0
1681903677232,LTWR 102,B00,182525,Staff,14,0,15,1
1681903678263,LTWR 115,A00,182526,Staff,12,0,15,3
1681903679292,MAE 8,A01,182528,Pham; Hieu Tan,68,0,70,2
1681903680326,MAE 11,A00,182529,Bahadori; Mohammad Yousef,94,0,100,6
1681903681355,MAE 20,A00,182530,Evdokimenko; Ekaterina,68,0,70,2
1681903682380,MAE 30A,A00,182532,Staff,44,0,45,1
1681903683411,MAE 101A,A00,182533,Bahadori; Mohammad Yousef,97,0,100,3
1681903684437,MAE 101C,A00,182538,Staff,62,0,70,8
1681903685463,MAE 104,A00,182539,Staff,45,0,50,5
1681903686489,MAE 131A,A00,182540,Ghazinejad; Maziar,41,0,45,4
1681903687519,MAE 143A,A00,182548,Bewley; Thomas R,43,0,50,7
1681903688553,MAE 150,A00,182549,Staff,28,0,40,12
1681903689582,MAE 160,A00,182550,Evdokimenko; Ekaterina,43,0,60,17
1681903690616,MATH 3C,A01,182725,Staff,27,0,30,3
1681903691641,MATH 10A,A01,182729,Staff,25,0,30,5
1681903691641,MATH 10A,B01,182732,Staff,26,0,30,4
1681903692669,MATH 10B,A01,182737,Staff,21,0,30,9
1681903692669,MATH 10B,A02,182738,Staff,28,0,30,2
1681903692669,MATH 10B,B01,182744,Staff,27,0,30,3
1681903692669,MATH 10B,B02,182745,Staff,27,0,30,3
1681903693699,MATH 18,A01,182750,Anzaldo; Leesa B,28,0,30,2
1681903693699,MATH 18,A02,182751,Anzaldo; Leesa B,29,0,30,1
1681903693699,MATH 18,A03,182753,Anzaldo; Leesa B,28,0,30,2
1681903693699,MATH 18,A04,182757,Anzaldo; Leesa B,29,0,30,1
1681903693699,MATH 18,B01,182761,Anzaldo; Leesa B,27,0,30,3
1681903693699,MATH 18,B02,182764,Anzaldo; Leesa B,27,0,30,3
1681903693699,MATH 18,B03,182765,Anzaldo; Leesa B,30,0,30,0
1681903693699,MATH 18,B04,182766,Anzaldo; Leesa B,30,0,30,0
1681903694724,MATH 20A,A01,182771,Suk; Andrew Hoon,28,0,30,2
1681903695751,MATH 20B,A01,182775,Bach; Quang Tran,30,0,30,0
1681903695751,MATH 20B,A02,182777,Bach; Quang Tran,29,0,30,1
1681903695751,MATH 20B,B01,182780,Bach; Quang Tran,27,0,30,3
1681903695751,MATH 20B,B02,182782,Bach; Quang Tran,30,0,30,0
1681903696781,MATH 20C,A01,182787,Staff,25,0,30,5
1681903696781,MATH 20C,A02,182790,Staff,29,0,30,1
1681903696781,MATH 20C,B01,182792,Staff,25,0,30,5
1681903696781,MATH 20C,B02,182796,Staff,27,0,30,3
1681903697809,MATH 20D,A01,182799,Staff,29,0,30,1
1681903697809,MATH 20D,A02,182802,Staff,30,0,30,0
1681903697809,MATH 20D,A03,182803,Staff,30,0,30,0
1681903698837,MATH 20E,A01,182809,Verstraete; Jacques Allan,24,0,30,6
1681903698837,MATH 20E,A02,182811,Verstraete; Jacques Allan,28,0,30,2
1681903698837,MATH 20E,B01,182814,Verstraete; Jacques Allan,23,0,30,7
1681903698837,MATH 20E,B02,182815,Verstraete; Jacques Allan,30,0,30,0
1681903699862,MATH 103A,A01,182820,Staff,9,0,30,21
1681903699862,MATH 103A,A02,182821,Staff,27,0,30,3
1681903699862,MATH 103A,A03,182822,Staff,23,0,30,7
1681903699862,MATH 103A,B01,182825,Staff,23,0,30,7
1681903699862,MATH 103A,B02,182826,Staff,30,0,30,0
1681903699862,MATH 103A,B03,182830,Staff,30,0,30,0
1681903700973,MATH 109,A01,182836,Chow; Bennett,24,0,30,6
1681903700973,MATH 109,A02,182838,Chow; Bennett,29,0,30,1
1681903700973,MATH 109,A03,182894,Chow; Bennett,29,0,30,1
1681903700973,MATH 109,B01,182908,Chow; Bennett,28,0,30,2
1681903700973,MATH 109,B02,182909,Chow; Bennett,30,0,30,0
1681903700973,MATH 109,B03,182910,Chow; Bennett,27,0,30,3
1681903702012,MATH 142A,A01,182925,Staff,11,0,30,19
1681903702012,MATH 142A,A02,182935,Staff,25,0,30,5
1681903702012,MATH 142A,A03,182967,Staff,26,0,30,4
1681903702012,MATH 142A,B01,183125,Staff,24,0,30,6
1681903702012,MATH 142A,B02,183157,Staff,28,0,30,2
1681903702012,MATH 142A,B03,183158,Staff,29,0,30,1
1681903703045,MATH 183,A01,183160,Arias-Castro; Ery,23,0,30,7
1681903703045,MATH 183,A02,183161,Arias-Castro; Ery,29,0,30,1
1681903703045,MATH 183,B01,183163,Arias-Castro; Ery,28,0,30,2
1681903703045,MATH 183,B02,183164,Arias-Castro; Ery,28,0,30,2
1681903704072,MATH 193A,A01,183167,Staff,4,0,35,31
1681903704072,MATH 193A,A02,183168,Staff,28,0,35,7
1681903704072,MATH 193A,A03,183169,Staff,34,0,35,1
1681903704072,MATH 193A,A04,183170,Staff,28,0,35,7
1681903705105,MGT 4,A01,202395,Anderson; John Charles,75,0,80,5
1681903706131,MGT 5,A00,202396,Houskeeper; Robert,80,0,90,10
1681903707163,MGT 103,A00,202397,Eberhard; Craig A,55,0,90,35
1681903708193,MGT 131A,A00,202398,Houskeeper; Robert,85,0,90,5
1681903709226,MGT 135,A00,202399,Anderson; John Charles,83,0,90,7
1681903710256,MGT 162R,A00,202403,Gneezy; Uri,151,0,200,49
1681903711306,MGT 172,A00,202404,Hedges; Kathleen,50,0,90,40
1681903712335,MGT 181,A00,202405,Dunn; Louis Jean,84,0,90,6
1681903713362,MMW 14,A01,183200,Staff,16,0,28,12
1681903713362,MMW 14,A02,183201,Staff,26,0,28,2
1681903713362,MMW 14,A03,183202,Staff,24,0,28,4
1681903713362,MMW 14,A04,183203,Staff,25,0,28,3
1681903713362,MMW 14,A05,183204,Staff,26,0,28,2
1681903713362,MMW 14,A06,183205,Staff,27,0,28,1
1681903713362,MMW 14,B01,183207,Staff,26,0,28,2
1681903713362,MMW 14,B02,183208,Staff,28,0,28,0
1681903713362,MMW 14,B03,183209,Staff,28,0,28,0
1681903713362,MMW 14,B04,183210,Staff,28,0,28,0
1681903713362,MMW 14,B05,183211,Staff,28,0,28,0
1681903713362,MMW 14,B06,183212,Staff,28,0,28,0
1681903714393,MMW 14GS,A00,183213,Zhiri; Oumelbanine,28,0,28,0
1681903715421,MMW 15GS,B00,183215,Rahimi; Babak,28,0,28,0
1681903716451,MMW 121,A01,183217,Patterson; Patrick H.,14,0,28,14
1681903716451,MMW 121,A02,183218,Patterson; Patrick H.,25,0,28,3
1681903717479,MUS 1A,A01,182554,Staff,8,0,35,27
1681903718507,MUS 5,A01,182558,Staff,20,0,35,15
1681903719539,MUS 6,A01,182562,Staff,25,0,35,10
1681903720571,MUS 8GS,A00,182563,Borgo; David Garcia,25,0,25,0
1681903721612,MUS 13,A01,182567,Staff,24,0,25,1
1681903722642,MUS 15,A01,182570,Staff,32,0,35,3
1681903722642,MUS 15,B01,182575,Staff,10,0,35,25
1681903723668,MUS 80,A00,182578,Staff,23,0,25,2
1681903723668,MUS 80,B00,182581,Staff,20,0,25,5
1681903724693,MUS 113,A00,182582,Staff,25,0,25,0
1681903725719,MUS 114,A00,182583,Staff,4,0,25,21
1681903726745,MUS 150GS,A01,182588,Borgo; David Garcia,25,0,25,0
1681903727781,PHIL 1,A00,182590,Staff,35,0,40,5
1681903728808,PHIL 10,A01,182596,Grush; Rick Scott,31,0,35,4
1681903728808,PHIL 10,A02,182597,Grush; Rick Scott,34,0,35,1
1681903729838,PHIL 15,A01,182601,Staff,31,0,35,4
1681903729838,PHIL 15,A02,182602,Staff,33,0,35,2
1681903730863,PHIL 27,A01,182604,Staff,30,0,35,5
1681903730863,PHIL 27,A02,182607,Staff,35,0,35,0
1681903731892,PHIL 32,A01,182609,Staff,35,0,35,0
1681903731892,PHIL 32,A02,182612,Staff,35,0,35,0
1681903732921,PHIL 130,A00,182614,Staff,63,0,70,7
1681903733947,PHIL 136,A00,182616,Cohen; Jonathan David,66,0,70,4
1681903734981,PHIL 155,A00,182617,Vargas; Manuel Rogelio,60,0,70,10
1681903736008,PHIL 163,A01,182620,Staff,15,0,20,5
1681903736008,PHIL 163,A02,182624,Staff,10,0,20,10
1681903737034,PHIL 164,A00,182627,Staff,30,0,40,10
1681903738063,PHIL 173,A00,182628,Staff,36,0,40,4
1681903739089,PHYS 1A,A00,183221,Staff,54,0,60,6
1681903740121,PHYS 1AL,001,183222,Staff,25,0,30,5
1681903740121,PHYS 1AL,002,183223,Staff,28,0,30,2
1681903741147,PHYS 1B,A00,183231,Staff,44,0,60,16
1681903742176,PHYS 1BL,001,183232,Staff,20,0,30,10
1681903742176,PHYS 1BL,002,183233,Staff,29,0,30,1
1681903743201,PHYS 1C,A00,183240,Staff,30,0,60,30
1681903744227,PHYS 1CL,001,183241,Staff,13,0,30,17
1681903744227,PHYS 1CL,002,183242,Staff,22,0,30,8
1681903745260,PHYS 2AR,A01,183250,Staff,44,0,50,6
1681903746288,PHYS 2B,A01,183252,Staff,106,0,115,9
1681903747317,PHYS 2BL,A01,183254,Staff,21,0,24,3
1681903747317,PHYS 2BL,A02,183255,Staff,22,0,24,2
1681903748348,PHYS 2C,A01,183522,Staff,105,0,115,10
1681903749379,PHYS 4A,A01,183524,Staff,49,0,50,1
1681903750408,POLI 5,A00,183525,Staff,44,0,50,6
1681903751436,POLI 12,A00,183540,Staff,48,0,50,2
1681903752462,POLI 13R,A00,183541,Forman; Fonna,42,0,50,8
1681903753490,POLI 30,A00,183542,Mignozzetti; Umberto,47,0,50,3
1681903754525,POLI 100A,A00,183543,Staff,45,0,50,5
1681903755550,POLI 100E,A00,223598,Staff,32,0,35,3
1681903756575,POLI 103A,A00,183564,Kousser; Thad,38,0,50,12
1681903757602,POLI 104B,A00,201329,Staff,29,0,35,6
1681903758627,POLI 113BR,A00,183576,Hoston; Germaine,28,0,50,22
1681903759652,POLI 114BR,A00,183588,Staff,27,0,30,3
1681903760678,POLI 117R,A00,183595,Forman; Fonna,9,0,20,11
1681903761704,POLI 120H,A00,183596,Fisk; David Lee,13,0,20,7
1681903762732,POLI 130AA,A00,183597,Staff,14,0,20,6
1681903763758,POLI 134AA,A00,183598,Staff,19,0,20,1
1681903764785,POLI 135,A00,183599,Fisk; David Lee,20,0,25,5
1681903765821,POLI 142P,A00,183623,Staff,37,0,40,3
1681903766848,POLI 144D,A00,183624,Staff,22,0,25,3
1681903767877,POLI 151,A00,183625,Staff,15,0,20,5
1681903768904,POLI 162,A00,183626,Mignozzetti; Umberto,18,0,20,2
1681903769930,PSYC 1,A00,253748,Staff,86,0,90,4
1681903770955,PSYC 2,A00,183627,Moranton; Nirelia Melbina-,25,0,35,10
1681903771982,PSYC 3,A00,183628,Staff,43,0,45,2
1681903774040,PSYC 60,A01,183631,Lowe; Angela Beth,35,0,40,5
1681903775071,PSYC 70,A01,253757,Staff,37,0,45,8
1681903776097,PSYC 101,A00,183632,Heyman; Gail D.,48,0,60,12
1681903777121,PSYC 105,A00,183848,Lowe; Angela Beth,50,0,60,10
1681903778151,PSYC 106,A00,183849,Dobkins; Karen R.,45,0,60,15
1681903779180,PSYC 108,A00,253750,Staff,24,0,60,36
1681903780206,PSYC 114,A01,184275,Winkielman; Piotr,0,6,30,30
1681903781258,PSYC 122,A00,183856,Moranton; Nirelia Melbina-,0,10,30,30
1681903782284,PSYC 124,A00,183865,Chapman; Eddie Nathaniel,52,0,80,28
1681903783319,PSYC 137,A00,183880,Staff,19,0,25,6
1681903785375,PSYC 154,A00,183910,Lacefield; Katharine I,0,2,90,90
1681903787431,PSYC 162,A00,183946,Wixted; John T,61,0,90,29
1681903788458,PSYC 172,A00,183947,Gorman; Michael R.,14,0,30,16
1681903789483,PSYC 178,A00,183963,Glaser; Dale,20,0,40,20
1681903790510,PSYC 181GS,A00,183964,Anagnostaras; Stephan,10,0,10,0
1681903791537,PSYC 186GS,A01,257660,Staff,10,0,10,0
1681903792566,PSYC 193,B00,253749,Staff,23,0,25,2
1681903794629,PSYC 193L,A01,184122,Staff,33,0,35,2
1681903794629,PSYC 193L,C01,184167,Winkielman; Piotr,16,0,30,14
1681903795658,RELI 188GS,A00,182629,Rahimi; Babak,20,0,20,0
1681903796694,SE 101A,A00,182646,Staff,26,0,30,4
1681903797726,SE 101C,A00,182650,Staff,18,0,20,2
1681903798752,SE 110A,A00,182651,Staff,28,0,28,0
1681903799775,SE 130A,A00,182652,Staff,39,0,40,1
1681903800803,SIO 46GS,A00,182636,Cook; Geoffrey W,28,0,28,0
1681903801827,SIO 109R,A00,194459,Staff,5,0,20,15
1681903802853,SIO 121GS,A00,182639,Cook; Geoffrey W,28,0,28,0
1681903803881,SIO 132,A01,182642,Staff,32,0,40,8
1681903804982,SIO 139,A00,182644,Kacev; David,36,0,40,4
1681903806008,SOCI 2,A01,258404,Staff,34,0,36,2
1681903806008,SOCI 2,A02,258405,Staff,35,0,36,1
1681903807037,SOCI 60,A01,258408,Staff,29,0,30,1
1681903807037,SOCI 60,A02,258413,Staff,30,0,30,0
1681903808072,SOCI 100,A01,258415,Staff,29,0,30,1
1681903808072,SOCI 100,A02,258416,Staff,28,0,30,2
1681903814239,SOCI 127,A00,258421,Staff,22,0,30,8
1681903815266,SOCI 132,A00,258422,Staff,45,0,50,5
1681903816293,SOCI 133,A00,258423,Staff,26,0,30,4
1681903817317,SOCI 138GS,A00,258424,Staff,15,0,15,0
1681903818345,SOCI 145,A00,258425,Staff,25,0,30,5
1681903819371,SOCI 148,A00,258426,Staff,26,0,30,4
1681903820401,SOCI 153,A00,199217,Staff,29,0,30,1
1681903821431,SOCI 160,A00,258427,Staff,28,0,30,2
1681903822456,SOCI 160E,A00,258435,Staff,56,0,60,4
1681903823482,SOCI 189GS,A00,258436,Staff,15,0,15,0
1681903824506,SOCI 190GS,A00,258437,Staff,15,0,15,0
1681903825544,SYN 2,001,182658,Staff,9,0,16,7
1681903825544,SYN 2,002,201439,Staff,15,0,16,1
1681903825544,SYN 2,003,201443,Staff,16,0,16,0
1681903826567,SYN 100,A01,182657,Staff,17,0,20,3
1681903827605,TDAC 1,A00,184381,Salovey; Todd,16,0,20,4
1681903827605,TDAC 1,B00,184385,Harting; Carla Kelso,19,0,20,1
1681903827605,TDAC 1,C00,184394,Staff,19,0,20,1
1681903828633,TDAC 101,A00,184483,Harting; Carla Kelso,19,0,20,1
1681903829656,TDDE 111,A00,184496,Staff,14,0,15,1
1681903830684,TDDE 131,A00,184504,Staff,20,0,20,0
1681903830684,TDDE 131,B00,184505,Staff,17,0,18,1
1681903830684,TDDE 131,C00,184534,Staff,49,0,50,1
1681903830684,TDDE 131,D00,184564,Staff,15,0,15,0
1681903830684,TDDE 131,E00,204725,Staff,19,0,20,1
1681903831715,TDGE 1,A01,184414,Salovey; Todd,37,0,50,13
1681903832743,TDGE 5,A01,184419,Staff,23,0,24,1
1681903833773,TDGE 10,A00,184428,Fulton; Julia,31,0,50,19
1681903834800,TDGE 124,A00,184565,Fulton; Julia,7,0,50,43
1681903835828,TDGE 125,B00,184567,Meyer; Ursula,9,0,25,16
1681903836859,TDHT 101,A00,184568,Staff,21,0,25,4
1681903836859,TDHT 101,B00,184569,Staff,20,0,20,0
1681903837886,TDHT 114,A00,184570,Staff,49,0,50,1
1681903838918,TDMV 1,A00,184437,Arcidiacono; Kristin,23,0,30,7
1681903838918,TDMV 1,B00,184448,Caligagan; Maria T.,22,0,30,8
1681903839947,TDMV 2,A00,184449,Weinberg; Sadie,27,0,30,3
1681903839947,TDMV 2,B00,184453,Arcidiacono; Kristin,29,0,30,1
1681903840974,TDMV 110,A00,184571,Weinberg; Sadie,30,0,30,0
1681903842001,TDMV 142,A00,184572,Caligagan; Tony,27,0,30,3
1681903842001,TDMV 142,B00,184573,Caligagan; Maria T.,27,0,30,3
1681903843031,TDTR 20,A00,184482,Jun; Grace Shin Hae,25,0,25,0
1681903844056,USP 2,A01,184290,Hinds; Juli Beth,24,0,25,1
1681903845089,USP 3,A01,184295,Staff,20,0,25,5
1681903846116,USP 4,A00,184304,McTague; Sarah,15,0,25,10
1681903847146,USP 100,A00,184315,Staff,17,0,25,8
1681903848181,USP 105,A00,184326,Staff,21,0,25,4
1681903849204,USP 151,A00,184327,Staff,20,0,25,5
1681903850230,USP 170,A00,184380,Hinds; Juli Beth,14,0,25,11
1681903851260,VIS 21B,A01,182660,Staff,28,0,31,3
1681903851260,VIS 21B,A02,182662,Staff,30,0,31,1
1681903852286,VIS 103D,A00,182663,Staff,74,0,75,1
1681903853316,VIS 105D,A00,182667,Li; Huai,15,0,22,7
1681903854343,VIS 122GS,A00,182668,Herbst; Matthew,20,0,20,0
1681903855369,VIS 128C,A00,182673,Staff,70,0,75,5
1681903856397,VIS 130,A00,182675,Staff,20,0,22,2
1681903857427,VIS 160A,A00,182678,Stalbaum; Brett,4,0,10,6
1681903859479,WCWP 10B,A00,201679,Staff,15,0,15,0
1681903859479,WCWP 10B,B00,201695,Staff,15,0,15,0
1681903860510,WCWP 100,A00,201716,Staff,15,0,15,0
1681903860510,WCWP 100,B00,201717,Staff,11,0,15,4
1681903862727,ANSC 105GS,A00,258289,Staff,0,0,0,0
1681903863754,ANSC 125GS,A00,258295,Staff,0,0,0,0
1681903864780,ANSC 150,A00,258267,Staff,30,0,40,10
1681903865805,ANSC 190GS,A00,258280,Staff,0,0,0,0
1681903866838,ANTH 1,A00,258264,Staff,38,0,40,2
1681903867867,ANTH 2,A01,258259,Staff,72,0,76,4
1681903868894,ANTH 23,A01,258228,Staff,36,0,40,4
1681903869930,ANTH 101,A01,258236,Staff,39,0,40,1
1681903870958,ANTH 102,A00,258272,Staff,59,0,60,1
1681903871985,ANTH 105,A00,258244,Staff,31,0,35,4
1681903873011,BENG 130,A00,253975,Staff,38,0,40,2
1681903874045,BIBC 102,A01,191866,Flagg; Matthew Paul,19,0,32,13
1681903874045,BIBC 102,A02,191867,Flagg; Matthew Paul,22,0,32,10
1681903874045,BIBC 102,A03,191868,Flagg; Matthew Paul,30,0,32,2
1681903874045,BIBC 102,A04,191936,Flagg; Matthew Paul,26,0,32,6
1681903874045,BIBC 102,A05,191937,Flagg; Matthew Paul,11,0,32,21
1681903875073,BICD 100,A01,191939,Cooper; Andrew Michael,28,0,32,4
1681903875073,BICD 100,A02,191940,Cooper; Andrew Michael,32,0,32,0
1681903875073,BICD 100,A03,191941,Cooper; Andrew Michael,32,0,32,0
1681903875073,BICD 100,A04,191942,Cooper; Andrew Michael,32,0,32,0
1681903875073,BICD 100,A05,191943,Cooper; Andrew Michael,32,0,32,0
1681903876098,BIEB 126,A01,191945,Cleland; Elsa Eleanor,1,0,32,31
1681903876098,BIEB 126,A02,191946,Cleland; Elsa Eleanor,28,0,32,4
1681903876098,BIEB 126,A03,191947,Cleland; Elsa Eleanor,29,0,32,3
1681903876098,BIEB 126,A04,191948,Cleland; Elsa Eleanor,23,0,32,9
1681903876098,BIEB 126,A05,191996,Cleland; Elsa Eleanor,28,0,32,4
1681903877140,BIEB 136GS,A00,191997,Shurin; Jonathan & Holway; David A.,0,0,0,0
1681903878164,BIEB 137GS,A01,191999,Shurin; Jonathan & Holway; David A.,0,0,0,0
1681903879190,BILD 1,A01,205385,Staff,31,0,32,1
1681903879190,BILD 1,A02,205386,Staff,30,0,32,2
1681903879190,BILD 1,A03,205387,Staff,32,0,32,0
1681903879190,BILD 1,A04,205388,Staff,28,0,32,4
1681903880222,BILD 2,A01,191774,Staff,28,0,32,4
1681903880222,BILD 2,A02,191775,Staff,30,0,32,2
1681903880222,BILD 2,A03,191777,Staff,30,0,32,2
1681903880222,BILD 2,A04,191856,Staff,31,0,32,1
1681903880222,BILD 2,A05,191857,Staff,32,0,32,0
1681903880222,BILD 2,A06,191858,Staff,32,0,32,0
1681903880222,BILD 2,A07,191859,Staff,31,0,32,1
1681903881246,BILD 3,A01,205391,Staff,29,0,32,3
1681903881246,BILD 3,A02,205393,Staff,32,0,32,0
1681903881246,BILD 3,A03,205394,Staff,28,0,32,4
1681903881246,BILD 3,A04,205395,Staff,32,0,32,0
1681903882271,BILD 20,A01,191861,Staff,32,0,32,0
1681903882271,BILD 20,A02,191862,Staff,32,0,32,0
1681903883301,BILD 30,A01,191864,Staff,31,0,32,1
1681903884327,BIMM 100,A01,192019,Staff,0,0,32,32
1681903884327,BIMM 100,A02,192020,Staff,23,0,32,9
1681903884327,BIMM 100,A03,192035,Staff,22,0,32,10
1681903885356,BIMM 110,A01,192037,Tat; John,0,0,32,32
1681903885356,BIMM 110,A02,192038,Tat; John,10,0,32,22
1681903886384,BIMM 120,A01,192040,Pickett; Brooke Elizabeth,2,0,32,30
1681903886384,BIMM 120,A02,192041,Pickett; Brooke Elizabeth,16,0,32,16
1681903886384,BIMM 120,A03,192042,Pickett; Brooke Elizabeth,16,0,32,16
1681903887411,BIPN 100,A01,192044,Armour; Jon Christopher,26,0,32,6
1681903887411,BIPN 100,A02,192059,Armour; Jon Christopher,30,0,32,2
1681903887411,BIPN 100,A03,192064,Armour; Jon Christopher,31,0,32,1
1681903887411,BIPN 100,A04,192073,Armour; Jon Christopher,28,0,32,4
1681903888439,BIPN 148,A01,205411,Leutgeb; Jill K.,16,0,32,16
1681903888439,BIPN 148,A02,205412,Leutgeb; Jill K.,31,0,32,1
1681903888439,BIPN 148,A03,205413,Leutgeb; Jill K.,30,0,32,2
1681903888439,BIPN 148,A04,205414,Leutgeb; Jill K.,30,0,32,2
1681903889471,BIPN 160,A01,192115,Marino; Marc J,19,0,32,13
1681903889471,BIPN 160,A02,192148,Marino; Marc J,27,0,32,5
1681903889471,BIPN 160,A03,192158,Marino; Marc J,31,0,32,1
1681903889471,BIPN 160,A04,192190,Marino; Marc J,32,0,32,0
1681903889471,BIPN 160,A05,192287,Marino; Marc J,32,0,32,0
1681903889471,BIPN 160,A06,192288,Marino; Marc J,32,0,32,0
1681903890495,BIPN 194,A00,206038,Staff,28,0,32,4
1681903891529,BISP 194,A00,192289,Leutgeb; Stefan,13,0,32,19
1681903891529,BISP 194,B00,245332,Nieh; James Charles,27,0,32,5
1681903892558,CAT 124,A01,202247,Staff,15,0,15,0
1681903893585,CAT 125,A00,202248,Staff,19,0,20,1
1681903893585,CAT 125,B00,202253,Staff,20,0,20,0
1681903893585,CAT 125,C00,202257,Staff,19,0,20,1
1681903894614,CAT 125GS,A01,202273,Bronstein; Phoebe Malan,20,0,20,0
1681903895646,CAT 125R,A00,202284,Staff,17,0,20,3
1681903895646,CAT 125R,C00,202286,Staff,10,0,20,10
1681903895646,CAT 125R,D00,202291,Staff,18,0,20,2
1681903895646,CAT 125R,E00,202295,Staff,13,0,20,7
1681903895646,CAT 125R,F00,202302,Staff,12,0,20,8
1681903896672,CENG 100,A00,204724,Opatkiewicz; Justin Paul,25,0,25,0
1681903897698,CGS 2A,A01,180420,Staff,31,0,36,5
1681903898723,CGS 101,A00,180421,Staff,16,0,20,4
1681903899751,CGS 112,A00,180422,Staff,10,0,16,6
1681903900776,CGS 113,A00,180423,Staff,18,0,20,2
1681903901800,CGS 137,A00,180424,Staff,12,0,12,0
1681903902826,CGS 147,A00,180425,Staff,10,0,10,0
1681903903859,CHEM 6A,A01,179556,Staff,97,0,100,3
1681903903859,CHEM 6A,A02,179558,Staff,0,0,0,0
1681903904885,CHEM 6B,A01,179560,Staff,100,0,100,0
1681903905911,CHEM 6C,A01,179565,Jazzar; Rodolphe,95,0,100,5
1681903906945,CHEM 7L,A01,179586,Schurmeier; Kimberly,13,0,24,11
1681903906945,CHEM 7L,A02,179587,Schurmeier; Kimberly,23,0,24,1
1681903906945,CHEM 7L,A03,179590,Schurmeier; Kimberly,22,0,24,2
1681903906945,CHEM 7L,A04,179591,Schurmeier; Kimberly,22,0,24,2
1681903906945,CHEM 7L,B01,179598,Schurmeier; Kimberly,17,0,24,7
1681903906945,CHEM 7L,B02,179599,Schurmeier; Kimberly,24,0,24,0
1681903906945,CHEM 7L,B03,179606,Schurmeier; Kimberly,23,0,24,1
1681903906945,CHEM 7L,B04,179607,Schurmeier; Kimberly,23,0,24,1
1681903907975,CHEM 11,A01,179609,Stallings; Dontarie M,88,0,100,12
1681903909075,CHEM 40A,A01,179621,Staff,41,0,50,9
1681903909075,CHEM 40A,A02,179622,Staff,47,0,50,3
1681903910100,CHEM 40B,A01,179630,Weizman; Haim,48,0,50,2
1681903910100,CHEM 40B,A02,179631,Weizman; Haim,45,0,50,5
1681903911127,CHEM 41A,A01,179660,Klosterman; Jeremy K,93,0,100,7
1681903912168,CHEM 43A,A01,179683,Klosterman; Jeremy K,0,0,24,24
1681903912168,CHEM 43A,A02,179688,Klosterman; Jeremy K,14,0,24,10
1681903912168,CHEM 43A,A03,179689,Klosterman; Jeremy K,20,0,24,4
1681903912168,CHEM 43A,A04,179691,Klosterman; Jeremy K,18,0,24,6
1681903913196,CHEM 114A,A01,179693,Stallings; Dontarie M,77,0,100,23
1681903914235,CHEM 143B,A01,179698,Weizman; Haim,17,0,24,7
1681903914235,CHEM 143B,A02,179700,Weizman; Haim,24,0,24,0
1681903915266,CHIN 169A,A00,179701,Wang; Xiao,20,0,20,0
1681903916292,COGS 2,A01,179750,Boyle; Mary E. T.,17,0,30,13
1681903917323,COGS 9,A01,179759,Jones; Cameron Robert,43,0,50,7
1681903918349,COGS 14A,A01,179854,Staff,18,0,50,32
1681903919378,COGS 14B,A01,179856,Staff,54,0,60,6
1681903920405,COGS 17,A01,179874,Staff,71,0,75,4
1681903921434,COGS 18,A01,179884,Staff,63,0,80,17
1681903922458,COGS 100,A01,179886,Staff,40,0,60,20
1681903923484,COGS 101B,A01,179892,Staff,1,0,30,29
1681903924517,COGS 101C,A01,179894,Staff,28,0,30,2
1681903925546,COGS 107A,A01,179896,Boyle; Mary E. T.,31,0,40,9
1681903926569,COGS 108,A01,179898,Simpkins; Charles Alexander,0,17,60,60
1681903927598,COGS 109,A01,179900,Staff,34,0,40,6
1681903928622,COGS 118A,A01,179946,Staff,9,0,40,31
1681903929647,COGS 153,A00,179978,Staff,1,0,30,29
1681903930683,COGS 156,A01,179981,Staff,27,0,30,3
1681903932736,COGS 172,A01,179987,Staff,13,0,30,17
1681903934795,COGS 186,A01,179991,Staff,13,0,30,17
1681903935831,COMM 10,A01,180001,Staff,15,0,25,10
1681903935831,COMM 10,A02,180004,Staff,20,0,25,5
1681903936856,COMM 100A,A01,180016,Staff,18,0,25,7
1681903936856,COMM 100A,A02,180020,Staff,24,0,25,1
1681903937881,COMM 101T,A00,180029,Halm; Gavin Patrick,23,0,35,12
1681903938908,COMM 106V,A00,180043,Staff,34,0,35,1
1681903939947,COMM 109P,A00,180044,Staff,31,0,35,4
1681903940972,COMM 113T,A00,180045,Havis; Allan,37,0,45,8
1681903941996,COMM 132,A00,180046,McKenna; Denise,23,0,30,7
1681903943024,COMM 143,A00,180047,Staff,19,0,30,11
1681903944054,COMM 190,A00,180048,Conner; Thomas Hartnell,20,0,23,3
1681903945079,CSE 8A,A50,180053,Cao; Yingjun,25,0,50,25
1681903945079,CSE 8A,B50,180180,Staff,50,0,50,0
1681903946102,CSE 11,A01,180190,Cao; Yingjun,31,0,50,19
1681903947133,CSE 20,A01,180192,Briones; Jor-el Thomas Caparas,23,0,30,7
1681903948158,CSE 21,A01,194538,Briones; Jor-el Thomas Caparas,50,0,60,10
1681903949187,CSE 30,A01,180324,Eldon; John,79,0,100,21
1681903950210,CSE 101,A01,201353,Staff,0,20,40,40
1681903951234,CSE 134B,A01,180326,Powell; Thomas Allan,74,0,100,26
1681903952259,CSE 140,A01,180328,Staff,46,0,75,29
1681903953283,CSE 140L,A01,180344,Eldon; John,69,0,100,31
1681903954309,CSE 150A,A01,180411,Staff,0,7,50,50
1681903955332,CSE 151A,A01,180414,Staff,0,6,50,50
1681903956355,CSE 175,A01,222521,Kumar; Rakesh,50,0,50,0
1681903957383,CSE 190,A00,201419,Staff,45,0,49,4
1681903969324,CSS 1,A01,194536,Staff,38,0,50,12
1681903970349,DSC 30,A01,202385,Staff,48,0,50,2
1681903971384,DSC 40A,A01,202387,Albuyeh; Rod,50,0,50,0
1681903972414,DSC 190,A01,202389,Silberman; Jack,21,0,21,0
1681903973438,DSGN 100,A01,179993,Staff,16,0,30,14
1681903974471,ECE 65,A50,180708,Staff,10,0,20,10
1681903974471,ECE 65,A51,180739,Staff,19,0,20,1
1681903975501,ECON 1,A01,180427,Famulari; Melissa,67,0,70,3
1681903976529,ECON 2,A01,180450,Levkoff; Steven B.,64,0,70,6
1681903977554,ECON 4,A01,203351,Anderson; John Charles,7,0,10,3
1681903978577,ECON 100A,A01,180472,Famulari; Melissa,65,0,70,5
1681903979709,ECON 120A,A01,180549,Staff,64,0,70,6
1681903992194,ECON 120B,A01,180655,Ma; Xinwei,46,0,70,24
1681903993230,ECON 129,A00,203333,Eckert; Fabian Paul,15,0,35,20
1681903994256,ECON 131,A00,180656,Staff,10,0,35,25
1681903995284,ECON 172B,A01,180672,Levkoff; Steven B.,32,0,35,3
1681903996309,ECON 178,A01,203342,Zhu; Ying,11,0,35,24
1681903997350,EDS 108GS,A00,202383,Wishard Guerra; Alison G.,20,0,20,0
1681903998374,EDS 111GS,A00,202347,Wishard Guerra; Alison G.,20,0,20,0
1681903999400,EDS 112,A01,202323,Staff,56,0,60,4
1681904000426,EDS 113,A00,202340,Staff,33,0,35,2
1681904001501,EDS 118,A00,201231,Staff,20,0,30,10
1681904013993,EDS 119,A00,204994,Staff,8,0,10,2
1681904015023,EDS 124BR,A00,202324,Eguchi; Emi,5,0,25,20
1681904016048,EDS 126,A01,203208,Jones; Makeba,26,0,30,4
1681904017078,EDS 135,A01,202333,Staff,18,0,20,2
1681904018102,EDS 180,A00,202311,Staff,47,0,50,3
1681904019127,ERC 190GS,A01,253747,Staff,28,0,28,0
1681904020150,ETHN 104,A00,180742,Staff,24,0,35,11
1681904021183,ETHN 118,A00,180745,Staff,28,0,35,7
1681904022208,ETHN 127,A00,180747,Staff,12,0,16,4
1681904023232,ETHN 137,A00,180880,Staff,12,0,12,0
1681904035375,ETHN 147,A00,180890,Staff,8,0,10,2
1681904036403,ETHN 154,A00,180891,Staff,7,0,8,1
1681904037426,ETHN 168,A00,180892,Staff,9,0,10,1
1681904038452,GLBH 20,A00,201051,Hannah; Seth Donal,0,1,0,1
1681904039481,GLBH 111,A01,209338,Burgos; Jose L.,0,0,0,0
1681904040506,GLBH 150,A00,258300,Staff,0,3,0,0
1681904041530,GLBH 181,A00,201207,Staff,15,0,40,25
1681904042557,HIEU 109,A00,180898,Staff,20,0,20,0
1681904043581,HIEU 111,A00,180899,Staff,1,0,20,19
1681904044607,HIEU 124,A00,180900,Staff,18,0,20,2
1681904056881,HILA 122,A00,180901,Staff,18,0,20,2
1681904057909,HILA 132,A00,180902,Vitz; Matthew,2,0,20,18
1681904058936,HILD 10,A01,180896,Staff,15,0,20,5
1681904059966,HILD 30GS,A00,180897,Edington; Claire Ellen,0,0,0,0
1681904060990,HISC 105,A00,180903,Staff,20,0,20,0
1681904062014,HISC 117,A00,180904,Staff,11,0,20,9
1681904063041,HIUS 108B,A00,181005,Staff,18,0,20,2
1681904064075,HIUS 113,A00,181093,Staff,4,0,20,16
1681904065101,HUM 3,A01,181190,Patterson; Patrick H.,40,0,50,10
1681904065101,HUM 3,B01,181195,Staff,47,0,50,3
1681904066127,HUM 3GS,A00,181196,Herbst; Matthew,0,0,0,0
1681904078621,HUM 4,A01,181227,West; Geoffrey Scott,34,0,50,16
1681904078621,HUM 4,B01,181282,Staff,43,0,50,7
1681904079649,HUM 4GS,A00,181377,Lyon; Antony J.,0,0,0,0
1681904080745,HUM 5,A01,181536,Zavodny; Tatiana Sophia,31,0,50,19
1681904080745,HUM 5,B01,181908,Staff,36,0,50,14
1681904081770,INTL 190,A00,181909,Segui; Alan S,0,0,0,6
1681904081770,INTL 190,B00,181961,Segui; Alan S,0,0,0,7
1681904082802,JAPN 20AR,A01,182113,Ross; Kayoko F,15,0,20,5
1681904083829,LATI 50,A01,202391,Martin-Cabrera; Luis,19,0,30,11
1681904083829,LATI 50,A02,202392,Martin-Cabrera; Luis,26,0,30,4
1681904084855,LATI 180,A00,202393,Kokinis; Troy Andreas,25,0,25,0
1681904085878,LIFR 1A,A00,182119,Staff,14,0,14,0
1681904086900,LIFR 1AX,A00,182324,Staff,14,0,14,0
1681904087925,LIFR 1B,A00,182259,Staff,14,0,14,0
1681904100740,LIFR 1BX,A00,182273,Staff,14,0,14,0
1681904101765,LIGN 8,A00,182330,Staff,137,0,150,13
1681904102789,LIGN 9GS,A00,182362,Staff,20,0,20,0
1681904103818,LIGN 119,A00,204992,Takahashi; Maho,12,0,15,3
1681904104845,LIGN 130,A01,182384,Staff,47,0,50,3
1681904105875,LIGN 149GS,A00,182390,Staff,20,0,20,0
1681904106910,LIGN 170,A00,182404,Staff,24,0,30,6
1681904107941,LISP 1D,A00,182281,Staff,7,0,14,7
1681904107941,LISP 1D,B00,182287,Staff,14,0,14,0
1681904107941,LISP 1D,C00,182295,Staff,11,0,14,3
1681904107941,LISP 1D,D00,182301,Staff,14,0,14,0
1681904108974,LISP 1DX,A00,182309,Staff,20,0,28,8
1681904108974,LISP 1DX,B00,182316,Staff,26,0,28,2
1681904110004,LTAF 120GS,A00,182412,Zhiri; Oumelbanine,20,0,20,0
1681904114642,LTCS 172GS,A00,182437,Bronstein; Phoebe Malan,20,0,20,0
1681904115666,LTEA 138,A00,182457,Staff,23,0,40,17
1681904116690,LTEN 114,A01,182490,Staff,23,0,25,2
1681904117727,LTEN 130GS,A00,182491,Lyon; Antony J.,20,0,20,0
1681904118752,LTEN 169,A00,182493,Cuong; Marisol,20,0,25,5
1681904119778,LTEN 178,A00,182501,Staff,14,0,15,1
1681904120803,LTEN 181,A00,182515,Staff,22,0,25,3
1681904121830,LTEN 185GS,A00,197655,Forbes; Camille,20,0,20,0
1681904122860,LTSP 100B,A00,202208,Bessett; Ryan Matthew,24,0,25,1
1681904123885,LTWL 100,A00,182516,Myerston Santana; Jacobo,23,0,30,7
1681904124914,LTWR 100GS,A00,182518,Forbes; Camille,20,0,20,0
1681904125938,LTWR 102,A00,182522,Staff,15,0,15,0
1681904125938,LTWR 102,B00,182525,Staff,14,0,15,1
1681904126963,LTWR 115,A00,182526,Staff,12,0,15,3
1681904127995,MAE 8,A01,182528,Pham; Hieu Tan,68,0,70,2
1681904129020,MAE 11,A00,182529,Bahadori; Mohammad Yousef,94,0,100,6
1681904130048,MAE 20,A00,182530,Evdokimenko; Ekaterina,68,0,70,2
1681904131071,MAE 30A,A00,182532,Staff,44,0,45,1
1681904132097,MAE 101A,A00,182533,Bahadori; Mohammad Yousef,97,0,100,3
1681904133122,MAE 101C,A00,182538,Staff,62,0,70,8
1681904134147,MAE 104,A00,182539,Staff,45,0,50,5
1681904135183,MAE 131A,A00,182540,Ghazinejad; Maziar,41,0,45,4
1681904136212,MAE 143A,A00,182548,Bewley; Thomas R,43,0,50,7
1681904137241,MAE 150,A00,182549,Staff,28,0,40,12
1681904138263,MAE 160,A00,182550,Evdokimenko; Ekaterina,43,0,60,17
1681904139286,MATH 3C,A01,182725,Staff,27,0,30,3
1681904140321,MATH 10A,A01,182729,Staff,25,0,30,5
1681904140321,MATH 10A,B01,182732,Staff,26,0,30,4
1681904141347,MATH 10B,A01,182737,Staff,21,0,30,9
1681904141347,MATH 10B,A02,182738,Staff,28,0,30,2
1681904141347,MATH 10B,B01,182744,Staff,27,0,30,3
1681904141347,MATH 10B,B02,182745,Staff,27,0,30,3
1681904142373,MATH 18,A01,182750,Anzaldo; Leesa B,28,0,30,2
1681904142373,MATH 18,A02,182751,Anzaldo; Leesa B,29,0,30,1
1681904142373,MATH 18,A03,182753,Anzaldo; Leesa B,28,0,30,2
1681904142373,MATH 18,A04,182757,Anzaldo; Leesa B,29,0,30,1
1681904142373,MATH 18,B01,182761,Anzaldo; Leesa B,27,0,30,3
1681904142373,MATH 18,B02,182764,Anzaldo; Leesa B,27,0,30,3
1681904142373,MATH 18,B03,182765,Anzaldo; Leesa B,30,0,30,0
1681904142373,MATH 18,B04,182766,Anzaldo; Leesa B,30,0,30,0
1681904143401,MATH 20A,A01,182771,Suk; Andrew Hoon,28,0,30,2
1681904144431,MATH 20B,A01,182775,Bach; Quang Tran,30,0,30,0
1681904144431,MATH 20B,A02,182777,Bach; Quang Tran,29,0,30,1
1681904144431,MATH 20B,B01,182780,Bach; Quang Tran,27,0,30,3
1681904144431,MATH 20B,B02,182782,Bach; Quang Tran,30,0,30,0
1681904145459,MATH 20C,A01,182787,Staff,25,0,30,5
1681904145459,MATH 20C,A02,182790,Staff,29,0,30,1
1681904145459,MATH 20C,B01,182792,Staff,25,0,30,5
1681904145459,MATH 20C,B02,182796,Staff,27,0,30,3
1681904146484,MATH 20D,A01,182799,Staff,29,0,30,1
1681904146484,MATH 20D,A02,182802,Staff,30,0,30,0
1681904146484,MATH 20D,A03,182803,Staff,30,0,30,0
1681904147510,MATH 20E,A01,182809,Verstraete; Jacques Allan,24,0,30,6
1681904147510,MATH 20E,A02,182811,Verstraete; Jacques Allan,28,0,30,2
1681904147510,MATH 20E,B01,182814,Verstraete; Jacques Allan,23,0,30,7
1681904147510,MATH 20E,B02,182815,Verstraete; Jacques Allan,30,0,30,0
1681904148538,MATH 103A,A01,182820,Staff,9,0,30,21
1681904148538,MATH 103A,A02,182821,Staff,27,0,30,3
1681904148538,MATH 103A,A03,182822,Staff,23,0,30,7
1681904148538,MATH 103A,B01,182825,Staff,23,0,30,7
1681904148538,MATH 103A,B02,182826,Staff,30,0,30,0
1681904148538,MATH 103A,B03,182830,Staff,30,0,30,0
1681904149569,MATH 109,A01,182836,Chow; Bennett,24,0,30,6
1681904149569,MATH 109,A02,182838,Chow; Bennett,29,0,30,1
1681904149569,MATH 109,A03,182894,Chow; Bennett,29,0,30,1
1681904149569,MATH 109,B01,182908,Chow; Bennett,28,0,30,2
1681904149569,MATH 109,B02,182909,Chow; Bennett,30,0,30,0
1681904149569,MATH 109,B03,182910,Chow; Bennett,27,0,30,3
1681904150597,MATH 142A,A01,182925,Staff,11,0,30,19
1681904150597,MATH 142A,A02,182935,Staff,25,0,30,5
1681904150597,MATH 142A,A03,182967,Staff,26,0,30,4
1681904150597,MATH 142A,B01,183125,Staff,24,0,30,6
1681904150597,MATH 142A,B02,183157,Staff,28,0,30,2
1681904150597,MATH 142A,B03,183158,Staff,29,0,30,1
1681904151624,MATH 183,A01,183160,Arias-Castro; Ery,23,0,30,7
1681904151624,MATH 183,A02,183161,Arias-Castro; Ery,29,0,30,1
1681904151624,MATH 183,B01,183163,Arias-Castro; Ery,28,0,30,2
1681904151624,MATH 183,B02,183164,Arias-Castro; Ery,28,0,30,2
1681904152646,MATH 193A,A01,183167,Staff,4,0,35,31
1681904152646,MATH 193A,A02,183168,Staff,28,0,35,7
1681904152646,MATH 193A,A03,183169,Staff,34,0,35,1
1681904152646,MATH 193A,A04,183170,Staff,28,0,35,7
1681904153671,MGT 4,A01,202395,Anderson; John Charles,75,0,80,5
1681904154697,MGT 5,A00,202396,Houskeeper; Robert,80,0,90,10
1681904155727,MGT 103,A00,202397,Eberhard; Craig A,55,0,90,35
1681904156751,MGT 131A,A00,202398,Houskeeper; Robert,85,0,90,5
1681904157777,MGT 135,A00,202399,Anderson; John Charles,83,0,90,7
1681904158811,MGT 162R,A00,202403,Gneezy; Uri,150,0,200,50
1681904159842,MGT 172,A00,202404,Hedges; Kathleen,50,0,90,40
1681904160933,MGT 181,A00,202405,Dunn; Louis Jean,84,0,90,6
1681904161960,MMW 14,A01,183200,Staff,16,0,28,12
1681904161960,MMW 14,A02,183201,Staff,26,0,28,2
1681904161960,MMW 14,A03,183202,Staff,24,0,28,4
1681904161960,MMW 14,A04,183203,Staff,25,0,28,3
1681904161960,MMW 14,A05,183204,Staff,26,0,28,2
1681904161960,MMW 14,A06,183205,Staff,27,0,28,1
1681904161960,MMW 14,B01,183207,Staff,26,0,28,2
1681904161960,MMW 14,B02,183208,Staff,28,0,28,0
1681904161960,MMW 14,B03,183209,Staff,28,0,28,0
1681904161960,MMW 14,B04,183210,Staff,28,0,28,0
1681904161960,MMW 14,B05,183211,Staff,28,0,28,0
1681904161960,MMW 14,B06,183212,Staff,28,0,28,0
1681904162985,MMW 14GS,A00,183213,Zhiri; Oumelbanine,28,0,28,0
1681904164012,MMW 15GS,B00,183215,Rahimi; Babak,28,0,28,0
1681904165047,MMW 121,A01,183217,Patterson; Patrick H.,14,0,28,14
1681904165047,MMW 121,A02,183218,Patterson; Patrick H.,25,0,28,3
1681904166076,MUS 1A,A01,182554,Staff,8,0,35,27
1681904167109,MUS 5,A01,182558,Staff,20,0,35,15
1681904168139,MUS 6,A01,182562,Staff,25,0,35,10
1681904169166,MUS 8GS,A00,182563,Borgo; David Garcia,25,0,25,0
1681904170190,MUS 13,A01,182567,Staff,24,0,25,1
1681904171216,MUS 15,A01,182570,Staff,32,0,35,3
1681904171216,MUS 15,B01,182575,Staff,10,0,35,25
1681904172243,MUS 80,A00,182578,Staff,23,0,25,2
1681904172243,MUS 80,B00,182581,Staff,20,0,25,5
1681904173266,MUS 113,A00,182582,Staff,25,0,25,0
1681904174289,MUS 114,A00,182583,Staff,4,0,25,21
1681904175327,MUS 150GS,A01,182588,Borgo; David Garcia,25,0,25,0
1681904176355,PHIL 1,A00,182590,Staff,35,0,40,5
1681904177384,PHIL 10,A01,182596,Grush; Rick Scott,31,0,35,4
1681904177384,PHIL 10,A02,182597,Grush; Rick Scott,34,0,35,1
1681904178413,PHIL 15,A01,182601,Staff,31,0,35,4
1681904178413,PHIL 15,A02,182602,Staff,33,0,35,2
1681904179438,PHIL 27,A01,182604,Staff,30,0,35,5
1681904179438,PHIL 27,A02,182607,Staff,35,0,35,0
1681904180460,PHIL 32,A01,182609,Staff,35,0,35,0
1681904180460,PHIL 32,A02,182612,Staff,35,0,35,0
1681904181487,PHIL 130,A00,182614,Staff,63,0,70,7
1681904182512,PHIL 136,A00,182616,Cohen; Jonathan David,66,0,70,4
1681904183539,PHIL 155,A00,182617,Vargas; Manuel Rogelio,60,0,70,10
1681904184566,PHIL 163,A01,182620,Staff,15,0,20,5
1681904184566,PHIL 163,A02,182624,Staff,10,0,20,10
1681904185591,PHIL 164,A00,182627,Staff,30,0,40,10
1681904186614,PHIL 173,A00,182628,Staff,36,0,40,4
1681904187639,PHYS 1A,A00,183221,Staff,54,0,60,6
1681904188668,PHYS 1AL,001,183222,Staff,25,0,30,5
1681904188668,PHYS 1AL,002,183223,Staff,28,0,30,2
1681904189694,PHYS 1B,A00,183231,Staff,44,0,60,16
1681904190723,PHYS 1BL,001,183232,Staff,20,0,30,10
1681904190723,PHYS 1BL,002,183233,Staff,29,0,30,1
1681904191750,PHYS 1C,A00,183240,Staff,30,0,60,30
1681904192777,PHYS 1CL,001,183241,Staff,13,0,30,17
1681904192777,PHYS 1CL,002,183242,Staff,22,0,30,8
1681904193801,PHYS 2AR,A01,183250,Staff,44,0,50,6
1681904194825,PHYS 2B,A01,183252,Staff,106,0,115,9
1681904195855,PHYS 2BL,A01,183254,Staff,21,0,24,3
1681904195855,PHYS 2BL,A02,183255,Staff,22,0,24,2
1681904196881,PHYS 2C,A01,183522,Staff,105,0,115,10
1681904197908,PHYS 4A,A01,183524,Staff,49,0,50,1
1681904198936,POLI 5,A00,183525,Staff,44,0,50,6
1681904200033,POLI 12,A00,183540,Staff,48,0,50,2
1681904201061,POLI 13R,A00,183541,Forman; Fonna,42,0,50,8
1681904202087,POLI 30,A00,183542,Mignozzetti; Umberto,47,0,50,3
1681904203110,POLI 100A,A00,183543,Staff,45,0,50,5
1681904204137,POLI 100E,A00,223598,Staff,32,0,35,3
1681904205159,POLI 103A,A00,183564,Kousser; Thad,38,0,50,12
1681904206186,POLI 104B,A00,201329,Staff,29,0,35,6
1681904207210,POLI 113BR,A00,183576,Hoston; Germaine,28,0,50,22
1681904208247,POLI 114BR,A00,183588,Staff,27,0,30,3
1681904209269,POLI 117R,A00,183595,Forman; Fonna,9,0,20,11
1681904210294,POLI 120H,A00,183596,Fisk; David Lee,13,0,20,7
1681904211320,POLI 130AA,A00,183597,Staff,14,0,20,6
1681904212348,POLI 134AA,A00,183598,Staff,19,0,20,1
1681904213375,POLI 135,A00,183599,Fisk; David Lee,20,0,25,5
1681904214398,POLI 142P,A00,183623,Staff,37,0,40,3
1681904215426,POLI 144D,A00,183624,Staff,22,0,25,3
1681904216448,POLI 151,A00,183625,Staff,15,0,20,5
1681904217476,POLI 162,A00,183626,Mignozzetti; Umberto,18,0,20,2
1681904218501,PSYC 1,A00,253748,Staff,86,0,90,4
1681904219527,PSYC 2,A00,183627,Moranton; Nirelia Melbina-,25,0,35,10
1681904220565,PSYC 3,A00,183628,Staff,43,0,45,2
1681904222620,PSYC 60,A01,183631,Lowe; Angela Beth,35,0,40,5
1681904223650,PSYC 70,A01,253757,Staff,37,0,45,8
1681904224678,PSYC 101,A00,183632,Heyman; Gail D.,48,0,60,12
1681904225706,PSYC 105,A00,183848,Lowe; Angela Beth,50,0,60,10
1681904226735,PSYC 106,A00,183849,Dobkins; Karen R.,45,0,60,15
1681904227759,PSYC 108,A00,253750,Staff,24,0,60,36
1681904228788,PSYC 114,A01,184275,Winkielman; Piotr,0,6,30,30
1681904229811,PSYC 122,A00,183856,Moranton; Nirelia Melbina-,0,10,30,30
1681904230834,PSYC 124,A00,183865,Chapman; Eddie Nathaniel,52,0,80,28
1681904231860,PSYC 137,A00,183880,Staff,19,0,25,6
1681904233912,PSYC 154,A00,183910,Lacefield; Katharine I,0,2,90,90
1681904235960,PSYC 162,A00,183946,Wixted; John T,61,0,90,29
1681904236983,PSYC 172,A00,183947,Gorman; Michael R.,14,0,30,16
1681904238011,PSYC 178,A00,183963,Glaser; Dale,20,0,40,20
1681904239039,PSYC 181GS,A00,183964,Anagnostaras; Stephan,10,0,10,0
1681904240062,PSYC 186GS,A01,257660,Staff,10,0,10,0
1681904241085,PSYC 193,B00,253749,Staff,23,0,25,2
1681904243137,PSYC 193L,A01,184122,Staff,33,0,35,2
1681904243137,PSYC 193L,C01,184167,Winkielman; Piotr,16,0,30,14
1681904244159,RELI 188GS,A00,182629,Rahimi; Babak,20,0,20,0
1681904245185,SE 101A,A00,182646,Staff,26,0,30,4
1681904246213,SE 101C,A00,182650,Staff,18,0,20,2
1681904247243,SE 110A,A00,182651,Staff,28,0,28,0
1681904248269,SE 130A,A00,182652,Staff,39,0,40,1
1681904249295,SIO 46GS,A00,182636,Cook; Geoffrey W,28,0,28,0
1681904250318,SIO 109R,A00,194459,Staff,5,0,20,15
1681904251345,SIO 121GS,A00,182639,Cook; Geoffrey W,28,0,28,0
1681904252382,SIO 132,A01,182642,Staff,32,0,40,8
1681904253409,SIO 139,A00,182644,Kacev; David,36,0,40,4
1681904254448,SOCI 2,A01,258404,Staff,34,0,36,2
1681904254448,SOCI 2,A02,258405,Staff,35,0,36,1
1681904255475,SOCI 60,A01,258408,Staff,29,0,30,1
1681904255475,SOCI 60,A02,258413,Staff,30,0,30,0
1681904256504,SOCI 100,A01,258415,Staff,29,0,30,1
1681904256504,SOCI 100,A02,258416,Staff,28,0,30,2
1681904262657,SOCI 127,A00,258421,Staff,22,0,30,8
1681904263680,SOCI 132,A00,258422,Staff,45,0,50,5
1681904264706,SOCI 133,A00,258423,Staff,26,0,30,4
1681904265732,SOCI 138GS,A00,258424,Staff,15,0,15,0
1681904266764,SOCI 145,A00,258425,Staff,25,0,30,5
1681904267793,SOCI 148,A00,258426,Staff,26,0,30,4
1681904268818,SOCI 153,A00,199217,Staff,29,0,30,1
1681904269842,SOCI 160,A00,258427,Staff,28,0,30,2
1681904270868,SOCI 160E,A00,258435,Staff,56,0,60,4
1681904271894,SOCI 189GS,A00,258436,Staff,15,0,15,0
1681904272924,SOCI 190GS,A00,258437,Staff,15,0,15,0
1681904273953,SYN 2,001,182658,Staff,9,0,16,7
1681904273953,SYN 2,002,201439,Staff,15,0,16,1
1681904273953,SYN 2,003,201443,Staff,16,0,16,0
1681904274980,SYN 100,A01,182657,Staff,17,0,20,3
1681904276006,TDAC 1,A00,184381,Salovey; Todd,16,0,20,4
1681904276006,TDAC 1,B00,184385,Harting; Carla Kelso,19,0,20,1
1681904276006,TDAC 1,C00,184394,Staff,19,0,20,1
1681904277034,TDAC 101,A00,184483,Harting; Carla Kelso,19,0,20,1
1681904278061,TDDE 111,A00,184496,Staff,14,0,15,1
1681904279098,TDDE 131,A00,184504,Staff,20,0,20,0
1681904279098,TDDE 131,B00,184505,Staff,17,0,18,1
1681904279098,TDDE 131,C00,184534,Staff,49,0,50,1
1681904279098,TDDE 131,D00,184564,Staff,15,0,15,0
1681904279098,TDDE 131,E00,204725,Staff,19,0,20,1
1681904280124,TDGE 1,A01,184414,Salovey; Todd,37,0,50,13
1681904281149,TDGE 5,A01,184419,Staff,23,0,24,1
1681904282172,TDGE 10,A00,184428,Fulton; Julia,31,0,50,19
1681904283196,TDGE 124,A00,184565,Fulton; Julia,7,0,50,43
1681904284220,TDGE 125,B00,184567,Meyer; Ursula,9,0,25,16
1681904285246,TDHT 101,A00,184568,Staff,21,0,25,4
1681904285246,TDHT 101,B00,184569,Staff,20,0,20,0
1681904286274,TDHT 114,A00,184570,Staff,49,0,50,1
1681904287297,TDMV 1,A00,184437,Arcidiacono; Kristin,23,0,30,7
1681904287297,TDMV 1,B00,184448,Caligagan; Maria T.,22,0,30,8
1681904288327,TDMV 2,A00,184449,Weinberg; Sadie,27,0,30,3
1681904288327,TDMV 2,B00,184453,Arcidiacono; Kristin,29,0,30,1
1681904289351,TDMV 110,A00,184571,Weinberg; Sadie,30,0,30,0
1681904290374,TDMV 142,A00,184572,Caligagan; Tony,27,0,30,3
1681904290374,TDMV 142,B00,184573,Caligagan; Maria T.,27,0,30,3
1681904291401,TDTR 20,A00,184482,Jun; Grace Shin Hae,25,0,25,0
1681904292426,USP 2,A01,184290,Hinds; Juli Beth,24,0,25,1
1681904293449,USP 3,A01,184295,Staff,20,0,25,5
1681904294471,USP 4,A00,184304,McTague; Sarah,15,0,25,10
1681904295495,USP 100,A00,184315,Staff,17,0,25,8
1681904296522,USP 105,A00,184326,Staff,21,0,25,4
1681904297545,USP 151,A00,184327,Staff,20,0,25,5
1681904298569,USP 170,A00,184380,Hinds; Juli Beth,14,0,25,11
1681904299597,VIS 21B,A01,182660,Staff,28,0,31,3
1681904299597,VIS 21B,A02,182662,Staff,30,0,31,1
1681904300628,VIS 103D,A00,182663,Staff,74,0,75,1
1681904301650,VIS 105D,A00,182667,Li; Huai,15,0,22,7
1681904302676,VIS 122GS,A00,182668,Herbst; Matthew,20,0,20,0
1681904303774,VIS 128C,A00,182673,Staff,70,0,75,5
1681904304797,VIS 130,A00,182675,Staff,20,0,22,2
1681904305824,VIS 160A,A00,182678,Stalbaum; Brett,4,0,10,6
1681904307871,WCWP 10B,A00,201679,Staff,15,0,15,0
1681904307871,WCWP 10B,B00,201695,Staff,15,0,15,0
1681904308894,WCWP 100,A00,201716,Staff,15,0,15,0
1681904308894,WCWP 100,B00,201717,Staff,11,0,15,4
1681904311031,ANSC 105GS,A00,258289,Staff,0,0,0,0
1681904312054,ANSC 125GS,A00,258295,Staff,0,0,0,0
1681904313076,ANSC 150,A00,258267,Staff,30,0,40,10
1681904314102,ANSC 190GS,A00,258280,Staff,0,0,0,0
1681904315126,ANTH 1,A00,258264,Staff,38,0,40,2
1681904316156,ANTH 2,A01,258259,Staff,72,0,76,4
1681904317184,ANTH 23,A01,258228,Staff,36,0,40,4
1681904318210,ANTH 101,A01,258236,Staff,39,0,40,1
1681904319236,ANTH 102,A00,258272,Staff,59,0,60,1
1681904320262,ANTH 105,A00,258244,Staff,31,0,35,4
1681904321284,BENG 130,A00,253975,Staff,38,0,40,2
1681904322309,BIBC 102,A01,191866,Flagg; Matthew Paul,19,0,32,13
1681904322309,BIBC 102,A02,191867,Flagg; Matthew Paul,22,0,32,10
1681904322309,BIBC 102,A03,191868,Flagg; Matthew Paul,30,0,32,2
1681904322309,BIBC 102,A04,191936,Flagg; Matthew Paul,26,0,32,6
1681904322309,BIBC 102,A05,191937,Flagg; Matthew Paul,11,0,32,21
1681904323332,BICD 100,A01,191939,Cooper; Andrew Michael,28,0,32,4
1681904323332,BICD 100,A02,191940,Cooper; Andrew Michael,32,0,32,0
1681904323332,BICD 100,A03,191941,Cooper; Andrew Michael,32,0,32,0
1681904323332,BICD 100,A04,191942,Cooper; Andrew Michael,32,0,32,0
1681904323332,BICD 100,A05,191943,Cooper; Andrew Michael,32,0,32,0
1681904324360,BIEB 126,A01,191945,Cleland; Elsa Eleanor,1,0,32,31
1681904324360,BIEB 126,A02,191946,Cleland; Elsa Eleanor,28,0,32,4
1681904324360,BIEB 126,A03,191947,Cleland; Elsa Eleanor,29,0,32,3
1681904324360,BIEB 126,A04,191948,Cleland; Elsa Eleanor,23,0,32,9
1681904324360,BIEB 126,A05,191996,Cleland; Elsa Eleanor,28,0,32,4
1681904325388,BIEB 136GS,A00,191997,Shurin; Jonathan & Holway; David A.,0,0,0,0
1681904326415,BIEB 137GS,A01,191999,Shurin; Jonathan & Holway; David A.,0,0,0,0
1681904327442,BILD 1,A01,205385,Staff,31,0,32,1
1681904327442,BILD 1,A02,205386,Staff,30,0,32,2
1681904327442,BILD 1,A03,205387,Staff,32,0,32,0
1681904327442,BILD 1,A04,205388,Staff,28,0,32,4
1681904328469,BILD 2,A01,191774,Staff,28,0,32,4
1681904328469,BILD 2,A02,191775,Staff,30,0,32,2
1681904328469,BILD 2,A03,191777,Staff,30,0,32,2
1681904328469,BILD 2,A04,191856,Staff,31,0,32,1
1681904328469,BILD 2,A05,191857,Staff,32,0,32,0
1681904328469,BILD 2,A06,191858,Staff,32,0,32,0
1681904328469,BILD 2,A07,191859,Staff,31,0,32,1
1681904329493,BILD 3,A01,205391,Staff,29,0,32,3
1681904329493,BILD 3,A02,205393,Staff,32,0,32,0
1681904329493,BILD 3,A03,205394,Staff,28,0,32,4
1681904329493,BILD 3,A04,205395,Staff,32,0,32,0
1681904330520,BILD 20,A01,191861,Staff,32,0,32,0
1681904330520,BILD 20,A02,191862,Staff,32,0,32,0
1681904331544,BILD 30,A01,191864,Staff,31,0,32,1
1681904332568,BIMM 100,A01,192019,Staff,0,0,32,32
1681904332568,BIMM 100,A02,192020,Staff,23,0,32,9
1681904332568,BIMM 100,A03,192035,Staff,22,0,32,10
1681904333597,BIMM 110,A01,192037,Tat; John,0,0,32,32
1681904333597,BIMM 110,A02,192038,Tat; John,10,0,32,22
1681904334621,BIMM 120,A01,192040,Pickett; Brooke Elizabeth,2,0,32,30
1681904334621,BIMM 120,A02,192041,Pickett; Brooke Elizabeth,16,0,32,16
1681904334621,BIMM 120,A03,192042,Pickett; Brooke Elizabeth,16,0,32,16
1681904335650,BIPN 100,A01,192044,Armour; Jon Christopher,26,0,32,6
1681904335650,BIPN 100,A02,192059,Armour; Jon Christopher,30,0,32,2
1681904335650,BIPN 100,A03,192064,Armour; Jon Christopher,31,0,32,1
1681904335650,BIPN 100,A04,192073,Armour; Jon Christopher,28,0,32,4
1681904336681,BIPN 148,A01,205411,Leutgeb; Jill K.,16,0,32,16
1681904336681,BIPN 148,A02,205412,Leutgeb; Jill K.,31,0,32,1
1681904336681,BIPN 148,A03,205413,Leutgeb; Jill K.,30,0,32,2
1681904336681,BIPN 148,A04,205414,Leutgeb; Jill K.,30,0,32,2
1681904337710,BIPN 160,A01,192115,Marino; Marc J,19,0,32,13
1681904337710,BIPN 160,A02,192148,Marino; Marc J,27,0,32,5
1681904337710,BIPN 160,A03,192158,Marino; Marc J,31,0,32,1
1681904337710,BIPN 160,A04,192190,Marino; Marc J,32,0,32,0
1681904337710,BIPN 160,A05,192287,Marino; Marc J,32,0,32,0
1681904337710,BIPN 160,A06,192288,Marino; Marc J,32,0,32,0
1681904338737,BIPN 194,A00,206038,Staff,28,0,32,4
1681904339769,BISP 194,A00,192289,Leutgeb; Stefan,13,0,32,19
1681904339769,BISP 194,B00,245332,Nieh; James Charles,27,0,32,5
1681904340796,CAT 124,A01,202247,Staff,15,0,15,0
1681904341821,CAT 125,A00,202248,Staff,19,0,20,1
1681904341821,CAT 125,B00,202253,Staff,20,0,20,0
1681904341821,CAT 125,C00,202257,Staff,19,0,20,1
1681904342847,CAT 125GS,A01,202273,Bronstein; Phoebe Malan,20,0,20,0
1681904343878,CAT 125R,A00,202284,Staff,17,0,20,3
1681904343878,CAT 125R,C00,202286,Staff,10,0,20,10
1681904343878,CAT 125R,D00,202291,Staff,18,0,20,2
1681904343878,CAT 125R,E00,202295,Staff,13,0,20,7
1681904343878,CAT 125R,F00,202302,Staff,12,0,20,8
1681904344904,CENG 100,A00,204724,Opatkiewicz; Justin Paul,25,0,25,0
1681904345932,CGS 2A,A01,180420,Staff,31,0,36,5
1681904346954,CGS 101,A00,180421,Staff,16,0,20,4
1681904347978,CGS 112,A00,180422,Staff,10,0,16,6
1681904349001,CGS 113,A00,180423,Staff,18,0,20,2
1681904350031,CGS 137,A00,180424,Staff,12,0,12,0
1681904351063,CGS 147,A00,180425,Staff,10,0,10,0
1681904352086,CHEM 6A,A01,179556,Staff,97,0,100,3
1681904352086,CHEM 6A,A02,179558,Staff,0,0,0,0
1681904353124,CHEM 6B,A01,179560,Staff,100,0,100,0
1681904354147,CHEM 6C,A01,179565,Jazzar; Rodolphe,95,0,100,5
1681904355183,CHEM 7L,A01,179586,Schurmeier; Kimberly,13,0,24,11
1681904355183,CHEM 7L,A02,179587,Schurmeier; Kimberly,23,0,24,1
1681904355183,CHEM 7L,A03,179590,Schurmeier; Kimberly,22,0,24,2
1681904355183,CHEM 7L,A04,179591,Schurmeier; Kimberly,22,0,24,2
1681904355183,CHEM 7L,B01,179598,Schurmeier; Kimberly,17,0,24,7
1681904355183,CHEM 7L,B02,179599,Schurmeier; Kimberly,24,0,24,0
1681904355183,CHEM 7L,B03,179606,Schurmeier; Kimberly,23,0,24,1
1681904355183,CHEM 7L,B04,179607,Schurmeier; Kimberly,23,0,24,1
1681904356208,CHEM 11,A01,179609,Stallings; Dontarie M,88,0,100,12
1681904357233,CHEM 40A,A01,179621,Staff,41,0,50,9
1681904357233,CHEM 40A,A02,179622,Staff,47,0,50,3
1681904358262,CHEM 40B,A01,179630,Weizman; Haim,48,0,50,2
1681904358262,CHEM 40B,A02,179631,Weizman; Haim,45,0,50,5
1681904359291,CHEM 41A,A01,179660,Klosterman; Jeremy K,93,0,100,7
1681904360319,CHEM 43A,A01,179683,Klosterman; Jeremy K,0,0,24,24
1681904360319,CHEM 43A,A02,179688,Klosterman; Jeremy K,14,0,24,10
1681904360319,CHEM 43A,A03,179689,Klosterman; Jeremy K,20,0,24,4
1681904360319,CHEM 43A,A04,179691,Klosterman; Jeremy K,18,0,24,6
1681904361346,CHEM 114A,A01,179693,Stallings; Dontarie M,77,0,100,23
1681904362374,CHEM 143B,A01,179698,Weizman; Haim,17,0,24,7
1681904362374,CHEM 143B,A02,179700,Weizman; Haim,24,0,24,0
1681904363404,CHIN 169A,A00,179701,Wang; Xiao,20,0,20,0
1681904364430,COGS 2,A01,179750,Boyle; Mary E. T.,17,0,30,13
1681904365460,COGS 9,A01,179759,Jones; Cameron Robert,43,0,50,7
1681904366486,COGS 14A,A01,179854,Staff,18,0,50,32
1681904367513,COGS 14B,A01,179856,Staff,54,0,60,6
1681904368538,COGS 17,A01,179874,Staff,71,0,75,4
1681904369565,COGS 18,A01,179884,Staff,63,0,80,17
1681904370588,COGS 100,A01,179886,Staff,40,0,60,20
1681904371613,COGS 101B,A01,179892,Staff,1,0,30,29
1681904372636,COGS 101C,A01,179894,Staff,28,0,30,2
1681904373661,COGS 107A,A01,179896,Boyle; Mary E. T.,31,0,40,9
1681904374686,COGS 108,A01,179898,Simpkins; Charles Alexander,0,17,60,60
1681904375712,COGS 109,A01,179900,Staff,34,0,40,6
1681904376737,COGS 118A,A01,179946,Staff,9,0,40,31
1681904377761,COGS 153,A00,179978,Staff,1,0,30,29
1681904378789,COGS 156,A01,179981,Staff,27,0,30,3
1681904380837,COGS 172,A01,179987,Staff,13,0,30,17
1681904382888,COGS 186,A01,179991,Staff,13,0,30,17
1681904383918,COMM 10,A01,180001,Staff,15,0,25,10
1681904383918,COMM 10,A02,180004,Staff,20,0,25,5
1681904384946,COMM 100A,A01,180016,Staff,18,0,25,7
1681904384946,COMM 100A,A02,180020,Staff,24,0,25,1
1681904385972,COMM 101T,A00,180029,Halm; Gavin Patrick,23,0,35,12
1681904386999,COMM 106V,A00,180043,Staff,34,0,35,1
1681904388024,COMM 109P,A00,180044,Staff,31,0,35,4
1681904389049,COMM 113T,A00,180045,Havis; Allan,37,0,45,8
1681904390073,COMM 132,A00,180046,McKenna; Denise,23,0,30,7
1681904391099,COMM 143,A00,180047,Staff,19,0,30,11
1681904392127,COMM 190,A00,180048,Conner; Thomas Hartnell,20,0,23,3
1681904393155,CSE 8A,A50,180053,Cao; Yingjun,25,0,50,25
1681904393155,CSE 8A,B50,180180,Staff,50,0,50,0
1681904394179,CSE 11,A01,180190,Cao; Yingjun,31,0,50,19
1681904395208,CSE 20,A01,180192,Briones; Jor-el Thomas Caparas,23,0,30,7
1681904396238,CSE 21,A01,194538,Briones; Jor-el Thomas Caparas,50,0,60,10
1681904397264,CSE 30,A01,180324,Eldon; John,79,0,100,21
1681904398299,CSE 101,A01,201353,Staff,0,20,40,40
1681904399331,CSE 134B,A01,180326,Powell; Thomas Allan,74,0,100,26
1681904400355,CSE 140,A01,180328,Staff,46,0,75,29
1681904401388,CSE 140L,A01,180344,Eldon; John,69,0,100,31
1681904402417,CSE 150A,A01,180411,Staff,0,7,50,50
1681904403444,CSE 151A,A01,180414,Staff,0,6,50,50
1681904404472,CSE 175,A01,222521,Kumar; Rakesh,50,0,50,0
1681904405496,CSE 190,A00,201419,Staff,45,0,49,4
1681904406524,CSS 1,A01,194536,Staff,38,0,50,12
1681904407643,DSC 30,A01,202385,Staff,48,0,50,2
1681904408672,DSC 40A,A01,202387,Albuyeh; Rod,50,0,50,0
1681904409697,DSC 190,A01,202389,Silberman; Jack,21,0,21,0
1681904410722,DSGN 100,A01,179993,Staff,16,0,30,14
1681904411745,ECE 65,A50,180708,Staff,10,0,20,10
1681904411745,ECE 65,A51,180739,Staff,19,0,20,1
1681904412772,ECON 1,A01,180427,Famulari; Melissa,67,0,70,3
1681904413805,ECON 2,A01,180450,Levkoff; Steven B.,64,0,70,6
1681904414832,ECON 4,A01,203351,Anderson; John Charles,7,0,10,3
1681904415855,ECON 100A,A01,180472,Famulari; Melissa,65,0,70,5
1681904416879,ECON 120A,A01,180549,Staff,64,0,70,6
1681904417906,ECON 120B,A01,180655,Ma; Xinwei,46,0,70,24
1681904418932,ECON 129,A00,203333,Eckert; Fabian Paul,15,0,35,20
1681904419958,ECON 131,A00,180656,Staff,10,0,35,25
1681904420985,ECON 172B,A01,180672,Levkoff; Steven B.,32,0,35,3
1681904422011,ECON 178,A01,203342,Zhu; Ying,11,0,35,24
1681904423039,EDS 108GS,A00,202383,Wishard Guerra; Alison G.,20,0,20,0
1681904424065,EDS 111GS,A00,202347,Wishard Guerra; Alison G.,20,0,20,0
1681904425090,EDS 112,A01,202323,Staff,56,0,60,4
1681904426121,EDS 113,A00,202340,Staff,33,0,35,2
1681904427146,EDS 118,A00,201231,Staff,20,0,30,10
1681904428182,EDS 119,A00,204994,Staff,8,0,10,2
1681904429209,EDS 124BR,A00,202324,Eguchi; Emi,5,0,25,20
1681904430239,EDS 126,A01,203208,Jones; Makeba,26,0,30,4
1681904431267,EDS 135,A01,202333,Staff,18,0,20,2
1681904432294,EDS 180,A00,202311,Staff,47,0,50,3
1681904433323,ERC 190GS,A01,253747,Staff,28,0,28,0
1681904434348,ETHN 104,A00,180742,Staff,24,0,35,11
1681904435373,ETHN 118,A00,180745,Staff,28,0,35,7
1681904436403,ETHN 127,A00,180747,Staff,12,0,16,4
1681904437426,ETHN 137,A00,180880,Staff,12,0,12,0
1681904438449,ETHN 147,A00,180890,Staff,8,0,10,2
1681904439473,ETHN 154,A00,180891,Staff,7,0,8,1
1681904440498,ETHN 168,A00,180892,Staff,9,0,10,1
1681904441527,GLBH 20,A00,201051,Hannah; Seth Donal,0,1,0,1
1681904442571,GLBH 111,A01,209338,Burgos; Jose L.,0,0,0,0
1681904443597,GLBH 150,A00,258300,Staff,0,3,0,0
1681904456647,GLBH 181,A00,201207,Staff,15,0,40,25
1681904457674,HIEU 109,A00,180898,Staff,20,0,20,0
1681904458700,HIEU 111,A00,180899,Staff,1,0,20,19
1681904459724,HIEU 124,A00,180900,Staff,18,0,20,2
1681904460747,HILA 122,A00,180901,Staff,18,0,20,2
1681904461774,HILA 132,A00,180902,Vitz; Matthew,2,0,20,18
1681904462800,HILD 10,A01,180896,Staff,15,0,20,5
1681904463825,HILD 30GS,A00,180897,Edington; Claire Ellen,0,0,0,0
1681904464850,HISC 105,A00,180903,Staff,20,0,20,0
1681904465873,HISC 117,A00,180904,Staff,11,0,20,9
1681904474584,HIUS 108B,A00,181005,Staff,18,0,20,2
1681904475617,HIUS 113,A00,181093,Staff,4,0,20,16
1681904476676,HUM 3,A01,181190,Patterson; Patrick H.,40,0,50,10
1681904476676,HUM 3,B01,181195,Staff,47,0,50,3
1681904477701,HUM 3GS,A00,181196,Herbst; Matthew,0,0,0,0
1681904478727,HUM 4,A01,181227,West; Geoffrey Scott,34,0,50,16
1681904478727,HUM 4,B01,181282,Staff,43,0,50,7
1681904479753,HUM 4GS,A00,181377,Lyon; Antony J.,0,0,0,0
1681904480777,HUM 5,A01,181536,Zavodny; Tatiana Sophia,31,0,50,19
1681904480777,HUM 5,B01,181908,Staff,36,0,50,14
1681904481801,INTL 190,A00,181909,Segui; Alan S,0,0,0,6
1681904481801,INTL 190,B00,181961,Segui; Alan S,0,0,0,7
1681904482831,JAPN 20AR,A01,182113,Ross; Kayoko F,15,0,20,5
1681904483860,LATI 50,A01,202391,Martin-Cabrera; Luis,19,0,30,11
1681904483860,LATI 50,A02,202392,Martin-Cabrera; Luis,26,0,30,4
1681904484889,LATI 180,A00,202393,Kokinis; Troy Andreas,25,0,25,0
1681904485913,LIFR 1A,A00,182119,Staff,14,0,14,0
1681904486940,LIFR 1AX,A00,182324,Staff,14,0,14,0
1681904487972,LIFR 1B,A00,182259,Staff,14,0,14,0
1681904488998,LIFR 1BX,A00,182273,Staff,14,0,14,0
1681904490021,LIGN 8,A00,182330,Staff,137,0,150,13
1681904491046,LIGN 9GS,A00,182362,Staff,20,0,20,0
1681904492075,LIGN 119,A00,204992,Takahashi; Maho,12,0,15,3
1681904493098,LIGN 130,A01,182384,Staff,47,0,50,3
1681904494122,LIGN 149GS,A00,182390,Staff,20,0,20,0
1681904495151,LIGN 170,A00,182404,Staff,24,0,30,6
1681904496175,LISP 1D,A00,182281,Staff,7,0,14,7
1681904496175,LISP 1D,B00,182287,Staff,14,0,14,0
1681904496175,LISP 1D,C00,182295,Staff,11,0,14,3
1681904496175,LISP 1D,D00,182301,Staff,14,0,14,0
1681904497200,LISP 1DX,A00,182309,Staff,20,0,28,8
1681904497200,LISP 1DX,B00,182316,Staff,26,0,28,2
1681904498226,LTAF 120GS,A00,182412,Zhiri; Oumelbanine,20,0,20,0
1681904499253,LTCS 172GS,A00,182437,Bronstein; Phoebe Malan,20,0,20,0
1681904500276,LTEA 138,A00,182457,Staff,22,0,40,18
1681904501305,LTEN 114,A01,182490,Staff,23,0,25,2
1681904502330,LTEN 130GS,A00,182491,Lyon; Antony J.,20,0,20,0
1681904503358,LTEN 169,A00,182493,Cuong; Marisol,20,0,25,5
1681904504382,LTEN 178,A00,182501,Staff,14,0,15,1
1681904505408,LTEN 181,A00,182515,Staff,22,0,25,3
1681904506435,LTEN 185GS,A00,197655,Forbes; Camille,20,0,20,0
1681904507460,LTSP 100B,A00,202208,Bessett; Ryan Matthew,24,0,25,1
1681904508486,LTWL 100,A00,182516,Myerston Santana; Jacobo,23,0,30,7
1681904509515,LTWR 100GS,A00,182518,Forbes; Camille,20,0,20,0
1681904510543,LTWR 102,A00,182522,Staff,15,0,15,0
1681904510543,LTWR 102,B00,182525,Staff,14,0,15,1
1681904511570,LTWR 115,A00,182526,Staff,12,0,15,3
1681904512594,MAE 8,A01,182528,Pham; Hieu Tan,68,0,70,2
1681904513624,MAE 11,A00,182529,Bahadori; Mohammad Yousef,94,0,100,6
1681904514648,MAE 20,A00,182530,Evdokimenko; Ekaterina,68,0,70,2
1681904515672,MAE 30A,A00,182532,Staff,44,0,45,1
1681904516709,MAE 101A,A00,182533,Bahadori; Mohammad Yousef,97,0,100,3
1681904517739,MAE 101C,A00,182538,Staff,62,0,70,8
1681904518763,MAE 104,A00,182539,Staff,45,0,50,5
1681904519792,MAE 131A,A00,182540,Ghazinejad; Maziar,41,0,45,4
1681904520817,MAE 143A,A00,182548,Bewley; Thomas R,43,0,50,7
1681904521867,MAE 150,A00,182549,Staff,28,0,40,12
1681904522893,MAE 160,A00,182550,Evdokimenko; Ekaterina,43,0,60,17
1681904523918,MATH 3C,A01,182725,Staff,27,0,30,3
1681904524944,MATH 10A,A01,182729,Staff,25,0,30,5
1681904524944,MATH 10A,B01,182732,Staff,26,0,30,4
1681904525970,MATH 10B,A01,182737,Staff,21,0,30,9
1681904525970,MATH 10B,A02,182738,Staff,28,0,30,2
1681904525970,MATH 10B,B01,182744,Staff,27,0,30,3
1681904525970,MATH 10B,B02,182745,Staff,27,0,30,3
1681904526996,MATH 18,A01,182750,Anzaldo; Leesa B,28,0,30,2
1681904526996,MATH 18,A02,182751,Anzaldo; Leesa B,29,0,30,1
1681904526996,MATH 18,A03,182753,Anzaldo; Leesa B,28,0,30,2
1681904526996,MATH 18,A04,182757,Anzaldo; Leesa B,29,0,30,1
1681904526996,MATH 18,B01,182761,Anzaldo; Leesa B,27,0,30,3
1681904526996,MATH 18,B02,182764,Anzaldo; Leesa B,27,0,30,3
1681904526996,MATH 18,B03,182765,Anzaldo; Leesa B,30,0,30,0
1681904526996,MATH 18,B04,182766,Anzaldo; Leesa B,30,0,30,0
1681904528024,MATH 20A,A01,182771,Suk; Andrew Hoon,28,0,30,2
1681904529051,MATH 20B,A01,182775,Bach; Quang Tran,30,0,30,0
1681904529051,MATH 20B,A02,182777,Bach; Quang Tran,29,0,30,1
1681904529051,MATH 20B,B01,182780,Bach; Quang Tran,27,0,30,3
1681904529051,MATH 20B,B02,182782,Bach; Quang Tran,30,0,30,0
1681904530076,MATH 20C,A01,182787,Staff,25,0,30,5
1681904530076,MATH 20C,A02,182790,Staff,29,0,30,1
1681904530076,MATH 20C,B01,182792,Staff,25,0,30,5
1681904530076,MATH 20C,B02,182796,Staff,27,0,30,3
1681904531176,MATH 20D,A01,182799,Staff,29,0,30,1
1681904531176,MATH 20D,A02,182802,Staff,30,0,30,0
1681904531176,MATH 20D,A03,182803,Staff,30,0,30,0
1681904532201,MATH 20E,A01,182809,Verstraete; Jacques Allan,24,0,30,6
1681904532201,MATH 20E,A02,182811,Verstraete; Jacques Allan,28,0,30,2
1681904532201,MATH 20E,B01,182814,Verstraete; Jacques Allan,23,0,30,7
1681904532201,MATH 20E,B02,182815,Verstraete; Jacques Allan,30,0,30,0
1681904533226,MATH 103A,A01,182820,Staff,9,0,30,21
1681904533226,MATH 103A,A02,182821,Staff,27,0,30,3
1681904533226,MATH 103A,A03,182822,Staff,23,0,30,7
1681904533226,MATH 103A,B01,182825,Staff,23,0,30,7
1681904533226,MATH 103A,B02,182826,Staff,30,0,30,0
1681904533226,MATH 103A,B03,182830,Staff,30,0,30,0
1681904534258,MATH 109,A01,182836,Chow; Bennett,24,0,30,6
1681904534258,MATH 109,A02,182838,Chow; Bennett,29,0,30,1
1681904534258,MATH 109,A03,182894,Chow; Bennett,29,0,30,1
1681904534258,MATH 109,B01,182908,Chow; Bennett,28,0,30,2
1681904534258,MATH 109,B02,182909,Chow; Bennett,30,0,30,0
1681904534258,MATH 109,B03,182910,Chow; Bennett,27,0,30,3
1681904535286,MATH 142A,A01,182925,Staff,11,0,30,19
1681904535286,MATH 142A,A02,182935,Staff,25,0,30,5
1681904535286,MATH 142A,A03,182967,Staff,26,0,30,4
1681904535286,MATH 142A,B01,183125,Staff,24,0,30,6
1681904535286,MATH 142A,B02,183157,Staff,28,0,30,2
1681904535286,MATH 142A,B03,183158,Staff,29,0,30,1
1681904536313,MATH 183,A01,183160,Arias-Castro; Ery,23,0,30,7
1681904536313,MATH 183,A02,183161,Arias-Castro; Ery,29,0,30,1
1681904536313,MATH 183,B01,183163,Arias-Castro; Ery,28,0,30,2
1681904536313,MATH 183,B02,183164,Arias-Castro; Ery,28,0,30,2
1681904537343,MATH 193A,A01,183167,Staff,4,0,35,31
1681904537343,MATH 193A,A02,183168,Staff,28,0,35,7
1681904537343,MATH 193A,A03,183169,Staff,34,0,35,1
1681904537343,MATH 193A,A04,183170,Staff,28,0,35,7
1681904538371,MGT 4,A01,202395,Anderson; John Charles,75,0,80,5
1681904539398,MGT 5,A00,202396,Houskeeper; Robert,80,0,90,10
1681904540426,MGT 103,A00,202397,Eberhard; Craig A,55,0,90,35
1681904541452,MGT 131A,A00,202398,Houskeeper; Robert,85,0,90,5
1681904542482,MGT 135,A00,202399,Anderson; John Charles,83,0,90,7
1681904543507,MGT 162R,A00,202403,Gneezy; Uri,150,0,200,50
1681904544539,MGT 172,A00,202404,Hedges; Kathleen,50,0,90,40
1681904545565,MGT 181,A00,202405,Dunn; Louis Jean,84,0,90,6
1681904546593,MMW 14,A01,183200,Staff,16,0,28,12
1681904546593,MMW 14,A02,183201,Staff,26,0,28,2
1681904546593,MMW 14,A03,183202,Staff,24,0,28,4
1681904546593,MMW 14,A04,183203,Staff,25,0,28,3
1681904546593,MMW 14,A05,183204,Staff,26,0,28,2
1681904546593,MMW 14,A06,183205,Staff,27,0,28,1
1681904546593,MMW 14,B01,183207,Staff,26,0,28,2
1681904546593,MMW 14,B02,183208,Staff,28,0,28,0
1681904546593,MMW 14,B03,183209,Staff,28,0,28,0
1681904546593,MMW 14,B04,183210,Staff,28,0,28,0
1681904546593,MMW 14,B05,183211,Staff,28,0,28,0
1681904546593,MMW 14,B06,183212,Staff,28,0,28,0
1681904547619,MMW 14GS,A00,183213,Zhiri; Oumelbanine,28,0,28,0
1681904548642,MMW 15GS,B00,183215,Rahimi; Babak,28,0,28,0
1681904549668,MMW 121,A01,183217,Patterson; Patrick H.,14,0,28,14
1681904549668,MMW 121,A02,183218,Patterson; Patrick H.,25,0,28,3
1681904550702,MUS 1A,A01,182554,Staff,8,0,35,27
1681904551732,MUS 5,A01,182558,Staff,20,0,35,15
1681904552756,MUS 6,A01,182562,Staff,25,0,35,10
1681904553780,MUS 8GS,A00,182563,Borgo; David Garcia,25,0,25,0
1681904554808,MUS 13,A01,182567,Staff,24,0,25,1
1681904555836,MUS 15,A01,182570,Staff,32,0,35,3
1681904555836,MUS 15,B01,182575,Staff,10,0,35,25
1681904556859,MUS 80,A00,182578,Staff,23,0,25,2
1681904556859,MUS 80,B00,182581,Staff,20,0,25,5
1681904557886,MUS 113,A00,182582,Staff,25,0,25,0
1681904558915,MUS 114,A00,182583,Staff,4,0,25,21
1681904559939,MUS 150GS,A01,182588,Borgo; David Garcia,25,0,25,0
1681904560961,PHIL 1,A00,182590,Staff,35,0,40,5
1681904561989,PHIL 10,A01,182596,Grush; Rick Scott,31,0,35,4
1681904561989,PHIL 10,A02,182597,Grush; Rick Scott,34,0,35,1
1681904563012,PHIL 15,A01,182601,Staff,31,0,35,4
1681904563012,PHIL 15,A02,182602,Staff,33,0,35,2
1681904564036,PHIL 27,A01,182604,Staff,30,0,35,5
1681904564036,PHIL 27,A02,182607,Staff,35,0,35,0
1681904565063,PHIL 32,A01,182609,Staff,35,0,35,0
1681904565063,PHIL 32,A02,182612,Staff,35,0,35,0
1681904566087,PHIL 130,A00,182614,Staff,63,0,70,7
1681904567110,PHIL 136,A00,182616,Cohen; Jonathan David,66,0,70,4
1681904568136,PHIL 155,A00,182617,Vargas; Manuel Rogelio,60,0,70,10
1681904569166,PHIL 163,A01,182620,Staff,15,0,20,5
1681904569166,PHIL 163,A02,182624,Staff,10,0,20,10
1681904570192,PHIL 164,A00,182627,Staff,30,0,40,10
1681904571216,PHIL 173,A00,182628,Staff,36,0,40,4
1681904572246,PHYS 1A,A00,183221,Staff,54,0,60,6
1681904573281,PHYS 1AL,001,183222,Staff,25,0,30,5
1681904573281,PHYS 1AL,002,183223,Staff,28,0,30,2
1681904574311,PHYS 1B,A00,183231,Staff,44,0,60,16
1681904575340,PHYS 1BL,001,183232,Staff,20,0,30,10
1681904575340,PHYS 1BL,002,183233,Staff,29,0,30,1
1681904576364,PHYS 1C,A00,183240,Staff,30,0,60,30
1681904577388,PHYS 1CL,001,183241,Staff,13,0,30,17
1681904577388,PHYS 1CL,002,183242,Staff,22,0,30,8
1681904578412,PHYS 2AR,A01,183250,Staff,44,0,50,6
1681904579440,PHYS 2B,A01,183252,Staff,106,0,115,9
1681904580466,PHYS 2BL,A01,183254,Staff,21,0,24,3
1681904580466,PHYS 2BL,A02,183255,Staff,22,0,24,2
1681904581494,PHYS 2C,A01,183522,Staff,105,0,115,10
1681904582520,PHYS 4A,A01,183524,Staff,49,0,50,1
1681904583544,POLI 5,A00,183525,Staff,44,0,50,6
1681904584571,POLI 12,A00,183540,Staff,48,0,50,2
1681904585596,POLI 13R,A00,183541,Forman; Fonna,42,0,50,8
1681904586624,POLI 30,A00,183542,Mignozzetti; Umberto,47,0,50,3
1681904587651,POLI 100A,A00,183543,Staff,45,0,50,5
1681904588683,POLI 100E,A00,223598,Staff,32,0,35,3
1681904589708,POLI 103A,A00,183564,Kousser; Thad,38,0,50,12
1681904590731,POLI 104B,A00,201329,Staff,29,0,35,6
1681904591760,POLI 113BR,A00,183576,Hoston; Germaine,28,0,50,22
1681904592787,POLI 114BR,A00,183588,Staff,27,0,30,3
1681904593813,POLI 117R,A00,183595,Forman; Fonna,9,0,20,11
1681904594838,POLI 120H,A00,183596,Fisk; David Lee,13,0,20,7
1681904595863,POLI 130AA,A00,183597,Staff,14,0,20,6
1681904596897,POLI 134AA,A00,183598,Staff,19,0,20,1
1681904597925,POLI 135,A00,183599,Fisk; David Lee,20,0,25,5
1681904598952,POLI 142P,A00,183623,Staff,37,0,40,3
1681904599977,POLI 144D,A00,183624,Staff,22,0,25,3
1681904601002,POLI 151,A00,183625,Staff,15,0,20,5
1681904602037,POLI 162,A00,183626,Mignozzetti; Umberto,18,0,20,2
1681904603063,PSYC 1,A00,253748,Staff,86,0,90,4
1681904604087,PSYC 2,A00,183627,Moranton; Nirelia Melbina-,25,0,35,10
1681904605112,PSYC 3,A00,183628,Staff,43,0,45,2
1681904607166,PSYC 60,A01,183631,Lowe; Angela Beth,35,0,40,5
1681904608190,PSYC 70,A01,253757,Staff,37,0,45,8
1681904609219,PSYC 101,A00,183632,Heyman; Gail D.,48,0,60,12
1681904610247,PSYC 105,A00,183848,Lowe; Angela Beth,50,0,60,10
1681904611271,PSYC 106,A00,183849,Dobkins; Karen R.,45,0,60,15
1681904612296,PSYC 108,A00,253750,Staff,24,0,60,36
1681904613329,PSYC 114,A01,184275,Winkielman; Piotr,0,6,30,30
1681904614356,PSYC 122,A00,183856,Moranton; Nirelia Melbina-,0,10,30,30
1681904615382,PSYC 124,A00,183865,Chapman; Eddie Nathaniel,52,0,80,28
1681904616422,PSYC 137,A00,183880,Staff,19,0,25,6
1681904618487,PSYC 154,A00,183910,Lacefield; Katharine I,0,2,90,90
1681904620536,PSYC 162,A00,183946,Wixted; John T,61,0,90,29
1681904621564,PSYC 172,A00,183947,Gorman; Michael R.,14,0,30,16
1681904622588,PSYC 178,A00,183963,Glaser; Dale,20,0,40,20
1681904623616,PSYC 181GS,A00,183964,Anagnostaras; Stephan,10,0,10,0
1681904624640,PSYC 186GS,A01,257660,Staff,10,0,10,0
1681904625668,PSYC 193,B00,253749,Staff,23,0,25,2
1681904627723,PSYC 193L,A01,184122,Staff,33,0,35,2
1681904627723,PSYC 193L,C01,184167,Winkielman; Piotr,16,0,30,14
1681904628750,RELI 188GS,A00,182629,Rahimi; Babak,20,0,20,0
1681904629777,SE 101A,A00,182646,Staff,26,0,30,4
1681904630808,SE 101C,A00,182650,Staff,18,0,20,2
1681904631835,SE 110A,A00,182651,Staff,28,0,28,0
1681904632866,SE 130A,A00,182652,Staff,39,0,40,1
1681904633894,SIO 46GS,A00,182636,Cook; Geoffrey W,28,0,28,0
1681904634992,SIO 109R,A00,194459,Staff,5,0,20,15
1681904636018,SIO 121GS,A00,182639,Cook; Geoffrey W,28,0,28,0
1681904637046,SIO 132,A01,182642,Staff,32,0,40,8
1681904638070,SIO 139,A00,182644,Kacev; David,36,0,40,4
1681904639095,SOCI 2,A01,258404,Staff,34,0,36,2
1681904639095,SOCI 2,A02,258405,Staff,35,0,36,1
1681904640122,SOCI 60,A01,258408,Staff,29,0,30,1
1681904640122,SOCI 60,A02,258413,Staff,30,0,30,0
1681904641145,SOCI 100,A01,258415,Staff,29,0,30,1
1681904641145,SOCI 100,A02,258416,Staff,28,0,30,2
1681904647305,SOCI 127,A00,258421,Staff,22,0,30,8
1681904648331,SOCI 132,A00,258422,Staff,45,0,50,5
1681904649355,SOCI 133,A00,258423,Staff,26,0,30,4
1681904650381,SOCI 138GS,A00,258424,Staff,15,0,15,0
1681904651406,SOCI 145,A00,258425,Staff,25,0,30,5
1681904652429,SOCI 148,A00,258426,Staff,26,0,30,4
1681904653454,SOCI 153,A00,199217,Staff,29,0,30,1
1681904654476,SOCI 160,A00,258427,Staff,28,0,30,2
1681904655504,SOCI 160E,A00,258435,Staff,56,0,60,4
1681904656529,SOCI 189GS,A00,258436,Staff,15,0,15,0
1681904657559,SOCI 190GS,A00,258437,Staff,15,0,15,0
1681904658585,SYN 2,001,182658,Staff,9,0,16,7
1681904658585,SYN 2,002,201439,Staff,15,0,16,1
1681904658585,SYN 2,003,201443,Staff,16,0,16,0
1681904659611,SYN 100,A01,182657,Staff,17,0,20,3
1681904660648,TDAC 1,A00,184381,Salovey; Todd,16,0,20,4
1681904660648,TDAC 1,B00,184385,Harting; Carla Kelso,19,0,20,1
1681904660648,TDAC 1,C00,184394,Staff,19,0,20,1
1681904661675,TDAC 101,A00,184483,Harting; Carla Kelso,19,0,20,1
1681904662700,TDDE 111,A00,184496,Staff,14,0,15,1
1681904663729,TDDE 131,A00,184504,Staff,20,0,20,0
1681904663729,TDDE 131,B00,184505,Staff,17,0,18,1
1681904663729,TDDE 131,C00,184534,Staff,49,0,50,1
1681904663729,TDDE 131,D00,184564,Staff,15,0,15,0
1681904663729,TDDE 131,E00,204725,Staff,19,0,20,1
1681904664755,TDGE 1,A01,184414,Salovey; Todd,37,0,50,13
1681904665781,TDGE 5,A01,184419,Staff,23,0,24,1
1681904666808,TDGE 10,A00,184428,Fulton; Julia,31,0,50,19
1681904667835,TDGE 124,A00,184565,Fulton; Julia,7,0,50,43
1681904668873,TDGE 125,B00,184567,Meyer; Ursula,9,0,25,16
1681904669897,TDHT 101,A00,184568,Staff,21,0,25,4
1681904669897,TDHT 101,B00,184569,Staff,20,0,20,0
1681904670925,TDHT 114,A00,184570,Staff,49,0,50,1
1681904671957,TDMV 1,A00,184437,Arcidiacono; Kristin,23,0,30,7
1681904671957,TDMV 1,B00,184448,Caligagan; Maria T.,22,0,30,8
1681904672981,TDMV 2,A00,184449,Weinberg; Sadie,27,0,30,3
1681904672981,TDMV 2,B00,184453,Arcidiacono; Kristin,29,0,30,1
1681904674004,TDMV 110,A00,184571,Weinberg; Sadie,30,0,30,0
1681904675028,TDMV 142,A00,184572,Caligagan; Tony,27,0,30,3
1681904675028,TDMV 142,B00,184573,Caligagan; Maria T.,27,0,30,3
1681904676053,TDTR 20,A00,184482,Jun; Grace Shin Hae,25,0,25,0
1681904677078,USP 2,A01,184290,Hinds; Juli Beth,24,0,25,1
1681904678107,USP 3,A01,184295,Staff,20,0,25,5
1681904679131,USP 4,A00,184304,McTague; Sarah,15,0,25,10
1681904680158,USP 100,A00,184315,Staff,17,0,25,8
1681904681186,USP 105,A00,184326,Staff,21,0,25,4
1681904682213,USP 151,A00,184327,Staff,20,0,25,5
1681904683238,USP 170,A00,184380,Hinds; Juli Beth,14,0,25,11
1681904684265,VIS 21B,A01,182660,Staff,28,0,31,3
1681904684265,VIS 21B,A02,182662,Staff,30,0,31,1
1681904685300,VIS 103D,A00,182663,Staff,74,0,75,1
1681904686324,VIS 105D,A00,182667,Li; Huai,15,0,22,7
1681904687350,VIS 122GS,A00,182668,Herbst; Matthew,20,0,20,0
1681904688374,VIS 128C,A00,182673,Staff,70,0,75,5
1681904689400,VIS 130,A00,182675,Staff,20,0,22,2
1681904690429,VIS 160A,A00,182678,Stalbaum; Brett,4,0,10,6
1681904692480,WCWP 10B,A00,201679,Staff,15,0,15,0
1681904692480,WCWP 10B,B00,201695,Staff,15,0,15,0
1681904693504,WCWP 100,A00,201716,Staff,15,0,15,0
1681904693504,WCWP 100,B00,201717,Staff,11,0,15,4
1681904695645,ANSC 105GS,A00,258289,Staff,0,0,0,0
1681904696669,ANSC 125GS,A00,258295,Staff,0,0,0,0
1681904697693,ANSC 150,A00,258267,Staff,30,0,40,10
1681904698718,ANSC 190GS,A00,258280,Staff,0,0,0,0
1681904699742,ANTH 1,A00,258264,Staff,38,0,40,2
1681904700767,ANTH 2,A01,258259,Staff,72,0,76,4
1681904701793,ANTH 23,A01,258228,Staff,36,0,40,4
1681904702817,ANTH 101,A01,258236,Staff,39,0,40,1
1681904703841,ANTH 102,A00,258272,Staff,59,0,60,1
1681904704864,ANTH 105,A00,258244,Staff,31,0,35,4
1681904705892,BENG 130,A00,253975,Staff,38,0,40,2
1681904706923,BIBC 102,A01,191866,Flagg; Matthew Paul,19,0,32,13
1681904706923,BIBC 102,A02,191867,Flagg; Matthew Paul,22,0,32,10
1681904706923,BIBC 102,A03,191868,Flagg; Matthew Paul,30,0,32,2
1681904706923,BIBC 102,A04,191936,Flagg; Matthew Paul,26,0,32,6
1681904706923,BIBC 102,A05,191937,Flagg; Matthew Paul,11,0,32,21
1681904707948,BICD 100,A01,191939,Cooper; Andrew Michael,28,0,32,4
1681904707948,BICD 100,A02,191940,Cooper; Andrew Michael,32,0,32,0
1681904707948,BICD 100,A03,191941,Cooper; Andrew Michael,32,0,32,0
1681904707948,BICD 100,A04,191942,Cooper; Andrew Michael,32,0,32,0
1681904707948,BICD 100,A05,191943,Cooper; Andrew Michael,32,0,32,0
1681904708972,BIEB 126,A01,191945,Cleland; Elsa Eleanor,1,0,32,31
1681904708972,BIEB 126,A02,191946,Cleland; Elsa Eleanor,28,0,32,4
1681904708972,BIEB 126,A03,191947,Cleland; Elsa Eleanor,29,0,32,3
1681904708972,BIEB 126,A04,191948,Cleland; Elsa Eleanor,23,0,32,9
1681904708972,BIEB 126,A05,191996,Cleland; Elsa Eleanor,28,0,32,4
1681904710007,BIEB 136GS,A00,191997,Shurin; Jonathan & Holway; David A.,0,0,0,0
1681904711032,BIEB 137GS,A01,191999,Shurin; Jonathan & Holway; David A.,0,0,0,0
1681904712061,BILD 1,A01,205385,Staff,31,0,32,1
1681904712061,BILD 1,A02,205386,Staff,30,0,32,2
1681904712061,BILD 1,A03,205387,Staff,32,0,32,0
1681904712061,BILD 1,A04,205388,Staff,28,0,32,4
1681904713088,BILD 2,A01,191774,Staff,28,0,32,4
1681904713088,BILD 2,A02,191775,Staff,30,0,32,2
1681904713088,BILD 2,A03,191777,Staff,30,0,32,2
1681904713088,BILD 2,A04,191856,Staff,31,0,32,1
1681904713088,BILD 2,A05,191857,Staff,32,0,32,0
1681904713088,BILD 2,A06,191858,Staff,32,0,32,0
1681904713088,BILD 2,A07,191859,Staff,31,0,32,1
1681904714117,BILD 3,A01,205391,Staff,29,0,32,3
1681904714117,BILD 3,A02,205393,Staff,32,0,32,0
1681904714117,BILD 3,A03,205394,Staff,28,0,32,4
1681904714117,BILD 3,A04,205395,Staff,32,0,32,0
1681904715146,BILD 20,A01,191861,Staff,32,0,32,0
1681904715146,BILD 20,A02,191862,Staff,32,0,32,0
1681904716171,BILD 30,A01,191864,Staff,31,0,32,1
1681904717201,BIMM 100,A01,192019,Staff,0,0,32,32
1681904717201,BIMM 100,A02,192020,Staff,23,0,32,9
1681904717201,BIMM 100,A03,192035,Staff,22,0,32,10
1681904718225,BIMM 110,A01,192037,Tat; John,0,0,32,32
1681904718225,BIMM 110,A02,192038,Tat; John,10,0,32,22
1681904719252,BIMM 120,A01,192040,Pickett; Brooke Elizabeth,2,0,32,30
1681904719252,BIMM 120,A02,192041,Pickett; Brooke Elizabeth,16,0,32,16
1681904719252,BIMM 120,A03,192042,Pickett; Brooke Elizabeth,16,0,32,16
1681904720287,BIPN 100,A01,192044,Armour; Jon Christopher,26,0,32,6
1681904720287,BIPN 100,A02,192059,Armour; Jon Christopher,30,0,32,2
1681904720287,BIPN 100,A03,192064,Armour; Jon Christopher,31,0,32,1
1681904720287,BIPN 100,A04,192073,Armour; Jon Christopher,28,0,32,4
1681904721313,BIPN 148,A01,205411,Leutgeb; Jill K.,16,0,32,16
1681904721313,BIPN 148,A02,205412,Leutgeb; Jill K.,31,0,32,1
1681904721313,BIPN 148,A03,205413,Leutgeb; Jill K.,30,0,32,2
1681904721313,BIPN 148,A04,205414,Leutgeb; Jill K.,30,0,32,2
1681904722345,BIPN 160,A01,192115,Marino; Marc J,19,0,32,13
1681904722345,BIPN 160,A02,192148,Marino; Marc J,27,0,32,5
1681904722345,BIPN 160,A03,192158,Marino; Marc J,31,0,32,1
1681904722345,BIPN 160,A04,192190,Marino; Marc J,32,0,32,0
1681904722345,BIPN 160,A05,192287,Marino; Marc J,32,0,32,0
1681904722345,BIPN 160,A06,192288,Marino; Marc J,32,0,32,0
1681904723370,BIPN 194,A00,206038,Staff,28,0,32,4
1681904724397,BISP 194,A00,192289,Leutgeb; Stefan,13,0,32,19
1681904724397,BISP 194,B00,245332,Nieh; James Charles,27,0,32,5
1681904725421,CAT 124,A01,202247,Staff,15,0,15,0
1681904726450,CAT 125,A00,202248,Staff,19,0,20,1
1681904726450,CAT 125,B00,202253,Staff,20,0,20,0
1681904726450,CAT 125,C00,202257,Staff,19,0,20,1
1681904727474,CAT 125GS,A01,202273,Bronstein; Phoebe Malan,20,0,20,0
1681904728502,CAT 125R,A00,202284,Staff,17,0,20,3
1681904728502,CAT 125R,C00,202286,Staff,10,0,20,10
1681904728502,CAT 125R,D00,202291,Staff,18,0,20,2
1681904728502,CAT 125R,E00,202295,Staff,13,0,20,7
1681904728502,CAT 125R,F00,202302,Staff,12,0,20,8
1681904729533,CENG 100,A00,204724,Opatkiewicz; Justin Paul,25,0,25,0
1681904730563,CGS 2A,A01,180420,Staff,31,0,36,5
1681904731594,CGS 101,A00,180421,Staff,16,0,20,4
1681904732616,CGS 112,A00,180422,Staff,10,0,16,6
1681904733644,CGS 113,A00,180423,Staff,18,0,20,2
1681904734673,CGS 137,A00,180424,Staff,12,0,12,0
1681904735698,CGS 147,A00,180425,Staff,10,0,10,0
1681904736729,CHEM 6A,A01,179556,Staff,97,0,100,3
1681904736729,CHEM 6A,A02,179558,Staff,0,0,0,0
1681904737753,CHEM 6B,A01,179560,Staff,100,0,100,0
1681904738866,CHEM 6C,A01,179565,Jazzar; Rodolphe,95,0,100,5
1681904739901,CHEM 7L,A01,179586,Schurmeier; Kimberly,13,0,24,11
1681904739901,CHEM 7L,A02,179587,Schurmeier; Kimberly,23,0,24,1
1681904739901,CHEM 7L,A03,179590,Schurmeier; Kimberly,22,0,24,2
1681904739901,CHEM 7L,A04,179591,Schurmeier; Kimberly,22,0,24,2
1681904739901,CHEM 7L,B01,179598,Schurmeier; Kimberly,17,0,24,7
1681904739901,CHEM 7L,B02,179599,Schurmeier; Kimberly,24,0,24,0
1681904739901,CHEM 7L,B03,179606,Schurmeier; Kimberly,23,0,24,1
1681904739901,CHEM 7L,B04,179607,Schurmeier; Kimberly,23,0,24,1
1681904740924,CHEM 11,A01,179609,Stallings; Dontarie M,88,0,100,12
1681904741952,CHEM 40A,A01,179621,Staff,41,0,50,9
1681904741952,CHEM 40A,A02,179622,Staff,47,0,50,3
1681904742977,CHEM 40B,A01,179630,Weizman; Haim,48,0,50,2
1681904742977,CHEM 40B,A02,179631,Weizman; Haim,45,0,50,5
1681904744003,CHEM 41A,A01,179660,Klosterman; Jeremy K,93,0,100,7
1681904745033,CHEM 43A,A01,179683,Klosterman; Jeremy K,0,0,24,24
1681904745033,CHEM 43A,A02,179688,Klosterman; Jeremy K,14,0,24,10
1681904745033,CHEM 43A,A03,179689,Klosterman; Jeremy K,20,0,24,4
1681904745033,CHEM 43A,A04,179691,Klosterman; Jeremy K,18,0,24,6
1681904746057,CHEM 114A,A01,179693,Stallings; Dontarie M,77,0,100,23
1681904747082,CHEM 143B,A01,179698,Weizman; Haim,17,0,24,7
1681904747082,CHEM 143B,A02,179700,Weizman; Haim,24,0,24,0
1681904748108,CHIN 169A,A00,179701,Wang; Xiao,20,0,20,0
1681904749136,COGS 2,A01,179750,Boyle; Mary E. T.,17,0,30,13
1681904750166,COGS 9,A01,179759,Jones; Cameron Robert,43,0,50,7
1681904751194,COGS 14A,A01,179854,Staff,18,0,50,32
1681904752224,COGS 14B,A01,179856,Staff,54,0,60,6
1681904753253,COGS 17,A01,179874,Staff,71,0,75,4
1681904754277,COGS 18,A01,179884,Staff,63,0,80,17
1681904755301,COGS 100,A01,179886,Staff,40,0,60,20
1681904756327,COGS 101B,A01,179892,Staff,1,0,30,29
1681904757357,COGS 101C,A01,179894,Staff,28,0,30,2
1681904758386,COGS 107A,A01,179896,Boyle; Mary E. T.,31,0,40,9
1681904759411,COGS 108,A01,179898,Simpkins; Charles Alexander,0,17,60,60
1681904760434,COGS 109,A01,179900,Staff,34,0,40,6
1681904761458,COGS 118A,A01,179946,Staff,9,0,40,31
1681904762488,COGS 153,A00,179978,Staff,1,0,30,29
1681904763512,COGS 156,A01,179981,Staff,27,0,30,3
1681904765574,COGS 172,A01,179987,Staff,13,0,30,17
1681904767626,COGS 186,A01,179991,Staff,13,0,30,17
1681904768649,COMM 10,A01,180001,Staff,15,0,25,10
1681904768649,COMM 10,A02,180004,Staff,20,0,25,5
1681904769678,COMM 100A,A01,180016,Staff,18,0,25,7
1681904769678,COMM 100A,A02,180020,Staff,24,0,25,1
1681904770705,COMM 101T,A00,180029,Halm; Gavin Patrick,23,0,35,12
1681904771735,COMM 106V,A00,180043,Staff,34,0,35,1
1681904772762,COMM 109P,A00,180044,Staff,31,0,35,4
1681904773788,COMM 113T,A00,180045,Havis; Allan,37,0,45,8
1681904774818,COMM 132,A00,180046,McKenna; Denise,23,0,30,7
1681904775842,COMM 143,A00,180047,Staff,19,0,30,11
1681904776867,COMM 190,A00,180048,Conner; Thomas Hartnell,20,0,23,3
1681904777898,CSE 8A,A50,180053,Cao; Yingjun,25,0,50,25
1681904777898,CSE 8A,B50,180180,Staff,50,0,50,0
1681904778926,CSE 11,A01,180190,Cao; Yingjun,31,0,50,19
1681904779951,CSE 20,A01,180192,Briones; Jor-el Thomas Caparas,23,0,30,7
1681904780980,CSE 21,A01,194538,Briones; Jor-el Thomas Caparas,50,0,60,10
1681904782006,CSE 30,A01,180324,Eldon; John,79,0,100,21
1681904783029,CSE 101,A01,201353,Staff,0,20,40,40
1681904784053,CSE 134B,A01,180326,Powell; Thomas Allan,74,0,100,26
1681904785078,CSE 140,A01,180328,Staff,46,0,75,29
1681904786104,CSE 140L,A01,180344,Eldon; John,69,0,100,31
1681904787128,CSE 150A,A01,180411,Staff,0,7,50,50
1681904788152,CSE 151A,A01,180414,Staff,0,6,50,50
1681904789176,CSE 175,A01,222521,Kumar; Rakesh,50,0,50,0
1681904790204,CSE 190,A00,201419,Staff,45,0,49,4
1681904791229,CSS 1,A01,194536,Staff,38,0,50,12
1681904792255,DSC 30,A01,202385,Staff,48,0,50,2
1681904793280,DSC 40A,A01,202387,Albuyeh; Rod,50,0,50,0
1681904794304,DSC 190,A01,202389,Silberman; Jack,21,0,21,0
1681904795330,DSGN 100,A01,179993,Staff,16,0,30,14
1681904796355,ECE 65,A50,180708,Staff,10,0,20,10
1681904796355,ECE 65,A51,180739,Staff,19,0,20,1
1681904797380,ECON 1,A01,180427,Famulari; Melissa,67,0,70,3
1681904798408,ECON 2,A01,180450,Levkoff; Steven B.,64,0,70,6
1681904799432,ECON 4,A01,203351,Anderson; John Charles,7,0,10,3
1681904800456,ECON 100A,A01,180472,Famulari; Melissa,65,0,70,5
1681904801486,ECON 120A,A01,180549,Staff,64,0,70,6
1681904802511,ECON 120B,A01,180655,Ma; Xinwei,46,0,70,24
1681904803545,ECON 129,A00,203333,Eckert; Fabian Paul,15,0,35,20
1681904804571,ECON 131,A00,180656,Staff,10,0,35,25
1681904805599,ECON 172B,A01,180672,Levkoff; Steven B.,32,0,35,3
1681904806628,ECON 178,A01,203342,Zhu; Ying,11,0,35,24
1681904807656,EDS 108GS,A00,202383,Wishard Guerra; Alison G.,20,0,20,0
1681904808679,EDS 111GS,A00,202347,Wishard Guerra; Alison G.,20,0,20,0
1681904809706,EDS 112,A01,202323,Staff,56,0,60,4
1681904810735,EDS 113,A00,202340,Staff,33,0,35,2
1681904811763,EDS 118,A00,201231,Staff,20,0,30,10
1681904812787,EDS 119,A00,204994,Staff,8,0,10,2
1681904813810,EDS 124BR,A00,202324,Eguchi; Emi,5,0,25,20
1681904814835,EDS 126,A01,203208,Jones; Makeba,26,0,30,4
1681904815863,EDS 135,A01,202333,Staff,18,0,20,2
1681904816886,EDS 180,A00,202311,Staff,47,0,50,3
1681904817910,ERC 190GS,A01,253747,Staff,28,0,28,0
1681904818932,ETHN 104,A00,180742,Staff,24,0,35,11
1681904819962,ETHN 118,A00,180745,Staff,28,0,35,7
1681904820995,ETHN 127,A00,180747,Staff,12,0,16,4
1681904822025,ETHN 137,A00,180880,Staff,12,0,12,0
1681904823050,ETHN 147,A00,180890,Staff,8,0,10,2
1681904824075,ETHN 154,A00,180891,Staff,7,0,8,1
1681904825102,ETHN 168,A00,180892,Staff,9,0,10,1
1681904826126,GLBH 20,A00,201051,Hannah; Seth Donal,0,1,0,1
1681904827154,GLBH 111,A01,209338,Burgos; Jose L.,0,0,0,0
1681904828182,GLBH 150,A00,258300,Staff,0,3,0,0
1681904829210,GLBH 181,A00,201207,Staff,15,0,40,25
1681904830232,HIEU 109,A00,180898,Staff,20,0,20,0
1681904831256,HIEU 111,A00,180899,Staff,1,0,20,19
1681904832280,HIEU 124,A00,180900,Staff,18,0,20,2
1681904833304,HILA 122,A00,180901,Staff,18,0,20,2
1681904834327,HILA 132,A00,180902,Vitz; Matthew,2,0,20,18
1681904835360,HILD 10,A01,180896,Staff,15,0,20,5
1681904836387,HILD 30GS,A00,180897,Edington; Claire Ellen,0,0,0,0
1681904837413,HISC 105,A00,180903,Staff,20,0,20,0
1681904838450,HISC 117,A00,180904,Staff,11,0,20,9
1681904839474,HIUS 108B,A00,181005,Staff,18,0,20,2
1681904840503,HIUS 113,A00,181093,Staff,4,0,20,16
1681904841529,HUM 3,A01,181190,Patterson; Patrick H.,40,0,50,10
1681904841529,HUM 3,B01,181195,Staff,47,0,50,3
1681904842640,HUM 3GS,A00,181196,Herbst; Matthew,0,0,0,0
1681904843668,HUM 4,A01,181227,West; Geoffrey Scott,34,0,50,16
1681904843668,HUM 4,B01,181282,Staff,43,0,50,7
1681904844702,HUM 4GS,A00,181377,Lyon; Antony J.,0,0,0,0
1681904845731,HUM 5,A01,181536,Zavodny; Tatiana Sophia,31,0,50,19
1681904845731,HUM 5,B01,181908,Staff,36,0,50,14
1681904846760,INTL 190,A00,181909,Segui; Alan S,0,0,0,6
1681904846760,INTL 190,B00,181961,Segui; Alan S,0,0,0,7
1681904847786,JAPN 20AR,A01,182113,Ross; Kayoko F,15,0,20,5
1681904848815,LATI 50,A01,202391,Martin-Cabrera; Luis,19,0,30,11
1681904848815,LATI 50,A02,202392,Martin-Cabrera; Luis,26,0,30,4
1681904849844,LATI 180,A00,202393,Kokinis; Troy Andreas,25,0,25,0
1681904850871,LIFR 1A,A00,182119,Staff,14,0,14,0
1681904851899,LIFR 1AX,A00,182324,Staff,14,0,14,0
1681904852924,LIFR 1B,A00,182259,Staff,14,0,14,0
1681904853951,LIFR 1BX,A00,182273,Staff,14,0,14,0
1681904854976,LIGN 8,A00,182330,Staff,137,0,150,13
1681904856001,LIGN 9GS,A00,182362,Staff,20,0,20,0
1681904857032,LIGN 119,A00,204992,Takahashi; Maho,12,0,15,3
1681904858056,LIGN 130,A01,182384,Staff,47,0,50,3
1681904859078,LIGN 149GS,A00,182390,Staff,20,0,20,0
1681904860100,LIGN 170,A00,182404,Staff,24,0,30,6
1681904861127,LISP 1D,A00,182281,Staff,7,0,14,7
1681904861127,LISP 1D,B00,182287,Staff,14,0,14,0
1681904861127,LISP 1D,C00,182295,Staff,11,0,14,3
1681904861127,LISP 1D,D00,182301,Staff,14,0,14,0
1681904862153,LISP 1DX,A00,182309,Staff,20,0,28,8
1681904862153,LISP 1DX,B00,182316,Staff,26,0,28,2
1681904863177,LTAF 120GS,A00,182412,Zhiri; Oumelbanine,20,0,20,0
1681904864206,LTCS 172GS,A00,182437,Bronstein; Phoebe Malan,20,0,20,0
1681904865234,LTEA 138,A00,182457,Staff,22,0,40,18
1681904866265,LTEN 114,A01,182490,Staff,23,0,25,2
1681904867291,LTEN 130GS,A00,182491,Lyon; Antony J.,20,0,20,0
1681904868319,LTEN 169,A00,182493,Cuong; Marisol,20,0,25,5
1681904869348,LTEN 178,A00,182501,Staff,14,0,15,1
1681904870373,LTEN 181,A00,182515,Staff,22,0,25,3
1681904871405,LTEN 185GS,A00,197655,Forbes; Camille,20,0,20,0
1681904872436,LTSP 100B,A00,202208,Bessett; Ryan Matthew,24,0,25,1
1681904873461,LTWL 100,A00,182516,Myerston Santana; Jacobo,23,0,30,7
1681904874491,LTWR 100GS,A00,182518,Forbes; Camille,20,0,20,0
1681904875517,LTWR 102,A00,182522,Staff,15,0,15,0
1681904875517,LTWR 102,B00,182525,Staff,14,0,15,1
1681904876550,LTWR 115,A00,182526,Staff,12,0,15,3
1681904877575,MAE 8,A01,182528,Pham; Hieu Tan,68,0,70,2
1681904878602,MAE 11,A00,182529,Bahadori; Mohammad Yousef,94,0,100,6
1681904879632,MAE 20,A00,182530,Evdokimenko; Ekaterina,68,0,70,2
1681904880660,MAE 30A,A00,182532,Staff,44,0,45,1
1681904881691,MAE 101A,A00,182533,Bahadori; Mohammad Yousef,97,0,100,3
1681904882717,MAE 101C,A00,182538,Staff,62,0,70,8
1681904883740,MAE 104,A00,182539,Staff,45,0,50,5
1681904884771,MAE 131A,A00,182540,Ghazinejad; Maziar,41,0,45,4
1681904885800,MAE 143A,A00,182548,Bewley; Thomas R,43,0,50,7
1681904886825,MAE 150,A00,182549,Staff,28,0,40,12
1681904887850,MAE 160,A00,182550,Evdokimenko; Ekaterina,43,0,60,17
1681904888875,MATH 3C,A01,182725,Staff,27,0,30,3
1681904889900,MATH 10A,A01,182729,Staff,25,0,30,5
1681904889900,MATH 10A,B01,182732,Staff,26,0,30,4
1681904890929,MATH 10B,A01,182737,Staff,21,0,30,9
1681904890929,MATH 10B,A02,182738,Staff,28,0,30,2
1681904890929,MATH 10B,B01,182744,Staff,27,0,30,3
1681904890929,MATH 10B,B02,182745,Staff,27,0,30,3
1681904891960,MATH 18,A01,182750,Anzaldo; Leesa B,28,0,30,2
1681904891960,MATH 18,A02,182751,Anzaldo; Leesa B,29,0,30,1
1681904891960,MATH 18,A03,182753,Anzaldo; Leesa B,28,0,30,2
1681904891960,MATH 18,A04,182757,Anzaldo; Leesa B,29,0,30,1
1681904891960,MATH 18,B01,182761,Anzaldo; Leesa B,27,0,30,3
1681904891960,MATH 18,B02,182764,Anzaldo; Leesa B,27,0,30,3
1681904891960,MATH 18,B03,182765,Anzaldo; Leesa B,30,0,30,0
1681904891960,MATH 18,B04,182766,Anzaldo; Leesa B,30,0,30,0
1681904892983,MATH 20A,A01,182771,Suk; Andrew Hoon,28,0,30,2
1681904894008,MATH 20B,A01,182775,Bach; Quang Tran,30,0,30,0
1681904894008,MATH 20B,A02,182777,Bach; Quang Tran,29,0,30,1
1681904894008,MATH 20B,B01,182780,Bach; Quang Tran,27,0,30,3
1681904894008,MATH 20B,B02,182782,Bach; Quang Tran,30,0,30,0
1681904895037,MATH 20C,A01,182787,Staff,25,0,30,5
1681904895037,MATH 20C,A02,182790,Staff,29,0,30,1
1681904895037,MATH 20C,B01,182792,Staff,25,0,30,5
1681904895037,MATH 20C,B02,182796,Staff,27,0,30,3
1681904896065,MATH 20D,A01,182799,Staff,29,0,30,1
1681904896065,MATH 20D,A02,182802,Staff,30,0,30,0
1681904896065,MATH 20D,A03,182803,Staff,30,0,30,0
1681904897090,MATH 20E,A01,182809,Verstraete; Jacques Allan,24,0,30,6
1681904897090,MATH 20E,A02,182811,Verstraete; Jacques Allan,28,0,30,2
1681904897090,MATH 20E,B01,182814,Verstraete; Jacques Allan,23,0,30,7
1681904897090,MATH 20E,B02,182815,Verstraete; Jacques Allan,30,0,30,0
1681904898118,MATH 103A,A01,182820,Staff,9,0,30,21
1681904898118,MATH 103A,A02,182821,Staff,27,0,30,3
1681904898118,MATH 103A,A03,182822,Staff,23,0,30,7
1681904898118,MATH 103A,B01,182825,Staff,23,0,30,7
1681904898118,MATH 103A,B02,182826,Staff,30,0,30,0
1681904898118,MATH 103A,B03,182830,Staff,30,0,30,0
1681904899148,MATH 109,A01,182836,Chow; Bennett,24,0,30,6
1681904899148,MATH 109,A02,182838,Chow; Bennett,29,0,30,1
1681904899148,MATH 109,A03,182894,Chow; Bennett,29,0,30,1
1681904899148,MATH 109,B01,182908,Chow; Bennett,28,0,30,2
1681904899148,MATH 109,B02,182909,Chow; Bennett,30,0,30,0
1681904899148,MATH 109,B03,182910,Chow; Bennett,27,0,30,3
1681904900173,MATH 142A,A01,182925,Staff,11,0,30,19
1681904900173,MATH 142A,A02,182935,Staff,25,0,30,5
1681904900173,MATH 142A,A03,182967,Staff,26,0,30,4
1681904900173,MATH 142A,B01,183125,Staff,24,0,30,6
1681904900173,MATH 142A,B02,183157,Staff,28,0,30,2
1681904900173,MATH 142A,B03,183158,Staff,29,0,30,1
1681904901198,MATH 183,A01,183160,Arias-Castro; Ery,23,0,30,7
1681904901198,MATH 183,A02,183161,Arias-Castro; Ery,29,0,30,1
1681904901198,MATH 183,B01,183163,Arias-Castro; Ery,28,0,30,2
1681904901198,MATH 183,B02,183164,Arias-Castro; Ery,28,0,30,2
1681904902226,MATH 193A,A01,183167,Staff,4,0,35,31
1681904902226,MATH 193A,A02,183168,Staff,28,0,35,7
1681904902226,MATH 193A,A03,183169,Staff,34,0,35,1
1681904902226,MATH 193A,A04,183170,Staff,28,0,35,7
1681904903253,MGT 4,A01,202395,Anderson; John Charles,75,0,80,5
1681904904280,MGT 5,A00,202396,Houskeeper; Robert,80,0,90,10
1681904905307,MGT 103,A00,202397,Eberhard; Craig A,55,0,90,35
1681904906330,MGT 131A,A00,202398,Houskeeper; Robert,85,0,90,5
1681904907354,MGT 135,A00,202399,Anderson; John Charles,83,0,90,7
1681904908383,MGT 162R,A00,202403,Gneezy; Uri,150,0,200,50
1681904909407,MGT 172,A00,202404,Hedges; Kathleen,50,0,90,40
1681904910436,MGT 181,A00,202405,Dunn; Louis Jean,84,0,90,6
1681904911468,MMW 14,A01,183200,Staff,16,0,28,12
1681904911468,MMW 14,A02,183201,Staff,26,0,28,2
1681904911468,MMW 14,A03,183202,Staff,24,0,28,4
1681904911468,MMW 14,A04,183203,Staff,25,0,28,3
1681904911468,MMW 14,A05,183204,Staff,26,0,28,2
1681904911468,MMW 14,A06,183205,Staff,27,0,28,1
1681904911468,MMW 14,B01,183207,Staff,26,0,28,2
1681904911468,MMW 14,B02,183208,Staff,28,0,28,0
1681904911468,MMW 14,B03,183209,Staff,28,0,28,0
1681904911468,MMW 14,B04,183210,Staff,28,0,28,0
1681904911468,MMW 14,B05,183211,Staff,28,0,28,0
1681904911468,MMW 14,B06,183212,Staff,28,0,28,0
1681904912502,MMW 14GS,A00,183213,Zhiri; Oumelbanine,28,0,28,0
1681904913530,MMW 15GS,B00,183215,Rahimi; Babak,28,0,28,0
1681904914555,MMW 121,A01,183217,Patterson; Patrick H.,14,0,28,14
1681904914555,MMW 121,A02,183218,Patterson; Patrick H.,25,0,28,3
1681904915580,MUS 1A,A01,182554,Staff,8,0,35,27
1681904916605,MUS 5,A01,182558,Staff,20,0,35,15
1681904917631,MUS 6,A01,182562,Staff,25,0,35,10
1681904918657,MUS 8GS,A00,182563,Borgo; David Garcia,25,0,25,0
1681904919687,MUS 13,A01,182567,Staff,24,0,25,1
1681904920711,MUS 15,A01,182570,Staff,32,0,35,3
1681904920711,MUS 15,B01,182575,Staff,10,0,35,25
1681904921735,MUS 80,A00,182578,Staff,23,0,25,2
1681904921735,MUS 80,B00,182581,Staff,20,0,25,5
1681904922760,MUS 113,A00,182582,Staff,25,0,25,0
1681904923783,MUS 114,A00,182583,Staff,4,0,25,21
1681904924811,MUS 150GS,A01,182588,Borgo; David Garcia,25,0,25,0
1681904925838,PHIL 1,A00,182590,Staff,35,0,40,5
1681904926867,PHIL 10,A01,182596,Grush; Rick Scott,31,0,35,4
1681904926867,PHIL 10,A02,182597,Grush; Rick Scott,34,0,35,1
1681904927892,PHIL 15,A01,182601,Staff,31,0,35,4
1681904927892,PHIL 15,A02,182602,Staff,33,0,35,2
1681904928920,PHIL 27,A01,182604,Staff,30,0,35,5
1681904928920,PHIL 27,A02,182607,Staff,35,0,35,0
1681904929945,PHIL 32,A01,182609,Staff,35,0,35,0
1681904929945,PHIL 32,A02,182612,Staff,35,0,35,0
1681904930970,PHIL 130,A00,182614,Staff,63,0,70,7
1681904931994,PHIL 136,A00,182616,Cohen; Jonathan David,66,0,70,4
1681904933036,PHIL 155,A00,182617,Vargas; Manuel Rogelio,60,0,70,10
1681904934062,PHIL 163,A01,182620,Staff,15,0,20,5
1681904934062,PHIL 163,A02,182624,Staff,10,0,20,10
1681904935086,PHIL 164,A00,182627,Staff,30,0,40,10
1681904936109,PHIL 173,A00,182628,Staff,36,0,40,4
1681904937138,PHYS 1A,A00,183221,Staff,54,0,60,6
1681904938161,PHYS 1AL,001,183222,Staff,25,0,30,5
1681904938161,PHYS 1AL,002,183223,Staff,28,0,30,2
1681904939190,PHYS 1B,A00,183231,Staff,44,0,60,16
1681904940215,PHYS 1BL,001,183232,Staff,20,0,30,10
1681904940215,PHYS 1BL,002,183233,Staff,29,0,30,1
1681904941240,PHYS 1C,A00,183240,Staff,30,0,60,30
1681904942264,PHYS 1CL,001,183241,Staff,13,0,30,17
1681904942264,PHYS 1CL,002,183242,Staff,22,0,30,8
1681904943287,PHYS 2AR,A01,183250,Staff,44,0,50,6
1681904944311,PHYS 2B,A01,183252,Staff,106,0,115,9
1681904945337,PHYS 2BL,A01,183254,Staff,21,0,24,3
1681904945337,PHYS 2BL,A02,183255,Staff,22,0,24,2
1681904946458,PHYS 2C,A01,183522,Staff,105,0,115,10
1681904947487,PHYS 4A,A01,183524,Staff,49,0,50,1
1681904948511,POLI 5,A00,183525,Staff,44,0,50,6
1681904949534,POLI 12,A00,183540,Staff,48,0,50,2
1681904950559,POLI 13R,A00,183541,Forman; Fonna,42,0,50,8
1681904951584,POLI 30,A00,183542,Mignozzetti; Umberto,47,0,50,3
1681904952606,POLI 100A,A00,183543,Staff,45,0,50,5
1681904953630,POLI 100E,A00,223598,Staff,32,0,35,3
1681904954657,POLI 103A,A00,183564,Kousser; Thad,38,0,50,12
1681904955687,POLI 104B,A00,201329,Staff,29,0,35,6
1681904956710,POLI 113BR,A00,183576,Hoston; Germaine,28,0,50,22
1681904957739,POLI 114BR,A00,183588,Staff,27,0,30,3
1681904958770,POLI 117R,A00,183595,Forman; Fonna,9,0,20,11
1681904959800,POLI 120H,A00,183596,Fisk; David Lee,13,0,20,7
1681904960822,POLI 130AA,A00,183597,Staff,14,0,20,6
1681904961846,POLI 134AA,A00,183598,Staff,19,0,20,1
1681904962870,POLI 135,A00,183599,Fisk; David Lee,20,0,25,5
1681904963902,POLI 142P,A00,183623,Staff,37,0,40,3
1681904964926,POLI 144D,A00,183624,Staff,22,0,25,3
1681904965949,POLI 151,A00,183625,Staff,15,0,20,5
1681904966977,POLI 162,A00,183626,Mignozzetti; Umberto,18,0,20,2
1681904968004,PSYC 1,A00,253748,Staff,86,0,90,4
1681904969035,PSYC 2,A00,183627,Moranton; Nirelia Melbina-,25,0,35,10
1681904970066,PSYC 3,A00,183628,Staff,43,0,45,2
1681904972120,PSYC 60,A01,183631,Lowe; Angela Beth,35,0,40,5
1681904973147,PSYC 70,A01,253757,Staff,37,0,45,8
1681904974170,PSYC 101,A00,183632,Heyman; Gail D.,48,0,60,12
1681904975195,PSYC 105,A00,183848,Lowe; Angela Beth,50,0,60,10
1681904976220,PSYC 106,A00,183849,Dobkins; Karen R.,45,0,60,15
1681904977243,PSYC 108,A00,253750,Staff,24,0,60,36
1681904978273,PSYC 114,A01,184275,Winkielman; Piotr,0,6,30,30
1681904979300,PSYC 122,A00,183856,Moranton; Nirelia Melbina-,0,10,30,30
1681904980328,PSYC 124,A00,183865,Chapman; Eddie Nathaniel,52,0,80,28
1681904981355,PSYC 137,A00,183880,Staff,19,0,25,6
1681904983409,PSYC 154,A00,183910,Lacefield; Katharine I,0,2,90,90
1681904985464,PSYC 162,A00,183946,Wixted; John T,61,0,90,29
1681904986492,PSYC 172,A00,183947,Gorman; Michael R.,14,0,30,16
1681904987514,PSYC 178,A00,183963,Glaser; Dale,20,0,40,20
1681904988541,PSYC 181GS,A00,183964,Anagnostaras; Stephan,10,0,10,0
1681904989565,PSYC 186GS,A01,257660,Staff,10,0,10,0
1681904990596,PSYC 193,B00,253749,Staff,23,0,25,2
1681904992646,PSYC 193L,A01,184122,Staff,33,0,35,2
1681904992646,PSYC 193L,C01,184167,Winkielman; Piotr,16,0,30,14
1681904993675,RELI 188GS,A00,182629,Rahimi; Babak,20,0,20,0
1681904994703,SE 101A,A00,182646,Staff,26,0,30,4
1681904995730,SE 101C,A00,182650,Staff,18,0,20,2
1681904996757,SE 110A,A00,182651,Staff,28,0,28,0
1681904998010,SE 130A,A00,182652,Staff,39,0,40,1
1681904999037,SIO 46GS,A00,182636,Cook; Geoffrey W,28,0,28,0
1681905000059,SIO 109R,A00,194459,Staff,5,0,20,15
1681905001082,SIO 121GS,A00,182639,Cook; Geoffrey W,28,0,28,0
1681905002113,SIO 132,A01,182642,Staff,32,0,40,8
1681905003138,SIO 139,A00,182644,Kacev; David,36,0,40,4
1681905004163,SOCI 2,A01,258404,Staff,34,0,36,2
1681905004163,SOCI 2,A02,258405,Staff,35,0,36,1
1681905005201,SOCI 60,A01,258408,Staff,29,0,30,1
1681905005201,SOCI 60,A02,258413,Staff,30,0,30,0
1681905006232,SOCI 100,A01,258415,Staff,29,0,30,1
1681905006232,SOCI 100,A02,258416,Staff,28,0,30,2
1681905012400,SOCI 127,A00,258421,Staff,22,0,30,8
1681905013423,SOCI 132,A00,258422,Staff,45,0,50,5
1681905014445,SOCI 133,A00,258423,Staff,26,0,30,4
1681905015469,SOCI 138GS,A00,258424,Staff,15,0,15,0
1681905016492,SOCI 145,A00,258425,Staff,25,0,30,5
1681905017516,SOCI 148,A00,258426,Staff,26,0,30,4
1681905018543,SOCI 153,A00,199217,Staff,29,0,30,1
1681905019569,SOCI 160,A00,258427,Staff,28,0,30,2
1681905020592,SOCI 160E,A00,258435,Staff,56,0,60,4
1681905021617,SOCI 189GS,A00,258436,Staff,15,0,15,0
1681905022641,SOCI 190GS,A00,258437,Staff,15,0,15,0
1681905023665,SYN 2,001,182658,Staff,9,0,16,7
1681905023665,SYN 2,002,201439,Staff,15,0,16,1
1681905023665,SYN 2,003,201443,Staff,16,0,16,0
1681905024687,SYN 100,A01,182657,Staff,17,0,20,3
1681905025720,TDAC 1,A00,184381,Salovey; Todd,16,0,20,4
1681905025720,TDAC 1,B00,184385,Harting; Carla Kelso,19,0,20,1
1681905025720,TDAC 1,C00,184394,Staff,19,0,20,1
1681905026743,TDAC 101,A00,184483,Harting; Carla Kelso,19,0,20,1
1681905027767,TDDE 111,A00,184496,Staff,14,0,15,1
1681905028800,TDDE 131,A00,184504,Staff,20,0,20,0
1681905028800,TDDE 131,B00,184505,Staff,17,0,18,1
1681905028800,TDDE 131,C00,184534,Staff,49,0,50,1
1681905028800,TDDE 131,D00,184564,Staff,15,0,15,0
1681905028800,TDDE 131,E00,204725,Staff,19,0,20,1
1681905029827,TDGE 1,A01,184414,Salovey; Todd,37,0,50,13
1681905030850,TDGE 5,A01,184419,Staff,23,0,24,1
1681905031876,TDGE 10,A00,184428,Fulton; Julia,31,0,50,19
1681905032904,TDGE 124,A00,184565,Fulton; Julia,7,0,50,43
1681905033929,TDGE 125,B00,184567,Meyer; Ursula,9,0,25,16
1681905034957,TDHT 101,A00,184568,Staff,21,0,25,4
1681905034957,TDHT 101,B00,184569,Staff,20,0,20,0
1681905035982,TDHT 114,A00,184570,Staff,49,0,50,1
1681905037012,TDMV 1,A00,184437,Arcidiacono; Kristin,23,0,30,7
1681905037012,TDMV 1,B00,184448,Caligagan; Maria T.,22,0,30,8
1681905038040,TDMV 2,A00,184449,Weinberg; Sadie,27,0,30,3
1681905038040,TDMV 2,B00,184453,Arcidiacono; Kristin,29,0,30,1
1681905039064,TDMV 110,A00,184571,Weinberg; Sadie,30,0,30,0
1681905040087,TDMV 142,A00,184572,Caligagan; Tony,27,0,30,3
1681905040087,TDMV 142,B00,184573,Caligagan; Maria T.,27,0,30,3
1681905041124,TDTR 20,A00,184482,Jun; Grace Shin Hae,25,0,25,0
1681905042152,USP 2,A01,184290,Hinds; Juli Beth,24,0,25,1
1681905043180,USP 3,A01,184295,Staff,20,0,25,5
1681905044209,USP 4,A00,184304,McTague; Sarah,15,0,25,10
1681905045232,USP 100,A00,184315,Staff,17,0,25,8
1681905046258,USP 105,A00,184326,Staff,21,0,25,4
1681905047282,USP 151,A00,184327,Staff,20,0,25,5
1681905048311,USP 170,A00,184380,Hinds; Juli Beth,14,0,25,11
1681905049338,VIS 21B,A01,182660,Staff,28,0,31,3
1681905049338,VIS 21B,A02,182662,Staff,30,0,31,1
1681905050453,VIS 103D,A00,182663,Staff,74,0,75,1
1681905051478,VIS 105D,A00,182667,Li; Huai,15,0,22,7
1681905052502,VIS 122GS,A00,182668,Herbst; Matthew,20,0,20,0
1681905053524,VIS 128C,A00,182673,Staff,70,0,75,5
1681905054550,VIS 130,A00,182675,Staff,20,0,22,2
1681905055584,VIS 160A,A00,182678,Stalbaum; Brett,4,0,10,6
1681905057638,WCWP 10B,A00,201679,Staff,15,0,15,0
1681905057638,WCWP 10B,B00,201695,Staff,15,0,15,0
1681905058669,WCWP 100,A00,201716,Staff,15,0,15,0
1681905058669,WCWP 100,B00,201717,Staff,11,0,15,4
1681905060783,ANSC 105GS,A00,258289,Staff,0,0,0,0
1681905061806,ANSC 125GS,A00,258295,Staff,0,0,0,0
1681905062837,ANSC 150,A00,258267,Staff,30,0,40,10
1681905063862,ANSC 190GS,A00,258280,Staff,0,0,0,0
1681905064886,ANTH 1,A00,258264,Staff,38,0,40,2
1681905065914,ANTH 2,A01,258259,Staff,72,0,76,4
1681905066938,ANTH 23,A01,258228,Staff,36,0,40,4
1681905067962,ANTH 101,A01,258236,Staff,39,0,40,1
1681905068986,ANTH 102,A00,258272,Staff,59,0,60,1
1681905070009,ANTH 105,A00,258244,Staff,31,0,35,4
1681905071037,BENG 130,A00,253975,Staff,38,0,40,2
1681905072073,BIBC 102,A01,191866,Flagg; Matthew Paul,19,0,32,13
1681905072073,BIBC 102,A02,191867,Flagg; Matthew Paul,22,0,32,10
1681905072073,BIBC 102,A03,191868,Flagg; Matthew Paul,30,0,32,2
1681905072073,BIBC 102,A04,191936,Flagg; Matthew Paul,26,0,32,6
1681905072073,BIBC 102,A05,191937,Flagg; Matthew Paul,11,0,32,21
1681905073101,BICD 100,A01,191939,Cooper; Andrew Michael,28,0,32,4
1681905073101,BICD 100,A02,191940,Cooper; Andrew Michael,32,0,32,0
1681905073101,BICD 100,A03,191941,Cooper; Andrew Michael,32,0,32,0
1681905073101,BICD 100,A04,191942,Cooper; Andrew Michael,32,0,32,0
1681905073101,BICD 100,A05,191943,Cooper; Andrew Michael,32,0,32,0
1681905074127,BIEB 126,A01,191945,Cleland; Elsa Eleanor,1,0,32,31
1681905074127,BIEB 126,A02,191946,Cleland; Elsa Eleanor,28,0,32,4
1681905074127,BIEB 126,A03,191947,Cleland; Elsa Eleanor,29,0,32,3
1681905074127,BIEB 126,A04,191948,Cleland; Elsa Eleanor,23,0,32,9
1681905074127,BIEB 126,A05,191996,Cleland; Elsa Eleanor,28,0,32,4
1681905075155,BIEB 136GS,A00,191997,Shurin; Jonathan & Holway; David A.,0,0,0,0
1681905076180,BIEB 137GS,A01,191999,Shurin; Jonathan & Holway; David A.,0,0,0,0
1681905077205,BILD 1,A01,205385,Staff,31,0,32,1
1681905077205,BILD 1,A02,205386,Staff,30,0,32,2
1681905077205,BILD 1,A03,205387,Staff,32,0,32,0
1681905077205,BILD 1,A04,205388,Staff,28,0,32,4
1681905078231,BILD 2,A01,191774,Staff,28,0,32,4
1681905078231,BILD 2,A02,191775,Staff,30,0,32,2
1681905078231,BILD 2,A03,191777,Staff,30,0,32,2
1681905078231,BILD 2,A04,191856,Staff,31,0,32,1
1681905078231,BILD 2,A05,191857,Staff,32,0,32,0
1681905078231,BILD 2,A06,191858,Staff,32,0,32,0
1681905078231,BILD 2,A07,191859,Staff,31,0,32,1
1681905079255,BILD 3,A01,205391,Staff,29,0,32,3
1681905079255,BILD 3,A02,205393,Staff,32,0,32,0
1681905079255,BILD 3,A03,205394,Staff,28,0,32,4
1681905079255,BILD 3,A04,205395,Staff,32,0,32,0
1681905080278,BILD 20,A01,191861,Staff,32,0,32,0
1681905080278,BILD 20,A02,191862,Staff,32,0,32,0
1681905081301,BILD 30,A01,191864,Staff,31,0,32,1
1681905082327,BIMM 100,A01,192019,Staff,0,0,32,32
1681905082327,BIMM 100,A02,192020,Staff,23,0,32,9
1681905082327,BIMM 100,A03,192035,Staff,22,0,32,10
1681905083355,BIMM 110,A01,192037,Tat; John,0,0,32,32
1681905083355,BIMM 110,A02,192038,Tat; John,10,0,32,22
1681905084383,BIMM 120,A01,192040,Pickett; Brooke Elizabeth,2,0,32,30
1681905084383,BIMM 120,A02,192041,Pickett; Brooke Elizabeth,16,0,32,16
1681905084383,BIMM 120,A03,192042,Pickett; Brooke Elizabeth,16,0,32,16
1681905085407,BIPN 100,A01,192044,Armour; Jon Christopher,26,0,32,6
1681905085407,BIPN 100,A02,192059,Armour; Jon Christopher,30,0,32,2
1681905085407,BIPN 100,A03,192064,Armour; Jon Christopher,31,0,32,1
1681905085407,BIPN 100,A04,192073,Armour; Jon Christopher,28,0,32,4
1681905086433,BIPN 148,A01,205411,Leutgeb; Jill K.,16,0,32,16
1681905086433,BIPN 148,A02,205412,Leutgeb; Jill K.,31,0,32,1
1681905086433,BIPN 148,A03,205413,Leutgeb; Jill K.,30,0,32,2
1681905086433,BIPN 148,A04,205414,Leutgeb; Jill K.,30,0,32,2
1681905087458,BIPN 160,A01,192115,Marino; Marc J,19,0,32,13
1681905087458,BIPN 160,A02,192148,Marino; Marc J,27,0,32,5
1681905087458,BIPN 160,A03,192158,Marino; Marc J,31,0,32,1
1681905087458,BIPN 160,A04,192190,Marino; Marc J,32,0,32,0
1681905087458,BIPN 160,A05,192287,Marino; Marc J,32,0,32,0
1681905087458,BIPN 160,A06,192288,Marino; Marc J,32,0,32,0
1681905088487,BIPN 194,A00,206038,Staff,28,0,32,4
1681905089518,BISP 194,A00,192289,Leutgeb; Stefan,13,0,32,19
1681905089518,BISP 194,B00,245332,Nieh; James Charles,27,0,32,5
1681905090543,CAT 124,A01,202247,Staff,15,0,15,0
1681905091570,CAT 125,A00,202248,Staff,19,0,20,1
1681905091570,CAT 125,B00,202253,Staff,20,0,20,0
1681905091570,CAT 125,C00,202257,Staff,19,0,20,1
1681905092596,CAT 125GS,A01,202273,Bronstein; Phoebe Malan,20,0,20,0
1681905093622,CAT 125R,A00,202284,Staff,17,0,20,3
1681905093622,CAT 125R,C00,202286,Staff,10,0,20,10
1681905093622,CAT 125R,D00,202291,Staff,18,0,20,2
1681905093622,CAT 125R,E00,202295,Staff,13,0,20,7
1681905093622,CAT 125R,F00,202302,Staff,12,0,20,8
1681905094651,CENG 100,A00,204724,Opatkiewicz; Justin Paul,25,0,25,0
1681905095676,CGS 2A,A01,180420,Staff,31,0,36,5
1681905096703,CGS 101,A00,180421,Staff,16,0,20,4
1681905097731,CGS 112,A00,180422,Staff,10,0,16,6
1681905098759,CGS 113,A00,180423,Staff,18,0,20,2
1681905099783,CGS 137,A00,180424,Staff,12,0,12,0
1681905100806,CGS 147,A00,180425,Staff,10,0,10,0
1681905101831,CHEM 6A,A01,179556,Staff,97,0,100,3
1681905101831,CHEM 6A,A02,179558,Staff,0,0,0,0
1681905102854,CHEM 6B,A01,179560,Staff,100,0,100,0
1681905103883,CHEM 6C,A01,179565,Jazzar; Rodolphe,95,0,100,5
1681905104910,CHEM 7L,A01,179586,Schurmeier; Kimberly,13,0,24,11
1681905104910,CHEM 7L,A02,179587,Schurmeier; Kimberly,23,0,24,1
1681905104910,CHEM 7L,A03,179590,Schurmeier; Kimberly,22,0,24,2
1681905104910,CHEM 7L,A04,179591,Schurmeier; Kimberly,22,0,24,2
1681905104910,CHEM 7L,B01,179598,Schurmeier; Kimberly,17,0,24,7
1681905104910,CHEM 7L,B02,179599,Schurmeier; Kimberly,24,0,24,0
1681905104910,CHEM 7L,B03,179606,Schurmeier; Kimberly,23,0,24,1
1681905104910,CHEM 7L,B04,179607,Schurmeier; Kimberly,23,0,24,1
1681905105935,CHEM 11,A01,179609,Stallings; Dontarie M,88,0,100,12
1681905106962,CHEM 40A,A01,179621,Staff,41,0,50,9
1681905106962,CHEM 40A,A02,179622,Staff,47,0,50,3
1681905107991,CHEM 40B,A01,179630,Weizman; Haim,48,0,50,2
1681905107991,CHEM 40B,A02,179631,Weizman; Haim,45,0,50,5
1681905109018,CHEM 41A,A01,179660,Klosterman; Jeremy K,93,0,100,7
1681905110042,CHEM 43A,A01,179683,Klosterman; Jeremy K,0,0,24,24
1681905110042,CHEM 43A,A02,179688,Klosterman; Jeremy K,14,0,24,10
1681905110042,CHEM 43A,A03,179689,Klosterman; Jeremy K,20,0,24,4
1681905110042,CHEM 43A,A04,179691,Klosterman; Jeremy K,18,0,24,6
1681905111076,CHEM 114A,A01,179693,Stallings; Dontarie M,77,0,100,23
1681905112100,CHEM 143B,A01,179698,Weizman; Haim,17,0,24,7
1681905112100,CHEM 143B,A02,179700,Weizman; Haim,24,0,24,0
1681905113125,CHIN 169A,A00,179701,Wang; Xiao,20,0,20,0
1681905114155,COGS 2,A01,179750,Boyle; Mary E. T.,17,0,30,13
1681905115185,COGS 9,A01,179759,Jones; Cameron Robert,43,0,50,7
1681905116209,COGS 14A,A01,179854,Staff,18,0,50,32
1681905117232,COGS 14B,A01,179856,Staff,54,0,60,6
1681905118260,COGS 17,A01,179874,Staff,71,0,75,4
1681905119282,COGS 18,A01,179884,Staff,63,0,80,17
1681905120310,COGS 100,A01,179886,Staff,40,0,60,20
1681905121345,COGS 101B,A01,179892,Staff,1,0,30,29
1681905122378,COGS 101C,A01,179894,Staff,28,0,30,2
1681905123408,COGS 107A,A01,179896,Boyle; Mary E. T.,31,0,40,9
1681905124434,COGS 108,A01,179898,Simpkins; Charles Alexander,0,17,60,60
1681905125468,COGS 109,A01,179900,Staff,34,0,40,6
1681905126495,COGS 118A,A01,179946,Staff,9,0,40,31
1681905127518,COGS 153,A00,179978,Staff,1,0,30,29
1681905128542,COGS 156,A01,179981,Staff,27,0,30,3
1681905130590,COGS 172,A01,179987,Staff,13,0,30,17
1681905132640,COGS 186,A01,179991,Staff,13,0,30,17
1681905133664,COMM 10,A01,180001,Staff,15,0,25,10
1681905133664,COMM 10,A02,180004,Staff,20,0,25,5
1681905134689,COMM 100A,A01,180016,Staff,18,0,25,7
1681905134689,COMM 100A,A02,180020,Staff,24,0,25,1
1681905135713,COMM 101T,A00,180029,Halm; Gavin Patrick,23,0,35,12
1681905136740,COMM 106V,A00,180043,Staff,34,0,35,1
1681905137764,COMM 109P,A00,180044,Staff,31,0,35,4
1681905138789,COMM 113T,A00,180045,Havis; Allan,37,0,45,8
1681905139816,COMM 132,A00,180046,McKenna; Denise,23,0,30,7
1681905140840,COMM 143,A00,180047,Staff,19,0,30,11
1681905141876,COMM 190,A00,180048,Conner; Thomas Hartnell,20,0,23,3
1681905142909,CSE 8A,A50,180053,Cao; Yingjun,25,0,50,25
1681905142909,CSE 8A,B50,180180,Staff,50,0,50,0
1681905143938,CSE 11,A01,180190,Cao; Yingjun,31,0,50,19
1681905144962,CSE 20,A01,180192,Briones; Jor-el Thomas Caparas,23,0,30,7
1681905145987,CSE 21,A01,194538,Briones; Jor-el Thomas Caparas,50,0,60,10
1681905147010,CSE 30,A01,180324,Eldon; John,79,0,100,21
1681905148041,CSE 101,A01,201353,Staff,0,20,40,40
1681905149070,CSE 134B,A01,180326,Powell; Thomas Allan,74,0,100,26
1681905150093,CSE 140,A01,180328,Staff,46,0,75,29
1681905151119,CSE 140L,A01,180344,Eldon; John,69,0,100,31
1681905152152,CSE 150A,A01,180411,Staff,0,7,50,50
1681905153177,CSE 151A,A01,180414,Staff,0,6,50,50
1681905154275,CSE 175,A01,222521,Kumar; Rakesh,50,0,50,0
1681905155297,CSE 190,A00,201419,Staff,45,0,49,4
1681905156324,CSS 1,A01,194536,Staff,38,0,50,12
1681905157352,DSC 30,A01,202385,Staff,48,0,50,2
1681905158382,DSC 40A,A01,202387,Albuyeh; Rod,50,0,50,0
1681905159417,DSC 190,A01,202389,Silberman; Jack,21,0,21,0
1681905160440,DSGN 100,A01,179993,Staff,16,0,30,14
1681905161465,ECE 65,A50,180708,Staff,10,0,20,10
1681905161465,ECE 65,A51,180739,Staff,19,0,20,1
1681905162489,ECON 1,A01,180427,Famulari; Melissa,67,0,70,3
1681905163516,ECON 2,A01,180450,Levkoff; Steven B.,64,0,70,6
1681905164544,ECON 4,A01,203351,Anderson; John Charles,7,0,10,3
1681905165573,ECON 100A,A01,180472,Famulari; Melissa,65,0,70,5
1681905166598,ECON 120A,A01,180549,Staff,64,0,70,6
1681905167624,ECON 120B,A01,180655,Ma; Xinwei,46,0,70,24
1681905168650,ECON 129,A00,203333,Eckert; Fabian Paul,15,0,35,20
1681905169678,ECON 131,A00,180656,Staff,10,0,35,25
1681905170705,ECON 172B,A01,180672,Levkoff; Steven B.,32,0,35,3
1681905171735,ECON 178,A01,203342,Zhu; Ying,11,0,35,24
1681905172760,EDS 108GS,A00,202383,Wishard Guerra; Alison G.,20,0,20,0
1681905173783,EDS 111GS,A00,202347,Wishard Guerra; Alison G.,20,0,20,0
1681905174815,EDS 112,A01,202323,Staff,56,0,60,4
1681905175844,EDS 113,A00,202340,Staff,33,0,35,2
1681905176868,EDS 118,A00,201231,Staff,20,0,30,10
1681905177893,EDS 119,A00,204994,Staff,8,0,10,2
1681905178920,EDS 124BR,A00,202324,Eguchi; Emi,5,0,25,20
1681905179944,EDS 126,A01,203208,Jones; Makeba,26,0,30,4
1681905180968,EDS 135,A01,202333,Staff,18,0,20,2
1681905181996,EDS 180,A00,202311,Staff,47,0,50,3
1681905183023,ERC 190GS,A01,253747,Staff,28,0,28,0
1681905184050,ETHN 104,A00,180742,Staff,24,0,35,11
1681905185074,ETHN 118,A00,180745,Staff,28,0,35,7
1681905186098,ETHN 127,A00,180747,Staff,12,0,16,4
1681905187122,ETHN 137,A00,180880,Staff,12,0,12,0
1681905188145,ETHN 147,A00,180890,Staff,8,0,10,2
1681905189171,ETHN 154,A00,180891,Staff,7,0,8,1
1681905190200,ETHN 168,A00,180892,Staff,9,0,10,1
1681905191226,GLBH 20,A00,201051,Hannah; Seth Donal,0,1,0,1
1681905192256,GLBH 111,A01,209338,Burgos; Jose L.,0,0,0,0
1681905193284,GLBH 150,A00,258300,Staff,0,3,0,0
1681905194312,GLBH 181,A00,201207,Staff,15,0,40,25
1681905195338,HIEU 109,A00,180898,Staff,20,0,20,0
1681905196365,HIEU 111,A00,180899,Staff,1,0,20,19
1681905197392,HIEU 124,A00,180900,Staff,18,0,20,2
1681905198417,HILA 122,A00,180901,Staff,18,0,20,2
1681905199440,HILA 132,A00,180902,Vitz; Matthew,2,0,20,18
1681905200466,HILD 10,A01,180896,Staff,15,0,20,5
1681905201489,HILD 30GS,A00,180897,Edington; Claire Ellen,0,0,0,0
1681905202513,HISC 105,A00,180903,Staff,20,0,20,0
1681905203536,HISC 117,A00,180904,Staff,11,0,20,9
1681905204564,HIUS 108B,A00,181005,Staff,18,0,20,2
1681905205589,HIUS 113,A00,181093,Staff,4,0,20,16
1681905206618,HUM 3,A01,181190,Patterson; Patrick H.,40,0,50,10
1681905206618,HUM 3,B01,181195,Staff,47,0,50,3
1681905207645,HUM 3GS,A00,181196,Herbst; Matthew,0,0,0,0
1681905208674,HUM 4,A01,181227,West; Geoffrey Scott,34,0,50,16
1681905208674,HUM 4,B01,181282,Staff,43,0,50,7
1681905209700,HUM 4GS,A00,181377,Lyon; Antony J.,0,0,0,0
1681905210727,HUM 5,A01,181536,Zavodny; Tatiana Sophia,31,0,50,19
1681905210727,HUM 5,B01,181908,Staff,36,0,50,14
1681905211753,INTL 190,A00,181909,Segui; Alan S,0,0,0,6
1681905211753,INTL 190,B00,181961,Segui; Alan S,0,0,0,7
1681905212786,JAPN 20AR,A01,182113,Ross; Kayoko F,15,0,20,5
1681905213816,LATI 50,A01,202391,Martin-Cabrera; Luis,19,0,30,11
1681905213816,LATI 50,A02,202392,Martin-Cabrera; Luis,26,0,30,4
1681905214846,LATI 180,A00,202393,Kokinis; Troy Andreas,25,0,25,0
1681905215871,LIFR 1A,A00,182119,Staff,14,0,14,0
1681905216894,LIFR 1AX,A00,182324,Staff,14,0,14,0
1681905217920,LIFR 1B,A00,182259,Staff,14,0,14,0
1681905218942,LIFR 1BX,A00,182273,Staff,14,0,14,0
1681905219968,LIGN 8,A00,182330,Staff,137,0,150,13
1681905220994,LIGN 9GS,A00,182362,Staff,20,0,20,0
1681905222020,LIGN 119,A00,204992,Takahashi; Maho,12,0,15,3
1681905223048,LIGN 130,A01,182384,Staff,47,0,50,3
1681905224074,LIGN 149GS,A00,182390,Staff,20,0,20,0
1681905225102,LIGN 170,A00,182404,Staff,24,0,30,6
1681905226126,LISP 1D,A00,182281,Staff,7,0,14,7
1681905226126,LISP 1D,B00,182287,Staff,14,0,14,0
1681905226126,LISP 1D,C00,182295,Staff,11,0,14,3
1681905226126,LISP 1D,D00,182301,Staff,14,0,14,0
1681905227150,LISP 1DX,A00,182309,Staff,20,0,28,8
1681905227150,LISP 1DX,B00,182316,Staff,26,0,28,2
1681905228175,LTAF 120GS,A00,182412,Zhiri; Oumelbanine,20,0,20,0
1681905229203,LTCS 172GS,A00,182437,Bronstein; Phoebe Malan,20,0,20,0
1681905230229,LTEA 138,A00,182457,Staff,22,0,40,18
1681905231256,LTEN 114,A01,182490,Staff,23,0,25,2
1681905232283,LTEN 130GS,A00,182491,Lyon; Antony J.,20,0,20,0
1681905233306,LTEN 169,A00,182493,Cuong; Marisol,20,0,25,5
1681905234332,LTEN 178,A00,182501,Staff,14,0,15,1
1681905235355,LTEN 181,A00,182515,Staff,22,0,25,3
1681905236385,LTEN 185GS,A00,197655,Forbes; Camille,20,0,20,0
1681905237414,LTSP 100B,A00,202208,Bessett; Ryan Matthew,24,0,25,1
1681905238439,LTWL 100,A00,182516,Myerston Santana; Jacobo,23,0,30,7
1681905239468,LTWR 100GS,A00,182518,Forbes; Camille,20,0,20,0
1681905240496,LTWR 102,A00,182522,Staff,15,0,15,0
1681905240496,LTWR 102,B00,182525,Staff,14,0,15,1
1681905241519,LTWR 115,A00,182526,Staff,12,0,15,3
1681905242544,MAE 8,A01,182528,Pham; Hieu Tan,68,0,70,2
1681905243568,MAE 11,A00,182529,Bahadori; Mohammad Yousef,94,0,100,6
1681905244594,MAE 20,A00,182530,Evdokimenko; Ekaterina,68,0,70,2
1681905245618,MAE 30A,A00,182532,Staff,44,0,45,1
1681905246641,MAE 101A,A00,182533,Bahadori; Mohammad Yousef,97,0,100,3
1681905247667,MAE 101C,A00,182538,Staff,62,0,70,8
1681905248697,MAE 104,A00,182539,Staff,45,0,50,5
1681905249721,MAE 131A,A00,182540,Ghazinejad; Maziar,41,0,45,4
1681905250749,MAE 143A,A00,182548,Bewley; Thomas R,43,0,50,7
1681905251773,MAE 150,A00,182549,Staff,28,0,40,12
1681905252797,MAE 160,A00,182550,Evdokimenko; Ekaterina,43,0,60,17
1681905253820,MATH 3C,A01,182725,Staff,27,0,30,3
1681905254849,MATH 10A,A01,182729,Staff,25,0,30,5
1681905254849,MATH 10A,B01,182732,Staff,26,0,30,4
1681905255884,MATH 10B,A01,182737,Staff,21,0,30,9
1681905255884,MATH 10B,A02,182738,Staff,28,0,30,2
1681905255884,MATH 10B,B01,182744,Staff,27,0,30,3
1681905255884,MATH 10B,B02,182745,Staff,27,0,30,3
1681905256910,MATH 18,A01,182750,Anzaldo; Leesa B,28,0,30,2
1681905256910,MATH 18,A02,182751,Anzaldo; Leesa B,29,0,30,1
1681905256910,MATH 18,A03,182753,Anzaldo; Leesa B,28,0,30,2
1681905256910,MATH 18,A04,182757,Anzaldo; Leesa B,29,0,30,1
1681905256910,MATH 18,B01,182761,Anzaldo; Leesa B,27,0,30,3
1681905256910,MATH 18,B02,182764,Anzaldo; Leesa B,27,0,30,3
1681905256910,MATH 18,B03,182765,Anzaldo; Leesa B,30,0,30,0
1681905256910,MATH 18,B04,182766,Anzaldo; Leesa B,30,0,30,0
1681905258015,MATH 20A,A01,182771,Suk; Andrew Hoon,28,0,30,2
1681905259038,MATH 20B,A01,182775,Bach; Quang Tran,30,0,30,0
1681905259038,MATH 20B,A02,182777,Bach; Quang Tran,29,0,30,1
1681905259038,MATH 20B,B01,182780,Bach; Quang Tran,27,0,30,3
1681905259038,MATH 20B,B02,182782,Bach; Quang Tran,30,0,30,0
1681905260068,MATH 20C,A01,182787,Staff,25,0,30,5
1681905260068,MATH 20C,A02,182790,Staff,29,0,30,1
1681905260068,MATH 20C,B01,182792,Staff,25,0,30,5
1681905260068,MATH 20C,B02,182796,Staff,27,0,30,3
1681905261094,MATH 20D,A01,182799,Staff,29,0,30,1
1681905261094,MATH 20D,A02,182802,Staff,30,0,30,0
1681905261094,MATH 20D,A03,182803,Staff,30,0,30,0
1681905262132,MATH 20E,A01,182809,Verstraete; Jacques Allan,24,0,30,6
1681905262132,MATH 20E,A02,182811,Verstraete; Jacques Allan,28,0,30,2
1681905262132,MATH 20E,B01,182814,Verstraete; Jacques Allan,23,0,30,7
1681905262132,MATH 20E,B02,182815,Verstraete; Jacques Allan,30,0,30,0
1681905263157,MATH 103A,A01,182820,Staff,9,0,30,21
1681905263157,MATH 103A,A02,182821,Staff,27,0,30,3
1681905263157,MATH 103A,A03,182822,Staff,23,0,30,7
1681905263157,MATH 103A,B01,182825,Staff,23,0,30,7
1681905263157,MATH 103A,B02,182826,Staff,30,0,30,0
1681905263157,MATH 103A,B03,182830,Staff,30,0,30,0
1681905264183,MATH 109,A01,182836,Chow; Bennett,24,0,30,6
1681905264183,MATH 109,A02,182838,Chow; Bennett,29,0,30,1
1681905264183,MATH 109,A03,182894,Chow; Bennett,29,0,30,1
1681905264183,MATH 109,B01,182908,Chow; Bennett,28,0,30,2
1681905264183,MATH 109,B02,182909,Chow; Bennett,30,0,30,0
1681905264183,MATH 109,B03,182910,Chow; Bennett,27,0,30,3
1681905265213,MATH 142A,A01,182925,Staff,11,0,30,19
1681905265213,MATH 142A,A02,182935,Staff,25,0,30,5
1681905265213,MATH 142A,A03,182967,Staff,26,0,30,4
1681905265213,MATH 142A,B01,183125,Staff,24,0,30,6
1681905265213,MATH 142A,B02,183157,Staff,28,0,30,2
1681905265213,MATH 142A,B03,183158,Staff,29,0,30,1
1681905266240,MATH 183,A01,183160,Arias-Castro; Ery,23,0,30,7
1681905266240,MATH 183,A02,183161,Arias-Castro; Ery,29,0,30,1
1681905266240,MATH 183,B01,183163,Arias-Castro; Ery,28,0,30,2
1681905266240,MATH 183,B02,183164,Arias-Castro; Ery,28,0,30,2
1681905267264,MATH 193A,A01,183167,Staff,4,0,35,31
1681905267264,MATH 193A,A02,183168,Staff,28,0,35,7
1681905267264,MATH 193A,A03,183169,Staff,34,0,35,1
1681905267264,MATH 193A,A04,183170,Staff,28,0,35,7
1681905268288,MGT 4,A01,202395,Anderson; John Charles,75,0,80,5
1681905269319,MGT 5,A00,202396,Houskeeper; Robert,80,0,90,10
1681905270342,MGT 103,A00,202397,Eberhard; Craig A,55,0,90,35
1681905271370,MGT 131A,A00,202398,Houskeeper; Robert,85,0,90,5
1681905272399,MGT 135,A00,202399,Anderson; John Charles,83,0,90,7
1681905273427,MGT 162R,A00,202403,Gneezy; Uri,150,0,200,50
1681905274450,MGT 172,A00,202404,Hedges; Kathleen,50,0,90,40
1681905275472,MGT 181,A00,202405,Dunn; Louis Jean,84,0,90,6
1681905276500,MMW 14,A01,183200,Staff,16,0,28,12
1681905276500,MMW 14,A02,183201,Staff,26,0,28,2
1681905276500,MMW 14,A03,183202,Staff,24,0,28,4
1681905276500,MMW 14,A04,183203,Staff,25,0,28,3
1681905276500,MMW 14,A05,183204,Staff,26,0,28,2
1681905276500,MMW 14,A06,183205,Staff,27,0,28,1
1681905276500,MMW 14,B01,183207,Staff,26,0,28,2
1681905276500,MMW 14,B02,183208,Staff,28,0,28,0
1681905276500,MMW 14,B03,183209,Staff,28,0,28,0
1681905276500,MMW 14,B04,183210,Staff,28,0,28,0
1681905276500,MMW 14,B05,183211,Staff,28,0,28,0
1681905276500,MMW 14,B06,183212,Staff,28,0,28,0
1681905277524,MMW 14GS,A00,183213,Zhiri; Oumelbanine,28,0,28,0
1681905278550,MMW 15GS,B00,183215,Rahimi; Babak,28,0,28,0
1681905279574,MMW 121,A01,183217,Patterson; Patrick H.,14,0,28,14
1681905279574,MMW 121,A02,183218,Patterson; Patrick H.,25,0,28,3
1681905280606,MUS 1A,A01,182554,Staff,8,0,35,27
1681905281631,MUS 5,A01,182558,Staff,20,0,35,15
1681905282658,MUS 6,A01,182562,Staff,25,0,35,10
1681905283683,MUS 8GS,A00,182563,Borgo; David Garcia,25,0,25,0
1681905284706,MUS 13,A01,182567,Staff,24,0,25,1
1681905285735,MUS 15,A01,182570,Staff,32,0,35,3
1681905285735,MUS 15,B01,182575,Staff,10,0,35,25
1681905286762,MUS 80,A00,182578,Staff,23,0,25,2
1681905286762,MUS 80,B00,182581,Staff,20,0,25,5
1681905287787,MUS 113,A00,182582,Staff,25,0,25,0
1681905288812,MUS 114,A00,182583,Staff,4,0,25,21
1681905289838,MUS 150GS,A01,182588,Borgo; David Garcia,25,0,25,0
1681905290865,PHIL 1,A00,182590,Staff,35,0,40,5
1681905291894,PHIL 10,A01,182596,Grush; Rick Scott,31,0,35,4
1681905291894,PHIL 10,A02,182597,Grush; Rick Scott,34,0,35,1
1681905292918,PHIL 15,A01,182601,Staff,31,0,35,4
1681905292918,PHIL 15,A02,182602,Staff,33,0,35,2
1681905293942,PHIL 27,A01,182604,Staff,30,0,35,5
1681905293942,PHIL 27,A02,182607,Staff,35,0,35,0
1681905294972,PHIL 32,A01,182609,Staff,35,0,35,0
1681905294972,PHIL 32,A02,182612,Staff,35,0,35,0
1681905295995,PHIL 130,A00,182614,Staff,63,0,70,7
1681905297020,PHIL 136,A00,182616,Cohen; Jonathan David,66,0,70,4
1681905298047,PHIL 155,A00,182617,Vargas; Manuel Rogelio,60,0,70,10
1681905299085,PHIL 163,A01,182620,Staff,15,0,20,5
1681905299085,PHIL 163,A02,182624,Staff,10,0,20,10
1681905300109,PHIL 164,A00,182627,Staff,30,0,40,10
1681905301134,PHIL 173,A00,182628,Staff,36,0,40,4
1681905302163,PHYS 1A,A00,183221,Staff,54,0,60,6
1681905303195,PHYS 1AL,001,183222,Staff,25,0,30,5
1681905303195,PHYS 1AL,002,183223,Staff,28,0,30,2
1681905304219,PHYS 1B,A00,183231,Staff,44,0,60,16
1681905305246,PHYS 1BL,001,183232,Staff,20,0,30,10
1681905305246,PHYS 1BL,002,183233,Staff,29,0,30,1
1681905306274,PHYS 1C,A00,183240,Staff,30,0,60,30
1681905307297,PHYS 1CL,001,183241,Staff,13,0,30,17
1681905307297,PHYS 1CL,002,183242,Staff,22,0,30,8
1681905308322,PHYS 2AR,A01,183250,Staff,44,0,50,6
1681905309349,PHYS 2B,A01,183252,Staff,106,0,115,9
1681905310376,PHYS 2BL,A01,183254,Staff,21,0,24,3
1681905310376,PHYS 2BL,A02,183255,Staff,22,0,24,2
1681905311405,PHYS 2C,A01,183522,Staff,105,0,115,10
1681905312438,PHYS 4A,A01,183524,Staff,49,0,50,1
1681905313465,POLI 5,A00,183525,Staff,44,0,50,6
1681905314494,POLI 12,A00,183540,Staff,48,0,50,2
1681905315520,POLI 13R,A00,183541,Forman; Fonna,42,0,50,8
1681905316547,POLI 30,A00,183542,Mignozzetti; Umberto,47,0,50,3
1681905317572,POLI 100A,A00,183543,Staff,45,0,50,5
1681905318597,POLI 100E,A00,223598,Staff,32,0,35,3
1681905319620,POLI 103A,A00,183564,Kousser; Thad,38,0,50,12
1681905320649,POLI 104B,A00,201329,Staff,29,0,35,6
1681905321675,POLI 113BR,A00,183576,Hoston; Germaine,28,0,50,22
1681905322699,POLI 114BR,A00,183588,Staff,27,0,30,3
1681905323722,POLI 117R,A00,183595,Forman; Fonna,9,0,20,11
1681905324748,POLI 120H,A00,183596,Fisk; David Lee,13,0,20,7
1681905325773,POLI 130AA,A00,183597,Staff,14,0,20,6
1681905326800,POLI 134AA,A00,183598,Staff,19,0,20,1
1681905327825,POLI 135,A00,183599,Fisk; David Lee,20,0,25,5
1681905328860,POLI 142P,A00,183623,Staff,37,0,40,3
1681905329886,POLI 144D,A00,183624,Staff,22,0,25,3
1681905330910,POLI 151,A00,183625,Staff,15,0,20,5
1681905331933,POLI 162,A00,183626,Mignozzetti; Umberto,18,0,20,2
1681905332961,PSYC 1,A00,253748,Staff,86,0,90,4
1681905333994,PSYC 2,A00,183627,Moranton; Nirelia Melbina-,25,0,35,10
1681905335023,PSYC 3,A00,183628,Staff,43,0,45,2
1681905337072,PSYC 60,A01,183631,Lowe; Angela Beth,35,0,40,5
1681905338100,PSYC 70,A01,253757,Staff,37,0,45,8
1681905339123,PSYC 101,A00,183632,Heyman; Gail D.,48,0,60,12
1681905340147,PSYC 105,A00,183848,Lowe; Angela Beth,50,0,60,10
1681905341176,PSYC 106,A00,183849,Dobkins; Karen R.,45,0,60,15
1681905342202,PSYC 108,A00,253750,Staff,24,0,60,36
1681905343238,PSYC 114,A01,184275,Winkielman; Piotr,0,6,30,30
1681905344261,PSYC 122,A00,183856,Moranton; Nirelia Melbina-,0,10,30,30
1681905345286,PSYC 124,A00,183865,Chapman; Eddie Nathaniel,52,0,80,28
1681905346311,PSYC 137,A00,183880,Staff,19,0,25,6
1681905348358,PSYC 154,A00,183910,Lacefield; Katharine I,0,2,90,90
1681905350419,PSYC 162,A00,183946,Wixted; John T,61,0,90,29
1681905351444,PSYC 172,A00,183947,Gorman; Michael R.,14,0,30,16
1681905352474,PSYC 178,A00,183963,Glaser; Dale,20,0,40,20
1681905353499,PSYC 181GS,A00,183964,Anagnostaras; Stephan,10,0,10,0
1681905354533,PSYC 186GS,A01,257660,Staff,10,0,10,0
1681905355561,PSYC 193,B00,253749,Staff,23,0,25,2
1681905357616,PSYC 193L,A01,184122,Staff,33,0,35,2
1681905357616,PSYC 193L,C01,184167,Winkielman; Piotr,16,0,30,14
1681905358641,RELI 188GS,A00,182629,Rahimi; Babak,20,0,20,0
1681905359664,SE 101A,A00,182646,Staff,26,0,30,4
1681905360691,SE 101C,A00,182650,Staff,18,0,20,2
1681905361790,SE 110A,A00,182651,Staff,28,0,28,0
1681905362814,SE 130A,A00,182652,Staff,39,0,40,1
1681905363839,SIO 46GS,A00,182636,Cook; Geoffrey W,28,0,28,0
1681905364865,SIO 109R,A00,194459,Staff,5,0,20,15
1681905365896,SIO 121GS,A00,182639,Cook; Geoffrey W,28,0,28,0
1681905366923,SIO 132,A01,182642,Staff,32,0,40,8
1681905367946,SIO 139,A00,182644,Kacev; David,36,0,40,4
1681905368971,SOCI 2,A01,258404,Staff,34,0,36,2
1681905368971,SOCI 2,A02,258405,Staff,35,0,36,1
1681905369995,SOCI 60,A01,258408,Staff,29,0,30,1
1681905369995,SOCI 60,A02,258413,Staff,30,0,30,0
1681905371023,SOCI 100,A01,258415,Staff,29,0,30,1
1681905371023,SOCI 100,A02,258416,Staff,28,0,30,2
1681905377172,SOCI 127,A00,258421,Staff,22,0,30,8
1681905378201,SOCI 132,A00,258422,Staff,45,0,50,5
1681905379231,SOCI 133,A00,258423,Staff,26,0,30,4
1681905380258,SOCI 138GS,A00,258424,Staff,15,0,15,0
1681905381282,SOCI 145,A00,258425,Staff,25,0,30,5
1681905382309,SOCI 148,A00,258426,Staff,26,0,30,4
1681905383333,SOCI 153,A00,199217,Staff,29,0,30,1
1681905384358,SOCI 160,A00,258427,Staff,28,0,30,2
1681905385385,SOCI 160E,A00,258435,Staff,56,0,60,4
1681905386410,SOCI 189GS,A00,258436,Staff,15,0,15,0
1681905387435,SOCI 190GS,A00,258437,Staff,15,0,15,0
1681905388461,SYN 2,001,182658,Staff,9,0,16,7
1681905388461,SYN 2,002,201439,Staff,15,0,16,1
1681905388461,SYN 2,003,201443,Staff,16,0,16,0
1681905389487,SYN 100,A01,182657,Staff,17,0,20,3
1681905390512,TDAC 1,A00,184381,Salovey; Todd,16,0,20,4
1681905390512,TDAC 1,B00,184385,Harting; Carla Kelso,19,0,20,1
1681905390512,TDAC 1,C00,184394,Staff,19,0,20,1
1681905391538,TDAC 101,A00,184483,Harting; Carla Kelso,19,0,20,1
1681905392564,TDDE 111,A00,184496,Staff,14,0,15,1
1681905393594,TDDE 131,A00,184504,Staff,20,0,20,0
1681905393594,TDDE 131,B00,184505,Staff,17,0,18,1
1681905393594,TDDE 131,C00,184534,Staff,49,0,50,1
1681905393594,TDDE 131,D00,184564,Staff,15,0,15,0
1681905393594,TDDE 131,E00,204725,Staff,19,0,20,1
1681905394623,TDGE 1,A01,184414,Salovey; Todd,37,0,50,13
1681905395646,TDGE 5,A01,184419,Staff,23,0,24,1
1681905396671,TDGE 10,A00,184428,Fulton; Julia,31,0,50,19
1681905397699,TDGE 124,A00,184565,Fulton; Julia,7,0,50,43
1681905398726,TDGE 125,B00,184567,Meyer; Ursula,9,0,25,16
1681905399751,TDHT 101,A00,184568,Staff,21,0,25,4
1681905399751,TDHT 101,B00,184569,Staff,20,0,20,0
1681905400779,TDHT 114,A00,184570,Staff,49,0,50,1
1681905401808,TDMV 1,A00,184437,Arcidiacono; Kristin,23,0,30,7
1681905401808,TDMV 1,B00,184448,Caligagan; Maria T.,22,0,30,8
1681905402833,TDMV 2,A00,184449,Weinberg; Sadie,27,0,30,3
1681905402833,TDMV 2,B00,184453,Arcidiacono; Kristin,29,0,30,1
1681905403858,TDMV 110,A00,184571,Weinberg; Sadie,30,0,30,0
1681905404881,TDMV 142,A00,184572,Caligagan; Tony,27,0,30,3
1681905404881,TDMV 142,B00,184573,Caligagan; Maria T.,27,0,30,3
1681905405908,TDTR 20,A00,184482,Jun; Grace Shin Hae,25,0,25,0
1681905406934,USP 2,A01,184290,Hinds; Juli Beth,24,0,25,1
1681905407958,USP 3,A01,184295,Staff,20,0,25,5
1681905408985,USP 4,A00,184304,McTague; Sarah,15,0,25,10
1681905410013,USP 100,A00,184315,Staff,17,0,25,8
1681905411041,USP 105,A00,184326,Staff,21,0,25,4
1681905412064,USP 151,A00,184327,Staff,20,0,25,5
1681905413087,USP 170,A00,184380,Hinds; Juli Beth,14,0,25,11
1681905414115,VIS 21B,A01,182660,Staff,28,0,31,3
1681905414115,VIS 21B,A02,182662,Staff,30,0,31,1
1681905415142,VIS 103D,A00,182663,Staff,74,0,75,1
1681905416171,VIS 105D,A00,182667,Li; Huai,15,0,22,7
1681905417196,VIS 122GS,A00,182668,Herbst; Matthew,20,0,20,0
1681905418223,VIS 128C,A00,182673,Staff,70,0,75,5
1681905419248,VIS 130,A00,182675,Staff,20,0,22,2
1681905420273,VIS 160A,A00,182678,Stalbaum; Brett,4,0,10,6
1681905422340,WCWP 10B,A00,201679,Staff,15,0,15,0
1681905422340,WCWP 10B,B00,201695,Staff,15,0,15,0
1681905423372,WCWP 100,A00,201716,Staff,15,0,15,0
1681905423372,WCWP 100,B00,201717,Staff,11,0,15,4
1681905425474,ANSC 105GS,A00,258289,Staff,0,0,0,0
1681905426498,ANSC 125GS,A00,258295,Staff,0,0,0,0
1681905427521,ANSC 150,A00,258267,Staff,30,0,40,10
1681905428544,ANSC 190GS,A00,258280,Staff,0,0,0,0
1681905429569,ANTH 1,A00,258264,Staff,38,0,40,2
1681905430596,ANTH 2,A01,258259,Staff,72,0,76,4
1681905431620,ANTH 23,A01,258228,Staff,36,0,40,4
1681905432648,ANTH 101,A01,258236,Staff,39,0,40,1
1681905433672,ANTH 102,A00,258272,Staff,59,0,60,1
1681905434695,ANTH 105,A00,258244,Staff,31,0,35,4
1681905435724,BENG 130,A00,253975,Staff,38,0,40,2
1681905436756,BIBC 102,A01,191866,Flagg; Matthew Paul,19,0,32,13
1681905436756,BIBC 102,A02,191867,Flagg; Matthew Paul,22,0,32,10
1681905436756,BIBC 102,A03,191868,Flagg; Matthew Paul,30,0,32,2
1681905436756,BIBC 102,A04,191936,Flagg; Matthew Paul,26,0,32,6
1681905436756,BIBC 102,A05,191937,Flagg; Matthew Paul,11,0,32,21
1681905437789,BICD 100,A01,191939,Cooper; Andrew Michael,28,0,32,4
1681905437789,BICD 100,A02,191940,Cooper; Andrew Michael,32,0,32,0
1681905437789,BICD 100,A03,191941,Cooper; Andrew Michael,32,0,32,0
1681905437789,BICD 100,A04,191942,Cooper; Andrew Michael,32,0,32,0
1681905437789,BICD 100,A05,191943,Cooper; Andrew Michael,32,0,32,0
1681905438816,BIEB 126,A01,191945,Cleland; Elsa Eleanor,1,0,32,31
1681905438816,BIEB 126,A02,191946,Cleland; Elsa Eleanor,28,0,32,4
1681905438816,BIEB 126,A03,191947,Cleland; Elsa Eleanor,29,0,32,3
1681905438816,BIEB 126,A04,191948,Cleland; Elsa Eleanor,23,0,32,9
1681905438816,BIEB 126,A05,191996,Cleland; Elsa Eleanor,28,0,32,4
1681905439842,BIEB 136GS,A00,191997,Shurin; Jonathan & Holway; David A.,0,0,0,0
1681905440870,BIEB 137GS,A01,191999,Shurin; Jonathan & Holway; David A.,0,0,0,0
1681905441900,BILD 1,A01,205385,Staff,31,0,32,1
1681905441900,BILD 1,A02,205386,Staff,30,0,32,2
1681905441900,BILD 1,A03,205387,Staff,32,0,32,0
1681905441900,BILD 1,A04,205388,Staff,28,0,32,4
1681905442925,BILD 2,A01,191774,Staff,28,0,32,4
1681905442925,BILD 2,A02,191775,Staff,30,0,32,2
1681905442925,BILD 2,A03,191777,Staff,30,0,32,2
1681905442925,BILD 2,A04,191856,Staff,31,0,32,1
1681905442925,BILD 2,A05,191857,Staff,32,0,32,0
1681905442925,BILD 2,A06,191858,Staff,32,0,32,0
1681905442925,BILD 2,A07,191859,Staff,31,0,32,1
1681905443949,BILD 3,A01,205391,Staff,29,0,32,3
1681905443949,BILD 3,A02,205393,Staff,32,0,32,0
1681905443949,BILD 3,A03,205394,Staff,28,0,32,4
1681905443949,BILD 3,A04,205395,Staff,32,0,32,0
1681905444977,BILD 20,A01,191861,Staff,32,0,32,0
1681905444977,BILD 20,A02,191862,Staff,32,0,32,0
1681905446002,BILD 30,A01,191864,Staff,31,0,32,1
1681905447030,BIMM 100,A01,192019,Staff,0,0,32,32
1681905447030,BIMM 100,A02,192020,Staff,23,0,32,9
1681905447030,BIMM 100,A03,192035,Staff,22,0,32,10
1681905448057,BIMM 110,A01,192037,Tat; John,0,0,32,32
1681905448057,BIMM 110,A02,192038,Tat; John,10,0,32,22
1681905449088,BIMM 120,A01,192040,Pickett; Brooke Elizabeth,2,0,32,30
1681905449088,BIMM 120,A02,192041,Pickett; Brooke Elizabeth,16,0,32,16
1681905449088,BIMM 120,A03,192042,Pickett; Brooke Elizabeth,16,0,32,16
1681905450114,BIPN 100,A01,192044,Armour; Jon Christopher,26,0,32,6
1681905450114,BIPN 100,A02,192059,Armour; Jon Christopher,30,0,32,2
1681905450114,BIPN 100,A03,192064,Armour; Jon Christopher,31,0,32,1
1681905450114,BIPN 100,A04,192073,Armour; Jon Christopher,28,0,32,4
1681905451150,BIPN 148,A01,205411,Leutgeb; Jill K.,16,0,32,16
1681905451150,BIPN 148,A02,205412,Leutgeb; Jill K.,31,0,32,1
1681905451150,BIPN 148,A03,205413,Leutgeb; Jill K.,30,0,32,2
1681905451150,BIPN 148,A04,205414,Leutgeb; Jill K.,30,0,32,2
1681905452177,BIPN 160,A01,192115,Marino; Marc J,19,0,32,13
1681905452177,BIPN 160,A02,192148,Marino; Marc J,27,0,32,5
1681905452177,BIPN 160,A03,192158,Marino; Marc J,31,0,32,1
1681905452177,BIPN 160,A04,192190,Marino; Marc J,32,0,32,0
1681905452177,BIPN 160,A05,192287,Marino; Marc J,32,0,32,0
1681905452177,BIPN 160,A06,192288,Marino; Marc J,32,0,32,0
1681905453201,BIPN 194,A00,206038,Staff,28,0,32,4
1681905454235,BISP 194,A00,192289,Leutgeb; Stefan,13,0,32,19
1681905454235,BISP 194,B00,245332,Nieh; James Charles,27,0,32,5
1681905455258,CAT 124,A01,202247,Staff,15,0,15,0
1681905456288,CAT 125,A00,202248,Staff,19,0,20,1
1681905456288,CAT 125,B00,202253,Staff,20,0,20,0
1681905456288,CAT 125,C00,202257,Staff,19,0,20,1
1681905457316,CAT 125GS,A01,202273,Bronstein; Phoebe Malan,20,0,20,0
1681905458349,CAT 125R,A00,202284,Staff,17,0,20,3
1681905458349,CAT 125R,C00,202286,Staff,10,0,20,10
1681905458349,CAT 125R,D00,202291,Staff,18,0,20,2
1681905458349,CAT 125R,E00,202295,Staff,13,0,20,7
1681905458349,CAT 125R,F00,202302,Staff,12,0,20,8
1681905459378,CENG 100,A00,204724,Opatkiewicz; Justin Paul,25,0,25,0
1681905460403,CGS 2A,A01,180420,Staff,31,0,36,5
1681905461427,CGS 101,A00,180421,Staff,16,0,20,4
1681905462452,CGS 112,A00,180422,Staff,10,0,16,6
1681905463475,CGS 113,A00,180423,Staff,18,0,20,2
1681905464498,CGS 137,A00,180424,Staff,12,0,12,0
1681905465613,CGS 147,A00,180425,Staff,10,0,10,0
1681905466643,CHEM 6A,A01,179556,Staff,97,0,100,3
1681905466643,CHEM 6A,A02,179558,Staff,0,0,0,0
1681905467666,CHEM 6B,A01,179560,Staff,100,0,100,0
1681905468692,CHEM 6C,A01,179565,Jazzar; Rodolphe,95,0,100,5
1681905469718,CHEM 7L,A01,179586,Schurmeier; Kimberly,13,0,24,11
1681905469718,CHEM 7L,A02,179587,Schurmeier; Kimberly,23,0,24,1
1681905469718,CHEM 7L,A03,179590,Schurmeier; Kimberly,22,0,24,2
1681905469718,CHEM 7L,A04,179591,Schurmeier; Kimberly,22,0,24,2
1681905469718,CHEM 7L,B01,179598,Schurmeier; Kimberly,17,0,24,7
1681905469718,CHEM 7L,B02,179599,Schurmeier; Kimberly,24,0,24,0
1681905469718,CHEM 7L,B03,179606,Schurmeier; Kimberly,23,0,24,1
1681905469718,CHEM 7L,B04,179607,Schurmeier; Kimberly,23,0,24,1
1681905470746,CHEM 11,A01,179609,Stallings; Dontarie M,88,0,100,12
1681905471774,CHEM 40A,A01,179621,Staff,41,0,50,9
1681905471774,CHEM 40A,A02,179622,Staff,47,0,50,3
1681905472806,CHEM 40B,A01,179630,Weizman; Haim,48,0,50,2
1681905472806,CHEM 40B,A02,179631,Weizman; Haim,45,0,50,5
1681905473832,CHEM 41A,A01,179660,Klosterman; Jeremy K,93,0,100,7
1681905474859,CHEM 43A,A01,179683,Klosterman; Jeremy K,0,0,24,24
1681905474859,CHEM 43A,A02,179688,Klosterman; Jeremy K,14,0,24,10
1681905474859,CHEM 43A,A03,179689,Klosterman; Jeremy K,20,0,24,4
1681905474859,CHEM 43A,A04,179691,Klosterman; Jeremy K,18,0,24,6
1681905475885,CHEM 114A,A01,179693,Stallings; Dontarie M,77,0,100,23
1681905476911,CHEM 143B,A01,179698,Weizman; Haim,17,0,24,7
1681905476911,CHEM 143B,A02,179700,Weizman; Haim,24,0,24,0
1681905478520,CHIN 169A,A00,179701,Wang; Xiao,20,0,20,0
1681905479544,COGS 2,A01,179750,Boyle; Mary E. T.,17,0,30,13
1681905480576,COGS 9,A01,179759,Jones; Cameron Robert,43,0,50,7
1681905481603,COGS 14A,A01,179854,Staff,18,0,50,32
1681905482630,COGS 14B,A01,179856,Staff,54,0,60,6
1681905483659,COGS 17,A01,179874,Staff,71,0,75,4
1681905484685,COGS 18,A01,179884,Staff,63,0,80,17
1681905485710,COGS 100,A01,179886,Staff,40,0,60,20
1681905486739,COGS 101B,A01,179892,Staff,1,0,30,29
1681905487764,COGS 101C,A01,179894,Staff,28,0,30,2
1681905488789,COGS 107A,A01,179896,Boyle; Mary E. T.,31,0,40,9
1681905489825,COGS 108,A01,179898,Simpkins; Charles Alexander,0,17,60,60
1681905490855,COGS 109,A01,179900,Staff,34,0,40,6
1681905491890,COGS 118A,A01,179946,Staff,9,0,40,31
1681905492913,COGS 153,A00,179978,Staff,1,0,30,29
1681905493941,COGS 156,A01,179981,Staff,27,0,30,3
1681905495991,COGS 172,A01,179987,Staff,13,0,30,17
1681905498040,COGS 186,A01,179991,Staff,13,0,30,17
1681905499069,COMM 10,A01,180001,Staff,15,0,25,10
1681905499069,COMM 10,A02,180004,Staff,20,0,25,5
1681905500098,COMM 100A,A01,180016,Staff,18,0,25,7
1681905500098,COMM 100A,A02,180020,Staff,24,0,25,1
1681905501128,COMM 101T,A00,180029,Halm; Gavin Patrick,23,0,35,12
1681905502152,COMM 106V,A00,180043,Staff,34,0,35,1
1681905503179,COMM 109P,A00,180044,Staff,31,0,35,4
1681905504209,COMM 113T,A00,180045,Havis; Allan,37,0,45,8
1681905505242,COMM 132,A00,180046,McKenna; Denise,23,0,30,7
1681905506266,COMM 143,A00,180047,Staff,19,0,30,11
1681905507291,COMM 190,A00,180048,Conner; Thomas Hartnell,20,0,23,3
1681905508325,CSE 8A,A50,180053,Cao; Yingjun,25,0,50,25
1681905508325,CSE 8A,B50,180180,Staff,50,0,50,0
1681905509354,CSE 11,A01,180190,Cao; Yingjun,31,0,50,19
1681905510383,CSE 20,A01,180192,Briones; Jor-el Thomas Caparas,23,0,30,7
1681905511409,CSE 21,A01,194538,Briones; Jor-el Thomas Caparas,50,0,60,10
1681905512436,CSE 30,A01,180324,Eldon; John,79,0,100,21
1681905513465,CSE 101,A01,201353,Staff,0,20,40,40
1681905514490,CSE 134B,A01,180326,Powell; Thomas Allan,74,0,100,26
1681905515517,CSE 140,A01,180328,Staff,46,0,75,29
1681905516545,CSE 140L,A01,180344,Eldon; John,69,0,100,31
1681905517573,CSE 150A,A01,180411,Staff,0,7,50,50
1681905518595,CSE 151A,A01,180414,Staff,0,6,50,50
1681905519627,CSE 175,A01,222521,Kumar; Rakesh,50,0,50,0
1681905520655,CSE 190,A00,201419,Staff,45,0,49,4
1681905521680,CSS 1,A01,194536,Staff,38,0,50,12
1681905522705,DSC 30,A01,202385,Staff,48,0,50,2
1681905523730,DSC 40A,A01,202387,Albuyeh; Rod,50,0,50,0
1681905524761,DSC 190,A01,202389,Silberman; Jack,21,0,21,0
1681905525787,DSGN 100,A01,179993,Staff,16,0,30,14
1681905526811,ECE 65,A50,180708,Staff,10,0,20,10
1681905526811,ECE 65,A51,180739,Staff,19,0,20,1
1681905527840,ECON 1,A01,180427,Famulari; Melissa,67,0,70,3
1681905528869,ECON 2,A01,180450,Levkoff; Steven B.,64,0,70,6
1681905529895,ECON 4,A01,203351,Anderson; John Charles,7,0,10,3
1681905530918,ECON 100A,A01,180472,Famulari; Melissa,65,0,70,5
1681905531942,ECON 120A,A01,180549,Staff,64,0,70,6
1681905532972,ECON 120B,A01,180655,Ma; Xinwei,46,0,70,24
1681905534009,ECON 129,A00,203333,Eckert; Fabian Paul,15,0,35,20
1681905535034,ECON 131,A00,180656,Staff,10,0,35,25
1681905536060,ECON 172B,A01,180672,Levkoff; Steven B.,32,0,35,3
1681905537085,ECON 178,A01,203342,Zhu; Ying,11,0,35,24
1681905538117,EDS 108GS,A00,202383,Wishard Guerra; Alison G.,20,0,20,0
1681905539140,EDS 111GS,A00,202347,Wishard Guerra; Alison G.,20,0,20,0
1681905540167,EDS 112,A01,202323,Staff,56,0,60,4
1681905541195,EDS 113,A00,202340,Staff,33,0,35,2
1681905542223,EDS 118,A00,201231,Staff,20,0,30,10
1681905543258,EDS 119,A00,204994,Staff,8,0,10,2
1681905544283,EDS 124BR,A00,202324,Eguchi; Emi,5,0,25,20
1681905545308,EDS 126,A01,203208,Jones; Makeba,26,0,30,4
1681905546336,EDS 135,A01,202333,Staff,18,0,20,2
1681905547371,EDS 180,A00,202311,Staff,47,0,50,3
1681905548397,ERC 190GS,A01,253747,Staff,28,0,28,0
1681905549421,ETHN 104,A00,180742,Staff,24,0,35,11
1681905550458,ETHN 118,A00,180745,Staff,28,0,35,7
1681905551487,ETHN 127,A00,180747,Staff,12,0,16,4
1681905552511,ETHN 137,A00,180880,Staff,12,0,12,0
1681905553538,ETHN 147,A00,180890,Staff,8,0,10,2
1681905554563,ETHN 154,A00,180891,Staff,7,0,8,1
1681905555587,ETHN 168,A00,180892,Staff,9,0,10,1
1681905556611,GLBH 20,A00,201051,Hannah; Seth Donal,0,1,0,1
1681905557637,GLBH 111,A01,209338,Burgos; Jose L.,0,0,0,0
1681905558663,GLBH 150,A00,258300,Staff,0,3,0,0
1681905559688,GLBH 181,A00,201207,Staff,15,0,40,25
1681905560712,HIEU 109,A00,180898,Staff,20,0,20,0
1681905561737,HIEU 111,A00,180899,Staff,1,0,20,19
1681905562762,HIEU 124,A00,180900,Staff,18,0,20,2
1681905563787,HILA 122,A00,180901,Staff,18,0,20,2
1681905564814,HILA 132,A00,180902,Vitz; Matthew,2,0,20,18
1681905565839,HILD 10,A01,180896,Staff,15,0,20,5
1681905566863,HILD 30GS,A00,180897,Edington; Claire Ellen,0,0,0,0
1681905567887,HISC 105,A00,180903,Staff,20,0,20,0
1681905568911,HISC 117,A00,180904,Staff,11,0,20,9
1681905570012,HIUS 108B,A00,181005,Staff,18,0,20,2
1681905571063,HIUS 113,A00,181093,Staff,4,0,20,16
1681905572095,HUM 3,A01,181190,Patterson; Patrick H.,40,0,50,10
1681905572095,HUM 3,B01,181195,Staff,47,0,50,3
1681905573124,HUM 3GS,A00,181196,Herbst; Matthew,0,0,0,0
1681905574149,HUM 4,A01,181227,West; Geoffrey Scott,34,0,50,16
1681905574149,HUM 4,B01,181282,Staff,43,0,50,7
1681905575178,HUM 4GS,A00,181377,Lyon; Antony J.,0,0,0,0
1681905576219,HUM 5,A01,181536,Zavodny; Tatiana Sophia,31,0,50,19
1681905576219,HUM 5,B01,181908,Staff,36,0,50,14
1681905577246,INTL 190,A00,181909,Segui; Alan S,0,0,0,6
1681905577246,INTL 190,B00,181961,Segui; Alan S,0,0,0,7
1681905578778,JAPN 20AR,A01,182113,Ross; Kayoko F,15,0,20,5
1681905579807,LATI 50,A01,202391,Martin-Cabrera; Luis,19,0,30,11
1681905579807,LATI 50,A02,202392,Martin-Cabrera; Luis,26,0,30,4
1681905580836,LATI 180,A00,202393,Kokinis; Troy Andreas,25,0,25,0
1681905581876,LIFR 1A,A00,182119,Staff,14,0,14,0
1681905582902,LIFR 1AX,A00,182324,Staff,14,0,14,0
1681905583926,LIFR 1B,A00,182259,Staff,14,0,14,0
1681905584954,LIFR 1BX,A00,182273,Staff,14,0,14,0
1681905585978,LIGN 8,A00,182330,Staff,137,0,150,13
1681905587006,LIGN 9GS,A00,182362,Staff,20,0,20,0
1681905588031,LIGN 119,A00,204992,Takahashi; Maho,12,0,15,3
1681905589060,LIGN 130,A01,182384,Staff,47,0,50,3
1681905590086,LIGN 149GS,A00,182390,Staff,20,0,20,0
1681905591114,LIGN 170,A00,182404,Staff,24,0,30,6
1681905592145,LISP 1D,A00,182281,Staff,7,0,14,7
1681905592145,LISP 1D,B00,182287,Staff,14,0,14,0
1681905592145,LISP 1D,C00,182295,Staff,11,0,14,3
1681905592145,LISP 1D,D00,182301,Staff,14,0,14,0
1681905593171,LISP 1DX,A00,182309,Staff,20,0,28,8
1681905593171,LISP 1DX,B00,182316,Staff,26,0,28,2
1681905594195,LTAF 120GS,A00,182412,Zhiri; Oumelbanine,20,0,20,0
1681905595224,LTCS 172GS,A00,182437,Bronstein; Phoebe Malan,20,0,20,0
1681905596254,LTEA 138,A00,182457,Staff,22,0,40,18
1681905597278,LTEN 114,A01,182490,Staff,23,0,25,2
1681905598308,LTEN 130GS,A00,182491,Lyon; Antony J.,20,0,20,0
1681905599337,LTEN 169,A00,182493,Cuong; Marisol,20,0,25,5
1681905600366,LTEN 178,A00,182501,Staff,14,0,15,1
1681905601391,LTEN 181,A00,182515,Staff,22,0,25,3
1681905602421,LTEN 185GS,A00,197655,Forbes; Camille,20,0,20,0
1681905603444,LTSP 100B,A00,202208,Bessett; Ryan Matthew,24,0,25,1
1681905604473,LTWL 100,A00,182516,Myerston Santana; Jacobo,23,0,30,7
1681905605500,LTWR 100GS,A00,182518,Forbes; Camille,20,0,20,0
1681905606526,LTWR 102,A00,182522,Staff,15,0,15,0
1681905606526,LTWR 102,B00,182525,Staff,14,0,15,1
1681905607556,LTWR 115,A00,182526,Staff,12,0,15,3
1681905608581,MAE 8,A01,182528,Pham; Hieu Tan,68,0,70,2
1681905609605,MAE 11,A00,182529,Bahadori; Mohammad Yousef,94,0,100,6
1681905610643,MAE 20,A00,182530,Evdokimenko; Ekaterina,68,0,70,2
1681905611678,MAE 30A,A00,182532,Staff,44,0,45,1
1681905612711,MAE 101A,A00,182533,Bahadori; Mohammad Yousef,97,0,100,3
1681905613739,MAE 101C,A00,182538,Staff,62,0,70,8
1681905614762,MAE 104,A00,182539,Staff,45,0,50,5
1681905615786,MAE 131A,A00,182540,Ghazinejad; Maziar,41,0,45,4
1681905616812,MAE 143A,A00,182548,Bewley; Thomas R,43,0,50,7
1681905617839,MAE 150,A00,182549,Staff,28,0,40,12
1681905618865,MAE 160,A00,182550,Evdokimenko; Ekaterina,43,0,60,17
1681905619890,MATH 3C,A01,182725,Staff,27,0,30,3
1681905620915,MATH 10A,A01,182729,Staff,25,0,30,5
1681905620915,MATH 10A,B01,182732,Staff,26,0,30,4
1681905621942,MATH 10B,A01,182737,Staff,21,0,30,9
1681905621942,MATH 10B,A02,182738,Staff,28,0,30,2
1681905621942,MATH 10B,B01,182744,Staff,27,0,30,3
1681905621942,MATH 10B,B02,182745,Staff,27,0,30,3
1681905622968,MATH 18,A01,182750,Anzaldo; Leesa B,28,0,30,2
1681905622968,MATH 18,A02,182751,Anzaldo; Leesa B,29,0,30,1
1681905622968,MATH 18,A03,182753,Anzaldo; Leesa B,28,0,30,2
1681905622968,MATH 18,A04,182757,Anzaldo; Leesa B,29,0,30,1
1681905622968,MATH 18,B01,182761,Anzaldo; Leesa B,27,0,30,3
1681905622968,MATH 18,B02,182764,Anzaldo; Leesa B,27,0,30,3
1681905622968,MATH 18,B03,182765,Anzaldo; Leesa B,30,0,30,0
1681905622968,MATH 18,B04,182766,Anzaldo; Leesa B,30,0,30,0
1681905623995,MATH 20A,A01,182771,Suk; Andrew Hoon,28,0,30,2
1681905625020,MATH 20B,A01,182775,Bach; Quang Tran,30,0,30,0
1681905625020,MATH 20B,A02,182777,Bach; Quang Tran,29,0,30,1
1681905625020,MATH 20B,B01,182780,Bach; Quang Tran,27,0,30,3
1681905625020,MATH 20B,B02,182782,Bach; Quang Tran,30,0,30,0
1681905626056,MATH 20C,A01,182787,Staff,25,0,30,5
1681905626056,MATH 20C,A02,182790,Staff,29,0,30,1
1681905626056,MATH 20C,B01,182792,Staff,25,0,30,5
1681905626056,MATH 20C,B02,182796,Staff,27,0,30,3
1681905627081,MATH 20D,A01,182799,Staff,29,0,30,1
1681905627081,MATH 20D,A02,182802,Staff,30,0,30,0
1681905627081,MATH 20D,A03,182803,Staff,30,0,30,0
1681905628123,MATH 20E,A01,182809,Verstraete; Jacques Allan,24,0,30,6
1681905628123,MATH 20E,A02,182811,Verstraete; Jacques Allan,28,0,30,2
1681905628123,MATH 20E,B01,182814,Verstraete; Jacques Allan,23,0,30,7
1681905628123,MATH 20E,B02,182815,Verstraete; Jacques Allan,30,0,30,0
1681905629152,MATH 103A,A01,182820,Staff,9,0,30,21
1681905629152,MATH 103A,A02,182821,Staff,27,0,30,3
1681905629152,MATH 103A,A03,182822,Staff,23,0,30,7
1681905629152,MATH 103A,B01,182825,Staff,23,0,30,7
1681905629152,MATH 103A,B02,182826,Staff,30,0,30,0
1681905629152,MATH 103A,B03,182830,Staff,30,0,30,0
1681905630181,MATH 109,A01,182836,Chow; Bennett,24,0,30,6
1681905630181,MATH 109,A02,182838,Chow; Bennett,29,0,30,1
1681905630181,MATH 109,A03,182894,Chow; Bennett,29,0,30,1
1681905630181,MATH 109,B01,182908,Chow; Bennett,28,0,30,2
1681905630181,MATH 109,B02,182909,Chow; Bennett,30,0,30,0
1681905630181,MATH 109,B03,182910,Chow; Bennett,27,0,30,3
1681905631211,MATH 142A,A01,182925,Staff,11,0,30,19
1681905631211,MATH 142A,A02,182935,Staff,25,0,30,5
1681905631211,MATH 142A,A03,182967,Staff,26,0,30,4
1681905631211,MATH 142A,B01,183125,Staff,24,0,30,6
1681905631211,MATH 142A,B02,183157,Staff,28,0,30,2
1681905631211,MATH 142A,B03,183158,Staff,29,0,30,1
1681905632242,MATH 183,A01,183160,Arias-Castro; Ery,23,0,30,7
1681905632242,MATH 183,A02,183161,Arias-Castro; Ery,29,0,30,1
1681905632242,MATH 183,B01,183163,Arias-Castro; Ery,28,0,30,2
1681905632242,MATH 183,B02,183164,Arias-Castro; Ery,28,0,30,2
1681905633272,MATH 193A,A01,183167,Staff,4,0,35,31
1681905633272,MATH 193A,A02,183168,Staff,28,0,35,7
1681905633272,MATH 193A,A03,183169,Staff,34,0,35,1
1681905633272,MATH 193A,A04,183170,Staff,28,0,35,7
1681905634302,MGT 4,A01,202395,Anderson; John Charles,75,0,80,5
1681905635329,MGT 5,A00,202396,Houskeeper; Robert,80,0,90,10
1681905636353,MGT 103,A00,202397,Eberhard; Craig A,55,0,90,35
1681905637381,MGT 131A,A00,202398,Houskeeper; Robert,85,0,90,5
1681905638407,MGT 135,A00,202399,Anderson; John Charles,83,0,90,7
1681905639429,MGT 162R,A00,202403,Gneezy; Uri,150,0,200,50
1681905640459,MGT 172,A00,202404,Hedges; Kathleen,50,0,90,40
1681905641482,MGT 181,A00,202405,Dunn; Louis Jean,84,0,90,6
1681905642510,MMW 14,A01,183200,Staff,16,0,28,12
1681905642510,MMW 14,A02,183201,Staff,26,0,28,2
1681905642510,MMW 14,A03,183202,Staff,24,0,28,4
1681905642510,MMW 14,A04,183203,Staff,25,0,28,3
1681905642510,MMW 14,A05,183204,Staff,26,0,28,2
1681905642510,MMW 14,A06,183205,Staff,27,0,28,1
1681905642510,MMW 14,B01,183207,Staff,26,0,28,2
1681905642510,MMW 14,B02,183208,Staff,28,0,28,0
1681905642510,MMW 14,B03,183209,Staff,28,0,28,0
1681905642510,MMW 14,B04,183210,Staff,28,0,28,0
1681905642510,MMW 14,B05,183211,Staff,28,0,28,0
1681905642510,MMW 14,B06,183212,Staff,28,0,28,0
1681905643533,MMW 14GS,A00,183213,Zhiri; Oumelbanine,28,0,28,0
1681905644558,MMW 15GS,B00,183215,Rahimi; Babak,28,0,28,0
1681905645592,MMW 121,A01,183217,Patterson; Patrick H.,14,0,28,14
1681905645592,MMW 121,A02,183218,Patterson; Patrick H.,25,0,28,3
1681905646619,MUS 1A,A01,182554,Staff,8,0,35,27
1681905647648,MUS 5,A01,182558,Staff,20,0,35,15
1681905648675,MUS 6,A01,182562,Staff,25,0,35,10
1681905649706,MUS 8GS,A00,182563,Borgo; David Garcia,25,0,25,0
1681905650734,MUS 13,A01,182567,Staff,24,0,25,1
1681905651758,MUS 15,A01,182570,Staff,32,0,35,3
1681905651758,MUS 15,B01,182575,Staff,10,0,35,25
1681905652797,MUS 80,A00,182578,Staff,23,0,25,2
1681905652797,MUS 80,B00,182581,Staff,20,0,25,5
1681905653822,MUS 113,A00,182582,Staff,25,0,25,0
1681905654847,MUS 114,A00,182583,Staff,4,0,25,21
1681905655871,MUS 150GS,A01,182588,Borgo; David Garcia,25,0,25,0
1681905656897,PHIL 1,A00,182590,Staff,35,0,40,5
1681905657923,PHIL 10,A01,182596,Grush; Rick Scott,31,0,35,4
1681905657923,PHIL 10,A02,182597,Grush; Rick Scott,34,0,35,1
1681905658955,PHIL 15,A01,182601,Staff,31,0,35,4
1681905658955,PHIL 15,A02,182602,Staff,33,0,35,2
1681905659987,PHIL 27,A01,182604,Staff,30,0,35,5
1681905659987,PHIL 27,A02,182607,Staff,35,0,35,0
1681905661022,PHIL 32,A01,182609,Staff,35,0,35,0
1681905661022,PHIL 32,A02,182612,Staff,35,0,35,0
1681905662047,PHIL 130,A00,182614,Staff,63,0,70,7
1681905663074,PHIL 136,A00,182616,Cohen; Jonathan David,66,0,70,4
1681905664101,PHIL 155,A00,182617,Vargas; Manuel Rogelio,60,0,70,10
1681905665135,PHIL 163,A01,182620,Staff,15,0,20,5
1681905665135,PHIL 163,A02,182624,Staff,10,0,20,10
1681905666163,PHIL 164,A00,182627,Staff,30,0,40,10
1681905667186,PHIL 173,A00,182628,Staff,36,0,40,4
1681905668211,PHYS 1A,A00,183221,Staff,54,0,60,6
1681905669235,PHYS 1AL,001,183222,Staff,25,0,30,5
1681905669235,PHYS 1AL,002,183223,Staff,28,0,30,2
1681905670262,PHYS 1B,A00,183231,Staff,44,0,60,16
1681905671287,PHYS 1BL,001,183232,Staff,20,0,30,10
1681905671287,PHYS 1BL,002,183233,Staff,29,0,30,1
1681905672315,PHYS 1C,A00,183240,Staff,30,0,60,30
1681905673342,PHYS 1CL,001,183241,Staff,13,0,30,17
1681905673342,PHYS 1CL,002,183242,Staff,22,0,30,8
1681905674444,PHYS 2AR,A01,183250,Staff,44,0,50,6
1681905675475,PHYS 2B,A01,183252,Staff,106,0,115,9
1681905676504,PHYS 2BL,A01,183254,Staff,21,0,24,3
1681905676504,PHYS 2BL,A02,183255,Staff,22,0,24,2
1681905677543,PHYS 2C,A01,183522,Staff,105,0,115,10
1681905678566,PHYS 4A,A01,183524,Staff,49,0,50,1
1681905679594,POLI 5,A00,183525,Staff,44,0,50,6
1681905680621,POLI 12,A00,183540,Staff,48,0,50,2
1681905681647,POLI 13R,A00,183541,Forman; Fonna,42,0,50,8
1681905682672,POLI 30,A00,183542,Mignozzetti; Umberto,47,0,50,3
1681905683698,POLI 100A,A00,183543,Staff,45,0,50,5
1681905684722,POLI 100E,A00,223598,Staff,32,0,35,3
1681905685745,POLI 103A,A00,183564,Kousser; Thad,38,0,50,12
1681905686768,POLI 104B,A00,201329,Staff,29,0,35,6
1681905687796,POLI 113BR,A00,183576,Hoston; Germaine,28,0,50,22
1681905688822,POLI 114BR,A00,183588,Staff,27,0,30,3
1681905689847,POLI 117R,A00,183595,Forman; Fonna,9,0,20,11
1681905690876,POLI 120H,A00,183596,Fisk; David Lee,13,0,20,7
1681905691900,POLI 130AA,A00,183597,Staff,14,0,20,6
1681905692926,POLI 134AA,A00,183598,Staff,19,0,20,1
1681905693950,POLI 135,A00,183599,Fisk; David Lee,20,0,25,5
1681905694975,POLI 142P,A00,183623,Staff,37,0,40,3
1681905696004,POLI 144D,A00,183624,Staff,22,0,25,3
1681905697028,POLI 151,A00,183625,Staff,15,0,20,5
1681905698054,POLI 162,A00,183626,Mignozzetti; Umberto,18,0,20,2
1681905699092,PSYC 1,A00,253748,Staff,86,0,90,4
1681905700126,PSYC 2,A00,183627,Moranton; Nirelia Melbina-,25,0,35,10
1681905701150,PSYC 3,A00,183628,Staff,43,0,45,2
1681905703210,PSYC 60,A01,183631,Lowe; Angela Beth,35,0,40,5
1681905704234,PSYC 70,A01,253757,Staff,37,0,45,8
1681905705257,PSYC 101,A00,183632,Heyman; Gail D.,48,0,60,12
1681905706282,PSYC 105,A00,183848,Lowe; Angela Beth,50,0,60,10
1681905707316,PSYC 106,A00,183849,Dobkins; Karen R.,45,0,60,15
1681905708341,PSYC 108,A00,253750,Staff,24,0,60,36
1681905709367,PSYC 114,A01,184275,Winkielman; Piotr,0,6,30,30
1681905710394,PSYC 122,A00,183856,Moranton; Nirelia Melbina-,0,10,30,30
1681905711423,PSYC 124,A00,183865,Chapman; Eddie Nathaniel,52,0,80,28
1681905712462,PSYC 137,A00,183880,Staff,19,0,25,6
1681905714522,PSYC 154,A00,183910,Lacefield; Katharine I,0,2,90,90
1681905716576,PSYC 162,A00,183946,Wixted; John T,61,0,90,29
1681905717601,PSYC 172,A00,183947,Gorman; Michael R.,14,0,30,16
1681905718625,PSYC 178,A00,183963,Glaser; Dale,20,0,40,20
1681905719647,PSYC 181GS,A00,183964,Anagnostaras; Stephan,10,0,10,0
1681905720673,PSYC 186GS,A01,257660,Staff,10,0,10,0
1681905721705,PSYC 193,B00,253749,Staff,23,0,25,2
1681905723757,PSYC 193L,A01,184122,Staff,33,0,35,2
1681905723757,PSYC 193L,C01,184167,Winkielman; Piotr,16,0,30,14
1681905724782,RELI 188GS,A00,182629,Rahimi; Babak,20,0,20,0
1681905725810,SE 101A,A00,182646,Staff,26,0,30,4
1681905726838,SE 101C,A00,182650,Staff,18,0,20,2
1681905727862,SE 110A,A00,182651,Staff,28,0,28,0
1681905728891,SE 130A,A00,182652,Staff,39,0,40,1
1681905729921,SIO 46GS,A00,182636,Cook; Geoffrey W,28,0,28,0
1681905730946,SIO 109R,A00,194459,Staff,5,0,20,15
1681905731968,SIO 121GS,A00,182639,Cook; Geoffrey W,28,0,28,0
1681905733004,SIO 132,A01,182642,Staff,32,0,40,8
1681905734028,SIO 139,A00,182644,Kacev; David,36,0,40,4
1681905735054,SOCI 2,A01,258404,Staff,34,0,36,2
1681905735054,SOCI 2,A02,258405,Staff,35,0,36,1
1681905736082,SOCI 60,A01,258408,Staff,29,0,30,1
1681905736082,SOCI 60,A02,258413,Staff,30,0,30,0
1681905737107,SOCI 100,A01,258415,Staff,29,0,30,1
1681905737107,SOCI 100,A02,258416,Staff,28,0,30,2
1681905743309,SOCI 127,A00,258421,Staff,22,0,30,8
1681905744334,SOCI 132,A00,258422,Staff,45,0,50,5
1681905745363,SOCI 133,A00,258423,Staff,26,0,30,4
1681905746386,SOCI 138GS,A00,258424,Staff,15,0,15,0
1681905747415,SOCI 145,A00,258425,Staff,25,0,30,5
1681905748447,SOCI 148,A00,258426,Staff,26,0,30,4
1681905749471,SOCI 153,A00,199217,Staff,29,0,30,1
1681905750500,SOCI 160,A00,258427,Staff,28,0,30,2
1681905751524,SOCI 160E,A00,258435,Staff,56,0,60,4
1681905752548,SOCI 189GS,A00,258436,Staff,15,0,15,0
1681905753571,SOCI 190GS,A00,258437,Staff,15,0,15,0
1681905754599,SYN 2,001,182658,Staff,9,0,16,7
1681905754599,SYN 2,002,201439,Staff,15,0,16,1
1681905754599,SYN 2,003,201443,Staff,16,0,16,0
1681905755632,SYN 100,A01,182657,Staff,17,0,20,3
1681905756670,TDAC 1,A00,184381,Salovey; Todd,16,0,20,4
1681905756670,TDAC 1,B00,184385,Harting; Carla Kelso,19,0,20,1
1681905756670,TDAC 1,C00,184394,Staff,19,0,20,1
1681905757728,TDAC 101,A00,184483,Harting; Carla Kelso,19,0,20,1
1681905758751,TDDE 111,A00,184496,Staff,14,0,15,1
1681905759779,TDDE 131,A00,184504,Staff,20,0,20,0
1681905759779,TDDE 131,B00,184505,Staff,17,0,18,1
1681905759779,TDDE 131,C00,184534,Staff,49,0,50,1
1681905759779,TDDE 131,D00,184564,Staff,15,0,15,0
1681905759779,TDDE 131,E00,204725,Staff,19,0,20,1
1681905760808,TDGE 1,A01,184414,Salovey; Todd,37,0,50,13
1681905761833,TDGE 5,A01,184419,Staff,23,0,24,1
1681905762859,TDGE 10,A00,184428,Fulton; Julia,31,0,50,19
1681905763887,TDGE 124,A00,184565,Fulton; Julia,7,0,50,43
1681905764912,TDGE 125,B00,184567,Meyer; Ursula,9,0,25,16
1681905765942,TDHT 101,A00,184568,Staff,21,0,25,4
1681905765942,TDHT 101,B00,184569,Staff,20,0,20,0
1681905766967,TDHT 114,A00,184570,Staff,49,0,50,1
1681905767995,TDMV 1,A00,184437,Arcidiacono; Kristin,23,0,30,7
1681905767995,TDMV 1,B00,184448,Caligagan; Maria T.,22,0,30,8
1681905769021,TDMV 2,A00,184449,Weinberg; Sadie,27,0,30,3
1681905769021,TDMV 2,B00,184453,Arcidiacono; Kristin,29,0,30,1
1681905770046,TDMV 110,A00,184571,Weinberg; Sadie,30,0,30,0
1681905771071,TDMV 142,A00,184572,Caligagan; Tony,27,0,30,3
1681905771071,TDMV 142,B00,184573,Caligagan; Maria T.,27,0,30,3
1681905772100,TDTR 20,A00,184482,Jun; Grace Shin Hae,25,0,25,0
1681905773125,USP 2,A01,184290,Hinds; Juli Beth,24,0,25,1
1681905774151,USP 3,A01,184295,Staff,20,0,25,5
1681905775177,USP 4,A00,184304,McTague; Sarah,15,0,25,10
1681905776200,USP 100,A00,184315,Staff,17,0,25,8
1681905777229,USP 105,A00,184326,Staff,21,0,25,4
1681905778327,USP 151,A00,184327,Staff,20,0,25,5
1681905779352,USP 170,A00,184380,Hinds; Juli Beth,14,0,25,11
1681905780383,VIS 21B,A01,182660,Staff,28,0,31,3
1681905780383,VIS 21B,A02,182662,Staff,30,0,31,1
1681905781408,VIS 103D,A00,182663,Staff,74,0,75,1
1681905782443,VIS 105D,A00,182667,Li; Huai,15,0,22,7
1681905783478,VIS 122GS,A00,182668,Herbst; Matthew,20,0,20,0
1681905784510,VIS 128C,A00,182673,Staff,70,0,75,5
1681905785535,VIS 130,A00,182675,Staff,20,0,22,2
1681905786560,VIS 160A,A00,182678,Stalbaum; Brett,4,0,10,6
1681905788610,WCWP 10B,A00,201679,Staff,15,0,15,0
1681905788610,WCWP 10B,B00,201695,Staff,15,0,15,0
1681905789641,WCWP 100,A00,201716,Staff,15,0,15,0
1681905789641,WCWP 100,B00,201717,Staff,11,0,15,4
1681905791767,ANSC 105GS,A00,258289,Staff,0,0,0,0
1681905792795,ANSC 125GS,A00,258295,Staff,0,0,0,0
1681905793823,ANSC 150,A00,258267,Staff,30,0,40,10
1681905794853,ANSC 190GS,A00,258280,Staff,0,0,0,0
1681905795878,ANTH 1,A00,258264,Staff,38,0,40,2
1681905796911,ANTH 2,A01,258259,Staff,72,0,76,4
1681905797943,ANTH 23,A01,258228,Staff,36,0,40,4
1681905798969,ANTH 101,A01,258236,Staff,39,0,40,1
1681905799992,ANTH 102,A00,258272,Staff,59,0,60,1
1681905801015,ANTH 105,A00,258244,Staff,31,0,35,4
1681905802040,BENG 130,A00,253975,Staff,38,0,40,2
1681905803068,BIBC 102,A01,191866,Flagg; Matthew Paul,19,0,32,13
1681905803068,BIBC 102,A02,191867,Flagg; Matthew Paul,22,0,32,10
1681905803068,BIBC 102,A03,191868,Flagg; Matthew Paul,30,0,32,2
1681905803068,BIBC 102,A04,191936,Flagg; Matthew Paul,26,0,32,6
1681905803068,BIBC 102,A05,191937,Flagg; Matthew Paul,11,0,32,21
1681905804099,BICD 100,A01,191939,Cooper; Andrew Michael,28,0,32,4
1681905804099,BICD 100,A02,191940,Cooper; Andrew Michael,32,0,32,0
1681905804099,BICD 100,A03,191941,Cooper; Andrew Michael,32,0,32,0
1681905804099,BICD 100,A04,191942,Cooper; Andrew Michael,32,0,32,0
1681905804099,BICD 100,A05,191943,Cooper; Andrew Michael,32,0,32,0
1681905805125,BIEB 126,A01,191945,Cleland; Elsa Eleanor,1,0,32,31
1681905805125,BIEB 126,A02,191946,Cleland; Elsa Eleanor,28,0,32,4
1681905805125,BIEB 126,A03,191947,Cleland; Elsa Eleanor,29,0,32,3
1681905805125,BIEB 126,A04,191948,Cleland; Elsa Eleanor,23,0,32,9
1681905805125,BIEB 126,A05,191996,Cleland; Elsa Eleanor,28,0,32,4
1681905806150,BIEB 136GS,A00,191997,Shurin; Jonathan & Holway; David A.,0,0,0,0
1681905807181,BIEB 137GS,A01,191999,Shurin; Jonathan & Holway; David A.,0,0,0,0
1681905808208,BILD 1,A01,205385,Staff,31,0,32,1
1681905808208,BILD 1,A02,205386,Staff,30,0,32,2
1681905808208,BILD 1,A03,205387,Staff,32,0,32,0
1681905808208,BILD 1,A04,205388,Staff,28,0,32,4
1681905809237,BILD 2,A01,191774,Staff,28,0,32,4
1681905809237,BILD 2,A02,191775,Staff,30,0,32,2
1681905809237,BILD 2,A03,191777,Staff,30,0,32,2
1681905809237,BILD 2,A04,191856,Staff,31,0,32,1
1681905809237,BILD 2,A05,191857,Staff,32,0,32,0
1681905809237,BILD 2,A06,191858,Staff,32,0,32,0
1681905809237,BILD 2,A07,191859,Staff,31,0,32,1
1681905810264,BILD 3,A01,205391,Staff,29,0,32,3
1681905810264,BILD 3,A02,205393,Staff,32,0,32,0
1681905810264,BILD 3,A03,205394,Staff,28,0,32,4
1681905810264,BILD 3,A04,205395,Staff,32,0,32,0
1681905811294,BILD 20,A01,191861,Staff,32,0,32,0
1681905811294,BILD 20,A02,191862,Staff,32,0,32,0
1681905812318,BILD 30,A01,191864,Staff,31,0,32,1
1681905813342,BIMM 100,A01,192019,Staff,0,0,32,32
1681905813342,BIMM 100,A02,192020,Staff,23,0,32,9
1681905813342,BIMM 100,A03,192035,Staff,22,0,32,10
1681905814377,BIMM 110,A01,192037,Tat; John,0,0,32,32
1681905814377,BIMM 110,A02,192038,Tat; John,10,0,32,22
1681905815400,BIMM 120,A01,192040,Pickett; Brooke Elizabeth,2,0,32,30
1681905815400,BIMM 120,A02,192041,Pickett; Brooke Elizabeth,16,0,32,16
1681905815400,BIMM 120,A03,192042,Pickett; Brooke Elizabeth,16,0,32,16
1681905816430,BIPN 100,A01,192044,Armour; Jon Christopher,26,0,32,6
1681905816430,BIPN 100,A02,192059,Armour; Jon Christopher,30,0,32,2
1681905816430,BIPN 100,A03,192064,Armour; Jon Christopher,31,0,32,1
1681905816430,BIPN 100,A04,192073,Armour; Jon Christopher,28,0,32,4
1681905817459,BIPN 148,A01,205411,Leutgeb; Jill K.,16,0,32,16
1681905817459,BIPN 148,A02,205412,Leutgeb; Jill K.,31,0,32,1
1681905817459,BIPN 148,A03,205413,Leutgeb; Jill K.,30,0,32,2
1681905817459,BIPN 148,A04,205414,Leutgeb; Jill K.,30,0,32,2
1681905818492,BIPN 160,A01,192115,Marino; Marc J,19,0,32,13
1681905818492,BIPN 160,A02,192148,Marino; Marc J,27,0,32,5
1681905818492,BIPN 160,A03,192158,Marino; Marc J,31,0,32,1
1681905818492,BIPN 160,A04,192190,Marino; Marc J,32,0,32,0
1681905818492,BIPN 160,A05,192287,Marino; Marc J,32,0,32,0
1681905818492,BIPN 160,A06,192288,Marino; Marc J,32,0,32,0
1681905819516,BIPN 194,A00,206038,Staff,28,0,32,4
1681905820632,BISP 194,A00,192289,Leutgeb; Stefan,13,0,32,19
1681905820632,BISP 194,B00,245332,Nieh; James Charles,27,0,32,5
1681905821657,CAT 124,A01,202247,Staff,15,0,15,0
1681905822681,CAT 125,A00,202248,Staff,19,0,20,1
1681905822681,CAT 125,B00,202253,Staff,20,0,20,0
1681905822681,CAT 125,C00,202257,Staff,19,0,20,1
1681905823712,CAT 125GS,A01,202273,Bronstein; Phoebe Malan,20,0,20,0
1681905824737,CAT 125R,A00,202284,Staff,17,0,20,3
1681905824737,CAT 125R,C00,202286,Staff,10,0,20,10
1681905824737,CAT 125R,D00,202291,Staff,18,0,20,2
1681905824737,CAT 125R,E00,202295,Staff,13,0,20,7
1681905824737,CAT 125R,F00,202302,Staff,12,0,20,8
1681905825763,CENG 100,A00,204724,Opatkiewicz; Justin Paul,25,0,25,0
1681905826788,CGS 2A,A01,180420,Staff,31,0,36,5
1681905827813,CGS 101,A00,180421,Staff,16,0,20,4
1681905828838,CGS 112,A00,180422,Staff,10,0,16,6
1681905829867,CGS 113,A00,180423,Staff,18,0,20,2
1681905830896,CGS 137,A00,180424,Staff,12,0,12,0
1681905831921,CGS 147,A00,180425,Staff,10,0,10,0
1681905832954,CHEM 6A,A01,179556,Staff,97,0,100,3
1681905832954,CHEM 6A,A02,179558,Staff,0,0,0,0
1681905833978,CHEM 6B,A01,179560,Staff,100,0,100,0
1681905835010,CHEM 6C,A01,179565,Jazzar; Rodolphe,95,0,100,5
1681905836036,CHEM 7L,A01,179586,Schurmeier; Kimberly,13,0,24,11
1681905836036,CHEM 7L,A02,179587,Schurmeier; Kimberly,23,0,24,1
1681905836036,CHEM 7L,A03,179590,Schurmeier; Kimberly,22,0,24,2
1681905836036,CHEM 7L,A04,179591,Schurmeier; Kimberly,22,0,24,2
1681905836036,CHEM 7L,B01,179598,Schurmeier; Kimberly,17,0,24,7
1681905836036,CHEM 7L,B02,179599,Schurmeier; Kimberly,24,0,24,0
1681905836036,CHEM 7L,B03,179606,Schurmeier; Kimberly,23,0,24,1
1681905836036,CHEM 7L,B04,179607,Schurmeier; Kimberly,23,0,24,1
1681905837072,CHEM 11,A01,179609,Stallings; Dontarie M,88,0,100,12
1681905838095,CHEM 40A,A01,179621,Staff,41,0,50,9
1681905838095,CHEM 40A,A02,179622,Staff,47,0,50,3
1681905839120,CHEM 40B,A01,179630,Weizman; Haim,48,0,50,2
1681905839120,CHEM 40B,A02,179631,Weizman; Haim,45,0,50,5
1681905840146,CHEM 41A,A01,179660,Klosterman; Jeremy K,93,0,100,7
1681905841173,CHEM 43A,A01,179683,Klosterman; Jeremy K,0,0,24,24
1681905841173,CHEM 43A,A02,179688,Klosterman; Jeremy K,14,0,24,10
1681905841173,CHEM 43A,A03,179689,Klosterman; Jeremy K,20,0,24,4
1681905841173,CHEM 43A,A04,179691,Klosterman; Jeremy K,18,0,24,6
1681905842198,CHEM 114A,A01,179693,Stallings; Dontarie M,77,0,100,23
1681905843226,CHEM 143B,A01,179698,Weizman; Haim,17,0,24,7
1681905843226,CHEM 143B,A02,179700,Weizman; Haim,24,0,24,0
1681905844262,CHIN 169A,A00,179701,Wang; Xiao,20,0,20,0
1681905845291,COGS 2,A01,179750,Boyle; Mary E. T.,17,0,30,13
1681905846317,COGS 9,A01,179759,Jones; Cameron Robert,43,0,50,7
1681905847344,COGS 14A,A01,179854,Staff,18,0,50,32
1681905848381,COGS 14B,A01,179856,Staff,54,0,60,6
1681905849409,COGS 17,A01,179874,Staff,71,0,75,4
1681905850433,COGS 18,A01,179884,Staff,63,0,80,17
1681905851455,COGS 100,A01,179886,Staff,40,0,60,20
1681905852483,COGS 101B,A01,179892,Staff,1,0,30,29
1681905853518,COGS 101C,A01,179894,Staff,28,0,30,2
1681905854552,COGS 107A,A01,179896,Boyle; Mary E. T.,31,0,40,9
1681905855584,COGS 108,A01,179898,Simpkins; Charles Alexander,0,17,60,60
1681905856607,COGS 109,A01,179900,Staff,34,0,40,6
1681905857639,COGS 118A,A01,179946,Staff,9,0,40,31
1681905858673,COGS 153,A00,179978,Staff,1,0,30,29
1681905859701,COGS 156,A01,179981,Staff,27,0,30,3
1681905861755,COGS 172,A01,179987,Staff,13,0,30,17
1681905863804,COGS 186,A01,179991,Staff,13,0,30,17
1681905864837,COMM 10,A01,180001,Staff,15,0,25,10
1681905864837,COMM 10,A02,180004,Staff,20,0,25,5
1681905865860,COMM 100A,A01,180016,Staff,18,0,25,7
1681905865860,COMM 100A,A02,180020,Staff,24,0,25,1
1681905866886,COMM 101T,A00,180029,Halm; Gavin Patrick,23,0,35,12
1681905867911,COMM 106V,A00,180043,Staff,34,0,35,1
1681905868942,COMM 109P,A00,180044,Staff,31,0,35,4
1681905869971,COMM 113T,A00,180045,Havis; Allan,37,0,45,8
1681905871000,COMM 132,A00,180046,McKenna; Denise,23,0,30,7
1681905872026,COMM 143,A00,180047,Staff,19,0,30,11
1681905873053,COMM 190,A00,180048,Conner; Thomas Hartnell,20,0,23,3
1681905874130,CSE 8A,A50,180053,Cao; Yingjun,25,0,50,25
1681905874130,CSE 8A,B50,180180,Staff,50,0,50,0
1681905875157,CSE 11,A01,180190,Cao; Yingjun,31,0,50,19
1681905876187,CSE 20,A01,180192,Briones; Jor-el Thomas Caparas,23,0,30,7
1681905877223,CSE 21,A01,194538,Briones; Jor-el Thomas Caparas,50,0,60,10
1681905878258,CSE 30,A01,180324,Eldon; John,79,0,100,21
1681905879285,CSE 101,A01,201353,Staff,0,20,40,40
1681905880312,CSE 134B,A01,180326,Powell; Thomas Allan,74,0,100,26
1681905881336,CSE 140,A01,180328,Staff,46,0,75,29
1681905882446,CSE 140L,A01,180344,Eldon; John,69,0,100,31
1681905883471,CSE 150A,A01,180411,Staff,0,7,50,50
1681905884498,CSE 151A,A01,180414,Staff,0,6,50,50
1681905885526,CSE 175,A01,222521,Kumar; Rakesh,50,0,50,0
1681905886554,CSE 190,A00,201419,Staff,45,0,49,4
1681905887577,CSS 1,A01,194536,Staff,38,0,50,12
1681905888616,DSC 30,A01,202385,Staff,48,0,50,2
1681905889641,DSC 40A,A01,202387,Albuyeh; Rod,50,0,50,0
1681905890669,DSC 190,A01,202389,Silberman; Jack,21,0,21,0
1681905891696,DSGN 100,A01,179993,Staff,16,0,30,14
1681905892747,ECE 65,A50,180708,Staff,10,0,20,10
1681905892747,ECE 65,A51,180739,Staff,19,0,20,1
1681905893775,ECON 1,A01,180427,Famulari; Melissa,67,0,70,3
1681905894802,ECON 2,A01,180450,Levkoff; Steven B.,64,0,70,6
1681905895829,ECON 4,A01,203351,Anderson; John Charles,7,0,10,3
1681905896856,ECON 100A,A01,180472,Famulari; Melissa,65,0,70,5
1681905897881,ECON 120A,A01,180549,Staff,64,0,70,6
1681905898906,ECON 120B,A01,180655,Ma; Xinwei,46,0,70,24
1681905899934,ECON 129,A00,203333,Eckert; Fabian Paul,15,0,35,20
1681905900958,ECON 131,A00,180656,Staff,10,0,35,25
1681905901991,ECON 172B,A01,180672,Levkoff; Steven B.,32,0,35,3
1681905903018,ECON 178,A01,203342,Zhu; Ying,11,0,35,24
1681905904042,EDS 108GS,A00,202383,Wishard Guerra; Alison G.,20,0,20,0
1681905905068,EDS 111GS,A00,202347,Wishard Guerra; Alison G.,20,0,20,0
1681905906095,EDS 112,A01,202323,Staff,56,0,60,4
1681905907130,EDS 113,A00,202340,Staff,33,0,35,2
1681905908157,EDS 118,A00,201231,Staff,20,0,30,10
1681905909187,EDS 119,A00,204994,Staff,8,0,10,2
1681905910215,EDS 124BR,A00,202324,Eguchi; Emi,5,0,25,20
1681905911248,EDS 126,A01,203208,Jones; Makeba,26,0,30,4
1681905912272,EDS 135,A01,202333,Staff,18,0,20,2
1681905913295,EDS 180,A00,202311,Staff,47,0,50,3
1681905914319,ERC 190GS,A01,253747,Staff,28,0,28,0
1681905915367,ETHN 104,A00,180742,Staff,24,0,35,11
1681905916400,ETHN 118,A00,180745,Staff,28,0,35,7
1681905917428,ETHN 127,A00,180747,Staff,12,0,16,4
1681905918452,ETHN 137,A00,180880,Staff,12,0,12,0
1681905919477,ETHN 147,A00,180890,Staff,8,0,10,2
1681905920500,ETHN 154,A00,180891,Staff,7,0,8,1
1681905921528,ETHN 168,A00,180892,Staff,9,0,10,1
1681905922557,GLBH 20,A00,201051,Hannah; Seth Donal,0,1,0,1
1681905923589,GLBH 111,A01,209338,Burgos; Jose L.,0,0,0,0
1681905924623,GLBH 150,A00,258300,Staff,0,3,0,0
1681905925654,GLBH 181,A00,201207,Staff,15,0,40,25
1681905926695,HIEU 109,A00,180898,Staff,20,0,20,0
1681905927723,HIEU 111,A00,180899,Staff,1,0,20,19
1681905928758,HIEU 124,A00,180900,Staff,18,0,20,2
1681905929790,HILA 122,A00,180901,Staff,18,0,20,2
1681905930815,HILA 132,A00,180902,Vitz; Matthew,2,0,20,18
1681905931852,HILD 10,A01,180896,Staff,15,0,20,5
1681905932893,HILD 30GS,A00,180897,Edington; Claire Ellen,0,0,0,0
1681905933917,HISC 105,A00,180903,Staff,20,0,20,0
1681905934945,HISC 117,A00,180904,Staff,11,0,20,9
1681905935973,HIUS 108B,A00,181005,Staff,18,0,20,2
1681905937001,HIUS 113,A00,181093,Staff,4,0,20,16
1681905938035,HUM 3,A01,181190,Patterson; Patrick H.,40,0,50,10
1681905938035,HUM 3,B01,181195,Staff,47,0,50,3
1681905939072,HUM 3GS,A00,181196,Herbst; Matthew,0,0,0,0
1681905940116,HUM 4,A01,181227,West; Geoffrey Scott,34,0,50,16
1681905940116,HUM 4,B01,181282,Staff,43,0,50,7
1681905941142,HUM 4GS,A00,181377,Lyon; Antony J.,0,0,0,0
1681905942165,HUM 5,A01,181536,Zavodny; Tatiana Sophia,31,0,50,19
1681905942165,HUM 5,B01,181908,Staff,36,0,50,14
1681905943201,INTL 190,A00,181909,Segui; Alan S,0,0,0,6
1681905943201,INTL 190,B00,181961,Segui; Alan S,0,0,0,7
1681905944226,JAPN 20AR,A01,182113,Ross; Kayoko F,15,0,20,5
1681905945256,LATI 50,A01,202391,Martin-Cabrera; Luis,19,0,30,11
1681905945256,LATI 50,A02,202392,Martin-Cabrera; Luis,26,0,30,4
1681905946281,LATI 180,A00,202393,Kokinis; Troy Andreas,25,0,25,0
1681905947311,LIFR 1A,A00,182119,Staff,14,0,14,0
1681905948336,LIFR 1AX,A00,182324,Staff,14,0,14,0
1681905949364,LIFR 1B,A00,182259,Staff,14,0,14,0
1681905950391,LIFR 1BX,A00,182273,Staff,14,0,14,0
1681905951424,LIGN 8,A00,182330,Staff,137,0,150,13
1681905952450,LIGN 9GS,A00,182362,Staff,20,0,20,0
1681905953477,LIGN 119,A00,204992,Takahashi; Maho,12,0,15,3
1681905954501,LIGN 130,A01,182384,Staff,47,0,50,3
1681905955524,LIGN 149GS,A00,182390,Staff,20,0,20,0
1681905956558,LIGN 170,A00,182404,Staff,24,0,30,6
1681905957583,LISP 1D,A00,182281,Staff,7,0,14,7
1681905957583,LISP 1D,B00,182287,Staff,14,0,14,0
1681905957583,LISP 1D,C00,182295,Staff,11,0,14,3
1681905957583,LISP 1D,D00,182301,Staff,14,0,14,0
1681905958610,LISP 1DX,A00,182309,Staff,20,0,28,8
1681905958610,LISP 1DX,B00,182316,Staff,26,0,28,2
1681905959636,LTAF 120GS,A00,182412,Zhiri; Oumelbanine,20,0,20,0
1681905960664,LTCS 172GS,A00,182437,Bronstein; Phoebe Malan,20,0,20,0
1681905961697,LTEA 138,A00,182457,Staff,22,0,40,18
1681905962730,LTEN 114,A01,182490,Staff,23,0,25,2
1681905963774,LTEN 130GS,A00,182491,Lyon; Antony J.,20,0,20,0
1681905964805,LTEN 169,A00,182493,Cuong; Marisol,20,0,25,5
1681905965834,LTEN 178,A00,182501,Staff,14,0,15,1
1681905966864,LTEN 181,A00,182515,Staff,22,0,25,3
1681905967893,LTEN 185GS,A00,197655,Forbes; Camille,20,0,20,0
1681905968924,LTSP 100B,A00,202208,Bessett; Ryan Matthew,24,0,25,1
1681905969949,LTWL 100,A00,182516,Myerston Santana; Jacobo,23,0,30,7
1681905970980,LTWR 100GS,A00,182518,Forbes; Camille,20,0,20,0
1681905972015,LTWR 102,A00,182522,Staff,15,0,15,0
1681905972015,LTWR 102,B00,182525,Staff,14,0,15,1
1681905973038,LTWR 115,A00,182526,Staff,12,0,15,3
1681905974063,MAE 8,A01,182528,Pham; Hieu Tan,68,0,70,2
1681905975096,MAE 11,A00,182529,Bahadori; Mohammad Yousef,94,0,100,6
1681905976136,MAE 20,A00,182530,Evdokimenko; Ekaterina,68,0,70,2
1681905977165,MAE 30A,A00,182532,Staff,44,0,45,1
1681905978200,MAE 101A,A00,182533,Bahadori; Mohammad Yousef,97,0,100,3
1681905979234,MAE 101C,A00,182538,Staff,62,0,70,8
1681905980258,MAE 104,A00,182539,Staff,45,0,50,5
1681905981288,MAE 131A,A00,182540,Ghazinejad; Maziar,41,0,45,4
1681905982321,MAE 143A,A00,182548,Bewley; Thomas R,43,0,50,7
1681905983379,MAE 150,A00,182549,Staff,28,0,40,12
1681905984411,MAE 160,A00,182550,Evdokimenko; Ekaterina,43,0,60,17
1681905985441,MATH 3C,A01,182725,Staff,27,0,30,3
1681905986577,MATH 10A,A01,182729,Staff,25,0,30,5
1681905986577,MATH 10A,B01,182732,Staff,26,0,30,4
1681905987608,MATH 10B,A01,182737,Staff,21,0,30,9
1681905987608,MATH 10B,A02,182738,Staff,27,0,30,3
1681905987608,MATH 10B,B01,182744,Staff,27,0,30,3
1681905987608,MATH 10B,B02,182745,Staff,27,0,30,3
1681905988635,MATH 18,A01,182750,Anzaldo; Leesa B,28,0,30,2
1681905988635,MATH 18,A02,182751,Anzaldo; Leesa B,29,0,30,1
1681905988635,MATH 18,A03,182753,Anzaldo; Leesa B,28,0,30,2
1681905988635,MATH 18,A04,182757,Anzaldo; Leesa B,29,0,30,1
1681905988635,MATH 18,B01,182761,Anzaldo; Leesa B,27,0,30,3
1681905988635,MATH 18,B02,182764,Anzaldo; Leesa B,27,0,30,3
1681905988635,MATH 18,B03,182765,Anzaldo; Leesa B,30,0,30,0
1681905988635,MATH 18,B04,182766,Anzaldo; Leesa B,30,0,30,0
1681905989662,MATH 20A,A01,182771,Suk; Andrew Hoon,28,0,30,2
1681905990699,MATH 20B,A01,182775,Bach; Quang Tran,30,0,30,0
1681905990699,MATH 20B,A02,182777,Bach; Quang Tran,29,0,30,1
1681905990699,MATH 20B,B01,182780,Bach; Quang Tran,27,0,30,3
1681905990699,MATH 20B,B02,182782,Bach; Quang Tran,30,0,30,0
1681905991731,MATH 20C,A01,182787,Staff,25,0,30,5
1681905991731,MATH 20C,A02,182790,Staff,29,0,30,1
1681905991731,MATH 20C,B01,182792,Staff,25,0,30,5
1681905991731,MATH 20C,B02,182796,Staff,27,0,30,3
1681905992768,MATH 20D,A01,182799,Staff,29,0,30,1
1681905992768,MATH 20D,A02,182802,Staff,30,0,30,0
1681905992768,MATH 20D,A03,182803,Staff,30,0,30,0
1681905993800,MATH 20E,A01,182809,Verstraete; Jacques Allan,24,0,30,6
1681905993800,MATH 20E,A02,182811,Verstraete; Jacques Allan,28,0,30,2
1681905993800,MATH 20E,B01,182814,Verstraete; Jacques Allan,23,0,30,7
1681905993800,MATH 20E,B02,182815,Verstraete; Jacques Allan,30,0,30,0
1681905994829,MATH 103A,A01,182820,Staff,9,0,30,21
1681905994829,MATH 103A,A02,182821,Staff,27,0,30,3
1681905994829,MATH 103A,A03,182822,Staff,23,0,30,7
1681905994829,MATH 103A,B01,182825,Staff,23,0,30,7
1681905994829,MATH 103A,B02,182826,Staff,30,0,30,0
1681905994829,MATH 103A,B03,182830,Staff,30,0,30,0
1681905995869,MATH 109,A01,182836,Chow; Bennett,24,0,30,6
1681905995869,MATH 109,A02,182838,Chow; Bennett,29,0,30,1
1681905995869,MATH 109,A03,182894,Chow; Bennett,29,0,30,1
1681905995869,MATH 109,B01,182908,Chow; Bennett,28,0,30,2
1681905995869,MATH 109,B02,182909,Chow; Bennett,30,0,30,0
1681905995869,MATH 109,B03,182910,Chow; Bennett,27,0,30,3
1681905996902,MATH 142A,A01,182925,Staff,11,0,30,19
1681905996902,MATH 142A,A02,182935,Staff,25,0,30,5
1681905996902,MATH 142A,A03,182967,Staff,26,0,30,4
1681905996902,MATH 142A,B01,183125,Staff,24,0,30,6
1681905996902,MATH 142A,B02,183157,Staff,28,0,30,2
1681905996902,MATH 142A,B03,183158,Staff,29,0,30,1
1681905997931,MATH 183,A01,183160,Arias-Castro; Ery,23,0,30,7
1681905997931,MATH 183,A02,183161,Arias-Castro; Ery,29,0,30,1
1681905997931,MATH 183,B01,183163,Arias-Castro; Ery,28,0,30,2
1681905997931,MATH 183,B02,183164,Arias-Castro; Ery,28,0,30,2
1681905998967,MATH 193A,A01,183167,Staff,4,0,35,31
1681905998967,MATH 193A,A02,183168,Staff,28,0,35,7
1681905998967,MATH 193A,A03,183169,Staff,34,0,35,1
1681905998967,MATH 193A,A04,183170,Staff,28,0,35,7
1681905999994,MGT 4,A01,202395,Anderson; John Charles,75,0,80,5
1681906001024,MGT 5,A00,202396,Houskeeper; Robert,80,0,90,10
1681906002056,MGT 103,A00,202397,Eberhard; Craig A,55,0,90,35
1681906003088,MGT 131A,A00,202398,Houskeeper; Robert,85,0,90,5
1681906004120,MGT 135,A00,202399,Anderson; John Charles,83,0,90,7
1681906005149,MGT 162R,A00,202403,Gneezy; Uri,150,0,200,50
1681906006180,MGT 172,A00,202404,Hedges; Kathleen,50,0,90,40
1681906007210,MGT 181,A00,202405,Dunn; Louis Jean,84,0,90,6
1681906008238,MMW 14,A01,183200,Staff,16,0,28,12
1681906008238,MMW 14,A02,183201,Staff,26,0,28,2
1681906008238,MMW 14,A03,183202,Staff,24,0,28,4
1681906008238,MMW 14,A04,183203,Staff,25,0,28,3
1681906008238,MMW 14,A05,183204,Staff,26,0,28,2
1681906008238,MMW 14,A06,183205,Staff,27,0,28,1
1681906008238,MMW 14,B01,183207,Staff,26,0,28,2
1681906008238,MMW 14,B02,183208,Staff,28,0,28,0
1681906008238,MMW 14,B03,183209,Staff,28,0,28,0
1681906008238,MMW 14,B04,183210,Staff,28,0,28,0
1681906008238,MMW 14,B05,183211,Staff,28,0,28,0
1681906008238,MMW 14,B06,183212,Staff,28,0,28,0
1681906009262,MMW 14GS,A00,183213,Zhiri; Oumelbanine,28,0,28,0
1681906010286,MMW 15GS,B00,183215,Rahimi; Babak,28,0,28,0
1681906011336,MMW 121,A01,183217,Patterson; Patrick H.,14,0,28,14
1681906011336,MMW 121,A02,183218,Patterson; Patrick H.,25,0,28,3
1681906012361,MUS 1A,A01,182554,Staff,8,0,35,27
1681906013397,MUS 5,A01,182558,Staff,20,0,35,15
1681906014426,MUS 6,A01,182562,Staff,25,0,35,10
1681906015462,MUS 8GS,A00,182563,Borgo; David Garcia,25,0,25,0
1681906016485,MUS 13,A01,182567,Staff,24,0,25,1
1681906017520,MUS 15,A01,182570,Staff,32,0,35,3
1681906017520,MUS 15,B01,182575,Staff,10,0,35,25
1681906018546,MUS 80,A00,182578,Staff,23,0,25,2
1681906018546,MUS 80,B00,182581,Staff,20,0,25,5
1681906019569,MUS 113,A00,182582,Staff,25,0,25,0
1681906020593,MUS 114,A00,182583,Staff,4,0,25,21
1681906021628,MUS 150GS,A01,182588,Borgo; David Garcia,25,0,25,0
1681906022652,PHIL 1,A00,182590,Staff,35,0,40,5
1681906023683,PHIL 10,A01,182596,Grush; Rick Scott,31,0,35,4
1681906023683,PHIL 10,A02,182597,Grush; Rick Scott,34,0,35,1
1681906024712,PHIL 15,A01,182601,Staff,31,0,35,4
1681906024712,PHIL 15,A02,182602,Staff,33,0,35,2
1681906025737,PHIL 27,A01,182604,Staff,30,0,35,5
1681906025737,PHIL 27,A02,182607,Staff,35,0,35,0
1681906026785,PHIL 32,A01,182609,Staff,35,0,35,0
1681906026785,PHIL 32,A02,182612,Staff,35,0,35,0
1681906027815,PHIL 130,A00,182614,Staff,63,0,70,7
1681906028854,PHIL 136,A00,182616,Cohen; Jonathan David,66,0,70,4
1681906029879,PHIL 155,A00,182617,Vargas; Manuel Rogelio,60,0,70,10
1681906030904,PHIL 163,A01,182620,Staff,15,0,20,5
1681906030904,PHIL 163,A02,182624,Staff,10,0,20,10
1681906031932,PHIL 164,A00,182627,Staff,30,0,40,10
1681906032971,PHIL 173,A00,182628,Staff,36,0,40,4
1681906033997,PHYS 1A,A00,183221,Staff,54,0,60,6
1681906035022,PHYS 1AL,001,183222,Staff,25,0,30,5
1681906035022,PHYS 1AL,002,183223,Staff,28,0,30,2
1681906036064,PHYS 1B,A00,183231,Staff,44,0,60,16
1681906037089,PHYS 1BL,001,183232,Staff,20,0,30,10
1681906037089,PHYS 1BL,002,183233,Staff,29,0,30,1
1681906038123,PHYS 1C,A00,183240,Staff,30,0,60,30
1681906039148,PHYS 1CL,001,183241,Staff,13,0,30,17
1681906039148,PHYS 1CL,002,183242,Staff,22,0,30,8
1681906040176,PHYS 2AR,A01,183250,Staff,44,0,50,6
1681906041201,PHYS 2B,A01,183252,Staff,106,0,115,9
1681906042227,PHYS 2BL,A01,183254,Staff,21,0,24,3
1681906042227,PHYS 2BL,A02,183255,Staff,22,0,24,2
1681906043252,PHYS 2C,A01,183522,Staff,105,0,115,10
1681906044282,PHYS 4A,A01,183524,Staff,49,0,50,1
1681906045311,POLI 5,A00,183525,Staff,44,0,50,6
1681906046344,POLI 12,A00,183540,Staff,48,0,50,2
1681906047376,POLI 13R,A00,183541,Forman; Fonna,42,0,50,8
1681906048412,POLI 30,A00,183542,Mignozzetti; Umberto,47,0,50,3
1681906049437,POLI 100A,A00,183543,Staff,45,0,50,5
1681906050462,POLI 100E,A00,223598,Staff,32,0,35,3
1681906051487,POLI 103A,A00,183564,Kousser; Thad,38,0,50,12
1681906052530,POLI 104B,A00,201329,Staff,29,0,35,6
1681906053561,POLI 113BR,A00,183576,Hoston; Germaine,28,0,50,22
1681906054591,POLI 114BR,A00,183588,Staff,27,0,30,3
1681906055614,POLI 117R,A00,183595,Forman; Fonna,9,0,20,11
1681906056641,POLI 120H,A00,183596,Fisk; David Lee,13,0,20,7
1681906057672,POLI 130AA,A00,183597,Staff,14,0,20,6
1681906058706,POLI 134AA,A00,183598,Staff,19,0,20,1
1681906059739,POLI 135,A00,183599,Fisk; David Lee,20,0,25,5
1681906060774,POLI 142P,A00,183623,Staff,37,0,40,3
1681906061801,POLI 144D,A00,183624,Staff,22,0,25,3
1681906062838,POLI 151,A00,183625,Staff,15,0,20,5
1681906063875,POLI 162,A00,183626,Mignozzetti; Umberto,18,0,20,2
1681906064904,PSYC 1,A00,253748,Staff,86,0,90,4
1681906065932,PSYC 2,A00,183627,Moranton; Nirelia Melbina-,25,0,35,10
1681906066960,PSYC 3,A00,183628,Staff,43,0,45,2
1681906069010,PSYC 60,A01,183631,Lowe; Angela Beth,35,0,40,5
1681906070033,PSYC 70,A01,253757,Staff,37,0,45,8
1681906071064,PSYC 101,A00,183632,Heyman; Gail D.,48,0,60,12
1681906072089,PSYC 105,A00,183848,Lowe; Angela Beth,50,0,60,10
1681906073114,PSYC 106,A00,183849,Dobkins; Karen R.,45,0,60,15
1681906074149,PSYC 108,A00,253750,Staff,24,0,60,36
1681906075179,PSYC 114,A01,184275,Winkielman; Piotr,0,6,30,30
1681906076209,PSYC 122,A00,183856,Moranton; Nirelia Melbina-,0,10,30,30
1681906077232,PSYC 124,A00,183865,Chapman; Eddie Nathaniel,52,0,80,28
1681906078258,PSYC 137,A00,183880,Staff,19,0,25,6
1681906080307,PSYC 154,A00,183910,Lacefield; Katharine I,0,2,90,90
1681906082354,PSYC 162,A00,183946,Wixted; John T,61,0,90,29
1681906083388,PSYC 172,A00,183947,Gorman; Michael R.,14,0,30,16
1681906084412,PSYC 178,A00,183963,Glaser; Dale,20,0,40,20
1681906085436,PSYC 181GS,A00,183964,Anagnostaras; Stephan,10,0,10,0
1681906086461,PSYC 186GS,A01,257660,Staff,10,0,10,0
1681906087484,PSYC 193,B00,253749,Staff,23,0,25,2
1681906089537,PSYC 193L,A01,184122,Staff,33,0,35,2
1681906089537,PSYC 193L,C01,184167,Winkielman; Piotr,16,0,30,14
1681906090642,RELI 188GS,A00,182629,Rahimi; Babak,20,0,20,0
1681906091678,SE 101A,A00,182646,Staff,26,0,30,4
1681906092710,SE 101C,A00,182650,Staff,18,0,20,2
1681906093734,SE 110A,A00,182651,Staff,28,0,28,0
1681906094758,SE 130A,A00,182652,Staff,39,0,40,1
1681906095782,SIO 46GS,A00,182636,Cook; Geoffrey W,28,0,28,0
1681906096809,SIO 109R,A00,194459,Staff,5,0,20,15
1681906097838,SIO 121GS,A00,182639,Cook; Geoffrey W,28,0,28,0
1681906098864,SIO 132,A01,182642,Staff,32,0,40,8
1681906099893,SIO 139,A00,182644,Kacev; David,36,0,40,4
1681906100921,SOCI 2,A01,258404,Staff,34,0,36,2
1681906100921,SOCI 2,A02,258405,Staff,35,0,36,1
1681906101950,SOCI 60,A01,258408,Staff,29,0,30,1
1681906101950,SOCI 60,A02,258413,Staff,30,0,30,0
1681906102978,SOCI 100,A01,258415,Staff,29,0,30,1
1681906102978,SOCI 100,A02,258416,Staff,28,0,30,2
1681906109150,SOCI 127,A00,258421,Staff,22,0,30,8
1681906110177,SOCI 132,A00,258422,Staff,45,0,50,5
1681906111203,SOCI 133,A00,258423,Staff,26,0,30,4
1681906112228,SOCI 138GS,A00,258424,Staff,15,0,15,0
1681906113253,SOCI 145,A00,258425,Staff,25,0,30,5
1681906114287,SOCI 148,A00,258426,Staff,26,0,30,4
1681906115319,SOCI 153,A00,199217,Staff,29,0,30,1
1681906116344,SOCI 160,A00,258427,Staff,28,0,30,2
1681906117373,SOCI 160E,A00,258435,Staff,56,0,60,4
1681906118400,SOCI 189GS,A00,258436,Staff,15,0,15,0
1681906119427,SOCI 190GS,A00,258437,Staff,15,0,15,0
1681906120451,SYN 2,001,182658,Staff,9,0,16,7
1681906120451,SYN 2,002,201439,Staff,15,0,16,1
1681906120451,SYN 2,003,201443,Staff,16,0,16,0
1681906121474,SYN 100,A01,182657,Staff,17,0,20,3
1681906122499,TDAC 1,A00,184381,Salovey; Todd,16,0,20,4
1681906122499,TDAC 1,B00,184385,Harting; Carla Kelso,19,0,20,1
1681906122499,TDAC 1,C00,184394,Staff,19,0,20,1
1681906123528,TDAC 101,A00,184483,Harting; Carla Kelso,19,0,20,1
1681906124552,TDDE 111,A00,184496,Staff,14,0,15,1
1681906125576,TDDE 131,A00,184504,Staff,20,0,20,0
1681906125576,TDDE 131,B00,184505,Staff,17,0,18,1
1681906125576,TDDE 131,C00,184534,Staff,49,0,50,1
1681906125576,TDDE 131,D00,184564,Staff,15,0,15,0
1681906125576,TDDE 131,E00,204725,Staff,19,0,20,1
1681906126606,TDGE 1,A01,184414,Salovey; Todd,37,0,50,13
1681906127630,TDGE 5,A01,184419,Staff,23,0,24,1
1681906128660,TDGE 10,A00,184428,Fulton; Julia,31,0,50,19
1681906129686,TDGE 124,A00,184565,Fulton; Julia,7,0,50,43
1681906130713,TDGE 125,B00,184567,Meyer; Ursula,9,0,25,16
1681906131741,TDHT 101,A00,184568,Staff,21,0,25,4
1681906131741,TDHT 101,B00,184569,Staff,20,0,20,0
1681906132768,TDHT 114,A00,184570,Staff,49,0,50,1
1681906133791,TDMV 1,A00,184437,Arcidiacono; Kristin,23,0,30,7
1681906133791,TDMV 1,B00,184448,Caligagan; Maria T.,22,0,30,8
1681906134820,TDMV 2,A00,184449,Weinberg; Sadie,27,0,30,3
1681906134820,TDMV 2,B00,184453,Arcidiacono; Kristin,29,0,30,1
1681906135842,TDMV 110,A00,184571,Weinberg; Sadie,30,0,30,0
1681906136869,TDMV 142,A00,184572,Caligagan; Tony,27,0,30,3
1681906136869,TDMV 142,B00,184573,Caligagan; Maria T.,27,0,30,3
1681906137891,TDTR 20,A00,184482,Jun; Grace Shin Hae,25,0,25,0
1681906138919,USP 2,A01,184290,Hinds; Juli Beth,24,0,25,1
1681906139944,USP 3,A01,184295,Staff,20,0,25,5
1681906140974,USP 4,A00,184304,McTague; Sarah,15,0,25,10
1681906141998,USP 100,A00,184315,Staff,17,0,25,8
1681906143026,USP 105,A00,184326,Staff,21,0,25,4
1681906144051,USP 151,A00,184327,Staff,20,0,25,5
1681906145082,USP 170,A00,184380,Hinds; Juli Beth,14,0,25,11
1681906146109,VIS 21B,A01,182660,Staff,28,0,31,3
1681906146109,VIS 21B,A02,182662,Staff,30,0,31,1
1681906147140,VIS 103D,A00,182663,Staff,74,0,75,1
1681906148174,VIS 105D,A00,182667,Li; Huai,15,0,22,7
1681906149202,VIS 122GS,A00,182668,Herbst; Matthew,20,0,20,0
1681906150229,VIS 128C,A00,182673,Staff,70,0,75,5
1681906151253,VIS 130,A00,182675,Staff,20,0,22,2
1681906152281,VIS 160A,A00,182678,Stalbaum; Brett,4,0,10,6
1681906154342,WCWP 10B,A00,201679,Staff,15,0,15,0
1681906154342,WCWP 10B,B00,201695,Staff,15,0,15,0
1681906155458,WCWP 100,A00,201716,Staff,15,0,15,0
1681906155458,WCWP 100,B00,201717,Staff,11,0,15,4
1681906157623,ANSC 105GS,A00,258289,Staff,0,0,0,0
1681906158645,ANSC 125GS,A00,258295,Staff,0,0,0,0
1681906159669,ANSC 150,A00,258267,Staff,30,0,40,10
1681906160691,ANSC 190GS,A00,258280,Staff,0,0,0,0
1681906161715,ANTH 1,A00,258264,Staff,38,0,40,2
1681906162740,ANTH 2,A01,258259,Staff,72,0,76,4
1681906163774,ANTH 23,A01,258228,Staff,36,0,40,4
1681906164797,ANTH 101,A01,258236,Staff,39,0,40,1
1681906165824,ANTH 102,A00,258272,Staff,59,0,60,1
1681906166852,ANTH 105,A00,258244,Staff,31,0,35,4
1681906167875,BENG 130,A00,253975,Staff,38,0,40,2
1681906168907,BIBC 102,A01,191866,Flagg; Matthew Paul,19,0,32,13
1681906168907,BIBC 102,A02,191867,Flagg; Matthew Paul,22,0,32,10
1681906168907,BIBC 102,A03,191868,Flagg; Matthew Paul,30,0,32,2
1681906168907,BIBC 102,A04,191936,Flagg; Matthew Paul,26,0,32,6
1681906168907,BIBC 102,A05,191937,Flagg; Matthew Paul,11,0,32,21
1681906169933,BICD 100,A01,191939,Cooper; Andrew Michael,28,0,32,4
1681906169933,BICD 100,A02,191940,Cooper; Andrew Michael,32,0,32,0
1681906169933,BICD 100,A03,191941,Cooper; Andrew Michael,32,0,32,0
1681906169933,BICD 100,A04,191942,Cooper; Andrew Michael,32,0,32,0
1681906169933,BICD 100,A05,191943,Cooper; Andrew Michael,32,0,32,0
1681906170958,BIEB 126,A01,191945,Cleland; Elsa Eleanor,1,0,32,31
1681906170958,BIEB 126,A02,191946,Cleland; Elsa Eleanor,28,0,32,4
1681906170958,BIEB 126,A03,191947,Cleland; Elsa Eleanor,29,0,32,3
1681906170958,BIEB 126,A04,191948,Cleland; Elsa Eleanor,23,0,32,9
1681906170958,BIEB 126,A05,191996,Cleland; Elsa Eleanor,28,0,32,4
1681906171985,BIEB 136GS,A00,191997,Shurin; Jonathan & Holway; David A.,0,0,0,0
1681906173009,BIEB 137GS,A01,191999,Shurin; Jonathan & Holway; David A.,0,0,0,0
1681906174040,BILD 1,A01,205385,Staff,31,0,32,1
1681906174040,BILD 1,A02,205386,Staff,30,0,32,2
1681906174040,BILD 1,A03,205387,Staff,32,0,32,0
1681906174040,BILD 1,A04,205388,Staff,28,0,32,4
1681906175071,BILD 2,A01,191774,Staff,28,0,32,4
1681906175071,BILD 2,A02,191775,Staff,30,0,32,2
1681906175071,BILD 2,A03,191777,Staff,30,0,32,2
1681906175071,BILD 2,A04,191856,Staff,31,0,32,1
1681906175071,BILD 2,A05,191857,Staff,32,0,32,0
1681906175071,BILD 2,A06,191858,Staff,32,0,32,0
1681906175071,BILD 2,A07,191859,Staff,31,0,32,1
1681906176095,BILD 3,A01,205391,Staff,29,0,32,3
1681906176095,BILD 3,A02,205393,Staff,32,0,32,0
1681906176095,BILD 3,A03,205394,Staff,28,0,32,4
1681906176095,BILD 3,A04,205395,Staff,32,0,32,0
1681906177124,BILD 20,A01,191861,Staff,32,0,32,0
1681906177124,BILD 20,A02,191862,Staff,32,0,32,0
1681906178150,BILD 30,A01,191864,Staff,31,0,32,1
1681906179174,BIMM 100,A01,192019,Staff,0,0,32,32
1681906179174,BIMM 100,A02,192020,Staff,23,0,32,9
1681906179174,BIMM 100,A03,192035,Staff,22,0,32,10
1681906180200,BIMM 110,A01,192037,Tat; John,0,0,32,32
1681906180200,BIMM 110,A02,192038,Tat; John,10,0,32,22
1681906181224,BIMM 120,A01,192040,Pickett; Brooke Elizabeth,2,0,32,30
1681906181224,BIMM 120,A02,192041,Pickett; Brooke Elizabeth,16,0,32,16
1681906181224,BIMM 120,A03,192042,Pickett; Brooke Elizabeth,16,0,32,16
1681906182256,BIPN 100,A01,192044,Armour; Jon Christopher,26,0,32,6
1681906182256,BIPN 100,A02,192059,Armour; Jon Christopher,30,0,32,2
1681906182256,BIPN 100,A03,192064,Armour; Jon Christopher,31,0,32,1
1681906182256,BIPN 100,A04,192073,Armour; Jon Christopher,28,0,32,4
1681906183289,BIPN 148,A01,205411,Leutgeb; Jill K.,16,0,32,16
1681906183289,BIPN 148,A02,205412,Leutgeb; Jill K.,31,0,32,1
1681906183289,BIPN 148,A03,205413,Leutgeb; Jill K.,30,0,32,2
1681906183289,BIPN 148,A04,205414,Leutgeb; Jill K.,30,0,32,2
1681906184314,BIPN 160,A01,192115,Marino; Marc J,19,0,32,13
1681906184314,BIPN 160,A02,192148,Marino; Marc J,27,0,32,5
1681906184314,BIPN 160,A03,192158,Marino; Marc J,31,0,32,1
1681906184314,BIPN 160,A04,192190,Marino; Marc J,32,0,32,0
1681906184314,BIPN 160,A05,192287,Marino; Marc J,32,0,32,0
1681906184314,BIPN 160,A06,192288,Marino; Marc J,32,0,32,0
1681906185341,BIPN 194,A00,206038,Staff,28,0,32,4
1681906186366,BISP 194,A00,192289,Leutgeb; Stefan,13,0,32,19
1681906186366,BISP 194,B00,245332,Nieh; James Charles,27,0,32,5
1681906187389,CAT 124,A01,202247,Staff,15,0,15,0
1681906188414,CAT 125,A00,202248,Staff,19,0,20,1
1681906188414,CAT 125,B00,202253,Staff,20,0,20,0
1681906188414,CAT 125,C00,202257,Staff,19,0,20,1
1681906189444,CAT 125GS,A01,202273,Bronstein; Phoebe Malan,20,0,20,0
1681906190473,CAT 125R,A00,202284,Staff,17,0,20,3
1681906190473,CAT 125R,C00,202286,Staff,10,0,20,10
1681906190473,CAT 125R,D00,202291,Staff,18,0,20,2
1681906190473,CAT 125R,E00,202295,Staff,13,0,20,7
1681906190473,CAT 125R,F00,202302,Staff,12,0,20,8
1681906191499,CENG 100,A00,204724,Opatkiewicz; Justin Paul,25,0,25,0
1681906192523,CGS 2A,A01,180420,Staff,31,0,36,5
1681906193553,CGS 101,A00,180421,Staff,16,0,20,4
1681906194653,CGS 112,A00,180422,Staff,10,0,16,6
1681906195680,CGS 113,A00,180423,Staff,18,0,20,2
1681906196705,CGS 137,A00,180424,Staff,12,0,12,0
1681906197728,CGS 147,A00,180425,Staff,10,0,10,0
1681906198754,CHEM 6A,A01,179556,Staff,97,0,100,3
1681906198754,CHEM 6A,A02,179558,Staff,0,0,0,0
1681906199781,CHEM 6B,A01,179560,Staff,100,0,100,0
1681906200809,CHEM 6C,A01,179565,Jazzar; Rodolphe,95,0,100,5
1681906201834,CHEM 7L,A01,179586,Schurmeier; Kimberly,13,0,24,11
1681906201834,CHEM 7L,A02,179587,Schurmeier; Kimberly,23,0,24,1
1681906201834,CHEM 7L,A03,179590,Schurmeier; Kimberly,22,0,24,2
1681906201834,CHEM 7L,A04,179591,Schurmeier; Kimberly,22,0,24,2
1681906201834,CHEM 7L,B01,179598,Schurmeier; Kimberly,17,0,24,7
1681906201834,CHEM 7L,B02,179599,Schurmeier; Kimberly,24,0,24,0
1681906201834,CHEM 7L,B03,179606,Schurmeier; Kimberly,23,0,24,1
1681906201834,CHEM 7L,B04,179607,Schurmeier; Kimberly,23,0,24,1
1681906202879,CHEM 11,A01,179609,Stallings; Dontarie M,88,0,100,12
1681906203917,CHEM 40A,A01,179621,Staff,41,0,50,9
1681906203917,CHEM 40A,A02,179622,Staff,47,0,50,3
1681906204942,CHEM 40B,A01,179630,Weizman; Haim,48,0,50,2
1681906204942,CHEM 40B,A02,179631,Weizman; Haim,45,0,50,5
1681906205982,CHEM 41A,A01,179660,Klosterman; Jeremy K,93,0,100,7
1681906207014,CHEM 43A,A01,179683,Klosterman; Jeremy K,0,0,24,24
1681906207014,CHEM 43A,A02,179688,Klosterman; Jeremy K,14,0,24,10
1681906207014,CHEM 43A,A03,179689,Klosterman; Jeremy K,20,0,24,4
1681906207014,CHEM 43A,A04,179691,Klosterman; Jeremy K,18,0,24,6
1681906208049,CHEM 114A,A01,179693,Stallings; Dontarie M,77,0,100,23
1681906209081,CHEM 143B,A01,179698,Weizman; Haim,17,0,24,7
1681906209081,CHEM 143B,A02,179700,Weizman; Haim,24,0,24,0
1681906210103,CHIN 169A,A00,179701,Wang; Xiao,20,0,20,0
1681906211138,COGS 2,A01,179750,Boyle; Mary E. T.,17,0,30,13
1681906212163,COGS 9,A01,179759,Jones; Cameron Robert,43,0,50,7
1681906213188,COGS 14A,A01,179854,Staff,18,0,50,32
1681906214214,COGS 14B,A01,179856,Staff,54,0,60,6
1681906215239,COGS 17,A01,179874,Staff,71,0,75,4
1681906216263,COGS 18,A01,179884,Staff,63,0,80,17
1681906217287,COGS 100,A01,179886,Staff,40,0,60,20
1681906218312,COGS 101B,A01,179892,Staff,1,0,30,29
1681906219336,COGS 101C,A01,179894,Staff,28,0,30,2
1681906220360,COGS 107A,A01,179896,Boyle; Mary E. T.,31,0,40,9
1681906221384,COGS 108,A01,179898,Simpkins; Charles Alexander,0,17,60,60
1681906222409,COGS 109,A01,179900,Staff,34,0,40,6
1681906223433,COGS 118A,A01,179946,Staff,9,0,40,31
1681906224456,COGS 153,A00,179978,Staff,1,0,30,29
1681906225488,COGS 156,A01,179981,Staff,27,0,30,3
1681906227536,COGS 172,A01,179987,Staff,13,0,30,17
1681906229589,COGS 186,A01,179991,Staff,13,0,30,17
1681906230617,COMM 10,A01,180001,Staff,15,0,25,10
1681906230617,COMM 10,A02,180004,Staff,20,0,25,5
1681906231643,COMM 100A,A01,180016,Staff,18,0,25,7
1681906231643,COMM 100A,A02,180020,Staff,24,0,25,1
1681906232677,COMM 101T,A00,180029,Halm; Gavin Patrick,23,0,35,12
1681906233708,COMM 106V,A00,180043,Staff,34,0,35,1
1681906234738,COMM 109P,A00,180044,Staff,31,0,35,4
1681906235769,COMM 113T,A00,180045,Havis; Allan,37,0,45,8
1681906236793,COMM 132,A00,180046,McKenna; Denise,23,0,30,7
1681906237821,COMM 143,A00,180047,Staff,19,0,30,11
1681906238849,COMM 190,A00,180048,Conner; Thomas Hartnell,20,0,23,3
1681906239885,CSE 8A,A50,180053,Cao; Yingjun,25,0,50,25
1681906239885,CSE 8A,B50,180180,Staff,50,0,50,0
1681906240913,CSE 11,A01,180190,Cao; Yingjun,31,0,50,19
1681906241943,CSE 20,A01,180192,Briones; Jor-el Thomas Caparas,23,0,30,7
1681906242974,CSE 21,A01,194538,Briones; Jor-el Thomas Caparas,50,0,60,10
1681906244000,CSE 30,A01,180324,Eldon; John,79,0,100,21
1681906245025,CSE 101,A01,201353,Staff,0,20,40,40
1681906246051,CSE 134B,A01,180326,Powell; Thomas Allan,74,0,100,26
1681906247079,CSE 140,A01,180328,Staff,46,0,75,29
1681906248105,CSE 140L,A01,180344,Eldon; John,69,0,100,31
1681906249135,CSE 150A,A01,180411,Staff,0,7,50,50
1681906250165,CSE 151A,A01,180414,Staff,0,6,50,50
1681906251199,CSE 175,A01,222521,Kumar; Rakesh,50,0,50,0
1681906252227,CSE 190,A00,201419,Staff,45,0,49,4
1681906253257,CSS 1,A01,194536,Staff,38,0,50,12
1681906254285,DSC 30,A01,202385,Staff,48,0,50,2
1681906255316,DSC 40A,A01,202387,Albuyeh; Rod,50,0,50,0
1681906256343,DSC 190,A01,202389,Silberman; Jack,21,0,21,0
1681906257365,DSGN 100,A01,179993,Staff,16,0,30,14
1681906258394,ECE 65,A50,180708,Staff,10,0,20,10
1681906258394,ECE 65,A51,180739,Staff,19,0,20,1
1681906259418,ECON 1,A01,180427,Famulari; Melissa,67,0,70,3
1681906260441,ECON 2,A01,180450,Levkoff; Steven B.,64,0,70,6
1681906261467,ECON 4,A01,203351,Anderson; John Charles,7,0,10,3
1681906262490,ECON 100A,A01,180472,Famulari; Melissa,65,0,70,5
1681906263516,ECON 120A,A01,180549,Staff,64,0,70,6
1681906264542,ECON 120B,A01,180655,Ma; Xinwei,46,0,70,24
1681906265565,ECON 129,A00,203333,Eckert; Fabian Paul,15,0,35,20
1681906266591,ECON 131,A00,180656,Staff,10,0,35,25
1681906267614,ECON 172B,A01,180672,Levkoff; Steven B.,32,0,35,3
1681906268637,ECON 178,A01,203342,Zhu; Ying,11,0,35,24
1681906269664,EDS 108GS,A00,202383,Wishard Guerra; Alison G.,20,0,20,0
1681906270696,EDS 111GS,A00,202347,Wishard Guerra; Alison G.,20,0,20,0
1681906271719,EDS 112,A01,202323,Staff,56,0,60,4
1681906272742,EDS 113,A00,202340,Staff,33,0,35,2
1681906273769,EDS 118,A00,201231,Staff,20,0,30,10
1681906274794,EDS 119,A00,204994,Staff,8,0,10,2
1681906275830,EDS 124BR,A00,202324,Eguchi; Emi,5,0,25,20
1681906276857,EDS 126,A01,203208,Jones; Makeba,26,0,30,4
1681906277882,EDS 135,A01,202333,Staff,18,0,20,2
1681906278909,EDS 180,A00,202311,Staff,47,0,50,3
1681906279940,ERC 190GS,A01,253747,Staff,28,0,28,0
1681906280965,ETHN 104,A00,180742,Staff,24,0,35,11
1681906281990,ETHN 118,A00,180745,Staff,28,0,35,7
1681906283018,ETHN 127,A00,180747,Staff,12,0,16,4
1681906284043,ETHN 137,A00,180880,Staff,12,0,12,0
1681906285070,ETHN 147,A00,180890,Staff,8,0,10,2
1681906286095,ETHN 154,A00,180891,Staff,7,0,8,1
1681906287124,ETHN 168,A00,180892,Staff,9,0,10,1
1681906288154,GLBH 20,A00,201051,Hannah; Seth Donal,0,1,0,1
1681906289190,GLBH 111,A01,209338,Burgos; Jose L.,0,0,0,0
1681906290214,GLBH 150,A00,258300,Staff,0,3,0,0
1681906291239,GLBH 181,A00,201207,Staff,15,0,40,25
1681906292266,HIEU 109,A00,180898,Staff,20,0,20,0
1681906293289,HIEU 111,A00,180899,Staff,1,0,20,19
1681906294318,HIEU 124,A00,180900,Staff,18,0,20,2
1681906295342,HILA 122,A00,180901,Staff,18,0,20,2
1681906296366,HILA 132,A00,180902,Vitz; Matthew,2,0,20,18
1681906297390,HILD 10,A01,180896,Staff,15,0,20,5
1681906298489,HILD 30GS,A00,180897,Edington; Claire Ellen,0,0,0,0
1681906299525,HISC 105,A00,180903,Staff,20,0,20,0
1681906300550,HISC 117,A00,180904,Staff,11,0,20,9
1681906301574,HIUS 108B,A00,181005,Staff,18,0,20,2
1681906302598,HIUS 113,A00,181093,Staff,4,0,20,16
1681906303624,HUM 3,A01,181190,Patterson; Patrick H.,40,0,50,10
1681906303624,HUM 3,B01,181195,Staff,47,0,50,3
1681906304657,HUM 3GS,A00,181196,Herbst; Matthew,0,0,0,0
1681906305686,HUM 4,A01,181227,West; Geoffrey Scott,34,0,50,16
1681906305686,HUM 4,B01,181282,Staff,43,0,50,7
1681906306709,HUM 4GS,A00,181377,Lyon; Antony J.,0,0,0,0
1681906307733,HUM 5,A01,181536,Zavodny; Tatiana Sophia,31,0,50,19
1681906307733,HUM 5,B01,181908,Staff,36,0,50,14
1681906308762,INTL 190,A00,181909,Segui; Alan S,0,0,0,6
1681906308762,INTL 190,B00,181961,Segui; Alan S,0,0,0,7
1681906309794,JAPN 20AR,A01,182113,Ross; Kayoko F,15,0,20,5
1681906310819,LATI 50,A01,202391,Martin-Cabrera; Luis,19,0,30,11
1681906310819,LATI 50,A02,202392,Martin-Cabrera; Luis,26,0,30,4
1681906311843,LATI 180,A00,202393,Kokinis; Troy Andreas,25,0,25,0
1681906312870,LIFR 1A,A00,182119,Staff,14,0,14,0
1681906313897,LIFR 1AX,A00,182324,Staff,14,0,14,0
1681906314944,LIFR 1B,A00,182259,Staff,14,0,14,0
1681906315974,LIFR 1BX,A00,182273,Staff,14,0,14,0
1681906316997,LIGN 8,A00,182330,Staff,137,0,150,13
1681906318023,LIGN 9GS,A00,182362,Staff,20,0,20,0
1681906319052,LIGN 119,A00,204992,Takahashi; Maho,12,0,15,3
1681906320078,LIGN 130,A01,182384,Staff,47,0,50,3
1681906321102,LIGN 149GS,A00,182390,Staff,20,0,20,0
1681906322130,LIGN 170,A00,182404,Staff,24,0,30,6
1681906323171,LISP 1D,A00,182281,Staff,7,0,14,7
1681906323171,LISP 1D,B00,182287,Staff,14,0,14,0
1681906323171,LISP 1D,C00,182295,Staff,11,0,14,3
1681906323171,LISP 1D,D00,182301,Staff,14,0,14,0
1681906324200,LISP 1DX,A00,182309,Staff,20,0,28,8
1681906324200,LISP 1DX,B00,182316,Staff,26,0,28,2
1681906325229,LTAF 120GS,A00,182412,Zhiri; Oumelbanine,20,0,20,0
1681906326254,LTCS 172GS,A00,182437,Bronstein; Phoebe Malan,20,0,20,0
1681906327290,LTEA 138,A00,182457,Staff,22,0,40,18
1681906328316,LTEN 114,A01,182490,Staff,23,0,25,2
1681906329344,LTEN 130GS,A00,182491,Lyon; Antony J.,20,0,20,0
1681906330373,LTEN 169,A00,182493,Cuong; Marisol,20,0,25,5
1681906331401,LTEN 178,A00,182501,Staff,14,0,15,1
1681906332430,LTEN 181,A00,182515,Staff,22,0,25,3
1681906333469,LTEN 185GS,A00,197655,Forbes; Camille,20,0,20,0
1681906334498,LTSP 100B,A00,202208,Bessett; Ryan Matthew,24,0,25,1
1681906335527,LTWL 100,A00,182516,Myerston Santana; Jacobo,23,0,30,7
1681906336556,LTWR 100GS,A00,182518,Forbes; Camille,20,0,20,0
1681906337578,LTWR 102,A00,182522,Staff,15,0,15,0
1681906337578,LTWR 102,B00,182525,Staff,14,0,15,1
1681906338609,LTWR 115,A00,182526,Staff,12,0,15,3
1681906339635,MAE 8,A01,182528,Pham; Hieu Tan,68,0,70,2
1681906340661,MAE 11,A00,182529,Bahadori; Mohammad Yousef,94,0,100,6
1681906341685,MAE 20,A00,182530,Evdokimenko; Ekaterina,68,0,70,2
1681906342708,MAE 30A,A00,182532,Staff,44,0,45,1
1681906343735,MAE 101A,A00,182533,Bahadori; Mohammad Yousef,97,0,100,3
1681906344764,MAE 101C,A00,182538,Staff,62,0,70,8
1681906345792,MAE 104,A00,182539,Staff,45,0,50,5
1681906346823,MAE 131A,A00,182540,Ghazinejad; Maziar,41,0,45,4
1681906347849,MAE 143A,A00,182548,Bewley; Thomas R,43,0,50,7
1681906348873,MAE 150,A00,182549,Staff,28,0,40,12
1681906349912,MAE 160,A00,182550,Evdokimenko; Ekaterina,43,0,60,17
1681906350948,MATH 3C,A01,182725,Staff,27,0,30,3
1681906351976,MATH 10A,A01,182729,Staff,25,0,30,5
1681906351976,MATH 10A,B01,182732,Staff,26,0,30,4
1681906353003,MATH 10B,A01,182737,Staff,21,0,30,9
1681906353003,MATH 10B,A02,182738,Staff,27,0,30,3
1681906353003,MATH 10B,B01,182744,Staff,27,0,30,3
1681906353003,MATH 10B,B02,182745,Staff,27,0,30,3
1681906354035,MATH 18,A01,182750,Anzaldo; Leesa B,28,0,30,2
1681906354035,MATH 18,A02,182751,Anzaldo; Leesa B,29,0,30,1
1681906354035,MATH 18,A03,182753,Anzaldo; Leesa B,28,0,30,2
1681906354035,MATH 18,A04,182757,Anzaldo; Leesa B,29,0,30,1
1681906354035,MATH 18,B01,182761,Anzaldo; Leesa B,27,0,30,3
1681906354035,MATH 18,B02,182764,Anzaldo; Leesa B,27,0,30,3
1681906354035,MATH 18,B03,182765,Anzaldo; Leesa B,30,0,30,0
1681906354035,MATH 18,B04,182766,Anzaldo; Leesa B,30,0,30,0
1681906355059,MATH 20A,A01,182771,Suk; Andrew Hoon,28,0,30,2
1681906356084,MATH 20B,A01,182775,Bach; Quang Tran,30,0,30,0
1681906356084,MATH 20B,A02,182777,Bach; Quang Tran,29,0,30,1
1681906356084,MATH 20B,B01,182780,Bach; Quang Tran,27,0,30,3
1681906356084,MATH 20B,B02,182782,Bach; Quang Tran,30,0,30,0
1681906357116,MATH 20C,A01,182787,Staff,25,0,30,5
1681906357116,MATH 20C,A02,182790,Staff,29,0,30,1
1681906357116,MATH 20C,B01,182792,Staff,25,0,30,5
1681906357116,MATH 20C,B02,182796,Staff,27,0,30,3
1681906358145,MATH 20D,A01,182799,Staff,29,0,30,1
1681906358145,MATH 20D,A02,182802,Staff,30,0,30,0
1681906358145,MATH 20D,A03,182803,Staff,30,0,30,0
1681906359176,MATH 20E,A01,182809,Verstraete; Jacques Allan,24,0,30,6
1681906359176,MATH 20E,A02,182811,Verstraete; Jacques Allan,28,0,30,2
1681906359176,MATH 20E,B01,182814,Verstraete; Jacques Allan,23,0,30,7
1681906359176,MATH 20E,B02,182815,Verstraete; Jacques Allan,30,0,30,0
1681906360205,MATH 103A,A01,182820,Staff,9,0,30,21
1681906360205,MATH 103A,A02,182821,Staff,27,0,30,3
1681906360205,MATH 103A,A03,182822,Staff,23,0,30,7
1681906360205,MATH 103A,B01,182825,Staff,23,0,30,7
1681906360205,MATH 103A,B02,182826,Staff,30,0,30,0
1681906360205,MATH 103A,B03,182830,Staff,30,0,30,0
1681906361238,MATH 109,A01,182836,Chow; Bennett,24,0,30,6
1681906361238,MATH 109,A02,182838,Chow; Bennett,29,0,30,1
1681906361238,MATH 109,A03,182894,Chow; Bennett,29,0,30,1
1681906361238,MATH 109,B01,182908,Chow; Bennett,28,0,30,2
1681906361238,MATH 109,B02,182909,Chow; Bennett,30,0,30,0
1681906361238,MATH 109,B03,182910,Chow; Bennett,27,0,30,3
1681906362271,MATH 142A,A01,182925,Staff,11,0,30,19
1681906362271,MATH 142A,A02,182935,Staff,25,0,30,5
1681906362271,MATH 142A,A03,182967,Staff,26,0,30,4
1681906362271,MATH 142A,B01,183125,Staff,24,0,30,6
1681906362271,MATH 142A,B02,183157,Staff,28,0,30,2
1681906362271,MATH 142A,B03,183158,Staff,29,0,30,1
1681906363296,MATH 183,A01,183160,Arias-Castro; Ery,23,0,30,7
1681906363296,MATH 183,A02,183161,Arias-Castro; Ery,29,0,30,1
1681906363296,MATH 183,B01,183163,Arias-Castro; Ery,28,0,30,2
1681906363296,MATH 183,B02,183164,Arias-Castro; Ery,28,0,30,2
1681906364325,MATH 193A,A01,183167,Staff,4,0,35,31
1681906364325,MATH 193A,A02,183168,Staff,28,0,35,7
1681906364325,MATH 193A,A03,183169,Staff,34,0,35,1
1681906364325,MATH 193A,A04,183170,Staff,28,0,35,7
1681906365351,MGT 4,A01,202395,Anderson; John Charles,75,0,80,5
1681906366375,MGT 5,A00,202396,Houskeeper; Robert,80,0,90,10
1681906367409,MGT 103,A00,202397,Eberhard; Craig A,55,0,90,35
1681906368434,MGT 131A,A00,202398,Houskeeper; Robert,85,0,90,5
1681906369459,MGT 135,A00,202399,Anderson; John Charles,83,0,90,7
1681906370486,MGT 162R,A00,202403,Gneezy; Uri,150,0,200,50
1681906371515,MGT 172,A00,202404,Hedges; Kathleen,50,0,90,40
1681906372555,MGT 181,A00,202405,Dunn; Louis Jean,84,0,90,6
1681906373580,MMW 14,A01,183200,Staff,16,0,28,12
1681906373580,MMW 14,A02,183201,Staff,26,0,28,2
1681906373580,MMW 14,A03,183202,Staff,24,0,28,4
1681906373580,MMW 14,A04,183203,Staff,25,0,28,3
1681906373580,MMW 14,A05,183204,Staff,26,0,28,2
1681906373580,MMW 14,A06,183205,Staff,27,0,28,1
1681906373580,MMW 14,B01,183207,Staff,26,0,28,2
1681906373580,MMW 14,B02,183208,Staff,28,0,28,0
1681906373580,MMW 14,B03,183209,Staff,28,0,28,0
1681906373580,MMW 14,B04,183210,Staff,28,0,28,0
1681906373580,MMW 14,B05,183211,Staff,28,0,28,0
1681906373580,MMW 14,B06,183212,Staff,28,0,28,0
1681906374615,MMW 14GS,A00,183213,Zhiri; Oumelbanine,28,0,28,0
1681906375648,MMW 15GS,B00,183215,Rahimi; Babak,28,0,28,0
1681906376673,MMW 121,A01,183217,Patterson; Patrick H.,14,0,28,14
1681906376673,MMW 121,A02,183218,Patterson; Patrick H.,25,0,28,3
1681906377699,MUS 1A,A01,182554,Staff,8,0,35,27
1681906378724,MUS 5,A01,182558,Staff,20,0,35,15
1681906379748,MUS 6,A01,182562,Staff,25,0,35,10
1681906380774,MUS 8GS,A00,182563,Borgo; David Garcia,25,0,25,0
1681906381799,MUS 13,A01,182567,Staff,24,0,25,1
1681906382824,MUS 15,A01,182570,Staff,32,0,35,3
1681906382824,MUS 15,B01,182575,Staff,10,0,35,25
1681906383852,MUS 80,A00,182578,Staff,23,0,25,2
1681906383852,MUS 80,B00,182581,Staff,20,0,25,5
1681906384877,MUS 113,A00,182582,Staff,25,0,25,0
1681906385905,MUS 114,A00,182583,Staff,4,0,25,21
1681906386930,MUS 150GS,A01,182588,Borgo; David Garcia,25,0,25,0
1681906387954,PHIL 1,A00,182590,Staff,35,0,40,5
1681906388985,PHIL 10,A01,182596,Grush; Rick Scott,31,0,35,4
1681906388985,PHIL 10,A02,182597,Grush; Rick Scott,34,0,35,1
1681906390011,PHIL 15,A01,182601,Staff,31,0,35,4
1681906390011,PHIL 15,A02,182602,Staff,33,0,35,2
1681906391036,PHIL 27,A01,182604,Staff,30,0,35,5
1681906391036,PHIL 27,A02,182607,Staff,35,0,35,0
1681906392066,PHIL 32,A01,182609,Staff,35,0,35,0
1681906392066,PHIL 32,A02,182612,Staff,35,0,35,0
1681906393104,PHIL 130,A00,182614,Staff,63,0,70,7
1681906394132,PHIL 136,A00,182616,Cohen; Jonathan David,66,0,70,4
1681906395160,PHIL 155,A00,182617,Vargas; Manuel Rogelio,60,0,70,10
1681906396185,PHIL 163,A01,182620,Staff,15,0,20,5
1681906396185,PHIL 163,A02,182624,Staff,10,0,20,10
1681906397210,PHIL 164,A00,182627,Staff,30,0,40,10
1681906398240,PHIL 173,A00,182628,Staff,36,0,40,4
1681906399267,PHYS 1A,A00,183221,Staff,54,0,60,6
1681906400295,PHYS 1AL,001,183222,Staff,25,0,30,5
1681906400295,PHYS 1AL,002,183223,Staff,28,0,30,2
1681906401319,PHYS 1B,A00,183231,Staff,44,0,60,16
1681906402437,PHYS 1BL,001,183232,Staff,20,0,30,10
1681906402437,PHYS 1BL,002,183233,Staff,29,0,30,1
1681906403470,PHYS 1C,A00,183240,Staff,30,0,60,30
1681906404492,PHYS 1CL,001,183241,Staff,13,0,30,17
1681906404492,PHYS 1CL,002,183242,Staff,22,0,30,8
1681906405516,PHYS 2AR,A01,183250,Staff,44,0,50,6
1681906406540,PHYS 2B,A01,183252,Staff,106,0,115,9
1681906407575,PHYS 2BL,A01,183254,Staff,21,0,24,3
1681906407575,PHYS 2BL,A02,183255,Staff,22,0,24,2
1681906408613,PHYS 2C,A01,183522,Staff,105,0,115,10
1681906409637,PHYS 4A,A01,183524,Staff,49,0,50,1
1681906410662,POLI 5,A00,183525,Staff,44,0,50,6
1681906411690,POLI 12,A00,183540,Staff,48,0,50,2
1681906412718,POLI 13R,A00,183541,Forman; Fonna,42,0,50,8
1681906413743,POLI 30,A00,183542,Mignozzetti; Umberto,47,0,50,3
1681906414767,POLI 100A,A00,183543,Staff,45,0,50,5
1681906415799,POLI 100E,A00,223598,Staff,32,0,35,3
1681906416826,POLI 103A,A00,183564,Kousser; Thad,38,0,50,12
1681906417849,POLI 104B,A00,201329,Staff,29,0,35,6
1681906418876,POLI 113BR,A00,183576,Hoston; Germaine,28,0,50,22
1681906419901,POLI 114BR,A00,183588,Staff,27,0,30,3
1681906420928,POLI 117R,A00,183595,Forman; Fonna,9,0,20,11
1681906421959,POLI 120H,A00,183596,Fisk; David Lee,13,0,20,7
1681906422991,POLI 130AA,A00,183597,Staff,14,0,20,6
1681906424016,POLI 134AA,A00,183598,Staff,19,0,20,1
1681906425040,POLI 135,A00,183599,Fisk; David Lee,20,0,25,5
1681906426069,POLI 142P,A00,183623,Staff,37,0,40,3
1681906427093,POLI 144D,A00,183624,Staff,22,0,25,3
1681906428120,POLI 151,A00,183625,Staff,15,0,20,5
1681906429143,POLI 162,A00,183626,Mignozzetti; Umberto,18,0,20,2
1681906430169,PSYC 1,A00,253748,Staff,86,0,90,4
1681906431199,PSYC 2,A00,183627,Moranton; Nirelia Melbina-,25,0,35,10
1681906432227,PSYC 3,A00,183628,Staff,43,0,45,2
1681906434296,PSYC 60,A01,183631,Lowe; Angela Beth,35,0,40,5
1681906435323,PSYC 70,A01,253757,Staff,37,0,45,8
1681906436351,PSYC 101,A00,183632,Heyman; Gail D.,48,0,60,12
1681906437377,PSYC 105,A00,183848,Lowe; Angela Beth,50,0,60,10
1681906438405,PSYC 106,A00,183849,Dobkins; Karen R.,45,0,60,15
1681906439432,PSYC 108,A00,253750,Staff,24,0,60,36
1681906440459,PSYC 114,A01,184275,Winkielman; Piotr,0,6,30,30
1681906441484,PSYC 122,A00,183856,Moranton; Nirelia Melbina-,0,10,30,30
1681906442514,PSYC 124,A00,183865,Chapman; Eddie Nathaniel,52,0,80,28
1681906443551,PSYC 137,A00,183880,Staff,19,0,25,6
1681906445602,PSYC 154,A00,183910,Lacefield; Katharine I,0,2,90,90
1681906447647,PSYC 162,A00,183946,Wixted; John T,61,0,90,29
1681906448672,PSYC 172,A00,183947,Gorman; Michael R.,14,0,30,16
1681906449697,PSYC 178,A00,183963,Glaser; Dale,20,0,40,20
1681906450723,PSYC 181GS,A00,183964,Anagnostaras; Stephan,10,0,10,0
1681906451746,PSYC 186GS,A01,257660,Staff,10,0,10,0
1681906452773,PSYC 193,B00,253749,Staff,23,0,25,2
1681906455033,PSYC 193L,A01,184122,Staff,33,0,35,2
1681906455033,PSYC 193L,C01,184167,Winkielman; Piotr,16,0,30,14
1681906456060,RELI 188GS,A00,182629,Rahimi; Babak,20,0,20,0
1681906457088,SE 101A,A00,182646,Staff,26,0,30,4
1681906458113,SE 101C,A00,182650,Staff,18,0,20,2
1681906459138,SE 110A,A00,182651,Staff,28,0,28,0
1681906460163,SE 130A,A00,182652,Staff,39,0,40,1
1681906461188,SIO 46GS,A00,182636,Cook; Geoffrey W,28,0,28,0
1681906462217,SIO 109R,A00,194459,Staff,5,0,20,15
1681906463245,SIO 121GS,A00,182639,Cook; Geoffrey W,28,0,28,0
1681906464270,SIO 132,A01,182642,Staff,32,0,40,8
1681906465301,SIO 139,A00,182644,Kacev; David,36,0,40,4
1681906466330,SOCI 2,A01,258404,Staff,34,0,36,2
1681906466330,SOCI 2,A02,258405,Staff,35,0,36,1
1681906467353,SOCI 60,A01,258408,Staff,29,0,30,1
1681906467353,SOCI 60,A02,258413,Staff,30,0,30,0
1681906468382,SOCI 100,A01,258415,Staff,29,0,30,1
1681906468382,SOCI 100,A02,258416,Staff,28,0,30,2
1681906474546,SOCI 127,A00,258421,Staff,22,0,30,8
1681906475578,SOCI 132,A00,258422,Staff,45,0,50,5
1681906476608,SOCI 133,A00,258423,Staff,26,0,30,4
1681906477637,SOCI 138GS,A00,258424,Staff,15,0,15,0
1681906478662,SOCI 145,A00,258425,Staff,25,0,30,5
1681906479686,SOCI 148,A00,258426,Staff,26,0,30,4
1681906480709,SOCI 153,A00,199217,Staff,29,0,30,1
1681906481731,SOCI 160,A00,258427,Staff,28,0,30,2
1681906482755,SOCI 160E,A00,258435,Staff,56,0,60,4
1681906483782,SOCI 189GS,A00,258436,Staff,15,0,15,0
1681906484810,SOCI 190GS,A00,258437,Staff,15,0,15,0
1681906485837,SYN 2,001,182658,Staff,9,0,16,7
1681906485837,SYN 2,002,201439,Staff,15,0,16,1
1681906485837,SYN 2,003,201443,Staff,16,0,16,0
1681906486866,SYN 100,A01,182657,Staff,17,0,20,3
1681906487890,TDAC 1,A00,184381,Salovey; Todd,16,0,20,4
1681906487890,TDAC 1,B00,184385,Harting; Carla Kelso,19,0,20,1
1681906487890,TDAC 1,C00,184394,Staff,19,0,20,1
1681906488920,TDAC 101,A00,184483,Harting; Carla Kelso,19,0,20,1
1681906489949,TDDE 111,A00,184496,Staff,14,0,15,1
1681906490974,TDDE 131,A00,184504,Staff,20,0,20,0
1681906490974,TDDE 131,B00,184505,Staff,17,0,18,1
1681906490974,TDDE 131,C00,184534,Staff,49,0,50,1
1681906490974,TDDE 131,D00,184564,Staff,15,0,15,0
1681906490974,TDDE 131,E00,204725,Staff,19,0,20,1
1681906491999,TDGE 1,A01,184414,Salovey; Todd,37,0,50,13
1681906493024,TDGE 5,A01,184419,Staff,23,0,24,1
1681906494047,TDGE 10,A00,184428,Fulton; Julia,31,0,50,19
1681906495074,TDGE 124,A00,184565,Fulton; Julia,7,0,50,43
1681906496099,TDGE 125,B00,184567,Meyer; Ursula,9,0,25,16
1681906497135,TDHT 101,A00,184568,Staff,21,0,25,4
1681906497135,TDHT 101,B00,184569,Staff,20,0,20,0
1681906498161,TDHT 114,A00,184570,Staff,49,0,50,1
1681906499189,TDMV 1,A00,184437,Arcidiacono; Kristin,23,0,30,7
1681906499189,TDMV 1,B00,184448,Caligagan; Maria T.,22,0,30,8
1681906500214,TDMV 2,A00,184449,Weinberg; Sadie,27,0,30,3
1681906500214,TDMV 2,B00,184453,Arcidiacono; Kristin,29,0,30,1
1681906501240,TDMV 110,A00,184571,Weinberg; Sadie,30,0,30,0
1681906502268,TDMV 142,A00,184572,Caligagan; Tony,27,0,30,3
1681906502268,TDMV 142,B00,184573,Caligagan; Maria T.,27,0,30,3
1681906503292,TDTR 20,A00,184482,Jun; Grace Shin Hae,25,0,25,0
1681906504328,USP 2,A01,184290,Hinds; Juli Beth,24,0,25,1
1681906505360,USP 3,A01,184295,Staff,20,0,25,5
1681906506475,USP 4,A00,184304,McTague; Sarah,15,0,25,10
1681906507505,USP 100,A00,184315,Staff,17,0,25,8
1681906508529,USP 105,A00,184326,Staff,21,0,25,4
1681906509555,USP 151,A00,184327,Staff,20,0,25,5
1681906510579,USP 170,A00,184380,Hinds; Juli Beth,14,0,25,11
1681906511607,VIS 21B,A01,182660,Staff,28,0,31,3
1681906511607,VIS 21B,A02,182662,Staff,30,0,31,1
1681906512632,VIS 103D,A00,182663,Staff,74,0,75,1
1681906513660,VIS 105D,A00,182667,Li; Huai,15,0,22,7
1681906514693,VIS 122GS,A00,182668,Herbst; Matthew,20,0,20,0
1681906515719,VIS 128C,A00,182673,Staff,70,0,75,5
1681906516742,VIS 130,A00,182675,Staff,20,0,22,2
1681906517769,VIS 160A,A00,182678,Stalbaum; Brett,4,0,10,6
1681906519819,WCWP 10B,A00,201679,Staff,15,0,15,0
1681906519819,WCWP 10B,B00,201695,Staff,15,0,15,0
1681906520845,WCWP 100,A00,201716,Staff,15,0,15,0
1681906520845,WCWP 100,B00,201717,Staff,11,0,15,4
1681906522962,ANSC 105GS,A00,258289,Staff,0,0,0,0
1681906523989,ANSC 125GS,A00,258295,Staff,0,0,0,0
1681906525017,ANSC 150,A00,258267,Staff,30,0,40,10
1681906526041,ANSC 190GS,A00,258280,Staff,0,0,0,0
1681906527065,ANTH 1,A00,258264,Staff,38,0,40,2
1681906528101,ANTH 2,A01,258259,Staff,72,0,76,4
1681906529141,ANTH 23,A01,258228,Staff,36,0,40,4
1681906530165,ANTH 101,A01,258236,Staff,39,0,40,1
1681906531193,ANTH 102,A00,258272,Staff,59,0,60,1
1681906532225,ANTH 105,A00,258244,Staff,31,0,35,4
1681906533253,BENG 130,A00,253975,Staff,38,0,40,2
1681906534284,BIBC 102,A01,191866,Flagg; Matthew Paul,19,0,32,13
1681906534284,BIBC 102,A02,191867,Flagg; Matthew Paul,22,0,32,10
1681906534284,BIBC 102,A03,191868,Flagg; Matthew Paul,30,0,32,2
1681906534284,BIBC 102,A04,191936,Flagg; Matthew Paul,26,0,32,6
1681906534284,BIBC 102,A05,191937,Flagg; Matthew Paul,11,0,32,21
1681906535313,BICD 100,A01,191939,Cooper; Andrew Michael,28,0,32,4
1681906535313,BICD 100,A02,191940,Cooper; Andrew Michael,32,0,32,0
1681906535313,BICD 100,A03,191941,Cooper; Andrew Michael,32,0,32,0
1681906535313,BICD 100,A04,191942,Cooper; Andrew Michael,32,0,32,0
1681906535313,BICD 100,A05,191943,Cooper; Andrew Michael,32,0,32,0
1681906536341,BIEB 126,A01,191945,Cleland; Elsa Eleanor,1,0,32,31
1681906536341,BIEB 126,A02,191946,Cleland; Elsa Eleanor,28,0,32,4
1681906536341,BIEB 126,A03,191947,Cleland; Elsa Eleanor,29,0,32,3
1681906536341,BIEB 126,A04,191948,Cleland; Elsa Eleanor,23,0,32,9
1681906536341,BIEB 126,A05,191996,Cleland; Elsa Eleanor,28,0,32,4
1681906537365,BIEB 136GS,A00,191997,Shurin; Jonathan & Holway; David A.,0,0,0,0
1681906538388,BIEB 137GS,A01,191999,Shurin; Jonathan & Holway; David A.,0,0,0,0
1681906539415,BILD 1,A01,205385,Staff,31,0,32,1
1681906539415,BILD 1,A02,205386,Staff,30,0,32,2
1681906539415,BILD 1,A03,205387,Staff,32,0,32,0
1681906539415,BILD 1,A04,205388,Staff,28,0,32,4
1681906540446,BILD 2,A01,191774,Staff,28,0,32,4
1681906540446,BILD 2,A02,191775,Staff,30,0,32,2
1681906540446,BILD 2,A03,191777,Staff,30,0,32,2
1681906540446,BILD 2,A04,191856,Staff,31,0,32,1
1681906540446,BILD 2,A05,191857,Staff,32,0,32,0
1681906540446,BILD 2,A06,191858,Staff,32,0,32,0
1681906540446,BILD 2,A07,191859,Staff,31,0,32,1
1681906541480,BILD 3,A01,205391,Staff,29,0,32,3
1681906541480,BILD 3,A02,205393,Staff,32,0,32,0
1681906541480,BILD 3,A03,205394,Staff,28,0,32,4
1681906541480,BILD 3,A04,205395,Staff,32,0,32,0
1681906542507,BILD 20,A01,191861,Staff,32,0,32,0
1681906542507,BILD 20,A02,191862,Staff,32,0,32,0
1681906543535,BILD 30,A01,191864,Staff,31,0,32,1
1681906544564,BIMM 100,A01,192019,Staff,0,0,32,32
1681906544564,BIMM 100,A02,192020,Staff,23,0,32,9
1681906544564,BIMM 100,A03,192035,Staff,22,0,32,10
1681906545596,BIMM 110,A01,192037,Tat; John,0,0,32,32
1681906545596,BIMM 110,A02,192038,Tat; John,10,0,32,22
1681906546621,BIMM 120,A01,192040,Pickett; Brooke Elizabeth,2,0,32,30
1681906546621,BIMM 120,A02,192041,Pickett; Brooke Elizabeth,16,0,32,16
1681906546621,BIMM 120,A03,192042,Pickett; Brooke Elizabeth,16,0,32,16
1681906547658,BIPN 100,A01,192044,Armour; Jon Christopher,26,0,32,6
1681906547658,BIPN 100,A02,192059,Armour; Jon Christopher,30,0,32,2
1681906547658,BIPN 100,A03,192064,Armour; Jon Christopher,31,0,32,1
1681906547658,BIPN 100,A04,192073,Armour; Jon Christopher,28,0,32,4
1681906548694,BIPN 148,A01,205411,Leutgeb; Jill K.,16,0,32,16
1681906548694,BIPN 148,A02,205412,Leutgeb; Jill K.,31,0,32,1
1681906548694,BIPN 148,A03,205413,Leutgeb; Jill K.,30,0,32,2
1681906548694,BIPN 148,A04,205414,Leutgeb; Jill K.,30,0,32,2
1681906549726,BIPN 160,A01,192115,Marino; Marc J,19,0,32,13
1681906549726,BIPN 160,A02,192148,Marino; Marc J,27,0,32,5
1681906549726,BIPN 160,A03,192158,Marino; Marc J,31,0,32,1
1681906549726,BIPN 160,A04,192190,Marino; Marc J,32,0,32,0
1681906549726,BIPN 160,A05,192287,Marino; Marc J,32,0,32,0
1681906549726,BIPN 160,A06,192288,Marino; Marc J,32,0,32,0
1681906550756,BIPN 194,A00,206038,Staff,28,0,32,4
1681906551788,BISP 194,A00,192289,Leutgeb; Stefan,13,0,32,19
1681906551788,BISP 194,B00,245332,Nieh; James Charles,27,0,32,5
1681906552811,CAT 124,A01,202247,Staff,15,0,15,0
1681906553835,CAT 125,A00,202248,Staff,19,0,20,1
1681906553835,CAT 125,B00,202253,Staff,20,0,20,0
1681906553835,CAT 125,C00,202257,Staff,19,0,20,1
1681906554863,CAT 125GS,A01,202273,Bronstein; Phoebe Malan,20,0,20,0
1681906555889,CAT 125R,A00,202284,Staff,17,0,20,3
1681906555889,CAT 125R,C00,202286,Staff,10,0,20,10
1681906555889,CAT 125R,D00,202291,Staff,18,0,20,2
1681906555889,CAT 125R,E00,202295,Staff,13,0,20,7
1681906555889,CAT 125R,F00,202302,Staff,12,0,20,8
1681906556915,CENG 100,A00,204724,Opatkiewicz; Justin Paul,25,0,25,0
1681906557941,CGS 2A,A01,180420,Staff,31,0,36,5
1681906558968,CGS 101,A00,180421,Staff,16,0,20,4
1681906559994,CGS 112,A00,180422,Staff,10,0,16,6
1681906561024,CGS 113,A00,180423,Staff,18,0,20,2
1681906562051,CGS 137,A00,180424,Staff,12,0,12,0
1681906563081,CGS 147,A00,180425,Staff,10,0,10,0
1681906564113,CHEM 6A,A01,179556,Staff,97,0,100,3
1681906564113,CHEM 6A,A02,179558,Staff,0,0,0,0
1681906565138,CHEM 6B,A01,179560,Staff,100,0,100,0
1681906566173,CHEM 6C,A01,179565,Jazzar; Rodolphe,95,0,100,5
1681906567209,CHEM 7L,A01,179586,Schurmeier; Kimberly,13,0,24,11
1681906567209,CHEM 7L,A02,179587,Schurmeier; Kimberly,23,0,24,1
1681906567209,CHEM 7L,A03,179590,Schurmeier; Kimberly,22,0,24,2
1681906567209,CHEM 7L,A04,179591,Schurmeier; Kimberly,22,0,24,2
1681906567209,CHEM 7L,B01,179598,Schurmeier; Kimberly,17,0,24,7
1681906567209,CHEM 7L,B02,179599,Schurmeier; Kimberly,24,0,24,0
1681906567209,CHEM 7L,B03,179606,Schurmeier; Kimberly,23,0,24,1
1681906567209,CHEM 7L,B04,179607,Schurmeier; Kimberly,23,0,24,1
1681906568240,CHEM 11,A01,179609,Stallings; Dontarie M,88,0,100,12
1681906569265,CHEM 40A,A01,179621,Staff,41,0,50,9
1681906569265,CHEM 40A,A02,179622,Staff,47,0,50,3
1681906570294,CHEM 40B,A01,179630,Weizman; Haim,48,0,50,2
1681906570294,CHEM 40B,A02,179631,Weizman; Haim,45,0,50,5
1681906571328,CHEM 41A,A01,179660,Klosterman; Jeremy K,93,0,100,7
1681906572358,CHEM 43A,A01,179683,Klosterman; Jeremy K,0,0,24,24
1681906572358,CHEM 43A,A02,179688,Klosterman; Jeremy K,14,0,24,10
1681906572358,CHEM 43A,A03,179689,Klosterman; Jeremy K,20,0,24,4
1681906572358,CHEM 43A,A04,179691,Klosterman; Jeremy K,18,0,24,6
1681906573411,CHEM 114A,A01,179693,Stallings; Dontarie M,77,0,100,23
1681906574435,CHEM 143B,A01,179698,Weizman; Haim,17,0,24,7
1681906574435,CHEM 143B,A02,179700,Weizman; Haim,24,0,24,0
1681906575459,CHIN 169A,A00,179701,Wang; Xiao,20,0,20,0
1681906576483,COGS 2,A01,179750,Boyle; Mary E. T.,17,0,30,13
1681906577513,COGS 9,A01,179759,Jones; Cameron Robert,43,0,50,7
1681906578541,COGS 14A,A01,179854,Staff,18,0,50,32
1681906579566,COGS 14B,A01,179856,Staff,54,0,60,6
1681906580595,COGS 17,A01,179874,Staff,71,0,75,4
1681906581635,COGS 18,A01,179884,Staff,63,0,80,17
1681906582663,COGS 100,A01,179886,Staff,40,0,60,20
1681906583687,COGS 101B,A01,179892,Staff,1,0,30,29
1681906584715,COGS 101C,A01,179894,Staff,28,0,30,2
1681906585739,COGS 107A,A01,179896,Boyle; Mary E. T.,31,0,40,9
1681906586765,COGS 108,A01,179898,Simpkins; Charles Alexander,0,17,60,60
1681906587793,COGS 109,A01,179900,Staff,34,0,40,6
1681906588830,COGS 118A,A01,179946,Staff,9,0,40,31
1681906589859,COGS 153,A00,179978,Staff,1,0,30,29
1681906590883,COGS 156,A01,179981,Staff,27,0,30,3
1681906592933,COGS 172,A01,179987,Staff,13,0,30,17
1681906594996,COGS 186,A01,179991,Staff,13,0,30,17
1681906596025,COMM 10,A01,180001,Staff,15,0,25,10
1681906596025,COMM 10,A02,180004,Staff,20,0,25,5
1681906597054,COMM 100A,A01,180016,Staff,18,0,25,7
1681906597054,COMM 100A,A02,180020,Staff,24,0,25,1
1681906598080,COMM 101T,A00,180029,Halm; Gavin Patrick,23,0,35,12
1681906599105,COMM 106V,A00,180043,Staff,34,0,35,1
1681906600132,COMM 109P,A00,180044,Staff,31,0,35,4
1681906601167,COMM 113T,A00,180045,Havis; Allan,37,0,45,8
1681906602200,COMM 132,A00,180046,McKenna; Denise,23,0,30,7
1681906603224,COMM 143,A00,180047,Staff,19,0,30,11
1681906604249,COMM 190,A00,180048,Conner; Thomas Hartnell,20,0,23,3
1681906605277,CSE 8A,A50,180053,Cao; Yingjun,25,0,50,25
1681906605277,CSE 8A,B50,180180,Staff,50,0,50,0
1681906606309,CSE 11,A01,180190,Cao; Yingjun,31,0,50,19
1681906607334,CSE 20,A01,180192,Briones; Jor-el Thomas Caparas,23,0,30,7
1681906608357,CSE 21,A01,194538,Briones; Jor-el Thomas Caparas,50,0,60,10
1681906609382,CSE 30,A01,180324,Eldon; John,79,0,100,21
1681906610482,CSE 101,A01,201353,Staff,0,20,40,40
1681906611511,CSE 134B,A01,180326,Powell; Thomas Allan,74,0,100,26
1681906612535,CSE 140,A01,180328,Staff,46,0,75,29
1681906613558,CSE 140L,A01,180344,Eldon; John,69,0,100,31
1681906614586,CSE 150A,A01,180411,Staff,0,7,50,50
1681906615609,CSE 151A,A01,180414,Staff,0,6,50,50
1681906616633,CSE 175,A01,222521,Kumar; Rakesh,50,0,50,0
1681906617658,CSE 190,A00,201419,Staff,45,0,49,4
1681906618684,CSS 1,A01,194536,Staff,38,0,50,12
1681906619716,DSC 30,A01,202385,Staff,48,0,50,2
1681906620745,DSC 40A,A01,202387,Albuyeh; Rod,50,0,50,0
1681906621778,DSC 190,A01,202389,Silberman; Jack,21,0,21,0
1681906622807,DSGN 100,A01,179993,Staff,16,0,30,14
1681906623834,ECE 65,A50,180708,Staff,10,0,20,10
1681906623834,ECE 65,A51,180739,Staff,19,0,20,1
1681906624862,ECON 1,A01,180427,Famulari; Melissa,67,0,70,3
1681906625890,ECON 2,A01,180450,Levkoff; Steven B.,64,0,70,6
1681906626918,ECON 4,A01,203351,Anderson; John Charles,7,0,10,3
1681906627947,ECON 100A,A01,180472,Famulari; Melissa,65,0,70,5
1681906628975,ECON 120A,A01,180549,Staff,64,0,70,6
1681906630003,ECON 120B,A01,180655,Ma; Xinwei,46,0,70,24
1681906631027,ECON 129,A00,203333,Eckert; Fabian Paul,15,0,35,20
1681906632051,ECON 131,A00,180656,Staff,10,0,35,25
1681906633078,ECON 172B,A01,180672,Levkoff; Steven B.,32,0,35,3
1681906634102,ECON 178,A01,203342,Zhu; Ying,11,0,35,24
1681906635129,EDS 108GS,A00,202383,Wishard Guerra; Alison G.,20,0,20,0
1681906636151,EDS 111GS,A00,202347,Wishard Guerra; Alison G.,20,0,20,0
1681906637175,EDS 112,A01,202323,Staff,56,0,60,4
1681906638201,EDS 113,A00,202340,Staff,33,0,35,2
1681906639223,EDS 118,A00,201231,Staff,20,0,30,10
1681906640248,EDS 119,A00,204994,Staff,8,0,10,2
1681906641276,EDS 124BR,A00,202324,Eguchi; Emi,5,0,25,20
1681906642301,EDS 126,A01,203208,Jones; Makeba,26,0,30,4
1681906643337,EDS 135,A01,202333,Staff,18,0,20,2
1681906644360,EDS 180,A00,202311,Staff,47,0,50,3
1681906645386,ERC 190GS,A01,253747,Staff,28,0,28,0
1681906646411,ETHN 104,A00,180742,Staff,24,0,35,11
1681906647439,ETHN 118,A00,180745,Staff,28,0,35,7
1681906648463,ETHN 127,A00,180747,Staff,12,0,16,4
1681906649489,ETHN 137,A00,180880,Staff,12,0,12,0
1681906650515,ETHN 147,A00,180890,Staff,8,0,10,2
1681906651538,ETHN 154,A00,180891,Staff,7,0,8,1
1681906652564,ETHN 168,A00,180892,Staff,9,0,10,1
1681906653589,GLBH 20,A00,201051,Hannah; Seth Donal,0,1,0,1
1681906654618,GLBH 111,A01,209338,Burgos; Jose L.,0,0,0,0
1681906655643,GLBH 150,A00,258300,Staff,0,3,0,0
1681906656667,GLBH 181,A00,201207,Staff,15,0,40,25
1681906657695,HIEU 109,A00,180898,Staff,20,0,20,0
1681906658721,HIEU 111,A00,180899,Staff,1,0,20,19
1681906659743,HIEU 124,A00,180900,Staff,18,0,20,2
1681906660772,HILA 122,A00,180901,Staff,18,0,20,2
1681906661801,HILA 132,A00,180902,Vitz; Matthew,2,0,20,18
1681906662827,HILD 10,A01,180896,Staff,15,0,20,5
1681906663851,HILD 30GS,A00,180897,Edington; Claire Ellen,0,0,0,0
1681906664878,HISC 105,A00,180903,Staff,20,0,20,0
1681906665905,HISC 117,A00,180904,Staff,11,0,20,9
1681906666928,HIUS 108B,A00,181005,Staff,18,0,20,2
1681906667952,HIUS 113,A00,181093,Staff,4,0,20,16
1681906668978,HUM 3,A01,181190,Patterson; Patrick H.,40,0,50,10
1681906668978,HUM 3,B01,181195,Staff,47,0,50,3
1681906670003,HUM 3GS,A00,181196,Herbst; Matthew,0,0,0,0
1681906671032,HUM 4,A01,181227,West; Geoffrey Scott,34,0,50,16
1681906671032,HUM 4,B01,181282,Staff,43,0,50,7
1681906672061,HUM 4GS,A00,181377,Lyon; Antony J.,0,0,0,0
1681906673086,HUM 5,A01,181536,Zavodny; Tatiana Sophia,31,0,50,19
1681906673086,HUM 5,B01,181908,Staff,36,0,50,14
1681906674113,INTL 190,A00,181909,Segui; Alan S,0,0,0,6
1681906674113,INTL 190,B00,181961,Segui; Alan S,0,0,0,7
1681906675140,JAPN 20AR,A01,182113,Ross; Kayoko F,15,0,20,5
1681906676165,LATI 50,A01,202391,Martin-Cabrera; Luis,19,0,30,11
1681906676165,LATI 50,A02,202392,Martin-Cabrera; Luis,26,0,30,4
1681906677199,LATI 180,A00,202393,Kokinis; Troy Andreas,25,0,25,0
1681906678230,LIFR 1A,A00,182119,Staff,14,0,14,0
1681906679262,LIFR 1AX,A00,182324,Staff,14,0,14,0
1681906680289,LIFR 1B,A00,182259,Staff,14,0,14,0
1681906681317,LIFR 1BX,A00,182273,Staff,14,0,14,0
1681906682343,LIGN 8,A00,182330,Staff,137,0,150,13
1681906683370,LIGN 9GS,A00,182362,Staff,20,0,20,0
1681906684395,LIGN 119,A00,204992,Takahashi; Maho,12,0,15,3
1681906685422,LIGN 130,A01,182384,Staff,47,0,50,3
1681906686449,LIGN 149GS,A00,182390,Staff,20,0,20,0
1681906687474,LIGN 170,A00,182404,Staff,24,0,30,6
1681906688504,LISP 1D,A00,182281,Staff,7,0,14,7
1681906688504,LISP 1D,B00,182287,Staff,14,0,14,0
1681906688504,LISP 1D,C00,182295,Staff,11,0,14,3
1681906688504,LISP 1D,D00,182301,Staff,14,0,14,0
1681906689533,LISP 1DX,A00,182309,Staff,20,0,28,8
1681906689533,LISP 1DX,B00,182316,Staff,26,0,28,2
1681906690563,LTAF 120GS,A00,182412,Zhiri; Oumelbanine,20,0,20,0
1681906691586,LTCS 172GS,A00,182437,Bronstein; Phoebe Malan,20,0,20,0
1681906692621,LTEA 138,A00,182457,Staff,22,0,40,18
1681906693650,LTEN 114,A01,182490,Staff,23,0,25,2
1681906694679,LTEN 130GS,A00,182491,Lyon; Antony J.,20,0,20,0
1681906695708,LTEN 169,A00,182493,Cuong; Marisol,20,0,25,5
1681906696736,LTEN 178,A00,182501,Staff,14,0,15,1
1681906697760,LTEN 181,A00,182515,Staff,22,0,25,3
1681906698785,LTEN 185GS,A00,197655,Forbes; Camille,20,0,20,0
1681906699827,LTSP 100B,A00,202208,Bessett; Ryan Matthew,24,0,25,1
1681906700858,LTWL 100,A00,182516,Myerston Santana; Jacobo,23,0,30,7
1681906701888,LTWR 100GS,A00,182518,Forbes; Camille,20,0,20,0
1681906702931,LTWR 102,A00,182522,Staff,15,0,15,0
1681906702931,LTWR 102,B00,182525,Staff,14,0,15,1
1681906703954,LTWR 115,A00,182526,Staff,12,0,15,3
1681906704979,MAE 8,A01,182528,Pham; Hieu Tan,68,0,70,2
1681906706007,MAE 11,A00,182529,Bahadori; Mohammad Yousef,94,0,100,6
1681906707033,MAE 20,A00,182530,Evdokimenko; Ekaterina,68,0,70,2
1681906708065,MAE 30A,A00,182532,Staff,44,0,45,1
1681906709090,MAE 101A,A00,182533,Bahadori; Mohammad Yousef,97,0,100,3
1681906710114,MAE 101C,A00,182538,Staff,62,0,70,8
1681906711137,MAE 104,A00,182539,Staff,45,0,50,5
1681906712162,MAE 131A,A00,182540,Ghazinejad; Maziar,41,0,45,4
1681906713186,MAE 143A,A00,182548,Bewley; Thomas R,43,0,50,7
1681906714287,MAE 150,A00,182549,Staff,28,0,40,12
1681906715312,MAE 160,A00,182550,Evdokimenko; Ekaterina,43,0,60,17
1681906716341,MATH 3C,A01,182725,Staff,27,0,30,3
1681906717366,MATH 10A,A01,182729,Staff,25,0,30,5
1681906717366,MATH 10A,B01,182732,Staff,26,0,30,4
1681906718396,MATH 10B,A01,182737,Staff,21,0,30,9
1681906718396,MATH 10B,A02,182738,Staff,27,0,30,3
1681906718396,MATH 10B,B01,182744,Staff,27,0,30,3
1681906718396,MATH 10B,B02,182745,Staff,27,0,30,3
1681906719422,MATH 18,A01,182750,Anzaldo; Leesa B,28,0,30,2
1681906719422,MATH 18,A02,182751,Anzaldo; Leesa B,29,0,30,1
1681906719422,MATH 18,A03,182753,Anzaldo; Leesa B,28,0,30,2
1681906719422,MATH 18,A04,182757,Anzaldo; Leesa B,29,0,30,1
1681906719422,MATH 18,B01,182761,Anzaldo; Leesa B,27,0,30,3
1681906719422,MATH 18,B02,182764,Anzaldo; Leesa B,27,0,30,3
1681906719422,MATH 18,B03,182765,Anzaldo; Leesa B,30,0,30,0
1681906719422,MATH 18,B04,182766,Anzaldo; Leesa B,30,0,30,0
1681906720446,MATH 20A,A01,182771,Suk; Andrew Hoon,28,0,30,2
1681906721470,MATH 20B,A01,182775,Bach; Quang Tran,30,0,30,0
1681906721470,MATH 20B,A02,182777,Bach; Quang Tran,29,0,30,1
1681906721470,MATH 20B,B01,182780,Bach; Quang Tran,27,0,30,3
1681906721470,MATH 20B,B02,182782,Bach; Quang Tran,30,0,30,0
1681906722495,MATH 20C,A01,182787,Staff,25,0,30,5
1681906722495,MATH 20C,A02,182790,Staff,29,0,30,1
1681906722495,MATH 20C,B01,182792,Staff,25,0,30,5
1681906722495,MATH 20C,B02,182796,Staff,27,0,30,3
1681906723518,MATH 20D,A01,182799,Staff,29,0,30,1
1681906723518,MATH 20D,A02,182802,Staff,30,0,30,0
1681906723518,MATH 20D,A03,182803,Staff,30,0,30,0
1681906724542,MATH 20E,A01,182809,Verstraete; Jacques Allan,24,0,30,6
1681906724542,MATH 20E,A02,182811,Verstraete; Jacques Allan,28,0,30,2
1681906724542,MATH 20E,B01,182814,Verstraete; Jacques Allan,23,0,30,7
1681906724542,MATH 20E,B02,182815,Verstraete; Jacques Allan,30,0,30,0
1681906725567,MATH 103A,A01,182820,Staff,9,0,30,21
1681906725567,MATH 103A,A02,182821,Staff,27,0,30,3
1681906725567,MATH 103A,A03,182822,Staff,23,0,30,7
1681906725567,MATH 103A,B01,182825,Staff,23,0,30,7
1681906725567,MATH 103A,B02,182826,Staff,30,0,30,0
1681906725567,MATH 103A,B03,182830,Staff,30,0,30,0
1681906726599,MATH 109,A01,182836,Chow; Bennett,24,0,30,6
1681906726599,MATH 109,A02,182838,Chow; Bennett,29,0,30,1
1681906726599,MATH 109,A03,182894,Chow; Bennett,29,0,30,1
1681906726599,MATH 109,B01,182908,Chow; Bennett,28,0,30,2
1681906726599,MATH 109,B02,182909,Chow; Bennett,30,0,30,0
1681906726599,MATH 109,B03,182910,Chow; Bennett,27,0,30,3
1681906727624,MATH 142A,A01,182925,Staff,11,0,30,19
1681906727624,MATH 142A,A02,182935,Staff,25,0,30,5
1681906727624,MATH 142A,A03,182967,Staff,26,0,30,4
1681906727624,MATH 142A,B01,183125,Staff,24,0,30,6
1681906727624,MATH 142A,B02,183157,Staff,28,0,30,2
1681906727624,MATH 142A,B03,183158,Staff,29,0,30,1
1681906728652,MATH 183,A01,183160,Arias-Castro; Ery,23,0,30,7
1681906728652,MATH 183,A02,183161,Arias-Castro; Ery,29,0,30,1
1681906728652,MATH 183,B01,183163,Arias-Castro; Ery,28,0,30,2
1681906728652,MATH 183,B02,183164,Arias-Castro; Ery,28,0,30,2
1681906729692,MATH 193A,A01,183167,Staff,4,0,35,31
1681906729692,MATH 193A,A02,183168,Staff,28,0,35,7
1681906729692,MATH 193A,A03,183169,Staff,34,0,35,1
1681906729692,MATH 193A,A04,183170,Staff,28,0,35,7
1681906730717,MGT 4,A01,202395,Anderson; John Charles,75,0,80,5
1681906731741,MGT 5,A00,202396,Houskeeper; Robert,80,0,90,10
1681906732765,MGT 103,A00,202397,Eberhard; Craig A,55,0,90,35
1681906733789,MGT 131A,A00,202398,Houskeeper; Robert,85,0,90,5
1681906734817,MGT 135,A00,202399,Anderson; John Charles,83,0,90,7
1681906735840,MGT 162R,A00,202403,Gneezy; Uri,150,0,200,50
1681906736868,MGT 172,A00,202404,Hedges; Kathleen,50,0,90,40
1681906737893,MGT 181,A00,202405,Dunn; Louis Jean,84,0,90,6
1681906738920,MMW 14,A01,183200,Staff,16,0,28,12
1681906738920,MMW 14,A02,183201,Staff,26,0,28,2
1681906738920,MMW 14,A03,183202,Staff,24,0,28,4
1681906738920,MMW 14,A04,183203,Staff,25,0,28,3
1681906738920,MMW 14,A05,183204,Staff,26,0,28,2
1681906738920,MMW 14,A06,183205,Staff,27,0,28,1
1681906738920,MMW 14,B01,183207,Staff,26,0,28,2
1681906738920,MMW 14,B02,183208,Staff,28,0,28,0
1681906738920,MMW 14,B03,183209,Staff,28,0,28,0
1681906738920,MMW 14,B04,183210,Staff,28,0,28,0
1681906738920,MMW 14,B05,183211,Staff,28,0,28,0
1681906738920,MMW 14,B06,183212,Staff,28,0,28,0
1681906739948,MMW 14GS,A00,183213,Zhiri; Oumelbanine,28,0,28,0
1681906740974,MMW 15GS,B00,183215,Rahimi; Babak,28,0,28,0
1681906741997,MMW 121,A01,183217,Patterson; Patrick H.,14,0,28,14
1681906741997,MMW 121,A02,183218,Patterson; Patrick H.,25,0,28,3
1681906743028,MUS 1A,A01,182554,Staff,8,0,35,27
1681906744053,MUS 5,A01,182558,Staff,20,0,35,15
1681906745078,MUS 6,A01,182562,Staff,25,0,35,10
1681906746101,MUS 8GS,A00,182563,Borgo; David Garcia,25,0,25,0
1681906747126,MUS 13,A01,182567,Staff,24,0,25,1
1681906748150,MUS 15,A01,182570,Staff,32,0,35,3
1681906748150,MUS 15,B01,182575,Staff,10,0,35,25
1681906749178,MUS 80,A00,182578,Staff,23,0,25,2
1681906749178,MUS 80,B00,182581,Staff,20,0,25,5
1681906750203,MUS 113,A00,182582,Staff,25,0,25,0
1681906751230,MUS 114,A00,182583,Staff,4,0,25,21
1681906752255,MUS 150GS,A01,182588,Borgo; David Garcia,25,0,25,0
1681906753279,PHIL 1,A00,182590,Staff,35,0,40,5
1681906754313,PHIL 10,A01,182596,Grush; Rick Scott,31,0,35,4
1681906754313,PHIL 10,A02,182597,Grush; Rick Scott,34,0,35,1
1681906755339,PHIL 15,A01,182601,Staff,31,0,35,4
1681906755339,PHIL 15,A02,182602,Staff,33,0,35,2
1681906756369,PHIL 27,A01,182604,Staff,30,0,35,5
1681906756369,PHIL 27,A02,182607,Staff,35,0,35,0
1681906757394,PHIL 32,A01,182609,Staff,35,0,35,0
1681906757394,PHIL 32,A02,182612,Staff,35,0,35,0
1681906758418,PHIL 130,A00,182614,Staff,63,0,70,7
1681906759446,PHIL 136,A00,182616,Cohen; Jonathan David,66,0,70,4
1681906760476,PHIL 155,A00,182617,Vargas; Manuel Rogelio,60,0,70,10
1681906761503,PHIL 163,A01,182620,Staff,15,0,20,5
1681906761503,PHIL 163,A02,182624,Staff,10,0,20,10
1681906762526,PHIL 164,A00,182627,Staff,30,0,40,10
1681906763563,PHIL 173,A00,182628,Staff,36,0,40,4
1681906764595,PHYS 1A,A00,183221,Staff,54,0,60,6
1681906765619,PHYS 1AL,001,183222,Staff,25,0,30,5
1681906765619,PHYS 1AL,002,183223,Staff,28,0,30,2
1681906766643,PHYS 1B,A00,183231,Staff,44,0,60,16
1681906767671,PHYS 1BL,001,183232,Staff,20,0,30,10
1681906767671,PHYS 1BL,002,183233,Staff,29,0,30,1
1681906768696,PHYS 1C,A00,183240,Staff,30,0,60,30
1681906769719,PHYS 1CL,001,183241,Staff,13,0,30,17
1681906769719,PHYS 1CL,002,183242,Staff,22,0,30,8
1681906770746,PHYS 2AR,A01,183250,Staff,44,0,50,6
1681906771770,PHYS 2B,A01,183252,Staff,106,0,115,9
1681906772795,PHYS 2BL,A01,183254,Staff,21,0,24,3
1681906772795,PHYS 2BL,A02,183255,Staff,22,0,24,2
1681906773823,PHYS 2C,A01,183522,Staff,105,0,115,10
1681906774858,PHYS 4A,A01,183524,Staff,49,0,50,1
1681906775887,POLI 5,A00,183525,Staff,44,0,50,6
1681906776914,POLI 12,A00,183540,Staff,48,0,50,2
1681906777940,POLI 13R,A00,183541,Forman; Fonna,42,0,50,8
1681906778968,POLI 30,A00,183542,Mignozzetti; Umberto,47,0,50,3
1681906779992,POLI 100A,A00,183543,Staff,45,0,50,5
1681906781017,POLI 100E,A00,223598,Staff,32,0,35,3
1681906782046,POLI 103A,A00,183564,Kousser; Thad,38,0,50,12
1681906783078,POLI 104B,A00,201329,Staff,29,0,35,6
1681906784102,POLI 113BR,A00,183576,Hoston; Germaine,28,0,50,22
1681906785136,POLI 114BR,A00,183588,Staff,27,0,30,3
1681906786163,POLI 117R,A00,183595,Forman; Fonna,9,0,20,11
1681906787190,POLI 120H,A00,183596,Fisk; David Lee,13,0,20,7
1681906788217,POLI 130AA,A00,183597,Staff,14,0,20,6
1681906789241,POLI 134AA,A00,183598,Staff,19,0,20,1
1681906790264,POLI 135,A00,183599,Fisk; David Lee,20,0,25,5
1681906791289,POLI 142P,A00,183623,Staff,37,0,40,3
1681906792320,POLI 144D,A00,183624,Staff,22,0,25,3
1681906793344,POLI 151,A00,183625,Staff,15,0,20,5
1681906794366,POLI 162,A00,183626,Mignozzetti; Umberto,18,0,20,2
1681906795390,PSYC 1,A00,253748,Staff,86,0,90,4
1681906796414,PSYC 2,A00,183627,Moranton; Nirelia Melbina-,25,0,35,10
1681906797442,PSYC 3,A00,183628,Staff,43,0,45,2
1681906799493,PSYC 60,A01,183631,Lowe; Angela Beth,35,0,40,5
1681906800519,PSYC 70,A01,253757,Staff,37,0,45,8
1681906801544,PSYC 101,A00,183632,Heyman; Gail D.,48,0,60,12
1681906802570,PSYC 105,A00,183848,Lowe; Angela Beth,50,0,60,10
1681906803595,PSYC 106,A00,183849,Dobkins; Karen R.,45,0,60,15
1681906804618,PSYC 108,A00,253750,Staff,24,0,60,36
1681906805641,PSYC 114,A01,184275,Winkielman; Piotr,0,6,30,30
1681906806666,PSYC 122,A00,183856,Moranton; Nirelia Melbina-,0,10,30,30
1681906807690,PSYC 124,A00,183865,Chapman; Eddie Nathaniel,52,0,80,28
1681906808717,PSYC 137,A00,183880,Staff,19,0,25,6
1681906810772,PSYC 154,A00,183910,Lacefield; Katharine I,0,2,90,90
1681906812822,PSYC 162,A00,183946,Wixted; John T,61,0,90,29
1681906813847,PSYC 172,A00,183947,Gorman; Michael R.,14,0,30,16
1681906814876,PSYC 178,A00,183963,Glaser; Dale,20,0,40,20
1681906815899,PSYC 181GS,A00,183964,Anagnostaras; Stephan,10,0,10,0
1681906816923,PSYC 186GS,A01,257660,Staff,10,0,10,0
1681906818026,PSYC 193,B00,253749,Staff,23,0,25,2
1681906820096,PSYC 193L,A01,184122,Staff,33,0,35,2
1681906820096,PSYC 193L,C01,184167,Winkielman; Piotr,16,0,30,14
1681906821123,RELI 188GS,A00,182629,Rahimi; Babak,20,0,20,0
1681906822146,SE 101A,A00,182646,Staff,26,0,30,4
1681906823170,SE 101C,A00,182650,Staff,18,0,20,2
1681906824198,SE 110A,A00,182651,Staff,28,0,28,0
1681906825226,SE 130A,A00,182652,Staff,39,0,40,1
1681906826249,SIO 46GS,A00,182636,Cook; Geoffrey W,28,0,28,0
1681906827274,SIO 109R,A00,194459,Staff,5,0,20,15
1681906828296,SIO 121GS,A00,182639,Cook; Geoffrey W,28,0,28,0
1681906829323,SIO 132,A01,182642,Staff,32,0,40,8
1681906830346,SIO 139,A00,182644,Kacev; David,36,0,40,4
1681906831373,SOCI 2,A01,258404,Staff,34,0,36,2
1681906831373,SOCI 2,A02,258405,Staff,35,0,36,1
1681906832401,SOCI 60,A01,258408,Staff,29,0,30,1
1681906832401,SOCI 60,A02,258413,Staff,30,0,30,0
1681906833426,SOCI 100,A01,258415,Staff,29,0,30,1
1681906833426,SOCI 100,A02,258416,Staff,28,0,30,2
1681906839586,SOCI 127,A00,258421,Staff,22,0,30,8
1681906840610,SOCI 132,A00,258422,Staff,45,0,50,5
1681906841643,SOCI 133,A00,258423,Staff,26,0,30,4
1681906842671,SOCI 138GS,A00,258424,Staff,15,0,15,0
1681906843695,SOCI 145,A00,258425,Staff,25,0,30,5
1681906844717,SOCI 148,A00,258426,Staff,26,0,30,4
1681906845746,SOCI 153,A00,199217,Staff,29,0,30,1
1681906846773,SOCI 160,A00,258427,Staff,28,0,30,2
1681906847801,SOCI 160E,A00,258435,Staff,56,0,60,4
1681906848831,SOCI 189GS,A00,258436,Staff,15,0,15,0
1681906849858,SOCI 190GS,A00,258437,Staff,15,0,15,0
1681906850887,SYN 2,001,182658,Staff,9,0,16,7
1681906850887,SYN 2,002,201439,Staff,15,0,16,1
1681906850887,SYN 2,003,201443,Staff,16,0,16,0
1681906851915,SYN 100,A01,182657,Staff,17,0,20,3
1681906852945,TDAC 1,A00,184381,Salovey; Todd,16,0,20,4
1681906852945,TDAC 1,B00,184385,Harting; Carla Kelso,19,0,20,1
1681906852945,TDAC 1,C00,184394,Staff,19,0,20,1
1681906853974,TDAC 101,A00,184483,Harting; Carla Kelso,19,0,20,1
1681906854998,TDDE 111,A00,184496,Staff,14,0,15,1
1681906856034,TDDE 131,A00,184504,Staff,20,0,20,0
1681906856034,TDDE 131,B00,184505,Staff,17,0,18,1
1681906856034,TDDE 131,C00,184534,Staff,49,0,50,1
1681906856034,TDDE 131,D00,184564,Staff,15,0,15,0
1681906856034,TDDE 131,E00,204725,Staff,19,0,20,1
1681906857060,TDGE 1,A01,184414,Salovey; Todd,37,0,50,13
1681906858085,TDGE 5,A01,184419,Staff,23,0,24,1
1681906859113,TDGE 10,A00,184428,Fulton; Julia,31,0,50,19
1681906860139,TDGE 124,A00,184565,Fulton; Julia,7,0,50,43
1681906861169,TDGE 125,B00,184567,Meyer; Ursula,9,0,25,16
1681906862204,TDHT 101,A00,184568,Staff,21,0,25,4
1681906862204,TDHT 101,B00,184569,Staff,20,0,20,0
1681906863228,TDHT 114,A00,184570,Staff,49,0,50,1
1681906864252,TDMV 1,A00,184437,Arcidiacono; Kristin,23,0,30,7
1681906864252,TDMV 1,B00,184448,Caligagan; Maria T.,22,0,30,8
1681906865275,TDMV 2,A00,184449,Weinberg; Sadie,27,0,30,3
1681906865275,TDMV 2,B00,184453,Arcidiacono; Kristin,29,0,30,1
1681906866298,TDMV 110,A00,184571,Weinberg; Sadie,30,0,30,0
1681906867324,TDMV 142,A00,184572,Caligagan; Tony,27,0,30,3
1681906867324,TDMV 142,B00,184573,Caligagan; Maria T.,27,0,30,3
1681906868355,TDTR 20,A00,184482,Jun; Grace Shin Hae,25,0,25,0
1681906869384,USP 2,A01,184290,Hinds; Juli Beth,24,0,25,1
1681906870410,USP 3,A01,184295,Staff,20,0,25,5
1681906871434,USP 4,A00,184304,McTague; Sarah,15,0,25,10
1681906872456,USP 100,A00,184315,Staff,17,0,25,8
1681906873479,USP 105,A00,184326,Staff,21,0,25,4
1681906874505,USP 151,A00,184327,Staff,20,0,25,5
1681906875528,USP 170,A00,184380,Hinds; Juli Beth,14,0,25,11
1681906876551,VIS 21B,A01,182660,Staff,28,0,31,3
1681906876551,VIS 21B,A02,182662,Staff,30,0,31,1
1681906877576,VIS 103D,A00,182663,Staff,74,0,75,1
1681906878599,VIS 105D,A00,182667,Li; Huai,15,0,22,7
1681906879622,VIS 122GS,A00,182668,Herbst; Matthew,20,0,20,0
1681906880647,VIS 128C,A00,182673,Staff,70,0,75,5
1681906881677,VIS 130,A00,182675,Staff,20,0,22,2
1681906882704,VIS 160A,A00,182678,Stalbaum; Brett,4,0,10,6
1681906884756,WCWP 10B,A00,201679,Staff,15,0,15,0
1681906884756,WCWP 10B,B00,201695,Staff,15,0,15,0
1681906885785,WCWP 100,A00,201716,Staff,15,0,15,0
1681906885785,WCWP 100,B00,201717,Staff,11,0,15,4
1681906887923,ANSC 105GS,A00,258289,Staff,0,0,0,0
1681906888949,ANSC 125GS,A00,258295,Staff,0,0,0,0
1681906889976,ANSC 150,A00,258267,Staff,30,0,40,10
1681906891001,ANSC 190GS,A00,258280,Staff,0,0,0,0
1681906892028,ANTH 1,A00,258264,Staff,38,0,40,2
1681906893057,ANTH 2,A01,258259,Staff,72,0,76,4
1681906894080,ANTH 23,A01,258228,Staff,36,0,40,4
1681906895109,ANTH 101,A01,258236,Staff,39,0,40,1
1681906896133,ANTH 102,A00,258272,Staff,59,0,60,1
1681906897160,ANTH 105,A00,258244,Staff,31,0,35,4
1681906898192,BENG 130,A00,253975,Staff,38,0,40,2
1681906899214,BIBC 102,A01,191866,Flagg; Matthew Paul,19,0,32,13
1681906899214,BIBC 102,A02,191867,Flagg; Matthew Paul,22,0,32,10
1681906899214,BIBC 102,A03,191868,Flagg; Matthew Paul,30,0,32,2
1681906899214,BIBC 102,A04,191936,Flagg; Matthew Paul,26,0,32,6
1681906899214,BIBC 102,A05,191937,Flagg; Matthew Paul,11,0,32,21
1681906900243,BICD 100,A01,191939,Cooper; Andrew Michael,28,0,32,4
1681906900243,BICD 100,A02,191940,Cooper; Andrew Michael,32,0,32,0
1681906900243,BICD 100,A03,191941,Cooper; Andrew Michael,32,0,32,0
1681906900243,BICD 100,A04,191942,Cooper; Andrew Michael,32,0,32,0
1681906900243,BICD 100,A05,191943,Cooper; Andrew Michael,32,0,32,0
1681906901267,BIEB 126,A01,191945,Cleland; Elsa Eleanor,1,0,32,31
1681906901267,BIEB 126,A02,191946,Cleland; Elsa Eleanor,28,0,32,4
1681906901267,BIEB 126,A03,191947,Cleland; Elsa Eleanor,29,0,32,3
1681906901267,BIEB 126,A04,191948,Cleland; Elsa Eleanor,23,0,32,9
1681906901267,BIEB 126,A05,191996,Cleland; Elsa Eleanor,28,0,32,4
1681906902290,BIEB 136GS,A00,191997,Shurin; Jonathan & Holway; David A.,0,0,0,0
1681906903314,BIEB 137GS,A01,191999,Shurin; Jonathan & Holway; David A.,0,0,0,0
1681906904342,BILD 1,A01,205385,Staff,31,0,32,1
1681906904342,BILD 1,A02,205386,Staff,30,0,32,2
1681906904342,BILD 1,A03,205387,Staff,32,0,32,0
1681906904342,BILD 1,A04,205388,Staff,28,0,32,4
1681906905367,BILD 2,A01,191774,Staff,28,0,32,4
1681906905367,BILD 2,A02,191775,Staff,30,0,32,2
1681906905367,BILD 2,A03,191777,Staff,30,0,32,2
1681906905367,BILD 2,A04,191856,Staff,31,0,32,1
1681906905367,BILD 2,A05,191857,Staff,32,0,32,0
1681906905367,BILD 2,A06,191858,Staff,32,0,32,0
1681906905367,BILD 2,A07,191859,Staff,31,0,32,1
1681906906394,BILD 3,A01,205391,Staff,29,0,32,3
1681906906394,BILD 3,A02,205393,Staff,32,0,32,0
1681906906394,BILD 3,A03,205394,Staff,28,0,32,4
1681906906394,BILD 3,A04,205395,Staff,32,0,32,0
1681906907418,BILD 20,A01,191861,Staff,32,0,32,0
1681906907418,BILD 20,A02,191862,Staff,32,0,32,0
1681906908447,BILD 30,A01,191864,Staff,31,0,32,1
1681906909480,BIMM 100,A01,192019,Staff,0,0,32,32
1681906909480,BIMM 100,A02,192020,Staff,23,0,32,9
1681906909480,BIMM 100,A03,192035,Staff,22,0,32,10
1681906910504,BIMM 110,A01,192037,Tat; John,0,0,32,32
1681906910504,BIMM 110,A02,192038,Tat; John,10,0,32,22
1681906911530,BIMM 120,A01,192040,Pickett; Brooke Elizabeth,2,0,32,30
1681906911530,BIMM 120,A02,192041,Pickett; Brooke Elizabeth,16,0,32,16
1681906911530,BIMM 120,A03,192042,Pickett; Brooke Elizabeth,16,0,32,16
1681906912554,BIPN 100,A01,192044,Armour; Jon Christopher,26,0,32,6
1681906912554,BIPN 100,A02,192059,Armour; Jon Christopher,30,0,32,2
1681906912554,BIPN 100,A03,192064,Armour; Jon Christopher,31,0,32,1
1681906912554,BIPN 100,A04,192073,Armour; Jon Christopher,28,0,32,4
1681906913585,BIPN 148,A01,205411,Leutgeb; Jill K.,16,0,32,16
1681906913585,BIPN 148,A02,205412,Leutgeb; Jill K.,31,0,32,1
1681906913585,BIPN 148,A03,205413,Leutgeb; Jill K.,30,0,32,2
1681906913585,BIPN 148,A04,205414,Leutgeb; Jill K.,30,0,32,2
1681906914617,BIPN 160,A01,192115,Marino; Marc J,19,0,32,13
1681906914617,BIPN 160,A02,192148,Marino; Marc J,27,0,32,5
1681906914617,BIPN 160,A03,192158,Marino; Marc J,31,0,32,1
1681906914617,BIPN 160,A04,192190,Marino; Marc J,32,0,32,0
1681906914617,BIPN 160,A05,192287,Marino; Marc J,32,0,32,0
1681906914617,BIPN 160,A06,192288,Marino; Marc J,32,0,32,0
1681906915642,BIPN 194,A00,206038,Staff,28,0,32,4
1681906916666,BISP 194,A00,192289,Leutgeb; Stefan,13,0,32,19
1681906916666,BISP 194,B00,245332,Nieh; James Charles,27,0,32,5
1681906917692,CAT 124,A01,202247,Staff,15,0,15,0
1681906918718,CAT 125,A00,202248,Staff,19,0,20,1
1681906918718,CAT 125,B00,202253,Staff,20,0,20,0
1681906918718,CAT 125,C00,202257,Staff,19,0,20,1
1681906919751,CAT 125GS,A01,202273,Bronstein; Phoebe Malan,20,0,20,0
1681906920779,CAT 125R,A00,202284,Staff,17,0,20,3
1681906920779,CAT 125R,C00,202286,Staff,10,0,20,10
1681906920779,CAT 125R,D00,202291,Staff,18,0,20,2
1681906920779,CAT 125R,E00,202295,Staff,13,0,20,7
1681906920779,CAT 125R,F00,202302,Staff,12,0,20,8
1681906921895,CENG 100,A00,204724,Opatkiewicz; Justin Paul,25,0,25,0
1681906922920,CGS 2A,A01,180420,Staff,31,0,36,5
1681906923945,CGS 101,A00,180421,Staff,16,0,20,4
1681906924970,CGS 112,A00,180422,Staff,10,0,16,6
1681906925995,CGS 113,A00,180423,Staff,18,0,20,2
1681906927020,CGS 137,A00,180424,Staff,12,0,12,0
1681906928046,CGS 147,A00,180425,Staff,10,0,10,0
1681906929076,CHEM 6A,A01,179556,Staff,97,0,100,3
1681906929076,CHEM 6A,A02,179558,Staff,0,0,0,0
1681906930108,CHEM 6B,A01,179560,Staff,100,0,100,0
1681906931133,CHEM 6C,A01,179565,Jazzar; Rodolphe,95,0,100,5
1681906932164,CHEM 7L,A01,179586,Schurmeier; Kimberly,13,0,24,11
1681906932164,CHEM 7L,A02,179587,Schurmeier; Kimberly,23,0,24,1
1681906932164,CHEM 7L,A03,179590,Schurmeier; Kimberly,22,0,24,2
1681906932164,CHEM 7L,A04,179591,Schurmeier; Kimberly,22,0,24,2
1681906932164,CHEM 7L,B01,179598,Schurmeier; Kimberly,17,0,24,7
1681906932164,CHEM 7L,B02,179599,Schurmeier; Kimberly,24,0,24,0
1681906932164,CHEM 7L,B03,179606,Schurmeier; Kimberly,23,0,24,1
1681906932164,CHEM 7L,B04,179607,Schurmeier; Kimberly,23,0,24,1
1681906933192,CHEM 11,A01,179609,Stallings; Dontarie M,88,0,100,12
1681906934216,CHEM 40A,A01,179621,Staff,41,0,50,9
1681906934216,CHEM 40A,A02,179622,Staff,47,0,50,3
1681906935252,CHEM 40B,A01,179630,Weizman; Haim,48,0,50,2
1681906935252,CHEM 40B,A02,179631,Weizman; Haim,45,0,50,5
1681906936276,CHEM 41A,A01,179660,Klosterman; Jeremy K,93,0,100,7
1681906937300,CHEM 43A,A01,179683,Klosterman; Jeremy K,0,0,24,24
1681906937300,CHEM 43A,A02,179688,Klosterman; Jeremy K,14,0,24,10
1681906937300,CHEM 43A,A03,179689,Klosterman; Jeremy K,20,0,24,4
1681906937300,CHEM 43A,A04,179691,Klosterman; Jeremy K,18,0,24,6
1681906938329,CHEM 114A,A01,179693,Stallings; Dontarie M,77,0,100,23
1681906939355,CHEM 143B,A01,179698,Weizman; Haim,17,0,24,7
1681906939355,CHEM 143B,A02,179700,Weizman; Haim,24,0,24,0
1681906940383,CHIN 169A,A00,179701,Wang; Xiao,20,0,20,0
1681906941407,COGS 2,A01,179750,Boyle; Mary E. T.,17,0,30,13
1681906942439,COGS 9,A01,179759,Jones; Cameron Robert,43,0,50,7
1681906943472,COGS 14A,A01,179854,Staff,18,0,50,32
1681906944499,COGS 14B,A01,179856,Staff,54,0,60,6
1681906945526,COGS 17,A01,179874,Staff,71,0,75,4
1681906946548,COGS 18,A01,179884,Staff,63,0,80,17
1681906947574,COGS 100,A01,179886,Staff,40,0,60,20
1681906948601,COGS 101B,A01,179892,Staff,1,0,30,29
1681906949623,COGS 101C,A01,179894,Staff,28,0,30,2
1681906950653,COGS 107A,A01,179896,Boyle; Mary E. T.,31,0,40,9
1681906951678,COGS 108,A01,179898,Simpkins; Charles Alexander,0,17,60,60
1681906952704,COGS 109,A01,179900,Staff,34,0,40,6
1681906953730,COGS 118A,A01,179946,Staff,9,0,40,31
1681906954753,COGS 153,A00,179978,Staff,1,0,30,29
1681906955780,COGS 156,A01,179981,Staff,27,0,30,3
1681906957826,COGS 172,A01,179987,Staff,13,0,30,17
1681906959871,COGS 186,A01,179991,Staff,13,0,30,17
1681906960899,COMM 10,A01,180001,Staff,15,0,25,10
1681906960899,COMM 10,A02,180004,Staff,20,0,25,5
1681906961927,COMM 100A,A01,180016,Staff,18,0,25,7
1681906961927,COMM 100A,A02,180020,Staff,24,0,25,1
1681906962960,COMM 101T,A00,180029,Halm; Gavin Patrick,23,0,35,12
1681906963987,COMM 106V,A00,180043,Staff,34,0,35,1
1681906965011,COMM 109P,A00,180044,Staff,31,0,35,4
1681906966035,COMM 113T,A00,180045,Havis; Allan,37,0,45,8
1681906967059,COMM 132,A00,180046,McKenna; Denise,23,0,30,7
1681906968084,COMM 143,A00,180047,Staff,19,0,30,11
1681906969108,COMM 190,A00,180048,Conner; Thomas Hartnell,20,0,23,3
1681906970137,CSE 8A,A50,180053,Cao; Yingjun,25,0,50,25
1681906970137,CSE 8A,B50,180180,Staff,50,0,50,0
1681906971169,CSE 11,A01,180190,Cao; Yingjun,31,0,50,19
1681906972193,CSE 20,A01,180192,Briones; Jor-el Thomas Caparas,23,0,30,7
1681906973219,CSE 21,A01,194538,Briones; Jor-el Thomas Caparas,50,0,60,10
1681906974243,CSE 30,A01,180324,Eldon; John,79,0,100,21
1681906975270,CSE 101,A01,201353,Staff,0,20,40,40
1681906976295,CSE 134B,A01,180326,Powell; Thomas Allan,74,0,100,26
1681906977321,CSE 140,A01,180328,Staff,46,0,75,29
1681906978347,CSE 140L,A01,180344,Eldon; John,69,0,100,31
1681906979371,CSE 150A,A01,180411,Staff,0,7,50,50
1681906980398,CSE 151A,A01,180414,Staff,0,6,50,50
1681906981423,CSE 175,A01,222521,Kumar; Rakesh,50,0,50,0
1681906982446,CSE 190,A00,201419,Staff,45,0,49,4
1681906983471,CSS 1,A01,194536,Staff,38,0,50,12
1681906984494,DSC 30,A01,202385,Staff,48,0,50,2
1681906985518,DSC 40A,A01,202387,Albuyeh; Rod,50,0,50,0
1681906986556,DSC 190,A01,202389,Silberman; Jack,21,0,21,0
1681906987583,DSGN 100,A01,179993,Staff,16,0,30,14
1681906988614,ECE 65,A50,180708,Staff,10,0,20,10
1681906988614,ECE 65,A51,180739,Staff,19,0,20,1
1681906989640,ECON 1,A01,180427,Famulari; Melissa,67,0,70,3
1681906990663,ECON 2,A01,180450,Levkoff; Steven B.,64,0,70,6
1681906991694,ECON 4,A01,203351,Anderson; John Charles,7,0,10,3
1681906992723,ECON 100A,A01,180472,Famulari; Melissa,65,0,70,5
1681906993747,ECON 120A,A01,180549,Staff,64,0,70,6
1681906994773,ECON 120B,A01,180655,Ma; Xinwei,46,0,70,24
1681906995796,ECON 129,A00,203333,Eckert; Fabian Paul,15,0,35,20
1681906996820,ECON 131,A00,180656,Staff,10,0,35,25
1681906997848,ECON 172B,A01,180672,Levkoff; Steven B.,32,0,35,3
1681906998871,ECON 178,A01,203342,Zhu; Ying,11,0,35,24
1681906999899,EDS 108GS,A00,202383,Wishard Guerra; Alison G.,20,0,20,0
1681907000923,EDS 111GS,A00,202347,Wishard Guerra; Alison G.,20,0,20,0
1681907001947,EDS 112,A01,202323,Staff,56,0,60,4
1681907002970,EDS 113,A00,202340,Staff,33,0,35,2
1681907003996,EDS 118,A00,201231,Staff,20,0,30,10
1681907005033,EDS 119,A00,204994,Staff,8,0,10,2
1681907006056,EDS 124BR,A00,202324,Eguchi; Emi,5,0,25,20
1681907007083,EDS 126,A01,203208,Jones; Makeba,26,0,30,4
1681907008111,EDS 135,A01,202333,Staff,18,0,20,2
1681907009138,EDS 180,A00,202311,Staff,47,0,50,3
1681907010160,ERC 190GS,A01,253747,Staff,28,0,28,0
1681907011198,ETHN 104,A00,180742,Staff,24,0,35,11
1681907012221,ETHN 118,A00,180745,Staff,28,0,35,7
1681907013245,ETHN 127,A00,180747,Staff,12,0,16,4
1681907014269,ETHN 137,A00,180880,Staff,12,0,12,0
1681907015292,ETHN 147,A00,180890,Staff,8,0,10,2
1681907016324,ETHN 154,A00,180891,Staff,7,0,8,1
1681907017348,ETHN 168,A00,180892,Staff,9,0,10,1
1681907018380,GLBH 20,A00,201051,Hannah; Seth Donal,0,1,0,1
1681907019407,GLBH 111,A01,209338,Burgos; Jose L.,0,0,0,0
1681907020431,GLBH 150,A00,258300,Staff,0,3,0,0
1681907021454,GLBH 181,A00,201207,Staff,15,0,40,25
1681907022476,HIEU 109,A00,180898,Staff,20,0,20,0
1681907023502,HIEU 111,A00,180899,Staff,1,0,20,19
1681907024528,HIEU 124,A00,180900,Staff,18,0,20,2
1681907025631,HILA 122,A00,180901,Staff,18,0,20,2
1681907026659,HILA 132,A00,180902,Vitz; Matthew,2,0,20,18
1681907027687,HILD 10,A01,180896,Staff,15,0,20,5
1681907028710,HILD 30GS,A00,180897,Edington; Claire Ellen,0,0,0,0
1681907029733,HISC 105,A00,180903,Staff,20,0,20,0
1681907030765,HISC 117,A00,180904,Staff,11,0,20,9
1681907031793,HIUS 108B,A00,181005,Staff,18,0,20,2
1681907032820,HIUS 113,A00,181093,Staff,4,0,20,16
1681907033849,HUM 3,A01,181190,Patterson; Patrick H.,40,0,50,10
1681907033849,HUM 3,B01,181195,Staff,47,0,50,3
1681907034871,HUM 3GS,A00,181196,Herbst; Matthew,0,0,0,0
1681907035904,HUM 4,A01,181227,West; Geoffrey Scott,34,0,50,16
1681907035904,HUM 4,B01,181282,Staff,43,0,50,7
1681907036938,HUM 4GS,A00,181377,Lyon; Antony J.,0,0,0,0
1681907037966,HUM 5,A01,181536,Zavodny; Tatiana Sophia,31,0,50,19
1681907037966,HUM 5,B01,181908,Staff,36,0,50,14
1681907038994,INTL 190,A00,181909,Segui; Alan S,0,0,0,6
1681907038994,INTL 190,B00,181961,Segui; Alan S,0,0,0,7
1681907040033,JAPN 20AR,A01,182113,Ross; Kayoko F,15,0,20,5
1681907041057,LATI 50,A01,202391,Martin-Cabrera; Luis,19,0,30,11
1681907041057,LATI 50,A02,202392,Martin-Cabrera; Luis,26,0,30,4
1681907042090,LATI 180,A00,202393,Kokinis; Troy Andreas,25,0,25,0
1681907043118,LIFR 1A,A00,182119,Staff,14,0,14,0
1681907044142,LIFR 1AX,A00,182324,Staff,14,0,14,0
1681907045166,LIFR 1B,A00,182259,Staff,14,0,14,0
1681907046190,LIFR 1BX,A00,182273,Staff,14,0,14,0
1681907047218,LIGN 8,A00,182330,Staff,137,0,150,13
1681907048243,LIGN 9GS,A00,182362,Staff,20,0,20,0
1681907049268,LIGN 119,A00,204992,Takahashi; Maho,12,0,15,3
1681907050296,LIGN 130,A01,182384,Staff,47,0,50,3
1681907051323,LIGN 149GS,A00,182390,Staff,20,0,20,0
1681907052350,LIGN 170,A00,182404,Staff,24,0,30,6
1681907053376,LISP 1D,A00,182281,Staff,7,0,14,7
1681907053376,LISP 1D,B00,182287,Staff,14,0,14,0
1681907053376,LISP 1D,C00,182295,Staff,11,0,14,3
1681907053376,LISP 1D,D00,182301,Staff,14,0,14,0
1681907054400,LISP 1DX,A00,182309,Staff,20,0,28,8
1681907054400,LISP 1DX,B00,182316,Staff,26,0,28,2
1681907055427,LTAF 120GS,A00,182412,Zhiri; Oumelbanine,20,0,20,0
1681907056455,LTCS 172GS,A00,182437,Bronstein; Phoebe Malan,20,0,20,0
1681907057479,LTEA 138,A00,182457,Staff,22,0,40,18
1681907058510,LTEN 114,A01,182490,Staff,23,0,25,2
1681907059533,LTEN 130GS,A00,182491,Lyon; Antony J.,20,0,20,0
1681907060560,LTEN 169,A00,182493,Cuong; Marisol,20,0,25,5
1681907061583,LTEN 178,A00,182501,Staff,14,0,15,1
1681907062611,LTEN 181,A00,182515,Staff,22,0,25,3
1681907063634,LTEN 185GS,A00,197655,Forbes; Camille,20,0,20,0
1681907064659,LTSP 100B,A00,202208,Bessett; Ryan Matthew,24,0,25,1
1681907065687,LTWL 100,A00,182516,Myerston Santana; Jacobo,23,0,30,7
1681907066714,LTWR 100GS,A00,182518,Forbes; Camille,20,0,20,0
1681907067738,LTWR 102,A00,182522,Staff,15,0,15,0
1681907067738,LTWR 102,B00,182525,Staff,14,0,15,1
1681907068763,LTWR 115,A00,182526,Staff,12,0,15,3
1681907069786,MAE 8,A01,182528,Pham; Hieu Tan,68,0,70,2
1681907070820,MAE 11,A00,182529,Bahadori; Mohammad Yousef,94,0,100,6
1681907071851,MAE 20,A00,182530,Evdokimenko; Ekaterina,68,0,70,2
1681907072880,MAE 30A,A00,182532,Staff,44,0,45,1
1681907073905,MAE 101A,A00,182533,Bahadori; Mohammad Yousef,97,0,100,3
1681907074930,MAE 101C,A00,182538,Staff,62,0,70,8
1681907075966,MAE 104,A00,182539,Staff,45,0,50,5
1681907076990,MAE 131A,A00,182540,Ghazinejad; Maziar,41,0,45,4
1681907078022,MAE 143A,A00,182548,Bewley; Thomas R,43,0,50,7
1681907079046,MAE 150,A00,182549,Staff,28,0,40,12
1681907080070,MAE 160,A00,182550,Evdokimenko; Ekaterina,43,0,60,17
1681907081096,MATH 3C,A01,182725,Staff,27,0,30,3
1681907082119,MATH 10A,A01,182729,Staff,25,0,30,5
1681907082119,MATH 10A,B01,182732,Staff,26,0,30,4
1681907083144,MATH 10B,A01,182737,Staff,21,0,30,9
1681907083144,MATH 10B,A02,182738,Staff,27,0,30,3
1681907083144,MATH 10B,B01,182744,Staff,27,0,30,3
1681907083144,MATH 10B,B02,182745,Staff,27,0,30,3
1681907084176,MATH 18,A01,182750,Anzaldo; Leesa B,28,0,30,2
1681907084176,MATH 18,A02,182751,Anzaldo; Leesa B,29,0,30,1
1681907084176,MATH 18,A03,182753,Anzaldo; Leesa B,28,0,30,2
1681907084176,MATH 18,A04,182757,Anzaldo; Leesa B,29,0,30,1
1681907084176,MATH 18,B01,182761,Anzaldo; Leesa B,27,0,30,3
1681907084176,MATH 18,B02,182764,Anzaldo; Leesa B,27,0,30,3
1681907084176,MATH 18,B03,182765,Anzaldo; Leesa B,30,0,30,0
1681907084176,MATH 18,B04,182766,Anzaldo; Leesa B,30,0,30,0
1681907085199,MATH 20A,A01,182771,Suk; Andrew Hoon,28,0,30,2
1681907086230,MATH 20B,A01,182775,Bach; Quang Tran,30,0,30,0
1681907086230,MATH 20B,A02,182777,Bach; Quang Tran,29,0,30,1
1681907086230,MATH 20B,B01,182780,Bach; Quang Tran,27,0,30,3
1681907086230,MATH 20B,B02,182782,Bach; Quang Tran,30,0,30,0
1681907087257,MATH 20C,A01,182787,Staff,25,0,30,5
1681907087257,MATH 20C,A02,182790,Staff,29,0,30,1
1681907087257,MATH 20C,B01,182792,Staff,25,0,30,5
1681907087257,MATH 20C,B02,182796,Staff,27,0,30,3
1681907088287,MATH 20D,A01,182799,Staff,29,0,30,1
1681907088287,MATH 20D,A02,182802,Staff,30,0,30,0
1681907088287,MATH 20D,A03,182803,Staff,30,0,30,0
1681907089311,MATH 20E,A01,182809,Verstraete; Jacques Allan,24,0,30,6
1681907089311,MATH 20E,A02,182811,Verstraete; Jacques Allan,28,0,30,2
1681907089311,MATH 20E,B01,182814,Verstraete; Jacques Allan,23,0,30,7
1681907089311,MATH 20E,B02,182815,Verstraete; Jacques Allan,30,0,30,0
1681907090346,MATH 103A,A01,182820,Staff,9,0,30,21
1681907090346,MATH 103A,A02,182821,Staff,27,0,30,3
1681907090346,MATH 103A,A03,182822,Staff,23,0,30,7
1681907090346,MATH 103A,B01,182825,Staff,23,0,30,7
1681907090346,MATH 103A,B02,182826,Staff,30,0,30,0
1681907090346,MATH 103A,B03,182830,Staff,30,0,30,0
1681907091379,MATH 109,A01,182836,Chow; Bennett,24,0,30,6
1681907091379,MATH 109,A02,182838,Chow; Bennett,29,0,30,1
1681907091379,MATH 109,A03,182894,Chow; Bennett,29,0,30,1
1681907091379,MATH 109,B01,182908,Chow; Bennett,28,0,30,2
1681907091379,MATH 109,B02,182909,Chow; Bennett,30,0,30,0
1681907091379,MATH 109,B03,182910,Chow; Bennett,27,0,30,3
1681907092407,MATH 142A,A01,182925,Staff,11,0,30,19
1681907092407,MATH 142A,A02,182935,Staff,25,0,30,5
1681907092407,MATH 142A,A03,182967,Staff,26,0,30,4
1681907092407,MATH 142A,B01,183125,Staff,24,0,30,6
1681907092407,MATH 142A,B02,183157,Staff,28,0,30,2
1681907092407,MATH 142A,B03,183158,Staff,29,0,30,1
1681907093437,MATH 183,A01,183160,Arias-Castro; Ery,23,0,30,7
1681907093437,MATH 183,A02,183161,Arias-Castro; Ery,29,0,30,1
1681907093437,MATH 183,B01,183163,Arias-Castro; Ery,28,0,30,2
1681907093437,MATH 183,B02,183164,Arias-Castro; Ery,28,0,30,2
1681907094462,MATH 193A,A01,183167,Staff,4,0,35,31
1681907094462,MATH 193A,A02,183168,Staff,28,0,35,7
1681907094462,MATH 193A,A03,183169,Staff,34,0,35,1
1681907094462,MATH 193A,A04,183170,Staff,28,0,35,7
1681907095488,MGT 4,A01,202395,Anderson; John Charles,75,0,80,5
1681907096522,MGT 5,A00,202396,Houskeeper; Robert,80,0,90,10
1681907097547,MGT 103,A00,202397,Eberhard; Craig A,55,0,90,35
1681907098573,MGT 131A,A00,202398,Houskeeper; Robert,85,0,90,5
1681907099600,MGT 135,A00,202399,Anderson; John Charles,83,0,90,7
1681907100628,MGT 162R,A00,202403,Gneezy; Uri,150,0,200,50
1681907101656,MGT 172,A00,202404,Hedges; Kathleen,50,0,90,40
1681907102681,MGT 181,A00,202405,Dunn; Louis Jean,84,0,90,6
1681907103708,MMW 14,A01,183200,Staff,16,0,28,12
1681907103708,MMW 14,A02,183201,Staff,26,0,28,2
1681907103708,MMW 14,A03,183202,Staff,24,0,28,4
1681907103708,MMW 14,A04,183203,Staff,25,0,28,3
1681907103708,MMW 14,A05,183204,Staff,26,0,28,2
1681907103708,MMW 14,A06,183205,Staff,27,0,28,1
1681907103708,MMW 14,B01,183207,Staff,26,0,28,2
1681907103708,MMW 14,B02,183208,Staff,28,0,28,0
1681907103708,MMW 14,B03,183209,Staff,28,0,28,0
1681907103708,MMW 14,B04,183210,Staff,28,0,28,0
1681907103708,MMW 14,B05,183211,Staff,28,0,28,0
1681907103708,MMW 14,B06,183212,Staff,28,0,28,0
1681907104730,MMW 14GS,A00,183213,Zhiri; Oumelbanine,28,0,28,0
1681907105761,MMW 15GS,B00,183215,Rahimi; Babak,28,0,28,0
1681907106790,MMW 121,A01,183217,Patterson; Patrick H.,14,0,28,14
1681907106790,MMW 121,A02,183218,Patterson; Patrick H.,25,0,28,3
1681907107813,MUS 1A,A01,182554,Staff,8,0,35,27
1681907108840,MUS 5,A01,182558,Staff,20,0,35,15
1681907109863,MUS 6,A01,182562,Staff,25,0,35,10
1681907110886,MUS 8GS,A00,182563,Borgo; David Garcia,25,0,25,0
1681907111916,MUS 13,A01,182567,Staff,24,0,25,1
1681907112939,MUS 15,A01,182570,Staff,32,0,35,3
1681907112939,MUS 15,B01,182575,Staff,10,0,35,25
1681907113964,MUS 80,A00,182578,Staff,23,0,25,2
1681907113964,MUS 80,B00,182581,Staff,20,0,25,5
1681907114998,MUS 113,A00,182582,Staff,25,0,25,0
1681907116026,MUS 114,A00,182583,Staff,4,0,25,21
1681907117050,MUS 150GS,A01,182588,Borgo; David Garcia,25,0,25,0
1681907118074,PHIL 1,A00,182590,Staff,35,0,40,5
1681907119103,PHIL 10,A01,182596,Grush; Rick Scott,31,0,35,4
1681907119103,PHIL 10,A02,182597,Grush; Rick Scott,34,0,35,1
1681907120133,PHIL 15,A01,182601,Staff,31,0,35,4
1681907120133,PHIL 15,A02,182602,Staff,33,0,35,2
1681907121158,PHIL 27,A01,182604,Staff,30,0,35,5
1681907121158,PHIL 27,A02,182607,Staff,35,0,35,0
1681907122181,PHIL 32,A01,182609,Staff,35,0,35,0
1681907122181,PHIL 32,A02,182612,Staff,35,0,35,0
1681907123204,PHIL 130,A00,182614,Staff,63,0,70,7
1681907124233,PHIL 136,A00,182616,Cohen; Jonathan David,66,0,70,4
1681907125257,PHIL 155,A00,182617,Vargas; Manuel Rogelio,60,0,70,10
1681907126285,PHIL 163,A01,182620,Staff,15,0,20,5
1681907126285,PHIL 163,A02,182624,Staff,10,0,20,10
1681907127314,PHIL 164,A00,182627,Staff,30,0,40,10
1681907128338,PHIL 173,A00,182628,Staff,36,0,40,4
1681907129454,PHYS 1A,A00,183221,Staff,54,0,60,6
1681907130484,PHYS 1AL,001,183222,Staff,25,0,30,5
1681907130484,PHYS 1AL,002,183223,Staff,28,0,30,2
1681907131513,PHYS 1B,A00,183231,Staff,44,0,60,16
1681907132542,PHYS 1BL,001,183232,Staff,20,0,30,10
1681907132542,PHYS 1BL,002,183233,Staff,29,0,30,1
1681907133565,PHYS 1C,A00,183240,Staff,30,0,60,30
1681907134589,PHYS 1CL,001,183241,Staff,13,0,30,17
1681907134589,PHYS 1CL,002,183242,Staff,22,0,30,8
1681907135617,PHYS 2AR,A01,183250,Staff,44,0,50,6
1681907136645,PHYS 2B,A01,183252,Staff,106,0,115,9
1681907137673,PHYS 2BL,A01,183254,Staff,21,0,24,3
1681907137673,PHYS 2BL,A02,183255,Staff,22,0,24,2
1681907138696,PHYS 2C,A01,183522,Staff,105,0,115,10
1681907139721,PHYS 4A,A01,183524,Staff,49,0,50,1
1681907140746,POLI 5,A00,183525,Staff,44,0,50,6
1681907141768,POLI 12,A00,183540,Staff,48,0,50,2
1681907142792,POLI 13R,A00,183541,Forman; Fonna,42,0,50,8
1681907143817,POLI 30,A00,183542,Mignozzetti; Umberto,47,0,50,3
1681907144841,POLI 100A,A00,183543,Staff,45,0,50,5
1681907145864,POLI 100E,A00,223598,Staff,32,0,35,3
1681907146894,POLI 103A,A00,183564,Kousser; Thad,38,0,50,12
1681907147918,POLI 104B,A00,201329,Staff,29,0,35,6
1681907148957,POLI 113BR,A00,183576,Hoston; Germaine,28,0,50,22
1681907149985,POLI 114BR,A00,183588,Staff,27,0,30,3
1681907151011,POLI 117R,A00,183595,Forman; Fonna,9,0,20,11
1681907152048,POLI 120H,A00,183596,Fisk; David Lee,13,0,20,7
1681907153073,POLI 130AA,A00,183597,Staff,14,0,20,6
1681907154105,POLI 134AA,A00,183598,Staff,19,0,20,1
1681907155133,POLI 135,A00,183599,Fisk; David Lee,20,0,25,5
1681907156159,POLI 142P,A00,183623,Staff,37,0,40,3
1681907157186,POLI 144D,A00,183624,Staff,22,0,25,3
1681907158214,POLI 151,A00,183625,Staff,15,0,20,5
1681907159242,POLI 162,A00,183626,Mignozzetti; Umberto,18,0,20,2
1681907160269,PSYC 1,A00,253748,Staff,86,0,90,4
1681907161308,PSYC 2,A00,183627,Moranton; Nirelia Melbina-,25,0,35,10
1681907162331,PSYC 3,A00,183628,Staff,43,0,45,2
1681907164378,PSYC 60,A01,183631,Lowe; Angela Beth,35,0,40,5
1681907165406,PSYC 70,A01,253757,Staff,37,0,45,8
1681907166432,PSYC 101,A00,183632,Heyman; Gail D.,48,0,60,12
1681907167455,PSYC 105,A00,183848,Lowe; Angela Beth,50,0,60,10
1681907168478,PSYC 106,A00,183849,Dobkins; Karen R.,45,0,60,15
1681907169507,PSYC 108,A00,253750,Staff,24,0,60,36
1681907170532,PSYC 114,A01,184275,Winkielman; Piotr,0,6,30,30
1681907171559,PSYC 122,A00,183856,Moranton; Nirelia Melbina-,0,10,30,30
1681907172586,PSYC 124,A00,183865,Chapman; Eddie Nathaniel,52,0,80,28
1681907173613,PSYC 137,A00,183880,Staff,19,0,25,6
1681907175659,PSYC 154,A00,183910,Lacefield; Katharine I,0,2,90,90
1681907177710,PSYC 162,A00,183946,Wixted; John T,61,0,90,29
1681907178736,PSYC 172,A00,183947,Gorman; Michael R.,14,0,30,16
1681907179763,PSYC 178,A00,183963,Glaser; Dale,20,0,40,20
1681907180788,PSYC 181GS,A00,183964,Anagnostaras; Stephan,10,0,10,0
1681907181811,PSYC 186GS,A01,257660,Staff,10,0,10,0
1681907182839,PSYC 193,B00,253749,Staff,23,0,25,2
1681907184895,PSYC 193L,A01,184122,Staff,33,0,35,2
1681907184895,PSYC 193L,C01,184167,Winkielman; Piotr,16,0,30,14
1681907185923,RELI 188GS,A00,182629,Rahimi; Babak,20,0,20,0
1681907186947,SE 101A,A00,182646,Staff,26,0,30,4
1681907187974,SE 101C,A00,182650,Staff,18,0,20,2
1681907189007,SE 110A,A00,182651,Staff,28,0,28,0
1681907190032,SE 130A,A00,182652,Staff,39,0,40,1
1681907191057,SIO 46GS,A00,182636,Cook; Geoffrey W,28,0,28,0
1681907192085,SIO 109R,A00,194459,Staff,5,0,20,15
1681907193113,SIO 121GS,A00,182639,Cook; Geoffrey W,28,0,28,0
1681907194140,SIO 132,A01,182642,Staff,32,0,40,8
1681907195168,SIO 139,A00,182644,Kacev; David,36,0,40,4
1681907196196,SOCI 2,A01,258404,Staff,34,0,36,2
1681907196196,SOCI 2,A02,258405,Staff,35,0,36,1
1681907197226,SOCI 60,A01,258408,Staff,29,0,30,1
1681907197226,SOCI 60,A02,258413,Staff,30,0,30,0
1681907198256,SOCI 100,A01,258415,Staff,29,0,30,1
1681907198256,SOCI 100,A02,258416,Staff,28,0,30,2
1681907204429,SOCI 127,A00,258421,Staff,22,0,30,8
1681907205456,SOCI 132,A00,258422,Staff,45,0,50,5
1681907206481,SOCI 133,A00,258423,Staff,26,0,30,4
1681907207505,SOCI 138GS,A00,258424,Staff,15,0,15,0
1681907208539,SOCI 145,A00,258425,Staff,25,0,30,5
1681907209566,SOCI 148,A00,258426,Staff,26,0,30,4
1681907210593,SOCI 153,A00,199217,Staff,29,0,30,1
1681907211619,SOCI 160,A00,258427,Staff,28,0,30,2
1681907212642,SOCI 160E,A00,258435,Staff,56,0,60,4
1681907213668,SOCI 189GS,A00,258436,Staff,15,0,15,0
1681907214692,SOCI 190GS,A00,258437,Staff,15,0,15,0
1681907215725,SYN 2,001,182658,Staff,9,0,16,7
1681907215725,SYN 2,002,201439,Staff,15,0,16,1
1681907215725,SYN 2,003,201443,Staff,16,0,16,0
1681907216749,SYN 100,A01,182657,Staff,17,0,20,3
1681907217785,TDAC 1,A00,184381,Salovey; Todd,16,0,20,4
1681907217785,TDAC 1,B00,184385,Harting; Carla Kelso,19,0,20,1
1681907217785,TDAC 1,C00,184394,Staff,19,0,20,1
1681907218808,TDAC 101,A00,184483,Harting; Carla Kelso,19,0,20,1
1681907219837,TDDE 111,A00,184496,Staff,14,0,15,1
1681907220867,TDDE 131,A00,184504,Staff,20,0,20,0
1681907220867,TDDE 131,B00,184505,Staff,17,0,18,1
1681907220867,TDDE 131,C00,184534,Staff,49,0,50,1
1681907220867,TDDE 131,D00,184564,Staff,15,0,15,0
1681907220867,TDDE 131,E00,204725,Staff,19,0,20,1
1681907221893,TDGE 1,A01,184414,Salovey; Todd,37,0,50,13
1681907222920,TDGE 5,A01,184419,Staff,23,0,24,1
1681907223945,TDGE 10,A00,184428,Fulton; Julia,31,0,50,19
1681907224973,TDGE 124,A00,184565,Fulton; Julia,7,0,50,43
1681907225998,TDGE 125,B00,184567,Meyer; Ursula,9,0,25,16
1681907227031,TDHT 101,A00,184568,Staff,21,0,25,4
1681907227031,TDHT 101,B00,184569,Staff,20,0,20,0
1681907228055,TDHT 114,A00,184570,Staff,49,0,50,1
1681907229080,TDMV 1,A00,184437,Arcidiacono; Kristin,23,0,30,7
1681907229080,TDMV 1,B00,184448,Caligagan; Maria T.,22,0,30,8
1681907230104,TDMV 2,A00,184449,Weinberg; Sadie,27,0,30,3
1681907230104,TDMV 2,B00,184453,Arcidiacono; Kristin,29,0,30,1
1681907231129,TDMV 110,A00,184571,Weinberg; Sadie,30,0,30,0
1681907232159,TDMV 142,A00,184572,Caligagan; Tony,27,0,30,3
1681907232159,TDMV 142,B00,184573,Caligagan; Maria T.,27,0,30,3
1681907233263,TDTR 20,A00,184482,Jun; Grace Shin Hae,25,0,25,0
1681907234290,USP 2,A01,184290,Hinds; Juli Beth,24,0,25,1
1681907235317,USP 3,A01,184295,Staff,20,0,25,5
1681907236343,USP 4,A00,184304,McTague; Sarah,15,0,25,10
1681907237367,USP 100,A00,184315,Staff,17,0,25,8
1681907238401,USP 105,A00,184326,Staff,21,0,25,4
1681907239428,USP 151,A00,184327,Staff,20,0,25,5
1681907240453,USP 170,A00,184380,Hinds; Juli Beth,14,0,25,11
1681907241481,VIS 21B,A01,182660,Staff,28,0,31,3
1681907241481,VIS 21B,A02,182662,Staff,30,0,31,1
1681907242508,VIS 103D,A00,182663,Staff,74,0,75,1
1681907243531,VIS 105D,A00,182667,Li; Huai,15,0,22,7
1681907244564,VIS 122GS,A00,182668,Herbst; Matthew,20,0,20,0
1681907245600,VIS 128C,A00,182673,Staff,70,0,75,5
1681907246624,VIS 130,A00,182675,Staff,20,0,22,2
1681907247660,VIS 160A,A00,182678,Stalbaum; Brett,4,0,10,6
1681907249732,WCWP 10B,A00,201679,Staff,15,0,15,0
1681907249732,WCWP 10B,B00,201695,Staff,15,0,15,0
1681907250767,WCWP 100,A00,201716,Staff,15,0,15,0
1681907250767,WCWP 100,B00,201717,Staff,11,0,15,4
1681907252866,ANSC 105GS,A00,258289,Staff,0,0,0,0
1681907253889,ANSC 125GS,A00,258295,Staff,0,0,0,0
1681907254917,ANSC 150,A00,258267,Staff,30,0,40,10
1681907255945,ANSC 190GS,A00,258280,Staff,0,0,0,0
1681907256970,ANTH 1,A00,258264,Staff,38,0,40,2
1681907257999,ANTH 2,A01,258259,Staff,72,0,76,4
1681907259035,ANTH 23,A01,258228,Staff,36,0,40,4
1681907260066,ANTH 101,A01,258236,Staff,39,0,40,1
1681907261089,ANTH 102,A00,258272,Staff,59,0,60,1
1681907262114,ANTH 105,A00,258244,Staff,31,0,35,4
1681907263143,BENG 130,A00,253975,Staff,38,0,40,2
1681907264175,BIBC 102,A01,191866,Flagg; Matthew Paul,19,0,32,13
1681907264175,BIBC 102,A02,191867,Flagg; Matthew Paul,22,0,32,10
1681907264175,BIBC 102,A03,191868,Flagg; Matthew Paul,30,0,32,2
1681907264175,BIBC 102,A04,191936,Flagg; Matthew Paul,26,0,32,6
1681907264175,BIBC 102,A05,191937,Flagg; Matthew Paul,11,0,32,21
1681907265200,BICD 100,A01,191939,Cooper; Andrew Michael,28,0,32,4
1681907265200,BICD 100,A02,191940,Cooper; Andrew Michael,32,0,32,0
1681907265200,BICD 100,A03,191941,Cooper; Andrew Michael,32,0,32,0
1681907265200,BICD 100,A04,191942,Cooper; Andrew Michael,32,0,32,0
1681907265200,BICD 100,A05,191943,Cooper; Andrew Michael,32,0,32,0
1681907266224,BIEB 126,A01,191945,Cleland; Elsa Eleanor,1,0,32,31
1681907266224,BIEB 126,A02,191946,Cleland; Elsa Eleanor,28,0,32,4
1681907266224,BIEB 126,A03,191947,Cleland; Elsa Eleanor,29,0,32,3
1681907266224,BIEB 126,A04,191948,Cleland; Elsa Eleanor,23,0,32,9
1681907266224,BIEB 126,A05,191996,Cleland; Elsa Eleanor,28,0,32,4
1681907267249,BIEB 136GS,A00,191997,Shurin; Jonathan & Holway; David A.,0,0,0,0
1681907268280,BIEB 137GS,A01,191999,Shurin; Jonathan & Holway; David A.,0,0,0,0
1681907269309,BILD 1,A01,205385,Staff,31,0,32,1
1681907269309,BILD 1,A02,205386,Staff,30,0,32,2
1681907269309,BILD 1,A03,205387,Staff,32,0,32,0
1681907269309,BILD 1,A04,205388,Staff,28,0,32,4
1681907270333,BILD 2,A01,191774,Staff,28,0,32,4
1681907270333,BILD 2,A02,191775,Staff,30,0,32,2
1681907270333,BILD 2,A03,191777,Staff,30,0,32,2
1681907270333,BILD 2,A04,191856,Staff,31,0,32,1
1681907270333,BILD 2,A05,191857,Staff,32,0,32,0
1681907270333,BILD 2,A06,191858,Staff,32,0,32,0
1681907270333,BILD 2,A07,191859,Staff,31,0,32,1
1681907271358,BILD 3,A01,205391,Staff,29,0,32,3
1681907271358,BILD 3,A02,205393,Staff,32,0,32,0
1681907271358,BILD 3,A03,205394,Staff,28,0,32,4
1681907271358,BILD 3,A04,205395,Staff,32,0,32,0
1681907272381,BILD 20,A01,191861,Staff,32,0,32,0
1681907272381,BILD 20,A02,191862,Staff,32,0,32,0
1681907273417,BILD 30,A01,191864,Staff,31,0,32,1
1681907274442,BIMM 100,A01,192019,Staff,0,0,32,32
1681907274442,BIMM 100,A02,192020,Staff,23,0,32,9
1681907274442,BIMM 100,A03,192035,Staff,22,0,32,10
1681907275469,BIMM 110,A01,192037,Tat; John,0,0,32,32
1681907275469,BIMM 110,A02,192038,Tat; John,10,0,32,22
1681907276496,BIMM 120,A01,192040,Pickett; Brooke Elizabeth,2,0,32,30
1681907276496,BIMM 120,A02,192041,Pickett; Brooke Elizabeth,16,0,32,16
1681907276496,BIMM 120,A03,192042,Pickett; Brooke Elizabeth,16,0,32,16
1681907277521,BIPN 100,A01,192044,Armour; Jon Christopher,26,0,32,6
1681907277521,BIPN 100,A02,192059,Armour; Jon Christopher,30,0,32,2
1681907277521,BIPN 100,A03,192064,Armour; Jon Christopher,31,0,32,1
1681907277521,BIPN 100,A04,192073,Armour; Jon Christopher,28,0,32,4
1681907278553,BIPN 148,A01,205411,Leutgeb; Jill K.,16,0,32,16
1681907278553,BIPN 148,A02,205412,Leutgeb; Jill K.,31,0,32,1
1681907278553,BIPN 148,A03,205413,Leutgeb; Jill K.,30,0,32,2
1681907278553,BIPN 148,A04,205414,Leutgeb; Jill K.,30,0,32,2
1681907279578,BIPN 160,A01,192115,Marino; Marc J,19,0,32,13
1681907279578,BIPN 160,A02,192148,Marino; Marc J,27,0,32,5
1681907279578,BIPN 160,A03,192158,Marino; Marc J,31,0,32,1
1681907279578,BIPN 160,A04,192190,Marino; Marc J,32,0,32,0
1681907279578,BIPN 160,A05,192287,Marino; Marc J,32,0,32,0
1681907279578,BIPN 160,A06,192288,Marino; Marc J,32,0,32,0
1681907280610,BIPN 194,A00,206038,Staff,28,0,32,4
1681907281643,BISP 194,A00,192289,Leutgeb; Stefan,13,0,32,19
1681907281643,BISP 194,B00,245332,Nieh; James Charles,27,0,32,5
1681907282678,CAT 124,A01,202247,Staff,15,0,15,0
1681907283708,CAT 125,A00,202248,Staff,19,0,20,1
1681907283708,CAT 125,B00,202253,Staff,20,0,20,0
1681907283708,CAT 125,C00,202257,Staff,19,0,20,1
1681907284740,CAT 125GS,A01,202273,Bronstein; Phoebe Malan,20,0,20,0
1681907285766,CAT 125R,A00,202284,Staff,17,0,20,3
1681907285766,CAT 125R,C00,202286,Staff,10,0,20,10
1681907285766,CAT 125R,D00,202291,Staff,18,0,20,2
1681907285766,CAT 125R,E00,202295,Staff,13,0,20,7
1681907285766,CAT 125R,F00,202302,Staff,12,0,20,8
1681907286790,CENG 100,A00,204724,Opatkiewicz; Justin Paul,25,0,25,0
1681907287825,CGS 2A,A01,180420,Staff,31,0,36,5
1681907288851,CGS 101,A00,180421,Staff,16,0,20,4
1681907289877,CGS 112,A00,180422,Staff,10,0,16,6
1681907290904,CGS 113,A00,180423,Staff,18,0,20,2
1681907291927,CGS 137,A00,180424,Staff,12,0,12,0
1681907292950,CGS 147,A00,180425,Staff,10,0,10,0
1681907293979,CHEM 6A,A01,179556,Staff,97,0,100,3
1681907293979,CHEM 6A,A02,179558,Staff,0,0,0,0
1681907295004,CHEM 6B,A01,179560,Staff,100,0,100,0
1681907296029,CHEM 6C,A01,179565,Jazzar; Rodolphe,95,0,100,5
1681907297064,CHEM 7L,A01,179586,Schurmeier; Kimberly,13,0,24,11
1681907297064,CHEM 7L,A02,179587,Schurmeier; Kimberly,23,0,24,1
1681907297064,CHEM 7L,A03,179590,Schurmeier; Kimberly,22,0,24,2
1681907297064,CHEM 7L,A04,179591,Schurmeier; Kimberly,22,0,24,2
1681907297064,CHEM 7L,B01,179598,Schurmeier; Kimberly,17,0,24,7
1681907297064,CHEM 7L,B02,179599,Schurmeier; Kimberly,24,0,24,0
1681907297064,CHEM 7L,B03,179606,Schurmeier; Kimberly,23,0,24,1
1681907297064,CHEM 7L,B04,179607,Schurmeier; Kimberly,23,0,24,1
1681907298092,CHEM 11,A01,179609,Stallings; Dontarie M,88,0,100,12
1681907299118,CHEM 40A,A01,179621,Staff,41,0,50,9
1681907299118,CHEM 40A,A02,179622,Staff,47,0,50,3
1681907300147,CHEM 40B,A01,179630,Weizman; Haim,48,0,50,2
1681907300147,CHEM 40B,A02,179631,Weizman; Haim,45,0,50,5
1681907301172,CHEM 41A,A01,179660,Klosterman; Jeremy K,93,0,100,7
1681907302205,CHEM 43A,A01,179683,Klosterman; Jeremy K,0,0,24,24
1681907302205,CHEM 43A,A02,179688,Klosterman; Jeremy K,14,0,24,10
1681907302205,CHEM 43A,A03,179689,Klosterman; Jeremy K,20,0,24,4
1681907302205,CHEM 43A,A04,179691,Klosterman; Jeremy K,18,0,24,6
1681907303230,CHEM 114A,A01,179693,Stallings; Dontarie M,77,0,100,23
1681907304264,CHEM 143B,A01,179698,Weizman; Haim,17,0,24,7
1681907304264,CHEM 143B,A02,179700,Weizman; Haim,24,0,24,0
1681907305288,CHIN 169A,A00,179701,Wang; Xiao,20,0,20,0
1681907306313,COGS 2,A01,179750,Boyle; Mary E. T.,17,0,30,13
1681907307342,COGS 9,A01,179759,Jones; Cameron Robert,43,0,50,7
1681907308372,COGS 14A,A01,179854,Staff,18,0,50,32
1681907309398,COGS 14B,A01,179856,Staff,54,0,60,6
1681907310433,COGS 17,A01,179874,Staff,71,0,75,4
1681907311457,COGS 18,A01,179884,Staff,63,0,80,17
1681907312482,COGS 100,A01,179886,Staff,40,0,60,20
1681907313508,COGS 101B,A01,179892,Staff,1,0,30,29
1681907314538,COGS 101C,A01,179894,Staff,28,0,30,2
1681907315571,COGS 107A,A01,179896,Boyle; Mary E. T.,31,0,40,9
1681907316600,COGS 108,A01,179898,Simpkins; Charles Alexander,0,17,60,60
1681907317623,COGS 109,A01,179900,Staff,34,0,40,6
1681907318646,COGS 118A,A01,179946,Staff,9,0,40,31
1681907319669,COGS 153,A00,179978,Staff,1,0,30,29
1681907320703,COGS 156,A01,179981,Staff,27,0,30,3
1681907322752,COGS 172,A01,179987,Staff,13,0,30,17
1681907324806,COGS 186,A01,179991,Staff,13,0,30,17
1681907325830,COMM 10,A01,180001,Staff,15,0,25,10
1681907325830,COMM 10,A02,180004,Staff,20,0,25,5
1681907326854,COMM 100A,A01,180016,Staff,18,0,25,7
1681907326854,COMM 100A,A02,180020,Staff,24,0,25,1
1681907327877,COMM 101T,A00,180029,Halm; Gavin Patrick,23,0,35,12
1681907328900,COMM 106V,A00,180043,Staff,34,0,35,1
1681907329923,COMM 109P,A00,180044,Staff,31,0,35,4
1681907330950,COMM 113T,A00,180045,Havis; Allan,37,0,45,8
1681907331972,COMM 132,A00,180046,McKenna; Denise,23,0,30,7
1681907332997,COMM 143,A00,180047,Staff,19,0,30,11
1681907334022,COMM 190,A00,180048,Conner; Thomas Hartnell,20,0,23,3
1681907335055,CSE 8A,A50,180053,Cao; Yingjun,25,0,50,25
1681907335055,CSE 8A,B50,180180,Staff,50,0,50,0
1681907336083,CSE 11,A01,180190,Cao; Yingjun,31,0,50,19
1681907337203,CSE 20,A01,180192,Briones; Jor-el Thomas Caparas,23,0,30,7
1681907338229,CSE 21,A01,194538,Briones; Jor-el Thomas Caparas,50,0,60,10
1681907339252,CSE 30,A01,180324,Eldon; John,79,0,100,21
1681907340280,CSE 101,A01,201353,Staff,0,20,40,40
1681907341354,CSE 134B,A01,180326,Powell; Thomas Allan,74,0,100,26
1681907342378,CSE 140,A01,180328,Staff,46,0,75,29
1681907343402,CSE 140L,A01,180344,Eldon; John,69,0,100,31
1681907344427,CSE 150A,A01,180411,Staff,0,7,50,50
1681907345453,CSE 151A,A01,180414,Staff,0,6,50,50
1681907346478,CSE 175,A01,222521,Kumar; Rakesh,50,0,50,0
1681907347512,CSE 190,A00,201419,Staff,45,0,49,4
1681907348536,CSS 1,A01,194536,Staff,38,0,50,12
1681907349566,DSC 30,A01,202385,Staff,48,0,50,2
1681907350591,DSC 40A,A01,202387,Albuyeh; Rod,50,0,50,0
1681907351618,DSC 190,A01,202389,Silberman; Jack,21,0,21,0
1681907352641,DSGN 100,A01,179993,Staff,16,0,30,14
1681907353666,ECE 65,A50,180708,Staff,10,0,20,10
1681907353666,ECE 65,A51,180739,Staff,19,0,20,1
1681907354689,ECON 1,A01,180427,Famulari; Melissa,67,0,70,3
1681907355714,ECON 2,A01,180450,Levkoff; Steven B.,64,0,70,6
1681907356739,ECON 4,A01,203351,Anderson; John Charles,7,0,10,3
1681907357762,ECON 100A,A01,180472,Famulari; Melissa,65,0,70,5
1681907358785,ECON 120A,A01,180549,Staff,64,0,70,6
1681907359810,ECON 120B,A01,180655,Ma; Xinwei,46,0,70,24
1681907360836,ECON 129,A00,203333,Eckert; Fabian Paul,15,0,35,20
1681907361863,ECON 131,A00,180656,Staff,10,0,35,25
1681907362893,ECON 172B,A01,180672,Levkoff; Steven B.,32,0,35,3
1681907363925,ECON 178,A01,203342,Zhu; Ying,11,0,35,24
1681907364948,EDS 108GS,A00,202383,Wishard Guerra; Alison G.,20,0,20,0
1681907365973,EDS 111GS,A00,202347,Wishard Guerra; Alison G.,20,0,20,0
1681907367006,EDS 112,A01,202323,Staff,56,0,60,4
1681907368029,EDS 113,A00,202340,Staff,33,0,35,2
1681907369056,EDS 118,A00,201231,Staff,20,0,30,10
1681907370085,EDS 119,A00,204994,Staff,8,0,10,2
1681907371118,EDS 124BR,A00,202324,Eguchi; Emi,5,0,25,20
1681907372149,EDS 126,A01,203208,Jones; Makeba,26,0,30,4
1681907373172,EDS 135,A01,202333,Staff,18,0,20,2
1681907374194,EDS 180,A00,202311,Staff,47,0,50,3
1681907375220,ERC 190GS,A01,253747,Staff,28,0,28,0
1681907376244,ETHN 104,A00,180742,Staff,24,0,35,11
1681907377271,ETHN 118,A00,180745,Staff,28,0,35,7
1681907378297,ETHN 127,A00,180747,Staff,12,0,16,4
1681907379321,ETHN 137,A00,180880,Staff,12,0,12,0
1681907380349,ETHN 147,A00,180890,Staff,8,0,10,2
1681907381375,ETHN 154,A00,180891,Staff,7,0,8,1
1681907382401,ETHN 168,A00,180892,Staff,9,0,10,1
1681907383431,GLBH 20,A00,201051,Hannah; Seth Donal,0,1,0,1
1681907384456,GLBH 111,A01,209338,Burgos; Jose L.,0,0,0,0
1681907385483,GLBH 150,A00,258300,Staff,0,3,0,0
1681907386510,GLBH 181,A00,201207,Staff,15,0,40,25
1681907387539,HIEU 109,A00,180898,Staff,20,0,20,0
1681907388568,HIEU 111,A00,180899,Staff,1,0,20,19
1681907389592,HIEU 124,A00,180900,Staff,18,0,20,2
1681907390618,HILA 122,A00,180901,Staff,18,0,20,2
1681907391643,HILA 132,A00,180902,Vitz; Matthew,2,0,20,18
1681907392668,HILD 10,A01,180896,Staff,15,0,20,5
1681907393695,HILD 30GS,A00,180897,Edington; Claire Ellen,0,0,0,0
1681907394719,HISC 105,A00,180903,Staff,20,0,20,0
1681907395743,HISC 117,A00,180904,Staff,11,0,20,9
1681907396768,HIUS 108B,A00,181005,Staff,18,0,20,2
1681907397793,HIUS 113,A00,181093,Staff,4,0,20,16
1681907398821,HUM 3,A01,181190,Patterson; Patrick H.,40,0,50,10
1681907398821,HUM 3,B01,181195,Staff,47,0,50,3
1681907399844,HUM 3GS,A00,181196,Herbst; Matthew,0,0,0,0
1681907400868,HUM 4,A01,181227,West; Geoffrey Scott,34,0,50,16
1681907400868,HUM 4,B01,181282,Staff,43,0,50,7
1681907401893,HUM 4GS,A00,181377,Lyon; Antony J.,0,0,0,0
1681907402923,HUM 5,A01,181536,Zavodny; Tatiana Sophia,31,0,50,19
1681907402923,HUM 5,B01,181908,Staff,36,0,50,14
1681907403951,INTL 190,A00,181909,Segui; Alan S,0,0,0,6
1681907403951,INTL 190,B00,181961,Segui; Alan S,0,0,0,7
1681907404975,JAPN 20AR,A01,182113,Ross; Kayoko F,15,0,20,5
1681907406000,LATI 50,A01,202391,Martin-Cabrera; Luis,19,0,30,11
1681907406000,LATI 50,A02,202392,Martin-Cabrera; Luis,26,0,30,4
1681907407033,LATI 180,A00,202393,Kokinis; Troy Andreas,25,0,25,0
1681907408066,LIFR 1A,A00,182119,Staff,14,0,14,0
1681907409090,LIFR 1AX,A00,182324,Staff,14,0,14,0
1681907410116,LIFR 1B,A00,182259,Staff,14,0,14,0
1681907411144,LIFR 1BX,A00,182273,Staff,14,0,14,0
1681907412171,LIGN 8,A00,182330,Staff,137,0,150,13
1681907413197,LIGN 9GS,A00,182362,Staff,20,0,20,0
1681907414223,LIGN 119,A00,204992,Takahashi; Maho,12,0,15,3
1681907415247,LIGN 130,A01,182384,Staff,47,0,50,3
1681907416271,LIGN 149GS,A00,182390,Staff,20,0,20,0
1681907417298,LIGN 170,A00,182404,Staff,24,0,30,6
1681907418331,LISP 1D,A00,182281,Staff,7,0,14,7
1681907418331,LISP 1D,B00,182287,Staff,14,0,14,0
1681907418331,LISP 1D,C00,182295,Staff,11,0,14,3
1681907418331,LISP 1D,D00,182301,Staff,14,0,14,0
1681907419355,LISP 1DX,A00,182309,Staff,20,0,28,8
1681907419355,LISP 1DX,B00,182316,Staff,26,0,28,2
1681907420383,LTAF 120GS,A00,182412,Zhiri; Oumelbanine,20,0,20,0
1681907421411,LTCS 172GS,A00,182437,Bronstein; Phoebe Malan,20,0,20,0
1681907422438,LTEA 138,A00,182457,Staff,22,0,40,18
1681907423464,LTEN 114,A01,182490,Staff,23,0,25,2
1681907424493,LTEN 130GS,A00,182491,Lyon; Antony J.,20,0,20,0
1681907425517,LTEN 169,A00,182493,Cuong; Marisol,20,0,25,5
1681907426548,LTEN 178,A00,182501,Staff,14,0,15,1
1681907427573,LTEN 181,A00,182515,Staff,22,0,25,3
1681907428705,LTEN 185GS,A00,197655,Forbes; Camille,20,0,20,0
1681907429731,LTSP 100B,A00,202208,Bessett; Ryan Matthew,24,0,25,1
1681907430756,LTWL 100,A00,182516,Myerston Santana; Jacobo,23,0,30,7
1681907431784,LTWR 100GS,A00,182518,Forbes; Camille,20,0,20,0
1681907432813,LTWR 102,A00,182522,Staff,15,0,15,0
1681907432813,LTWR 102,B00,182525,Staff,14,0,15,1
1681907433837,LTWR 115,A00,182526,Staff,12,0,15,3
1681907434863,MAE 8,A01,182528,Pham; Hieu Tan,68,0,70,2
1681907435889,MAE 11,A00,182529,Bahadori; Mohammad Yousef,94,0,100,6
1681907436916,MAE 20,A00,182530,Evdokimenko; Ekaterina,68,0,70,2
1681907437953,MAE 30A,A00,182532,Staff,44,0,45,1
1681907438982,MAE 101A,A00,182533,Bahadori; Mohammad Yousef,97,0,100,3
1681907440008,MAE 101C,A00,182538,Staff,62,0,70,8
1681907441108,MAE 104,A00,182539,Staff,45,0,50,5
1681907442133,MAE 131A,A00,182540,Ghazinejad; Maziar,41,0,45,4
1681907443161,MAE 143A,A00,182548,Bewley; Thomas R,43,0,50,7
1681907444186,MAE 150,A00,182549,Staff,28,0,40,12
1681907445220,MAE 160,A00,182550,Evdokimenko; Ekaterina,43,0,60,17
1681907446248,MATH 3C,A01,182725,Staff,27,0,30,3
1681907447271,MATH 10A,A01,182729,Staff,25,0,30,5
1681907447271,MATH 10A,B01,182732,Staff,26,0,30,4
1681907448296,MATH 10B,A01,182737,Staff,21,0,30,9
1681907448296,MATH 10B,A02,182738,Staff,27,0,30,3
1681907448296,MATH 10B,B01,182744,Staff,27,0,30,3
1681907448296,MATH 10B,B02,182745,Staff,27,0,30,3
1681907449328,MATH 18,A01,182750,Anzaldo; Leesa B,28,0,30,2
1681907449328,MATH 18,A02,182751,Anzaldo; Leesa B,29,0,30,1
1681907449328,MATH 18,A03,182753,Anzaldo; Leesa B,28,0,30,2
1681907449328,MATH 18,A04,182757,Anzaldo; Leesa B,29,0,30,1
1681907449328,MATH 18,B01,182761,Anzaldo; Leesa B,27,0,30,3
1681907449328,MATH 18,B02,182764,Anzaldo; Leesa B,27,0,30,3
1681907449328,MATH 18,B03,182765,Anzaldo; Leesa B,30,0,30,0
1681907449328,MATH 18,B04,182766,Anzaldo; Leesa B,30,0,30,0
1681907450356,MATH 20A,A01,182771,Suk; Andrew Hoon,28,0,30,2
1681907451385,MATH 20B,A01,182775,Bach; Quang Tran,30,0,30,0
1681907451385,MATH 20B,A02,182777,Bach; Quang Tran,29,0,30,1
1681907451385,MATH 20B,B01,182780,Bach; Quang Tran,27,0,30,3
1681907451385,MATH 20B,B02,182782,Bach; Quang Tran,30,0,30,0
1681907452413,MATH 20C,A01,182787,Staff,25,0,30,5
1681907452413,MATH 20C,A02,182790,Staff,29,0,30,1
1681907452413,MATH 20C,B01,182792,Staff,25,0,30,5
1681907452413,MATH 20C,B02,182796,Staff,27,0,30,3
1681907453442,MATH 20D,A01,182799,Staff,29,0,30,1
1681907453442,MATH 20D,A02,182802,Staff,30,0,30,0
1681907453442,MATH 20D,A03,182803,Staff,30,0,30,0
1681907454467,MATH 20E,A01,182809,Verstraete; Jacques Allan,24,0,30,6
1681907454467,MATH 20E,A02,182811,Verstraete; Jacques Allan,28,0,30,2
1681907454467,MATH 20E,B01,182814,Verstraete; Jacques Allan,23,0,30,7
1681907454467,MATH 20E,B02,182815,Verstraete; Jacques Allan,30,0,30,0
1681907455499,MATH 103A,A01,182820,Staff,9,0,30,21
1681907455499,MATH 103A,A02,182821,Staff,27,0,30,3
1681907455499,MATH 103A,A03,182822,Staff,23,0,30,7
1681907455499,MATH 103A,B01,182825,Staff,23,0,30,7
1681907455499,MATH 103A,B02,182826,Staff,30,0,30,0
1681907455499,MATH 103A,B03,182830,Staff,30,0,30,0
1681907456539,MATH 109,A01,182836,Chow; Bennett,24,0,30,6
1681907456539,MATH 109,A02,182838,Chow; Bennett,29,0,30,1
1681907456539,MATH 109,A03,182894,Chow; Bennett,29,0,30,1
1681907456539,MATH 109,B01,182908,Chow; Bennett,28,0,30,2
1681907456539,MATH 109,B02,182909,Chow; Bennett,30,0,30,0
1681907456539,MATH 109,B03,182910,Chow; Bennett,27,0,30,3
1681907457564,MATH 142A,A01,182925,Staff,11,0,30,19
1681907457564,MATH 142A,A02,182935,Staff,25,0,30,5
1681907457564,MATH 142A,A03,182967,Staff,26,0,30,4
1681907457564,MATH 142A,B01,183125,Staff,24,0,30,6
1681907457564,MATH 142A,B02,183157,Staff,28,0,30,2
1681907457564,MATH 142A,B03,183158,Staff,29,0,30,1
1681907458591,MATH 183,A01,183160,Arias-Castro; Ery,23,0,30,7
1681907458591,MATH 183,A02,183161,Arias-Castro; Ery,29,0,30,1
1681907458591,MATH 183,B01,183163,Arias-Castro; Ery,28,0,30,2
1681907458591,MATH 183,B02,183164,Arias-Castro; Ery,28,0,30,2
1681907459628,MATH 193A,A01,183167,Staff,4,0,35,31
1681907459628,MATH 193A,A02,183168,Staff,28,0,35,7
1681907459628,MATH 193A,A03,183169,Staff,34,0,35,1
1681907459628,MATH 193A,A04,183170,Staff,28,0,35,7
1681907460665,MGT 4,A01,202395,Anderson; John Charles,75,0,80,5
1681907461692,MGT 5,A00,202396,Houskeeper; Robert,80,0,90,10
1681907462725,MGT 103,A00,202397,Eberhard; Craig A,55,0,90,35
1681907463748,MGT 131A,A00,202398,Houskeeper; Robert,85,0,90,5
1681907464774,MGT 135,A00,202399,Anderson; John Charles,83,0,90,7
1681907465803,MGT 162R,A00,202403,Gneezy; Uri,150,0,200,50
1681907466827,MGT 172,A00,202404,Hedges; Kathleen,50,0,90,40
1681907467851,MGT 181,A00,202405,Dunn; Louis Jean,84,0,90,6
1681907468876,MMW 14,A01,183200,Staff,16,0,28,12
1681907468876,MMW 14,A02,183201,Staff,26,0,28,2
1681907468876,MMW 14,A03,183202,Staff,24,0,28,4
1681907468876,MMW 14,A04,183203,Staff,25,0,28,3
1681907468876,MMW 14,A05,183204,Staff,26,0,28,2
1681907468876,MMW 14,A06,183205,Staff,27,0,28,1
1681907468876,MMW 14,B01,183207,Staff,26,0,28,2
1681907468876,MMW 14,B02,183208,Staff,28,0,28,0
1681907468876,MMW 14,B03,183209,Staff,28,0,28,0
1681907468876,MMW 14,B04,183210,Staff,28,0,28,0
1681907468876,MMW 14,B05,183211,Staff,28,0,28,0
1681907468876,MMW 14,B06,183212,Staff,28,0,28,0
1681907469912,MMW 14GS,A00,183213,Zhiri; Oumelbanine,28,0,28,0
1681907470937,MMW 15GS,B00,183215,Rahimi; Babak,28,0,28,0
1681907471964,MMW 121,A01,183217,Patterson; Patrick H.,14,0,28,14
1681907471964,MMW 121,A02,183218,Patterson; Patrick H.,25,0,28,3
1681907472989,MUS 1A,A01,182554,Staff,8,0,35,27
1681907474013,MUS 5,A01,182558,Staff,20,0,35,15
1681907475041,MUS 6,A01,182562,Staff,25,0,35,10
1681907476067,MUS 8GS,A00,182563,Borgo; David Garcia,25,0,25,0
1681907477090,MUS 13,A01,182567,Staff,24,0,25,1
1681907478120,MUS 15,A01,182570,Staff,32,0,35,3
1681907478120,MUS 15,B01,182575,Staff,10,0,35,25
1681907479143,MUS 80,A00,182578,Staff,23,0,25,2
1681907479143,MUS 80,B00,182581,Staff,20,0,25,5
1681907480167,MUS 113,A00,182582,Staff,25,0,25,0
1681907481198,MUS 114,A00,182583,Staff,4,0,25,21
1681907482223,MUS 150GS,A01,182588,Borgo; David Garcia,25,0,25,0
1681907483257,PHIL 1,A00,182590,Staff,35,0,40,5
1681907484281,PHIL 10,A01,182596,Grush; Rick Scott,31,0,35,4
1681907484281,PHIL 10,A02,182597,Grush; Rick Scott,34,0,35,1
1681907485306,PHIL 15,A01,182601,Staff,31,0,35,4
1681907485306,PHIL 15,A02,182602,Staff,33,0,35,2
1681907486333,PHIL 27,A01,182604,Staff,30,0,35,5
1681907486333,PHIL 27,A02,182607,Staff,35,0,35,0
1681907487360,PHIL 32,A01,182609,Staff,35,0,35,0
1681907487360,PHIL 32,A02,182612,Staff,35,0,35,0
1681907488386,PHIL 130,A00,182614,Staff,63,0,70,7
1681907489412,PHIL 136,A00,182616,Cohen; Jonathan David,66,0,70,4
1681907490443,PHIL 155,A00,182617,Vargas; Manuel Rogelio,60,0,70,10
1681907491469,PHIL 163,A01,182620,Staff,15,0,20,5
1681907491469,PHIL 163,A02,182624,Staff,10,0,20,10
1681907492494,PHIL 164,A00,182627,Staff,30,0,40,10
1681907493523,PHIL 173,A00,182628,Staff,36,0,40,4
1681907494551,PHYS 1A,A00,183221,Staff,54,0,60,6
1681907495578,PHYS 1AL,001,183222,Staff,25,0,30,5
1681907495578,PHYS 1AL,002,183223,Staff,28,0,30,2
1681907496603,PHYS 1B,A00,183231,Staff,44,0,60,16
1681907497628,PHYS 1BL,001,183232,Staff,20,0,30,10
1681907497628,PHYS 1BL,002,183233,Staff,29,0,30,1
1681907498653,PHYS 1C,A00,183240,Staff,30,0,60,30
1681907499678,PHYS 1CL,001,183241,Staff,13,0,30,17
1681907499678,PHYS 1CL,002,183242,Staff,22,0,30,8
1681907500706,PHYS 2AR,A01,183250,Staff,44,0,50,6
1681907501740,PHYS 2B,A01,183252,Staff,106,0,115,9
1681907502767,PHYS 2BL,A01,183254,Staff,21,0,24,3
1681907502767,PHYS 2BL,A02,183255,Staff,22,0,24,2
1681907503790,PHYS 2C,A01,183522,Staff,105,0,115,10
1681907504815,PHYS 4A,A01,183524,Staff,49,0,50,1
1681907505838,POLI 5,A00,183525,Staff,44,0,50,6
1681907506869,POLI 12,A00,183540,Staff,48,0,50,2
1681907507898,POLI 13R,A00,183541,Forman; Fonna,42,0,50,8
1681907508927,POLI 30,A00,183542,Mignozzetti; Umberto,47,0,50,3
1681907509958,POLI 100A,A00,183543,Staff,45,0,50,5
1681907510983,POLI 100E,A00,223598,Staff,32,0,35,3
1681907512017,POLI 103A,A00,183564,Kousser; Thad,38,0,50,12
1681907513042,POLI 104B,A00,201329,Staff,29,0,35,6
1681907514070,POLI 113BR,A00,183576,Hoston; Germaine,28,0,50,22
1681907515095,POLI 114BR,A00,183588,Staff,27,0,30,3
1681907516123,POLI 117R,A00,183595,Forman; Fonna,9,0,20,11
1681907517148,POLI 120H,A00,183596,Fisk; David Lee,13,0,20,7
1681907518172,POLI 130AA,A00,183597,Staff,14,0,20,6
1681907519198,POLI 134AA,A00,183598,Staff,19,0,20,1
1681907520227,POLI 135,A00,183599,Fisk; David Lee,20,0,25,5
1681907521258,POLI 142P,A00,183623,Staff,37,0,40,3
1681907522298,POLI 144D,A00,183624,Staff,22,0,25,3
1681907523333,POLI 151,A00,183625,Staff,15,0,20,5
1681907524361,POLI 162,A00,183626,Mignozzetti; Umberto,18,0,20,2
1681907525395,PSYC 1,A00,253748,Staff,86,0,90,4
1681907526420,PSYC 2,A00,183627,Moranton; Nirelia Melbina-,25,0,35,10
1681907527442,PSYC 3,A00,183628,Staff,43,0,45,2
1681907529492,PSYC 60,A01,183631,Lowe; Angela Beth,35,0,40,5
1681907530519,PSYC 70,A01,253757,Staff,37,0,45,8
1681907531548,PSYC 101,A00,183632,Heyman; Gail D.,48,0,60,12
1681907532572,PSYC 105,A00,183848,Lowe; Angela Beth,50,0,60,10
1681907533608,PSYC 106,A00,183849,Dobkins; Karen R.,45,0,60,15
1681907534639,PSYC 108,A00,253750,Staff,24,0,60,36
1681907535664,PSYC 114,A01,184275,Winkielman; Piotr,0,6,30,30
1681907536688,PSYC 122,A00,183856,Moranton; Nirelia Melbina-,0,10,30,30
1681907537713,PSYC 124,A00,183865,Chapman; Eddie Nathaniel,52,0,80,28
1681907538741,PSYC 137,A00,183880,Staff,19,0,25,6
1681907540798,PSYC 154,A00,183910,Lacefield; Katharine I,0,2,90,90
1681907542854,PSYC 162,A00,183946,Wixted; John T,61,0,90,29
1681907543883,PSYC 172,A00,183947,Gorman; Michael R.,14,0,30,16
1681907544988,PSYC 178,A00,183963,Glaser; Dale,20,0,40,20
1681907546020,PSYC 181GS,A00,183964,Anagnostaras; Stephan,10,0,10,0
1681907547048,PSYC 186GS,A01,257660,Staff,10,0,10,0
1681907548074,PSYC 193,B00,253749,Staff,23,0,25,2
1681907550140,PSYC 193L,A01,184122,Staff,33,0,35,2
1681907550140,PSYC 193L,C01,184167,Winkielman; Piotr,16,0,30,14
1681907551169,RELI 188GS,A00,182629,Rahimi; Babak,20,0,20,0
1681907552204,SE 101A,A00,182646,Staff,26,0,30,4
1681907553228,SE 101C,A00,182650,Staff,18,0,20,2
1681907554263,SE 110A,A00,182651,Staff,28,0,28,0
1681907555287,SE 130A,A00,182652,Staff,39,0,40,1
1681907556318,SIO 46GS,A00,182636,Cook; Geoffrey W,28,0,28,0
1681907557344,SIO 109R,A00,194459,Staff,5,0,20,15
1681907558368,SIO 121GS,A00,182639,Cook; Geoffrey W,28,0,28,0
1681907559396,SIO 132,A01,182642,Staff,32,0,40,8
1681907560426,SIO 139,A00,182644,Kacev; David,36,0,40,4
1681907561456,SOCI 2,A01,258404,Staff,34,0,36,2
1681907561456,SOCI 2,A02,258405,Staff,35,0,36,1
1681907562481,SOCI 60,A01,258408,Staff,29,0,30,1
1681907562481,SOCI 60,A02,258413,Staff,30,0,30,0
1681907563509,SOCI 100,A01,258415,Staff,29,0,30,1
1681907563509,SOCI 100,A02,258416,Staff,28,0,30,2
1681907569673,SOCI 127,A00,258421,Staff,22,0,30,8
1681907570705,SOCI 132,A00,258422,Staff,45,0,50,5
1681907571733,SOCI 133,A00,258423,Staff,26,0,30,4
1681907572766,SOCI 138GS,A00,258424,Staff,15,0,15,0
1681907573789,SOCI 145,A00,258425,Staff,25,0,30,5
1681907574817,SOCI 148,A00,258426,Staff,26,0,30,4
1681907575842,SOCI 153,A00,199217,Staff,29,0,30,1
1681907576875,SOCI 160,A00,258427,Staff,28,0,30,2
1681907577908,SOCI 160E,A00,258435,Staff,56,0,60,4
1681907578934,SOCI 189GS,A00,258436,Staff,15,0,15,0
1681907579960,SOCI 190GS,A00,258437,Staff,15,0,15,0
1681907580989,SYN 2,001,182658,Staff,9,0,16,7
1681907580989,SYN 2,002,201439,Staff,15,0,16,1
1681907580989,SYN 2,003,201443,Staff,16,0,16,0
1681907582017,SYN 100,A01,182657,Staff,17,0,20,3
1681907583054,TDAC 1,A00,184381,Salovey; Todd,16,0,20,4
1681907583054,TDAC 1,B00,184385,Harting; Carla Kelso,19,0,20,1
1681907583054,TDAC 1,C00,184394,Staff,19,0,20,1
1681907584082,TDAC 101,A00,184483,Harting; Carla Kelso,19,0,20,1
1681907585111,TDDE 111,A00,184496,Staff,14,0,15,1
1681907586138,TDDE 131,A00,184504,Staff,20,0,20,0
1681907586138,TDDE 131,B00,184505,Staff,17,0,18,1
1681907586138,TDDE 131,C00,184534,Staff,49,0,50,1
1681907586138,TDDE 131,D00,184564,Staff,15,0,15,0
1681907586138,TDDE 131,E00,204725,Staff,19,0,20,1
1681907587175,TDGE 1,A01,184414,Salovey; Todd,37,0,50,13
1681907588206,TDGE 5,A01,184419,Staff,23,0,24,1
1681907589231,TDGE 10,A00,184428,Fulton; Julia,31,0,50,19
1681907590255,TDGE 124,A00,184565,Fulton; Julia,7,0,50,43
1681907591286,TDGE 125,B00,184567,Meyer; Ursula,9,0,25,16
1681907592310,TDHT 101,A00,184568,Staff,21,0,25,4
1681907592310,TDHT 101,B00,184569,Staff,20,0,20,0
1681907593334,TDHT 114,A00,184570,Staff,49,0,50,1
1681907594360,TDMV 1,A00,184437,Arcidiacono; Kristin,23,0,30,7
1681907594360,TDMV 1,B00,184448,Caligagan; Maria T.,22,0,30,8
1681907595384,TDMV 2,A00,184449,Weinberg; Sadie,27,0,30,3
1681907595384,TDMV 2,B00,184453,Arcidiacono; Kristin,29,0,30,1
1681907596409,TDMV 110,A00,184571,Weinberg; Sadie,30,0,30,0
1681907597439,TDMV 142,A00,184572,Caligagan; Tony,27,0,30,3
1681907597439,TDMV 142,B00,184573,Caligagan; Maria T.,27,0,30,3
1681907598463,TDTR 20,A00,184482,Jun; Grace Shin Hae,25,0,25,0
1681907599499,USP 2,A01,184290,Hinds; Juli Beth,24,0,25,1
1681907600532,USP 3,A01,184295,Staff,20,0,25,5
1681907601560,USP 4,A00,184304,McTague; Sarah,15,0,25,10
1681907602587,USP 100,A00,184315,Staff,17,0,25,8
1681907603614,USP 105,A00,184326,Staff,21,0,25,4
1681907604654,USP 151,A00,184327,Staff,20,0,25,5
1681907605679,USP 170,A00,184380,Hinds; Juli Beth,14,0,25,11
1681907606702,VIS 21B,A01,182660,Staff,28,0,31,3
1681907606702,VIS 21B,A02,182662,Staff,30,0,31,1
1681907607727,VIS 103D,A00,182663,Staff,74,0,75,1
1681907608757,VIS 105D,A00,182667,Li; Huai,15,0,22,7
1681907609780,VIS 122GS,A00,182668,Herbst; Matthew,20,0,20,0
1681907610811,VIS 128C,A00,182673,Staff,70,0,75,5
1681907611837,VIS 130,A00,182675,Staff,20,0,22,2
1681907612870,VIS 160A,A00,182678,Stalbaum; Brett,4,0,10,6
1681907614923,WCWP 10B,A00,201679,Staff,15,0,15,0
1681907614923,WCWP 10B,B00,201695,Staff,15,0,15,0
1681907615947,WCWP 100,A00,201716,Staff,15,0,15,0
1681907615947,WCWP 100,B00,201717,Staff,11,0,15,4
1681907618048,ANSC 105GS,A00,258289,Staff,0,0,0,0
1681907619072,ANSC 125GS,A00,258295,Staff,0,0,0,0
1681907620112,ANSC 150,A00,258267,Staff,30,0,40,10
1681907621140,ANSC 190GS,A00,258280,Staff,0,0,0,0
1681907622168,ANTH 1,A00,258264,Staff,38,0,40,2
1681907623200,ANTH 2,A01,258259,Staff,72,0,76,4
1681907624228,ANTH 23,A01,258228,Staff,36,0,40,4
1681907625257,ANTH 101,A01,258236,Staff,39,0,40,1
1681907626285,ANTH 102,A00,258272,Staff,59,0,60,1
1681907627322,ANTH 105,A00,258244,Staff,31,0,35,4
1681907628346,BENG 130,A00,253975,Staff,38,0,40,2
1681907629379,BIBC 102,A01,191866,Flagg; Matthew Paul,19,0,32,13
1681907629379,BIBC 102,A02,191867,Flagg; Matthew Paul,22,0,32,10
1681907629379,BIBC 102,A03,191868,Flagg; Matthew Paul,30,0,32,2
1681907629379,BIBC 102,A04,191936,Flagg; Matthew Paul,26,0,32,6
1681907629379,BIBC 102,A05,191937,Flagg; Matthew Paul,11,0,32,21
1681907630403,BICD 100,A01,191939,Cooper; Andrew Michael,28,0,32,4
1681907630403,BICD 100,A02,191940,Cooper; Andrew Michael,32,0,32,0
1681907630403,BICD 100,A03,191941,Cooper; Andrew Michael,32,0,32,0
1681907630403,BICD 100,A04,191942,Cooper; Andrew Michael,32,0,32,0
1681907630403,BICD 100,A05,191943,Cooper; Andrew Michael,32,0,32,0
1681907631433,BIEB 126,A01,191945,Cleland; Elsa Eleanor,1,0,32,31
1681907631433,BIEB 126,A02,191946,Cleland; Elsa Eleanor,28,0,32,4
1681907631433,BIEB 126,A03,191947,Cleland; Elsa Eleanor,29,0,32,3
1681907631433,BIEB 126,A04,191948,Cleland; Elsa Eleanor,23,0,32,9
1681907631433,BIEB 126,A05,191996,Cleland; Elsa Eleanor,28,0,32,4
1681907632463,BIEB 136GS,A00,191997,Shurin; Jonathan & Holway; David A.,0,0,0,0
1681907633489,BIEB 137GS,A01,191999,Shurin; Jonathan & Holway; David A.,0,0,0,0
1681907634515,BILD 1,A01,205385,Staff,31,0,32,1
1681907634515,BILD 1,A02,205386,Staff,30,0,32,2
1681907634515,BILD 1,A03,205387,Staff,32,0,32,0
1681907634515,BILD 1,A04,205388,Staff,28,0,32,4
1681907635546,BILD 2,A01,191774,Staff,28,0,32,4
1681907635546,BILD 2,A02,191775,Staff,30,0,32,2
1681907635546,BILD 2,A03,191777,Staff,30,0,32,2
1681907635546,BILD 2,A04,191856,Staff,31,0,32,1
1681907635546,BILD 2,A05,191857,Staff,32,0,32,0
1681907635546,BILD 2,A06,191858,Staff,32,0,32,0
1681907635546,BILD 2,A07,191859,Staff,31,0,32,1
1681907636573,BILD 3,A01,205391,Staff,29,0,32,3
1681907636573,BILD 3,A02,205393,Staff,32,0,32,0
1681907636573,BILD 3,A03,205394,Staff,28,0,32,4
1681907636573,BILD 3,A04,205395,Staff,32,0,32,0
1681907637600,BILD 20,A01,191861,Staff,32,0,32,0
1681907637600,BILD 20,A02,191862,Staff,32,0,32,0
1681907638625,BILD 30,A01,191864,Staff,31,0,32,1
1681907639648,BIMM 100,A01,192019,Staff,0,0,32,32
1681907639648,BIMM 100,A02,192020,Staff,23,0,32,9
1681907639648,BIMM 100,A03,192035,Staff,22,0,32,10
1681907640671,BIMM 110,A01,192037,Tat; John,0,0,32,32
1681907640671,BIMM 110,A02,192038,Tat; John,10,0,32,22
1681907641700,BIMM 120,A01,192040,Pickett; Brooke Elizabeth,2,0,32,30
1681907641700,BIMM 120,A02,192041,Pickett; Brooke Elizabeth,16,0,32,16
1681907641700,BIMM 120,A03,192042,Pickett; Brooke Elizabeth,16,0,32,16
1681907642731,BIPN 100,A01,192044,Armour; Jon Christopher,26,0,32,6
1681907642731,BIPN 100,A02,192059,Armour; Jon Christopher,30,0,32,2
1681907642731,BIPN 100,A03,192064,Armour; Jon Christopher,31,0,32,1
1681907642731,BIPN 100,A04,192073,Armour; Jon Christopher,28,0,32,4
1681907643757,BIPN 148,A01,205411,Leutgeb; Jill K.,16,0,32,16
1681907643757,BIPN 148,A02,205412,Leutgeb; Jill K.,31,0,32,1
1681907643757,BIPN 148,A03,205413,Leutgeb; Jill K.,30,0,32,2
1681907643757,BIPN 148,A04,205414,Leutgeb; Jill K.,30,0,32,2
1681907644784,BIPN 160,A01,192115,Marino; Marc J,19,0,32,13
1681907644784,BIPN 160,A02,192148,Marino; Marc J,27,0,32,5
1681907644784,BIPN 160,A03,192158,Marino; Marc J,31,0,32,1
1681907644784,BIPN 160,A04,192190,Marino; Marc J,32,0,32,0
1681907644784,BIPN 160,A05,192287,Marino; Marc J,32,0,32,0
1681907644784,BIPN 160,A06,192288,Marino; Marc J,32,0,32,0
1681907645810,BIPN 194,A00,206038,Staff,28,0,32,4
1681907646850,BISP 194,A00,192289,Leutgeb; Stefan,13,0,32,19
1681907646850,BISP 194,B00,245332,Nieh; James Charles,27,0,32,5
1681907647874,CAT 124,A01,202247,Staff,15,0,15,0
1681907648976,CAT 125,A00,202248,Staff,19,0,20,1
1681907648976,CAT 125,B00,202253,Staff,20,0,20,0
1681907648976,CAT 125,C00,202257,Staff,19,0,20,1
1681907649999,CAT 125GS,A01,202273,Bronstein; Phoebe Malan,20,0,20,0
1681907651024,CAT 125R,A00,202284,Staff,17,0,20,3
1681907651024,CAT 125R,C00,202286,Staff,10,0,20,10
1681907651024,CAT 125R,D00,202291,Staff,18,0,20,2
1681907651024,CAT 125R,E00,202295,Staff,13,0,20,7
1681907651024,CAT 125R,F00,202302,Staff,12,0,20,8
1681907652051,CENG 100,A00,204724,Opatkiewicz; Justin Paul,25,0,25,0
1681907653077,CGS 2A,A01,180420,Staff,31,0,36,5
1681907654114,CGS 101,A00,180421,Staff,16,0,20,4
1681907655139,CGS 112,A00,180422,Staff,10,0,16,6
1681907656165,CGS 113,A00,180423,Staff,18,0,20,2
1681907657192,CGS 137,A00,180424,Staff,12,0,12,0
1681907658220,CGS 147,A00,180425,Staff,10,0,10,0
1681907659251,CHEM 6A,A01,179556,Staff,97,0,100,3
1681907659251,CHEM 6A,A02,179558,Staff,0,0,0,0
1681907660276,CHEM 6B,A01,179560,Staff,100,0,100,0
1681907661300,CHEM 6C,A01,179565,Jazzar; Rodolphe,95,0,100,5
1681907662327,CHEM 7L,A01,179586,Schurmeier; Kimberly,13,0,24,11
1681907662327,CHEM 7L,A02,179587,Schurmeier; Kimberly,23,0,24,1
1681907662327,CHEM 7L,A03,179590,Schurmeier; Kimberly,22,0,24,2
1681907662327,CHEM 7L,A04,179591,Schurmeier; Kimberly,22,0,24,2
1681907662327,CHEM 7L,B01,179598,Schurmeier; Kimberly,17,0,24,7
1681907662327,CHEM 7L,B02,179599,Schurmeier; Kimberly,24,0,24,0
1681907662327,CHEM 7L,B03,179606,Schurmeier; Kimberly,23,0,24,1
1681907662327,CHEM 7L,B04,179607,Schurmeier; Kimberly,23,0,24,1
1681907663356,CHEM 11,A01,179609,Stallings; Dontarie M,88,0,100,12
1681907664386,CHEM 40A,A01,179621,Staff,41,0,50,9
1681907664386,CHEM 40A,A02,179622,Staff,47,0,50,3
1681907665422,CHEM 40B,A01,179630,Weizman; Haim,48,0,50,2
1681907665422,CHEM 40B,A02,179631,Weizman; Haim,45,0,50,5
1681907666451,CHEM 41A,A01,179660,Klosterman; Jeremy K,93,0,100,7
1681907667477,CHEM 43A,A01,179683,Klosterman; Jeremy K,0,0,24,24
1681907667477,CHEM 43A,A02,179688,Klosterman; Jeremy K,14,0,24,10
1681907667477,CHEM 43A,A03,179689,Klosterman; Jeremy K,20,0,24,4
1681907667477,CHEM 43A,A04,179691,Klosterman; Jeremy K,18,0,24,6
1681907668510,CHEM 114A,A01,179693,Stallings; Dontarie M,77,0,100,23
1681907669541,CHEM 143B,A01,179698,Weizman; Haim,17,0,24,7
1681907669541,CHEM 143B,A02,179700,Weizman; Haim,24,0,24,0
1681907670568,CHIN 169A,A00,179701,Wang; Xiao,20,0,20,0
1681907671594,COGS 2,A01,179750,Boyle; Mary E. T.,17,0,30,13
1681907672623,COGS 9,A01,179759,Jones; Cameron Robert,43,0,50,7
1681907673651,COGS 14A,A01,179854,Staff,18,0,50,32
1681907674678,COGS 14B,A01,179856,Staff,54,0,60,6
1681907675702,COGS 17,A01,179874,Staff,71,0,75,4
1681907676727,COGS 18,A01,179884,Staff,63,0,80,17
1681907677750,COGS 100,A01,179886,Staff,40,0,60,20
1681907678774,COGS 101B,A01,179892,Staff,1,0,30,29
1681907679798,COGS 101C,A01,179894,Staff,28,0,30,2
1681907680823,COGS 107A,A01,179896,Boyle; Mary E. T.,31,0,40,9
1681907681958,COGS 108,A01,179898,Simpkins; Charles Alexander,0,17,60,60
1681907682989,COGS 109,A01,179900,Staff,34,0,40,6
1681907684014,COGS 118A,A01,179946,Staff,9,0,40,31
1681907685041,COGS 153,A00,179978,Staff,1,0,30,29
1681907686064,COGS 156,A01,179981,Staff,27,0,30,3
1681907688111,COGS 172,A01,179987,Staff,13,0,30,17
1681907690162,COGS 186,A01,179991,Staff,13,0,30,17
1681907691192,COMM 10,A01,180001,Staff,15,0,25,10
1681907691192,COMM 10,A02,180004,Staff,20,0,25,5
1681907692216,COMM 100A,A01,180016,Staff,18,0,25,7
1681907692216,COMM 100A,A02,180020,Staff,24,0,25,1
1681907693241,COMM 101T,A00,180029,Halm; Gavin Patrick,23,0,35,12
1681907694264,COMM 106V,A00,180043,Staff,34,0,35,1
1681907695288,COMM 109P,A00,180044,Staff,31,0,35,4
1681907696321,COMM 113T,A00,180045,Havis; Allan,37,0,45,8
1681907697346,COMM 132,A00,180046,McKenna; Denise,23,0,30,7
1681907698373,COMM 143,A00,180047,Staff,19,0,30,11
1681907699399,COMM 190,A00,180048,Conner; Thomas Hartnell,20,0,23,3
1681907700434,CSE 8A,A50,180053,Cao; Yingjun,25,0,50,25
1681907700434,CSE 8A,B50,180180,Staff,50,0,50,0
1681907701462,CSE 11,A01,180190,Cao; Yingjun,31,0,50,19
1681907702491,CSE 20,A01,180192,Briones; Jor-el Thomas Caparas,23,0,30,7
1681907703513,CSE 21,A01,194538,Briones; Jor-el Thomas Caparas,50,0,60,10
1681907704540,CSE 30,A01,180324,Eldon; John,79,0,100,21
1681907705563,CSE 101,A01,201353,Staff,0,20,40,40
1681907706588,CSE 134B,A01,180326,Powell; Thomas Allan,74,0,100,26
1681907707615,CSE 140,A01,180328,Staff,46,0,75,29
1681907708640,CSE 140L,A01,180344,Eldon; John,69,0,100,31
1681907709675,CSE 150A,A01,180411,Staff,0,7,50,50
1681907710698,CSE 151A,A01,180414,Staff,0,6,50,50
1681907711721,CSE 175,A01,222521,Kumar; Rakesh,50,0,50,0
1681907712746,CSE 190,A00,201419,Staff,45,0,49,4
1681907713775,CSS 1,A01,194536,Staff,38,0,50,12
1681907714809,DSC 30,A01,202385,Staff,48,0,50,2
1681907715845,DSC 40A,A01,202387,Albuyeh; Rod,50,0,50,0
1681907716870,DSC 190,A01,202389,Silberman; Jack,21,0,21,0
1681907717894,DSGN 100,A01,179993,Staff,16,0,30,14
1681907718923,ECE 65,A50,180708,Staff,10,0,20,10
1681907718923,ECE 65,A51,180739,Staff,19,0,20,1
1681907719946,ECON 1,A01,180427,Famulari; Melissa,67,0,70,3
1681907720971,ECON 2,A01,180450,Levkoff; Steven B.,64,0,70,6
1681907721996,ECON 4,A01,203351,Anderson; John Charles,7,0,10,3
1681907723029,ECON 100A,A01,180472,Famulari; Melissa,65,0,70,5
1681907724052,ECON 120A,A01,180549,Staff,64,0,70,6
1681907725081,ECON 120B,A01,180655,Ma; Xinwei,46,0,70,24
1681907726104,ECON 129,A00,203333,Eckert; Fabian Paul,15,0,35,20
1681907727128,ECON 131,A00,180656,Staff,9,0,35,26
1681907728164,ECON 172B,A01,180672,Levkoff; Steven B.,32,0,35,3
1681907729186,ECON 178,A01,203342,Zhu; Ying,11,0,35,24
1681907730212,EDS 108GS,A00,202383,Wishard Guerra; Alison G.,20,0,20,0
1681907731246,EDS 111GS,A00,202347,Wishard Guerra; Alison G.,20,0,20,0
1681907732270,EDS 112,A01,202323,Staff,56,0,60,4
1681907733295,EDS 113,A00,202340,Staff,33,0,35,2
1681907734325,EDS 118,A00,201231,Staff,20,0,30,10
1681907735353,EDS 119,A00,204994,Staff,8,0,10,2
1681907736377,EDS 124BR,A00,202324,Eguchi; Emi,5,0,25,20
1681907737408,EDS 126,A01,203208,Jones; Makeba,26,0,30,4
1681907738432,EDS 135,A01,202333,Staff,18,0,20,2
1681907739457,EDS 180,A00,202311,Staff,47,0,50,3
1681907740482,ERC 190GS,A01,253747,Staff,28,0,28,0
1681907741518,ETHN 104,A00,180742,Staff,24,0,35,11
1681907742541,ETHN 118,A00,180745,Staff,28,0,35,7
1681907743566,ETHN 127,A00,180747,Staff,12,0,16,4
1681907744589,ETHN 137,A00,180880,Staff,12,0,12,0
1681907745614,ETHN 147,A00,180890,Staff,8,0,10,2
1681907746641,ETHN 154,A00,180891,Staff,7,0,8,1
1681907747665,ETHN 168,A00,180892,Staff,9,0,10,1
1681907748688,GLBH 20,A00,201051,Hannah; Seth Donal,0,1,0,1
1681907749711,GLBH 111,A01,209338,Burgos; Jose L.,0,0,0,0
1681907750735,GLBH 150,A00,258300,Staff,0,3,0,0
1681907751760,GLBH 181,A00,201207,Staff,15,0,40,25
1681907752857,HIEU 109,A00,180898,Staff,20,0,20,0
1681907753885,HIEU 111,A00,180899,Staff,1,0,20,19
1681907754908,HIEU 124,A00,180900,Staff,18,0,20,2
1681907755935,HILA 122,A00,180901,Staff,18,0,20,2
1681907756970,HILA 132,A00,180902,Vitz; Matthew,2,0,20,18
1681907757998,HILD 10,A01,180896,Staff,15,0,20,5
1681907759025,HILD 30GS,A00,180897,Edington; Claire Ellen,0,0,0,0
1681907760050,HISC 105,A00,180903,Staff,20,0,20,0
1681907761078,HISC 117,A00,180904,Staff,11,0,20,9
1681907762104,HIUS 108B,A00,181005,Staff,18,0,20,2
1681907763127,HIUS 113,A00,181093,Staff,4,0,20,16
1681907764159,HUM 3,A01,181190,Patterson; Patrick H.,40,0,50,10
1681907764159,HUM 3,B01,181195,Staff,47,0,50,3
1681907765183,HUM 3GS,A00,181196,Herbst; Matthew,0,0,0,0
1681907766209,HUM 4,A01,181227,West; Geoffrey Scott,34,0,50,16
1681907766209,HUM 4,B01,181282,Staff,43,0,50,7
1681907767249,HUM 4GS,A00,181377,Lyon; Antony J.,0,0,0,0
1681907768275,HUM 5,A01,181536,Zavodny; Tatiana Sophia,31,0,50,19
1681907768275,HUM 5,B01,181908,Staff,36,0,50,14
1681907769300,INTL 190,A00,181909,Segui; Alan S,0,0,0,6
1681907769300,INTL 190,B00,181961,Segui; Alan S,0,0,0,7
1681907770329,JAPN 20AR,A01,182113,Ross; Kayoko F,15,0,20,5
1681907771357,LATI 50,A01,202391,Martin-Cabrera; Luis,19,0,30,11
1681907771357,LATI 50,A02,202392,Martin-Cabrera; Luis,26,0,30,4
1681907772385,LATI 180,A00,202393,Kokinis; Troy Andreas,25,0,25,0
1681907773409,LIFR 1A,A00,182119,Staff,14,0,14,0
1681907774433,LIFR 1AX,A00,182324,Staff,14,0,14,0
1681907775458,LIFR 1B,A00,182259,Staff,14,0,14,0
1681907776486,LIFR 1BX,A00,182273,Staff,14,0,14,0
1681907777511,LIGN 8,A00,182330,Staff,137,0,150,13
1681907778537,LIGN 9GS,A00,182362,Staff,20,0,20,0
1681907779560,LIGN 119,A00,204992,Takahashi; Maho,12,0,15,3
1681907780587,LIGN 130,A01,182384,Staff,47,0,50,3
1681907781614,LIGN 149GS,A00,182390,Staff,20,0,20,0
1681907782642,LIGN 170,A00,182404,Staff,24,0,30,6
1681907783671,LISP 1D,A00,182281,Staff,7,0,14,7
1681907783671,LISP 1D,B00,182287,Staff,14,0,14,0
1681907783671,LISP 1D,C00,182295,Staff,11,0,14,3
1681907783671,LISP 1D,D00,182301,Staff,14,0,14,0
1681907784695,LISP 1DX,A00,182309,Staff,20,0,28,8
1681907784695,LISP 1DX,B00,182316,Staff,26,0,28,2
1681907785732,LTAF 120GS,A00,182412,Zhiri; Oumelbanine,20,0,20,0
1681907786757,LTCS 172GS,A00,182437,Bronstein; Phoebe Malan,20,0,20,0
1681907787784,LTEA 138,A00,182457,Staff,22,0,40,18
1681907788812,LTEN 114,A01,182490,Staff,23,0,25,2
1681907789836,LTEN 130GS,A00,182491,Lyon; Antony J.,20,0,20,0
1681907790861,LTEN 169,A00,182493,Cuong; Marisol,20,0,25,5
1681907791886,LTEN 178,A00,182501,Staff,14,0,15,1
1681907792911,LTEN 181,A00,182515,Staff,22,0,25,3
1681907793936,LTEN 185GS,A00,197655,Forbes; Camille,20,0,20,0
1681907794965,LTSP 100B,A00,202208,Bessett; Ryan Matthew,24,0,25,1
1681907795989,LTWL 100,A00,182516,Myerston Santana; Jacobo,23,0,30,7
1681907797013,LTWR 100GS,A00,182518,Forbes; Camille,20,0,20,0
1681907798040,LTWR 102,A00,182522,Staff,15,0,15,0
1681907798040,LTWR 102,B00,182525,Staff,14,0,15,1
1681907799066,LTWR 115,A00,182526,Staff,12,0,15,3
1681907800091,MAE 8,A01,182528,Pham; Hieu Tan,68,0,70,2
1681907801116,MAE 11,A00,182529,Bahadori; Mohammad Yousef,94,0,100,6
1681907802141,MAE 20,A00,182530,Evdokimenko; Ekaterina,68,0,70,2
1681907803169,MAE 30A,A00,182532,Staff,44,0,45,1
1681907804204,MAE 101A,A00,182533,Bahadori; Mohammad Yousef,97,0,100,3
1681907805235,MAE 101C,A00,182538,Staff,62,0,70,8
1681907806263,MAE 104,A00,182539,Staff,45,0,50,5
1681907807287,MAE 131A,A00,182540,Ghazinejad; Maziar,41,0,45,4
1681907808312,MAE 143A,A00,182548,Bewley; Thomas R,43,0,50,7
1681907809340,MAE 150,A00,182549,Staff,28,0,40,12
1681907810367,MAE 160,A00,182550,Evdokimenko; Ekaterina,43,0,60,17
1681907811398,MATH 3C,A01,182725,Staff,27,0,30,3
1681907812424,MATH 10A,A01,182729,Staff,25,0,30,5
1681907812424,MATH 10A,B01,182732,Staff,26,0,30,4
1681907813447,MATH 10B,A01,182737,Staff,21,0,30,9
1681907813447,MATH 10B,A02,182738,Staff,27,0,30,3
1681907813447,MATH 10B,B01,182744,Staff,27,0,30,3
1681907813447,MATH 10B,B02,182745,Staff,27,0,30,3
1681907814472,MATH 18,A01,182750,Anzaldo; Leesa B,28,0,30,2
1681907814472,MATH 18,A02,182751,Anzaldo; Leesa B,29,0,30,1
1681907814472,MATH 18,A03,182753,Anzaldo; Leesa B,28,0,30,2
1681907814472,MATH 18,A04,182757,Anzaldo; Leesa B,29,0,30,1
1681907814472,MATH 18,B01,182761,Anzaldo; Leesa B,27,0,30,3
1681907814472,MATH 18,B02,182764,Anzaldo; Leesa B,27,0,30,3
1681907814472,MATH 18,B03,182765,Anzaldo; Leesa B,30,0,30,0
1681907814472,MATH 18,B04,182766,Anzaldo; Leesa B,30,0,30,0
1681907815498,MATH 20A,A01,182771,Suk; Andrew Hoon,28,0,30,2
1681907816538,MATH 20B,A01,182775,Bach; Quang Tran,30,0,30,0
1681907816538,MATH 20B,A02,182777,Bach; Quang Tran,29,0,30,1
1681907816538,MATH 20B,B01,182780,Bach; Quang Tran,27,0,30,3
1681907816538,MATH 20B,B02,182782,Bach; Quang Tran,30,0,30,0
1681907817568,MATH 20C,A01,182787,Staff,25,0,30,5
1681907817568,MATH 20C,A02,182790,Staff,29,0,30,1
1681907817568,MATH 20C,B01,182792,Staff,25,0,30,5
1681907817568,MATH 20C,B02,182796,Staff,27,0,30,3
1681907818593,MATH 20D,A01,182799,Staff,29,0,30,1
1681907818593,MATH 20D,A02,182802,Staff,30,0,30,0
1681907818593,MATH 20D,A03,182803,Staff,30,0,30,0
1681907819615,MATH 20E,A01,182809,Verstraete; Jacques Allan,24,0,30,6
1681907819615,MATH 20E,A02,182811,Verstraete; Jacques Allan,28,0,30,2
1681907819615,MATH 20E,B01,182814,Verstraete; Jacques Allan,23,0,30,7
1681907819615,MATH 20E,B02,182815,Verstraete; Jacques Allan,30,0,30,0
1681907820641,MATH 103A,A01,182820,Staff,9,0,30,21
1681907820641,MATH 103A,A02,182821,Staff,27,0,30,3
1681907820641,MATH 103A,A03,182822,Staff,23,0,30,7
1681907820641,MATH 103A,B01,182825,Staff,23,0,30,7
1681907820641,MATH 103A,B02,182826,Staff,30,0,30,0
1681907820641,MATH 103A,B03,182830,Staff,30,0,30,0
1681907821667,MATH 109,A01,182836,Chow; Bennett,24,0,30,6
1681907821667,MATH 109,A02,182838,Chow; Bennett,29,0,30,1
1681907821667,MATH 109,A03,182894,Chow; Bennett,29,0,30,1
1681907821667,MATH 109,B01,182908,Chow; Bennett,28,0,30,2
1681907821667,MATH 109,B02,182909,Chow; Bennett,30,0,30,0
1681907821667,MATH 109,B03,182910,Chow; Bennett,27,0,30,3
1681907822694,MATH 142A,A01,182925,Staff,11,0,30,19
1681907822694,MATH 142A,A02,182935,Staff,25,0,30,5
1681907822694,MATH 142A,A03,182967,Staff,26,0,30,4
1681907822694,MATH 142A,B01,183125,Staff,24,0,30,6
1681907822694,MATH 142A,B02,183157,Staff,28,0,30,2
1681907822694,MATH 142A,B03,183158,Staff,29,0,30,1
1681907823720,MATH 183,A01,183160,Arias-Castro; Ery,23,0,30,7
1681907823720,MATH 183,A02,183161,Arias-Castro; Ery,29,0,30,1
1681907823720,MATH 183,B01,183163,Arias-Castro; Ery,28,0,30,2
1681907823720,MATH 183,B02,183164,Arias-Castro; Ery,28,0,30,2
1681907824748,MATH 193A,A01,183167,Staff,4,0,35,31
1681907824748,MATH 193A,A02,183168,Staff,28,0,35,7
1681907824748,MATH 193A,A03,183169,Staff,34,0,35,1
1681907824748,MATH 193A,A04,183170,Staff,28,0,35,7
1681907825778,MGT 4,A01,202395,Anderson; John Charles,75,0,80,5
1681907826802,MGT 5,A00,202396,Houskeeper; Robert,80,0,90,10
1681907827830,MGT 103,A00,202397,Eberhard; Craig A,55,0,90,35
1681907828858,MGT 131A,A00,202398,Houskeeper; Robert,85,0,90,5
1681907829881,MGT 135,A00,202399,Anderson; John Charles,83,0,90,7
1681907830903,MGT 162R,A00,202403,Gneezy; Uri,150,0,200,50
1681907831934,MGT 172,A00,202404,Hedges; Kathleen,50,0,90,40
1681907832958,MGT 181,A00,202405,Dunn; Louis Jean,84,0,90,6
1681907833987,MMW 14,A01,183200,Staff,16,0,28,12
1681907833987,MMW 14,A02,183201,Staff,26,0,28,2
1681907833987,MMW 14,A03,183202,Staff,24,0,28,4
1681907833987,MMW 14,A04,183203,Staff,25,0,28,3
1681907833987,MMW 14,A05,183204,Staff,26,0,28,2
1681907833987,MMW 14,A06,183205,Staff,27,0,28,1
1681907833987,MMW 14,B01,183207,Staff,26,0,28,2
1681907833987,MMW 14,B02,183208,Staff,28,0,28,0
1681907833987,MMW 14,B03,183209,Staff,28,0,28,0
1681907833987,MMW 14,B04,183210,Staff,28,0,28,0
1681907833987,MMW 14,B05,183211,Staff,28,0,28,0
1681907833987,MMW 14,B06,183212,Staff,28,0,28,0
1681907835014,MMW 14GS,A00,183213,Zhiri; Oumelbanine,28,0,28,0
1681907836036,MMW 15GS,B00,183215,Rahimi; Babak,28,0,28,0
1681907837062,MMW 121,A01,183217,Patterson; Patrick H.,14,0,28,14
1681907837062,MMW 121,A02,183218,Patterson; Patrick H.,25,0,28,3
1681907838087,MUS 1A,A01,182554,Staff,8,0,35,27
1681907839114,MUS 5,A01,182558,Staff,20,0,35,15
1681907840139,MUS 6,A01,182562,Staff,25,0,35,10
1681907841168,MUS 8GS,A00,182563,Borgo; David Garcia,25,0,25,0
1681907842196,MUS 13,A01,182567,Staff,24,0,25,1
1681907843221,MUS 15,A01,182570,Staff,32,0,35,3
1681907843221,MUS 15,B01,182575,Staff,10,0,35,25
1681907844246,MUS 80,A00,182578,Staff,23,0,25,2
1681907844246,MUS 80,B00,182581,Staff,20,0,25,5
1681907845275,MUS 113,A00,182582,Staff,25,0,25,0
1681907846302,MUS 114,A00,182583,Staff,4,0,25,21
1681907847325,MUS 150GS,A01,182588,Borgo; David Garcia,25,0,25,0
1681907848349,PHIL 1,A00,182590,Staff,35,0,40,5
1681907849377,PHIL 10,A01,182596,Grush; Rick Scott,31,0,35,4
1681907849377,PHIL 10,A02,182597,Grush; Rick Scott,34,0,35,1
1681907850411,PHIL 15,A01,182601,Staff,31,0,35,4
1681907850411,PHIL 15,A02,182602,Staff,33,0,35,2
1681907851436,PHIL 27,A01,182604,Staff,30,0,35,5
1681907851436,PHIL 27,A02,182607,Staff,35,0,35,0
1681907852460,PHIL 32,A01,182609,Staff,35,0,35,0
1681907852460,PHIL 32,A02,182612,Staff,35,0,35,0
1681907853488,PHIL 130,A00,182614,Staff,63,0,70,7
1681907854519,PHIL 136,A00,182616,Cohen; Jonathan David,66,0,70,4
1681907855545,PHIL 155,A00,182617,Vargas; Manuel Rogelio,60,0,70,10
1681907856660,PHIL 163,A01,182620,Staff,15,0,20,5
1681907856660,PHIL 163,A02,182624,Staff,10,0,20,10
1681907857682,PHIL 164,A00,182627,Staff,30,0,40,10
1681907858708,PHIL 173,A00,182628,Staff,36,0,40,4
1681907859739,PHYS 1A,A00,183221,Staff,54,0,60,6
1681907860762,PHYS 1AL,001,183222,Staff,25,0,30,5
1681907860762,PHYS 1AL,002,183223,Staff,28,0,30,2
1681907861791,PHYS 1B,A00,183231,Staff,44,0,60,16
1681907862825,PHYS 1BL,001,183232,Staff,20,0,30,10
1681907862825,PHYS 1BL,002,183233,Staff,29,0,30,1
1681907863852,PHYS 1C,A00,183240,Staff,30,0,60,30
1681907864877,PHYS 1CL,001,183241,Staff,13,0,30,17
1681907864877,PHYS 1CL,002,183242,Staff,22,0,30,8
1681907865901,PHYS 2AR,A01,183250,Staff,44,0,50,6
1681907866927,PHYS 2B,A01,183252,Staff,106,0,115,9
1681907867954,PHYS 2BL,A01,183254,Staff,21,0,24,3
1681907867954,PHYS 2BL,A02,183255,Staff,22,0,24,2
1681907868978,PHYS 2C,A01,183522,Staff,105,0,115,10
1681907870003,PHYS 4A,A01,183524,Staff,49,0,50,1
1681907871027,POLI 5,A00,183525,Staff,44,0,50,6
1681907872052,POLI 12,A00,183540,Staff,48,0,50,2
1681907873081,POLI 13R,A00,183541,Forman; Fonna,42,0,50,8
1681907874106,POLI 30,A00,183542,Mignozzetti; Umberto,47,0,50,3
1681907875134,POLI 100A,A00,183543,Staff,45,0,50,5
1681907876159,POLI 100E,A00,223598,Staff,32,0,35,3
1681907877189,POLI 103A,A00,183564,Kousser; Thad,38,0,50,12
1681907878212,POLI 104B,A00,201329,Staff,29,0,35,6
1681907879237,POLI 113BR,A00,183576,Hoston; Germaine,28,0,50,22
1681907880264,POLI 114BR,A00,183588,Staff,27,0,30,3
1681907881288,POLI 117R,A00,183595,Forman; Fonna,9,0,20,11
1681907882313,POLI 120H,A00,183596,Fisk; David Lee,13,0,20,7
1681907883340,POLI 130AA,A00,183597,Staff,14,0,20,6
1681907884364,POLI 134AA,A00,183598,Staff,19,0,20,1
1681907885389,POLI 135,A00,183599,Fisk; David Lee,20,0,25,5
1681907886416,POLI 142P,A00,183623,Staff,37,0,40,3
1681907887439,POLI 144D,A00,183624,Staff,22,0,25,3
1681907888464,POLI 151,A00,183625,Staff,15,0,20,5
1681907889487,POLI 162,A00,183626,Mignozzetti; Umberto,18,0,20,2
1681907890511,PSYC 1,A00,253748,Staff,86,0,90,4
1681907891535,PSYC 2,A00,183627,Moranton; Nirelia Melbina-,25,0,35,10
1681907892557,PSYC 3,A00,183628,Staff,43,0,45,2
1681907894606,PSYC 60,A01,183631,Lowe; Angela Beth,35,0,40,5
1681907895643,PSYC 70,A01,253757,Staff,37,0,45,8
1681907896675,PSYC 101,A00,183632,Heyman; Gail D.,48,0,60,12
1681907897698,PSYC 105,A00,183848,Lowe; Angela Beth,50,0,60,10
1681907898720,PSYC 106,A00,183849,Dobkins; Karen R.,45,0,60,15
1681907899748,PSYC 108,A00,253750,Staff,24,0,60,36
1681907900777,PSYC 114,A01,184275,Winkielman; Piotr,0,6,30,30
1681907901802,PSYC 122,A00,183856,Moranton; Nirelia Melbina-,0,10,30,30
1681907902827,PSYC 124,A00,183865,Chapman; Eddie Nathaniel,52,0,80,28
1681907903852,PSYC 137,A00,183880,Staff,19,0,25,6
1681907905905,PSYC 154,A00,183910,Lacefield; Katharine I,0,2,90,90
1681907907962,PSYC 162,A00,183946,Wixted; John T,61,0,90,29
1681907908988,PSYC 172,A00,183947,Gorman; Michael R.,14,0,30,16
1681907910012,PSYC 178,A00,183963,Glaser; Dale,20,0,40,20
1681907911036,PSYC 181GS,A00,183964,Anagnostaras; Stephan,10,0,10,0
1681907912063,PSYC 186GS,A01,257660,Staff,10,0,10,0
1681907913087,PSYC 193,B00,253749,Staff,23,0,25,2
1681907915139,PSYC 193L,A01,184122,Staff,33,0,35,2
1681907915139,PSYC 193L,C01,184167,Winkielman; Piotr,16,0,30,14
1681907916164,RELI 188GS,A00,182629,Rahimi; Babak,20,0,20,0
1681907917191,SE 101A,A00,182646,Staff,26,0,30,4
1681907918220,SE 101C,A00,182650,Staff,18,0,20,2
1681907919244,SE 110A,A00,182651,Staff,28,0,28,0
1681907920267,SE 130A,A00,182652,Staff,39,0,40,1
1681907921870,SIO 46GS,A00,182636,Cook; Geoffrey W,28,0,28,0
1681907922894,SIO 109R,A00,194459,Staff,5,0,20,15
1681907923919,SIO 121GS,A00,182639,Cook; Geoffrey W,28,0,28,0
1681907924944,SIO 132,A01,182642,Staff,32,0,40,8
1681907925973,SIO 139,A00,182644,Kacev; David,36,0,40,4
1681907926998,SOCI 2,A01,258404,Staff,34,0,36,2
1681907926998,SOCI 2,A02,258405,Staff,35,0,36,1
1681907928022,SOCI 60,A01,258408,Staff,29,0,30,1
1681907928022,SOCI 60,A02,258413,Staff,30,0,30,0
1681907929049,SOCI 100,A01,258415,Staff,29,0,30,1
1681907929049,SOCI 100,A02,258416,Staff,28,0,30,2
1681907935198,SOCI 127,A00,258421,Staff,22,0,30,8
1681907936226,SOCI 132,A00,258422,Staff,45,0,50,5
1681907937250,SOCI 133,A00,258423,Staff,26,0,30,4
1681907938274,SOCI 138GS,A00,258424,Staff,15,0,15,0
1681907939298,SOCI 145,A00,258425,Staff,25,0,30,5
1681907940324,SOCI 148,A00,258426,Staff,26,0,30,4
1681907941360,SOCI 153,A00,199217,Staff,29,0,30,1
1681907942394,SOCI 160,A00,258427,Staff,28,0,30,2
1681907943418,SOCI 160E,A00,258435,Staff,56,0,60,4
1681907944444,SOCI 189GS,A00,258436,Staff,15,0,15,0
1681907945470,SOCI 190GS,A00,258437,Staff,15,0,15,0
1681907946506,SYN 2,001,182658,Staff,9,0,16,7
1681907946506,SYN 2,002,201439,Staff,15,0,16,1
1681907946506,SYN 2,003,201443,Staff,16,0,16,0
1681907947539,SYN 100,A01,182657,Staff,17,0,20,3
1681907948563,TDAC 1,A00,184381,Salovey; Todd,16,0,20,4
1681907948563,TDAC 1,B00,184385,Harting; Carla Kelso,19,0,20,1
1681907948563,TDAC 1,C00,184394,Staff,19,0,20,1
1681907949592,TDAC 101,A00,184483,Harting; Carla Kelso,19,0,20,1
1681907950616,TDDE 111,A00,184496,Staff,14,0,15,1
1681907951644,TDDE 131,A00,184504,Staff,20,0,20,0
1681907951644,TDDE 131,B00,184505,Staff,17,0,18,1
1681907951644,TDDE 131,C00,184534,Staff,49,0,50,1
1681907951644,TDDE 131,D00,184564,Staff,15,0,15,0
1681907951644,TDDE 131,E00,204725,Staff,19,0,20,1
1681907952675,TDGE 1,A01,184414,Salovey; Todd,37,0,50,13
1681907953698,TDGE 5,A01,184419,Staff,23,0,24,1
1681907954725,TDGE 10,A00,184428,Fulton; Julia,31,0,50,19
1681907955749,TDGE 124,A00,184565,Fulton; Julia,7,0,50,43
1681907956773,TDGE 125,B00,184567,Meyer; Ursula,9,0,25,16
1681907957796,TDHT 101,A00,184568,Staff,21,0,25,4
1681907957796,TDHT 101,B00,184569,Staff,20,0,20,0
1681907958823,TDHT 114,A00,184570,Staff,49,0,50,1
1681907959848,TDMV 1,A00,184437,Arcidiacono; Kristin,23,0,30,7
1681907959848,TDMV 1,B00,184448,Caligagan; Maria T.,22,0,30,8
1681907960944,TDMV 2,A00,184449,Weinberg; Sadie,27,0,30,3
1681907960944,TDMV 2,B00,184453,Arcidiacono; Kristin,29,0,30,1
1681907961968,TDMV 110,A00,184571,Weinberg; Sadie,30,0,30,0
1681907962996,TDMV 142,A00,184572,Caligagan; Tony,27,0,30,3
1681907962996,TDMV 142,B00,184573,Caligagan; Maria T.,27,0,30,3
1681907964026,TDTR 20,A00,184482,Jun; Grace Shin Hae,25,0,25,0
1681907965050,USP 2,A01,184290,Hinds; Juli Beth,24,0,25,1
1681907966076,USP 3,A01,184295,Staff,20,0,25,5
1681907967107,USP 4,A00,184304,McTague; Sarah,15,0,25,10
1681907968131,USP 100,A00,184315,Staff,17,0,25,8
1681907969160,USP 105,A00,184326,Staff,21,0,25,4
1681907970187,USP 151,A00,184327,Staff,20,0,25,5
1681907971214,USP 170,A00,184380,Hinds; Juli Beth,14,0,25,11
1681907972237,VIS 21B,A01,182660,Staff,28,0,31,3
1681907972237,VIS 21B,A02,182662,Staff,30,0,31,1
1681907973261,VIS 103D,A00,182663,Staff,74,0,75,1
1681907974284,VIS 105D,A00,182667,Li; Huai,15,0,22,7
1681907975309,VIS 122GS,A00,182668,Herbst; Matthew,20,0,20,0
1681907976334,VIS 128C,A00,182673,Staff,70,0,75,5
1681907977359,VIS 130,A00,182675,Staff,20,0,22,2
1681907978387,VIS 160A,A00,182678,Stalbaum; Brett,4,0,10,6
1681907980443,WCWP 10B,A00,201679,Staff,15,0,15,0
1681907980443,WCWP 10B,B00,201695,Staff,15,0,15,0
1681907981466,WCWP 100,A00,201716,Staff,15,0,15,0
1681907981466,WCWP 100,B00,201717,Staff,11,0,15,4
1681907983543,ANSC 105GS,A00,258289,Staff,0,0,0,0
1681907984568,ANSC 125GS,A00,258295,Staff,0,0,0,0
1681907985593,ANSC 150,A00,258267,Staff,30,0,40,10
1681907986620,ANSC 190GS,A00,258280,Staff,0,0,0,0
1681907987648,ANTH 1,A00,258264,Staff,38,0,40,2
1681907988676,ANTH 2,A01,258259,Staff,72,0,76,4
1681907989701,ANTH 23,A01,258228,Staff,36,0,40,4
1681907990726,ANTH 101,A01,258236,Staff,39,0,40,1
1681907991750,ANTH 102,A00,258272,Staff,59,0,60,1
1681907992776,ANTH 105,A00,258244,Staff,31,0,35,4
1681907993801,BENG 130,A00,253975,Staff,38,0,40,2
1681907994836,BIBC 102,A01,191866,Flagg; Matthew Paul,19,0,32,13
1681907994836,BIBC 102,A02,191867,Flagg; Matthew Paul,22,0,32,10
1681907994836,BIBC 102,A03,191868,Flagg; Matthew Paul,30,0,32,2
1681907994836,BIBC 102,A04,191936,Flagg; Matthew Paul,26,0,32,6
1681907994836,BIBC 102,A05,191937,Flagg; Matthew Paul,11,0,32,21
1681907995860,BICD 100,A01,191939,Cooper; Andrew Michael,28,0,32,4
1681907995860,BICD 100,A02,191940,Cooper; Andrew Michael,32,0,32,0
1681907995860,BICD 100,A03,191941,Cooper; Andrew Michael,32,0,32,0
1681907995860,BICD 100,A04,191942,Cooper; Andrew Michael,32,0,32,0
1681907995860,BICD 100,A05,191943,Cooper; Andrew Michael,32,0,32,0
1681907996891,BIEB 126,A01,191945,Cleland; Elsa Eleanor,1,0,32,31
1681907996891,BIEB 126,A02,191946,Cleland; Elsa Eleanor,28,0,32,4
1681907996891,BIEB 126,A03,191947,Cleland; Elsa Eleanor,29,0,32,3
1681907996891,BIEB 126,A04,191948,Cleland; Elsa Eleanor,23,0,32,9
1681907996891,BIEB 126,A05,191996,Cleland; Elsa Eleanor,28,0,32,4
1681907997914,BIEB 136GS,A00,191997,Shurin; Jonathan & Holway; David A.,0,0,0,0
1681907998941,BIEB 137GS,A01,191999,Shurin; Jonathan & Holway; David A.,0,0,0,0
1681907999967,BILD 1,A01,205385,Staff,31,0,32,1
1681907999967,BILD 1,A02,205386,Staff,30,0,32,2
1681907999967,BILD 1,A03,205387,Staff,32,0,32,0
1681907999967,BILD 1,A04,205388,Staff,28,0,32,4
1681908000990,BILD 2,A01,191774,Staff,28,0,32,4
1681908000990,BILD 2,A02,191775,Staff,30,0,32,2
1681908000990,BILD 2,A03,191777,Staff,30,0,32,2
1681908000990,BILD 2,A04,191856,Staff,31,0,32,1
1681908000990,BILD 2,A05,191857,Staff,32,0,32,0
1681908000990,BILD 2,A06,191858,Staff,32,0,32,0
1681908000990,BILD 2,A07,191859,Staff,31,0,32,1
1681908002015,BILD 3,A01,205391,Staff,29,0,32,3
1681908002015,BILD 3,A02,205393,Staff,32,0,32,0
1681908002015,BILD 3,A03,205394,Staff,28,0,32,4
1681908002015,BILD 3,A04,205395,Staff,32,0,32,0
1681908003040,BILD 20,A01,191861,Staff,32,0,32,0
1681908003040,BILD 20,A02,191862,Staff,32,0,32,0
1681908004065,BILD 30,A01,191864,Staff,31,0,32,1
1681908005092,BIMM 100,A01,192019,Staff,0,0,32,32
1681908005092,BIMM 100,A02,192020,Staff,23,0,32,9
1681908005092,BIMM 100,A03,192035,Staff,22,0,32,10
1681908006125,BIMM 110,A01,192037,Tat; John,0,0,32,32
1681908006125,BIMM 110,A02,192038,Tat; John,10,0,32,22
1681908007156,BIMM 120,A01,192040,Pickett; Brooke Elizabeth,2,0,32,30
1681908007156,BIMM 120,A02,192041,Pickett; Brooke Elizabeth,16,0,32,16
1681908007156,BIMM 120,A03,192042,Pickett; Brooke Elizabeth,16,0,32,16
1681908008180,BIPN 100,A01,192044,Armour; Jon Christopher,26,0,32,6
1681908008180,BIPN 100,A02,192059,Armour; Jon Christopher,30,0,32,2
1681908008180,BIPN 100,A03,192064,Armour; Jon Christopher,31,0,32,1
1681908008180,BIPN 100,A04,192073,Armour; Jon Christopher,28,0,32,4
1681908009204,BIPN 148,A01,205411,Leutgeb; Jill K.,16,0,32,16
1681908009204,BIPN 148,A02,205412,Leutgeb; Jill K.,31,0,32,1
1681908009204,BIPN 148,A03,205413,Leutgeb; Jill K.,30,0,32,2
1681908009204,BIPN 148,A04,205414,Leutgeb; Jill K.,30,0,32,2
1681908010236,BIPN 160,A01,192115,Marino; Marc J,19,0,32,13
1681908010236,BIPN 160,A02,192148,Marino; Marc J,27,0,32,5
1681908010236,BIPN 160,A03,192158,Marino; Marc J,31,0,32,1
1681908010236,BIPN 160,A04,192190,Marino; Marc J,32,0,32,0
1681908010236,BIPN 160,A05,192287,Marino; Marc J,32,0,32,0
1681908010236,BIPN 160,A06,192288,Marino; Marc J,32,0,32,0
1681908011266,BIPN 194,A00,206038,Staff,28,0,32,4
1681908012297,BISP 194,A00,192289,Leutgeb; Stefan,13,0,32,19
1681908012297,BISP 194,B00,245332,Nieh; James Charles,27,0,32,5
1681908013322,CAT 124,A01,202247,Staff,15,0,15,0
1681908014349,CAT 125,A00,202248,Staff,19,0,20,1
1681908014349,CAT 125,B00,202253,Staff,20,0,20,0
1681908014349,CAT 125,C00,202257,Staff,19,0,20,1
1681908015373,CAT 125GS,A01,202273,Bronstein; Phoebe Malan,20,0,20,0
1681908016406,CAT 125R,A00,202284,Staff,17,0,20,3
1681908016406,CAT 125R,C00,202286,Staff,10,0,20,10
1681908016406,CAT 125R,D00,202291,Staff,18,0,20,2
1681908016406,CAT 125R,E00,202295,Staff,13,0,20,7
1681908016406,CAT 125R,F00,202302,Staff,12,0,20,8
1681908017434,CENG 100,A00,204724,Opatkiewicz; Justin Paul,25,0,25,0
1681908018458,CGS 2A,A01,180420,Staff,31,0,36,5
1681908019490,CGS 101,A00,180421,Staff,16,0,20,4
1681908020514,CGS 112,A00,180422,Staff,10,0,16,6
1681908021538,CGS 113,A00,180423,Staff,18,0,20,2
1681908022564,CGS 137,A00,180424,Staff,12,0,12,0
1681908023593,CGS 147,A00,180425,Staff,10,0,10,0
1681908024623,CHEM 6A,A01,179556,Staff,97,0,100,3
1681908024623,CHEM 6A,A02,179558,Staff,0,0,0,0
1681908025648,CHEM 6B,A01,179560,Staff,100,0,100,0
1681908026675,CHEM 6C,A01,179565,Jazzar; Rodolphe,95,0,100,5
1681908027702,CHEM 7L,A01,179586,Schurmeier; Kimberly,13,0,24,11
1681908027702,CHEM 7L,A02,179587,Schurmeier; Kimberly,23,0,24,1
1681908027702,CHEM 7L,A03,179590,Schurmeier; Kimberly,22,0,24,2
1681908027702,CHEM 7L,A04,179591,Schurmeier; Kimberly,22,0,24,2
1681908027702,CHEM 7L,B01,179598,Schurmeier; Kimberly,17,0,24,7
1681908027702,CHEM 7L,B02,179599,Schurmeier; Kimberly,24,0,24,0
1681908027702,CHEM 7L,B03,179606,Schurmeier; Kimberly,23,0,24,1
1681908027702,CHEM 7L,B04,179607,Schurmeier; Kimberly,23,0,24,1
1681908028728,CHEM 11,A01,179609,Stallings; Dontarie M,88,0,100,12
1681908029750,CHEM 40A,A01,179621,Staff,41,0,50,9
1681908029750,CHEM 40A,A02,179622,Staff,47,0,50,3
1681908030774,CHEM 40B,A01,179630,Weizman; Haim,48,0,50,2
1681908030774,CHEM 40B,A02,179631,Weizman; Haim,45,0,50,5
1681908031810,CHEM 41A,A01,179660,Klosterman; Jeremy K,93,0,100,7
1681908032840,CHEM 43A,A01,179683,Klosterman; Jeremy K,0,0,24,24
1681908032840,CHEM 43A,A02,179688,Klosterman; Jeremy K,14,0,24,10
1681908032840,CHEM 43A,A03,179689,Klosterman; Jeremy K,20,0,24,4
1681908032840,CHEM 43A,A04,179691,Klosterman; Jeremy K,18,0,24,6
1681908033865,CHEM 114A,A01,179693,Stallings; Dontarie M,77,0,100,23
1681908034890,CHEM 143B,A01,179698,Weizman; Haim,17,0,24,7
1681908034890,CHEM 143B,A02,179700,Weizman; Haim,24,0,24,0
1681908035925,CHIN 169A,A00,179701,Wang; Xiao,20,0,20,0
1681908036950,COGS 2,A01,179750,Boyle; Mary E. T.,17,0,30,13
1681908037980,COGS 9,A01,179759,Jones; Cameron Robert,43,0,50,7
1681908039004,COGS 14A,A01,179854,Staff,18,0,50,32
1681908040031,COGS 14B,A01,179856,Staff,54,0,60,6
1681908041056,COGS 17,A01,179874,Staff,71,0,75,4
1681908042080,COGS 18,A01,179884,Staff,63,0,80,17
1681908043106,COGS 100,A01,179886,Staff,40,0,60,20
1681908044134,COGS 101B,A01,179892,Staff,1,0,30,29
1681908045157,COGS 101C,A01,179894,Staff,28,0,30,2
1681908046181,COGS 107A,A01,179896,Boyle; Mary E. T.,31,0,40,9
1681908047206,COGS 108,A01,179898,Simpkins; Charles Alexander,0,17,60,60
1681908048234,COGS 109,A01,179900,Staff,34,0,40,6
1681908049259,COGS 118A,A01,179946,Staff,9,0,40,31
1681908050287,COGS 153,A00,179978,Staff,1,0,30,29
1681908051316,COGS 156,A01,179981,Staff,27,0,30,3
1681908053368,COGS 172,A01,179987,Staff,13,0,30,17
1681908055436,COGS 186,A01,179991,Staff,13,0,30,17
1681908056461,COMM 10,A01,180001,Staff,15,0,25,10
1681908056461,COMM 10,A02,180004,Staff,20,0,25,5
1681908057491,COMM 100A,A01,180016,Staff,18,0,25,7
1681908057491,COMM 100A,A02,180020,Staff,24,0,25,1
1681908058521,COMM 101T,A00,180029,Halm; Gavin Patrick,23,0,35,12
1681908059547,COMM 106V,A00,180043,Staff,34,0,35,1
1681908060575,COMM 109P,A00,180044,Staff,31,0,35,4
1681908061598,COMM 113T,A00,180045,Havis; Allan,37,0,45,8
1681908062623,COMM 132,A00,180046,McKenna; Denise,23,0,30,7
1681908063659,COMM 143,A00,180047,Staff,19,0,30,11
1681908064760,COMM 190,A00,180048,Conner; Thomas Hartnell,20,0,23,3
1681908065787,CSE 8A,A50,180053,Cao; Yingjun,25,0,50,25
1681908065787,CSE 8A,B50,180180,Staff,50,0,50,0
1681908066819,CSE 11,A01,180190,Cao; Yingjun,31,0,50,19
1681908067843,CSE 20,A01,180192,Briones; Jor-el Thomas Caparas,23,0,30,7
1681908068866,CSE 21,A01,194538,Briones; Jor-el Thomas Caparas,50,0,60,10
1681908069890,CSE 30,A01,180324,Eldon; John,79,0,100,21
1681908070917,CSE 101,A01,201353,Staff,0,20,40,40
1681908071943,CSE 134B,A01,180326,Powell; Thomas Allan,74,0,100,26
1681908072967,CSE 140,A01,180328,Staff,46,0,75,29
1681908073991,CSE 140L,A01,180344,Eldon; John,69,0,100,31
1681908075013,CSE 150A,A01,180411,Staff,0,7,50,50
1681908076039,CSE 151A,A01,180414,Staff,0,6,50,50
1681908077064,CSE 175,A01,222521,Kumar; Rakesh,50,0,50,0
1681908078092,CSE 190,A00,201419,Staff,45,0,49,4
1681908079115,CSS 1,A01,194536,Staff,38,0,50,12
1681908080138,DSC 30,A01,202385,Staff,48,0,50,2
1681908081168,DSC 40A,A01,202387,Albuyeh; Rod,50,0,50,0
1681908082192,DSC 190,A01,202389,Silberman; Jack,21,0,21,0
1681908083216,DSGN 100,A01,179993,Staff,16,0,30,14
1681908084240,ECE 65,A50,180708,Staff,10,0,20,10
1681908084240,ECE 65,A51,180739,Staff,19,0,20,1
1681908085268,ECON 1,A01,180427,Famulari; Melissa,67,0,70,3
1681908086296,ECON 2,A01,180450,Levkoff; Steven B.,64,0,70,6
1681908087320,ECON 4,A01,203351,Anderson; John Charles,7,0,10,3
1681908088351,ECON 100A,A01,180472,Famulari; Melissa,65,0,70,5
1681908089373,ECON 120A,A01,180549,Staff,64,0,70,6
1681908090402,ECON 120B,A01,180655,Ma; Xinwei,46,0,70,24
1681908091426,ECON 129,A00,203333,Eckert; Fabian Paul,15,0,35,20
1681908092461,ECON 131,A00,180656,Staff,9,0,35,26
1681908093488,ECON 172B,A01,180672,Levkoff; Steven B.,32,0,35,3
1681908094511,ECON 178,A01,203342,Zhu; Ying,11,0,35,24
1681908095534,EDS 108GS,A00,202383,Wishard Guerra; Alison G.,20,0,20,0
1681908096558,EDS 111GS,A00,202347,Wishard Guerra; Alison G.,20,0,20,0
1681908097585,EDS 112,A01,202323,Staff,56,0,60,4
1681908098608,EDS 113,A00,202340,Staff,33,0,35,2
1681908099631,EDS 118,A00,201231,Staff,20,0,30,10
1681908100655,EDS 119,A00,204994,Staff,8,0,10,2
1681908101681,EDS 124BR,A00,202324,Eguchi; Emi,5,0,25,20
1681908102707,EDS 126,A01,203208,Jones; Makeba,26,0,30,4
1681908103730,EDS 135,A01,202333,Staff,18,0,20,2
1681908104805,EDS 180,A00,202311,Staff,47,0,50,3
1681908105830,ERC 190GS,A01,253747,Staff,28,0,28,0
1681908106858,ETHN 104,A00,180742,Staff,24,0,35,11
1681908107885,ETHN 118,A00,180745,Staff,28,0,35,7
1681908108908,ETHN 127,A00,180747,Staff,12,0,16,4
1681908109939,ETHN 137,A00,180880,Staff,12,0,12,0
1681908110964,ETHN 147,A00,180890,Staff,8,0,10,2
1681908111987,ETHN 154,A00,180891,Staff,7,0,8,1
1681908113014,ETHN 168,A00,180892,Staff,9,0,10,1
1681908114039,GLBH 20,A00,201051,Hannah; Seth Donal,0,1,0,1
1681908115064,GLBH 111,A01,209338,Burgos; Jose L.,0,0,0,0
1681908116088,GLBH 150,A00,258300,Staff,0,3,0,0
1681908117116,GLBH 181,A00,201207,Staff,15,0,40,25
1681908118140,HIEU 109,A00,180898,Staff,20,0,20,0
1681908119168,HIEU 111,A00,180899,Staff,1,0,20,19
1681908120195,HIEU 124,A00,180900,Staff,18,0,20,2
1681908121225,HILA 122,A00,180901,Staff,18,0,20,2
1681908122252,HILA 132,A00,180902,Vitz; Matthew,2,0,20,18
1681908123278,HILD 10,A01,180896,Staff,15,0,20,5
1681908124307,HILD 30GS,A00,180897,Edington; Claire Ellen,0,0,0,0
1681908125330,HISC 105,A00,180903,Staff,20,0,20,0
1681908126357,HISC 117,A00,180904,Staff,11,0,20,9
1681908127383,HIUS 108B,A00,181005,Staff,18,0,20,2
1681908128407,HIUS 113,A00,181093,Staff,4,0,20,16
1681908129435,HUM 3,A01,181190,Patterson; Patrick H.,40,0,50,10
1681908129435,HUM 3,B01,181195,Staff,47,0,50,3
1681908130464,HUM 3GS,A00,181196,Herbst; Matthew,0,0,0,0
1681908131489,HUM 4,A01,181227,West; Geoffrey Scott,34,0,50,16
1681908131489,HUM 4,B01,181282,Staff,43,0,50,7
1681908132517,HUM 4GS,A00,181377,Lyon; Antony J.,0,0,0,0
1681908133540,HUM 5,A01,181536,Zavodny; Tatiana Sophia,31,0,50,19
1681908133540,HUM 5,B01,181908,Staff,36,0,50,14
1681908134567,INTL 190,A00,181909,Segui; Alan S,0,0,0,6
1681908134567,INTL 190,B00,181961,Segui; Alan S,0,0,0,7
1681908135592,JAPN 20AR,A01,182113,Ross; Kayoko F,15,0,20,5
1681908136619,LATI 50,A01,202391,Martin-Cabrera; Luis,19,0,30,11
1681908136619,LATI 50,A02,202392,Martin-Cabrera; Luis,26,0,30,4
1681908137653,LATI 180,A00,202393,Kokinis; Troy Andreas,25,0,25,0
1681908138677,LIFR 1A,A00,182119,Staff,14,0,14,0
1681908139703,LIFR 1AX,A00,182324,Staff,14,0,14,0
1681908140726,LIFR 1B,A00,182259,Staff,14,0,14,0
1681908141753,LIFR 1BX,A00,182273,Staff,14,0,14,0
1681908142776,LIGN 8,A00,182330,Staff,137,0,150,13
1681908143800,LIGN 9GS,A00,182362,Staff,20,0,20,0
1681908144826,LIGN 119,A00,204992,Takahashi; Maho,12,0,15,3
1681908145851,LIGN 130,A01,182384,Staff,47,0,50,3
1681908146874,LIGN 149GS,A00,182390,Staff,20,0,20,0
1681908147908,LIGN 170,A00,182404,Staff,24,0,30,6
1681908148940,LISP 1D,A00,182281,Staff,7,0,14,7
1681908148940,LISP 1D,B00,182287,Staff,14,0,14,0
1681908148940,LISP 1D,C00,182295,Staff,11,0,14,3
1681908148940,LISP 1D,D00,182301,Staff,14,0,14,0
1681908149969,LISP 1DX,A00,182309,Staff,20,0,28,8
1681908149969,LISP 1DX,B00,182316,Staff,26,0,28,2
1681908150995,LTAF 120GS,A00,182412,Zhiri; Oumelbanine,20,0,20,0
1681908152020,LTCS 172GS,A00,182437,Bronstein; Phoebe Malan,20,0,20,0
1681908153044,LTEA 138,A00,182457,Staff,22,0,40,18
1681908154074,LTEN 114,A01,182490,Staff,23,0,25,2
1681908155102,LTEN 130GS,A00,182491,Lyon; Antony J.,20,0,20,0
1681908156127,LTEN 169,A00,182493,Cuong; Marisol,20,0,25,5
1681908157154,LTEN 178,A00,182501,Staff,14,0,15,1
1681908158181,LTEN 181,A00,182515,Staff,22,0,25,3
1681908159211,LTEN 185GS,A00,197655,Forbes; Camille,20,0,20,0
1681908160235,LTSP 100B,A00,202208,Bessett; Ryan Matthew,24,0,25,1
1681908161261,LTWL 100,A00,182516,Myerston Santana; Jacobo,23,0,30,7
1681908162296,LTWR 100GS,A00,182518,Forbes; Camille,20,0,20,0
1681908163327,LTWR 102,A00,182522,Staff,15,0,15,0
1681908163327,LTWR 102,B00,182525,Staff,14,0,15,1
1681908164352,LTWR 115,A00,182526,Staff,12,0,15,3
1681908165378,MAE 8,A01,182528,Pham; Hieu Tan,68,0,70,2
1681908166406,MAE 11,A00,182529,Bahadori; Mohammad Yousef,94,0,100,6
1681908167435,MAE 20,A00,182530,Evdokimenko; Ekaterina,68,0,70,2
1681908168547,MAE 30A,A00,182532,Staff,44,0,45,1
1681908169574,MAE 101A,A00,182533,Bahadori; Mohammad Yousef,97,0,100,3
1681908170599,MAE 101C,A00,182538,Staff,62,0,70,8
1681908171625,MAE 104,A00,182539,Staff,45,0,50,5
1681908172648,MAE 131A,A00,182540,Ghazinejad; Maziar,41,0,45,4
1681908173675,MAE 143A,A00,182548,Bewley; Thomas R,43,0,50,7
1681908174706,MAE 150,A00,182549,Staff,28,0,40,12
1681908175735,MAE 160,A00,182550,Evdokimenko; Ekaterina,43,0,60,17
1681908176763,MATH 3C,A01,182725,Staff,27,0,30,3
1681908177787,MATH 10A,A01,182729,Staff,25,0,30,5
1681908177787,MATH 10A,B01,182732,Staff,26,0,30,4
1681908178811,MATH 10B,A01,182737,Staff,21,0,30,9
1681908178811,MATH 10B,A02,182738,Staff,27,0,30,3
1681908178811,MATH 10B,B01,182744,Staff,27,0,30,3
1681908178811,MATH 10B,B02,182745,Staff,27,0,30,3
1681908179834,MATH 18,A01,182750,Anzaldo; Leesa B,28,0,30,2
1681908179834,MATH 18,A02,182751,Anzaldo; Leesa B,29,0,30,1
1681908179834,MATH 18,A03,182753,Anzaldo; Leesa B,28,0,30,2
1681908179834,MATH 18,A04,182757,Anzaldo; Leesa B,29,0,30,1
1681908179834,MATH 18,B01,182761,Anzaldo; Leesa B,27,0,30,3
1681908179834,MATH 18,B02,182764,Anzaldo; Leesa B,27,0,30,3
1681908179834,MATH 18,B03,182765,Anzaldo; Leesa B,30,0,30,0
1681908179834,MATH 18,B04,182766,Anzaldo; Leesa B,30,0,30,0
1681908180863,MATH 20A,A01,182771,Suk; Andrew Hoon,28,0,30,2
1681908181889,MATH 20B,A01,182775,Bach; Quang Tran,30,0,30,0
1681908181889,MATH 20B,A02,182777,Bach; Quang Tran,29,0,30,1
1681908181889,MATH 20B,B01,182780,Bach; Quang Tran,27,0,30,3
1681908181889,MATH 20B,B02,182782,Bach; Quang Tran,30,0,30,0
1681908182914,MATH 20C,A01,182787,Staff,25,0,30,5
1681908182914,MATH 20C,A02,182790,Staff,29,0,30,1
1681908182914,MATH 20C,B01,182792,Staff,25,0,30,5
1681908182914,MATH 20C,B02,182796,Staff,27,0,30,3
1681908183940,MATH 20D,A01,182799,Staff,29,0,30,1
1681908183940,MATH 20D,A02,182802,Staff,30,0,30,0
1681908183940,MATH 20D,A03,182803,Staff,30,0,30,0
1681908184967,MATH 20E,A01,182809,Verstraete; Jacques Allan,24,0,30,6
1681908184967,MATH 20E,A02,182811,Verstraete; Jacques Allan,28,0,30,2
1681908184967,MATH 20E,B01,182814,Verstraete; Jacques Allan,23,0,30,7
1681908184967,MATH 20E,B02,182815,Verstraete; Jacques Allan,30,0,30,0
1681908185998,MATH 103A,A01,182820,Staff,9,0,30,21
1681908185998,MATH 103A,A02,182821,Staff,27,0,30,3
1681908185998,MATH 103A,A03,182822,Staff,23,0,30,7
1681908185998,MATH 103A,B01,182825,Staff,23,0,30,7
1681908185998,MATH 103A,B02,182826,Staff,30,0,30,0
1681908185998,MATH 103A,B03,182830,Staff,30,0,30,0
1681908187024,MATH 109,A01,182836,Chow; Bennett,24,0,30,6
1681908187024,MATH 109,A02,182838,Chow; Bennett,29,0,30,1
1681908187024,MATH 109,A03,182894,Chow; Bennett,29,0,30,1
1681908187024,MATH 109,B01,182908,Chow; Bennett,28,0,30,2
1681908187024,MATH 109,B02,182909,Chow; Bennett,30,0,30,0
1681908187024,MATH 109,B03,182910,Chow; Bennett,27,0,30,3
1681908188056,MATH 142A,A01,182925,Staff,11,0,30,19
1681908188056,MATH 142A,A02,182935,Staff,25,0,30,5
1681908188056,MATH 142A,A03,182967,Staff,26,0,30,4
1681908188056,MATH 142A,B01,183125,Staff,24,0,30,6
1681908188056,MATH 142A,B02,183157,Staff,28,0,30,2
1681908188056,MATH 142A,B03,183158,Staff,29,0,30,1
1681908189081,MATH 183,A01,183160,Arias-Castro; Ery,23,0,30,7
1681908189081,MATH 183,A02,183161,Arias-Castro; Ery,29,0,30,1
1681908189081,MATH 183,B01,183163,Arias-Castro; Ery,28,0,30,2
1681908189081,MATH 183,B02,183164,Arias-Castro; Ery,28,0,30,2
1681908190110,MATH 193A,A01,183167,Staff,4,0,35,31
1681908190110,MATH 193A,A02,183168,Staff,28,0,35,7
1681908190110,MATH 193A,A03,183169,Staff,34,0,35,1
1681908190110,MATH 193A,A04,183170,Staff,28,0,35,7
1681908191139,MGT 4,A01,202395,Anderson; John Charles,75,0,80,5
1681908192163,MGT 5,A00,202396,Houskeeper; Robert,80,0,90,10
1681908193188,MGT 103,A00,202397,Eberhard; Craig A,55,0,90,35
1681908194216,MGT 131A,A00,202398,Houskeeper; Robert,85,0,90,5
1681908195244,MGT 135,A00,202399,Anderson; John Charles,82,0,90,8
1681908196270,MGT 162R,A00,202403,Gneezy; Uri,150,0,200,50
1681908197294,MGT 172,A00,202404,Hedges; Kathleen,50,0,90,40
1681908198317,MGT 181,A00,202405,Dunn; Louis Jean,84,0,90,6
1681908199342,MMW 14,A01,183200,Staff,16,0,28,12
1681908199342,MMW 14,A02,183201,Staff,26,0,28,2
1681908199342,MMW 14,A03,183202,Staff,24,0,28,4
1681908199342,MMW 14,A04,183203,Staff,25,0,28,3
1681908199342,MMW 14,A05,183204,Staff,26,0,28,2
1681908199342,MMW 14,A06,183205,Staff,27,0,28,1
1681908199342,MMW 14,B01,183207,Staff,26,0,28,2
1681908199342,MMW 14,B02,183208,Staff,28,0,28,0
1681908199342,MMW 14,B03,183209,Staff,28,0,28,0
1681908199342,MMW 14,B04,183210,Staff,28,0,28,0
1681908199342,MMW 14,B05,183211,Staff,28,0,28,0
1681908199342,MMW 14,B06,183212,Staff,28,0,28,0
1681908200365,MMW 14GS,A00,183213,Zhiri; Oumelbanine,28,0,28,0
1681908201389,MMW 15GS,B00,183215,Rahimi; Babak,28,0,28,0
1681908202417,MMW 121,A01,183217,Patterson; Patrick H.,14,0,28,14
1681908202417,MMW 121,A02,183218,Patterson; Patrick H.,25,0,28,3
1681908203444,MUS 1A,A01,182554,Staff,8,0,35,27
1681908204470,MUS 5,A01,182558,Staff,20,0,35,15
1681908205496,MUS 6,A01,182562,Staff,25,0,35,10
1681908206522,MUS 8GS,A00,182563,Borgo; David Garcia,25,0,25,0
1681908207549,MUS 13,A01,182567,Staff,24,0,25,1
1681908208576,MUS 15,A01,182570,Staff,32,0,35,3
1681908208576,MUS 15,B01,182575,Staff,10,0,35,25
1681908209603,MUS 80,A00,182578,Staff,23,0,25,2
1681908209603,MUS 80,B00,182581,Staff,20,0,25,5
1681908210627,MUS 113,A00,182582,Staff,25,0,25,0
1681908211652,MUS 114,A00,182583,Staff,4,0,25,21
1681908212677,MUS 150GS,A01,182588,Borgo; David Garcia,25,0,25,0
1681908213705,PHIL 1,A00,182590,Staff,35,0,40,5
1681908214733,PHIL 10,A01,182596,Grush; Rick Scott,31,0,35,4
1681908214733,PHIL 10,A02,182597,Grush; Rick Scott,34,0,35,1
1681908215757,PHIL 15,A01,182601,Staff,31,0,35,4
1681908215757,PHIL 15,A02,182602,Staff,33,0,35,2
1681908216782,PHIL 27,A01,182604,Staff,30,0,35,5
1681908216782,PHIL 27,A02,182607,Staff,35,0,35,0
1681908217809,PHIL 32,A01,182609,Staff,35,0,35,0
1681908217809,PHIL 32,A02,182612,Staff,35,0,35,0
1681908218834,PHIL 130,A00,182614,Staff,63,0,70,7
1681908219858,PHIL 136,A00,182616,Cohen; Jonathan David,66,0,70,4
1681908220886,PHIL 155,A00,182617,Vargas; Manuel Rogelio,60,0,70,10
1681908221914,PHIL 163,A01,182620,Staff,15,0,20,5
1681908221914,PHIL 163,A02,182624,Staff,10,0,20,10
1681908222942,PHIL 164,A00,182627,Staff,30,0,40,10
1681908223965,PHIL 173,A00,182628,Staff,36,0,40,4
1681908224991,PHYS 1A,A00,183221,Staff,54,0,60,6
1681908226015,PHYS 1AL,001,183222,Staff,25,0,30,5
1681908226015,PHYS 1AL,002,183223,Staff,28,0,30,2
1681908227043,PHYS 1B,A00,183231,Staff,44,0,60,16
1681908228066,PHYS 1BL,001,183232,Staff,20,0,30,10
1681908228066,PHYS 1BL,002,183233,Staff,29,0,30,1
1681908229089,PHYS 1C,A00,183240,Staff,30,0,60,30
1681908230116,PHYS 1CL,001,183241,Staff,13,0,30,17
1681908230116,PHYS 1CL,002,183242,Staff,22,0,30,8
1681908231142,PHYS 2AR,A01,183250,Staff,44,0,50,6
1681908232166,PHYS 2B,A01,183252,Staff,106,0,115,9
1681908233190,PHYS 2BL,A01,183254,Staff,21,0,24,3
1681908233190,PHYS 2BL,A02,183255,Staff,22,0,24,2
1681908234217,PHYS 2C,A01,183522,Staff,105,0,115,10
1681908235243,PHYS 4A,A01,183524,Staff,49,0,50,1
1681908236266,POLI 5,A00,183525,Staff,44,0,50,6
1681908237294,POLI 12,A00,183540,Staff,48,0,50,2
1681908238319,POLI 13R,A00,183541,Forman; Fonna,42,0,50,8
1681908239341,POLI 30,A00,183542,Mignozzetti; Umberto,47,0,50,3
1681908240364,POLI 100A,A00,183543,Staff,45,0,50,5
1681908241393,POLI 100E,A00,223598,Staff,32,0,35,3
1681908242418,POLI 103A,A00,183564,Kousser; Thad,38,0,50,12
1681908243447,POLI 104B,A00,201329,Staff,29,0,35,6
1681908244473,POLI 113BR,A00,183576,Hoston; Germaine,28,0,50,22
1681908245496,POLI 114BR,A00,183588,Staff,27,0,30,3
1681908246520,POLI 117R,A00,183595,Forman; Fonna,9,0,20,11
1681908247548,POLI 120H,A00,183596,Fisk; David Lee,13,0,20,7
1681908248574,POLI 130AA,A00,183597,Staff,14,0,20,6
1681908249597,POLI 134AA,A00,183598,Staff,19,0,20,1
1681908250622,POLI 135,A00,183599,Fisk; David Lee,20,0,25,5
1681908251645,POLI 142P,A00,183623,Staff,37,0,40,3
1681908252672,POLI 144D,A00,183624,Staff,22,0,25,3
1681908253695,POLI 151,A00,183625,Staff,15,0,20,5
1681908254718,POLI 162,A00,183626,Mignozzetti; Umberto,18,0,20,2
1681908255743,PSYC 1,A00,253748,Staff,86,0,90,4
1681908256768,PSYC 2,A00,183627,Moranton; Nirelia Melbina-,25,0,35,10
1681908257792,PSYC 3,A00,183628,Staff,43,0,45,2
1681908259839,PSYC 60,A01,183631,Lowe; Angela Beth,35,0,40,5
1681908260868,PSYC 70,A01,253757,Staff,37,0,45,8
1681908261893,PSYC 101,A00,183632,Heyman; Gail D.,48,0,60,12
1681908262919,PSYC 105,A00,183848,Lowe; Angela Beth,50,0,60,10
1681908263942,PSYC 106,A00,183849,Dobkins; Karen R.,45,0,60,15
1681908264965,PSYC 108,A00,253750,Staff,24,0,60,36
1681908265991,PSYC 114,A01,184275,Winkielman; Piotr,0,6,30,30
1681908267021,PSYC 122,A00,183856,Moranton; Nirelia Melbina-,0,10,30,30
1681908268050,PSYC 124,A00,183865,Chapman; Eddie Nathaniel,52,0,80,28
1681908269074,PSYC 137,A00,183880,Staff,19,0,25,6
1681908271126,PSYC 154,A00,183910,Lacefield; Katharine I,0,2,90,90
1681908273258,PSYC 162,A00,183946,Wixted; John T,61,0,90,29
1681908274286,PSYC 172,A00,183947,Gorman; Michael R.,14,0,30,16
1681908275316,PSYC 178,A00,183963,Glaser; Dale,20,0,40,20
1681908276342,PSYC 181GS,A00,183964,Anagnostaras; Stephan,10,0,10,0
1681908277369,PSYC 186GS,A01,257660,Staff,10,0,10,0
1681908278394,PSYC 193,B00,253749,Staff,23,0,25,2
1681908280445,PSYC 193L,A01,184122,Staff,33,0,35,2
1681908280445,PSYC 193L,C01,184167,Winkielman; Piotr,16,0,30,14
1681908281478,RELI 188GS,A00,182629,Rahimi; Babak,20,0,20,0
1681908282508,SE 101A,A00,182646,Staff,26,0,30,4
1681908283532,SE 101C,A00,182650,Staff,18,0,20,2
1681908284556,SE 110A,A00,182651,Staff,28,0,28,0
1681908285581,SE 130A,A00,182652,Staff,39,0,40,1
1681908286607,SIO 46GS,A00,182636,Cook; Geoffrey W,28,0,28,0
1681908287630,SIO 109R,A00,194459,Staff,5,0,20,15
1681908288660,SIO 121GS,A00,182639,Cook; Geoffrey W,28,0,28,0
1681908289685,SIO 132,A01,182642,Staff,32,0,40,8
1681908290712,SIO 139,A00,182644,Kacev; David,36,0,40,4
1681908291739,SOCI 2,A01,258404,Staff,34,0,36,2
1681908291739,SOCI 2,A02,258405,Staff,35,0,36,1
1681908292764,SOCI 60,A01,258408,Staff,29,0,30,1
1681908292764,SOCI 60,A02,258413,Staff,30,0,30,0
1681908293790,SOCI 100,A01,258415,Staff,29,0,30,1
1681908293790,SOCI 100,A02,258416,Staff,28,0,30,2
1681908299944,SOCI 127,A00,258421,Staff,22,0,30,8
1681908300967,SOCI 132,A00,258422,Staff,45,0,50,5
1681908301999,SOCI 133,A00,258423,Staff,26,0,30,4
1681908303027,SOCI 138GS,A00,258424,Staff,15,0,15,0
1681908304054,SOCI 145,A00,258425,Staff,25,0,30,5
1681908305077,SOCI 148,A00,258426,Staff,26,0,30,4
1681908306100,SOCI 153,A00,199217,Staff,29,0,30,1
1681908307129,SOCI 160,A00,258427,Staff,28,0,30,2
1681908308152,SOCI 160E,A00,258435,Staff,56,0,60,4
1681908309175,SOCI 189GS,A00,258436,Staff,15,0,15,0
1681908310202,SOCI 190GS,A00,258437,Staff,15,0,15,0
1681908311225,SYN 2,001,182658,Staff,9,0,16,7
1681908311225,SYN 2,002,201439,Staff,15,0,16,1
1681908311225,SYN 2,003,201443,Staff,16,0,16,0
1681908312258,SYN 100,A01,182657,Staff,17,0,20,3
1681908313285,TDAC 1,A00,184381,Salovey; Todd,16,0,20,4
1681908313285,TDAC 1,B00,184385,Harting; Carla Kelso,19,0,20,1
1681908313285,TDAC 1,C00,184394,Staff,19,0,20,1
1681908314313,TDAC 101,A00,184483,Harting; Carla Kelso,19,0,20,1
1681908315341,TDDE 111,A00,184496,Staff,14,0,15,1
1681908316370,TDDE 131,A00,184504,Staff,20,0,20,0
1681908316370,TDDE 131,B00,184505,Staff,17,0,18,1
1681908316370,TDDE 131,C00,184534,Staff,49,0,50,1
1681908316370,TDDE 131,D00,184564,Staff,15,0,15,0
1681908316370,TDDE 131,E00,204725,Staff,19,0,20,1
1681908317402,TDGE 1,A01,184414,Salovey; Todd,37,0,50,13
1681908318434,TDGE 5,A01,184419,Staff,23,0,24,1
1681908319459,TDGE 10,A00,184428,Fulton; Julia,31,0,50,19
1681908320483,TDGE 124,A00,184565,Fulton; Julia,7,0,50,43
1681908321508,TDGE 125,B00,184567,Meyer; Ursula,9,0,25,16
1681908322535,TDHT 101,A00,184568,Staff,21,0,25,4
1681908322535,TDHT 101,B00,184569,Staff,20,0,20,0
1681908323563,TDHT 114,A00,184570,Staff,49,0,50,1
1681908324587,TDMV 1,A00,184437,Arcidiacono; Kristin,23,0,30,7
1681908324587,TDMV 1,B00,184448,Caligagan; Maria T.,22,0,30,8
1681908325624,TDMV 2,A00,184449,Weinberg; Sadie,27,0,30,3
1681908325624,TDMV 2,B00,184453,Arcidiacono; Kristin,29,0,30,1
1681908326653,TDMV 110,A00,184571,Weinberg; Sadie,30,0,30,0
1681908327676,TDMV 142,A00,184572,Caligagan; Tony,27,0,30,3
1681908327676,TDMV 142,B00,184573,Caligagan; Maria T.,27,0,30,3
1681908328703,TDTR 20,A00,184482,Jun; Grace Shin Hae,25,0,25,0
1681908329727,USP 2,A01,184290,Hinds; Juli Beth,24,0,25,1
1681908330751,USP 3,A01,184295,Staff,20,0,25,5
1681908331776,USP 4,A00,184304,McTague; Sarah,15,0,25,10
1681908332802,USP 100,A00,184315,Staff,17,0,25,8
1681908333826,USP 105,A00,184326,Staff,21,0,25,4
1681908334850,USP 151,A00,184327,Staff,20,0,25,5
1681908335879,USP 170,A00,184380,Hinds; Juli Beth,14,0,25,11
1681908336927,VIS 21B,A01,182660,Staff,28,0,31,3
1681908336927,VIS 21B,A02,182662,Staff,30,0,31,1
1681908337951,VIS 103D,A00,182663,Staff,74,0,75,1
1681908338975,VIS 105D,A00,182667,Li; Huai,15,0,22,7
1681908339999,VIS 122GS,A00,182668,Herbst; Matthew,20,0,20,0
1681908341027,VIS 128C,A00,182673,Staff,70,0,75,5
1681908342056,VIS 130,A00,182675,Staff,20,0,22,2
1681908343084,VIS 160A,A00,182678,Stalbaum; Brett,4,0,10,6
1681908345132,WCWP 10B,A00,201679,Staff,15,0,15,0
1681908345132,WCWP 10B,B00,201695,Staff,15,0,15,0
1681908346156,WCWP 100,A00,201716,Staff,15,0,15,0
1681908346156,WCWP 100,B00,201717,Staff,11,0,15,4
1681908348232,ANSC 105GS,A00,258289,Staff,0,0,0,0
1681908349256,ANSC 125GS,A00,258295,Staff,0,0,0,0
1681908350281,ANSC 150,A00,258267,Staff,30,0,40,10
1681908351304,ANSC 190GS,A00,258280,Staff,0,0,0,0
1681908352327,ANTH 1,A00,258264,Staff,38,0,40,2
1681908353350,ANTH 2,A01,258259,Staff,72,0,76,4
1681908354375,ANTH 23,A01,258228,Staff,36,0,40,4
1681908355402,ANTH 101,A01,258236,Staff,39,0,40,1
1681908356431,ANTH 102,A00,258272,Staff,59,0,60,1
1681908357465,ANTH 105,A00,258244,Staff,31,0,35,4
1681908358492,BENG 130,A00,253975,Staff,38,0,40,2
1681908359521,BIBC 102,A01,191866,Flagg; Matthew Paul,19,0,32,13
1681908359521,BIBC 102,A02,191867,Flagg; Matthew Paul,22,0,32,10
1681908359521,BIBC 102,A03,191868,Flagg; Matthew Paul,30,0,32,2
1681908359521,BIBC 102,A04,191936,Flagg; Matthew Paul,26,0,32,6
1681908359521,BIBC 102,A05,191937,Flagg; Matthew Paul,11,0,32,21
1681908360547,BICD 100,A01,191939,Cooper; Andrew Michael,28,0,32,4
1681908360547,BICD 100,A02,191940,Cooper; Andrew Michael,32,0,32,0
1681908360547,BICD 100,A03,191941,Cooper; Andrew Michael,32,0,32,0
1681908360547,BICD 100,A04,191942,Cooper; Andrew Michael,32,0,32,0
1681908360547,BICD 100,A05,191943,Cooper; Andrew Michael,32,0,32,0
1681908361572,BIEB 126,A01,191945,Cleland; Elsa Eleanor,1,0,32,31
1681908361572,BIEB 126,A02,191946,Cleland; Elsa Eleanor,28,0,32,4
1681908361572,BIEB 126,A03,191947,Cleland; Elsa Eleanor,29,0,32,3
1681908361572,BIEB 126,A04,191948,Cleland; Elsa Eleanor,23,0,32,9
1681908361572,BIEB 126,A05,191996,Cleland; Elsa Eleanor,28,0,32,4
1681908362597,BIEB 136GS,A00,191997,Shurin; Jonathan & Holway; David A.,0,0,0,0
1681908363624,BIEB 137GS,A01,191999,Shurin; Jonathan & Holway; David A.,0,0,0,0
1681908364654,BILD 1,A01,205385,Staff,31,0,32,1
1681908364654,BILD 1,A02,205386,Staff,30,0,32,2
1681908364654,BILD 1,A03,205387,Staff,32,0,32,0
1681908364654,BILD 1,A04,205388,Staff,28,0,32,4
1681908365678,BILD 2,A01,191774,Staff,28,0,32,4
1681908365678,BILD 2,A02,191775,Staff,30,0,32,2
1681908365678,BILD 2,A03,191777,Staff,30,0,32,2
1681908365678,BILD 2,A04,191856,Staff,31,0,32,1
1681908365678,BILD 2,A05,191857,Staff,32,0,32,0
1681908365678,BILD 2,A06,191858,Staff,32,0,32,0
1681908365678,BILD 2,A07,191859,Staff,31,0,32,1
1681908366707,BILD 3,A01,205391,Staff,29,0,32,3
1681908366707,BILD 3,A02,205393,Staff,32,0,32,0
1681908366707,BILD 3,A03,205394,Staff,28,0,32,4
1681908366707,BILD 3,A04,205395,Staff,32,0,32,0
1681908367733,BILD 20,A01,191861,Staff,32,0,32,0
1681908367733,BILD 20,A02,191862,Staff,32,0,32,0
1681908368759,BILD 30,A01,191864,Staff,31,0,32,1
1681908369787,BIMM 100,A01,192019,Staff,0,0,32,32
1681908369787,BIMM 100,A02,192020,Staff,23,0,32,9
1681908369787,BIMM 100,A03,192035,Staff,22,0,32,10
1681908370815,BIMM 110,A01,192037,Tat; John,0,0,32,32
1681908370815,BIMM 110,A02,192038,Tat; John,10,0,32,22
1681908371843,BIMM 120,A01,192040,Pickett; Brooke Elizabeth,2,0,32,30
1681908371843,BIMM 120,A02,192041,Pickett; Brooke Elizabeth,16,0,32,16
1681908371843,BIMM 120,A03,192042,Pickett; Brooke Elizabeth,16,0,32,16
1681908372872,BIPN 100,A01,192044,Armour; Jon Christopher,26,0,32,6
1681908372872,BIPN 100,A02,192059,Armour; Jon Christopher,30,0,32,2
1681908372872,BIPN 100,A03,192064,Armour; Jon Christopher,31,0,32,1
1681908372872,BIPN 100,A04,192073,Armour; Jon Christopher,28,0,32,4
1681908373898,BIPN 148,A01,205411,Leutgeb; Jill K.,16,0,32,16
1681908373898,BIPN 148,A02,205412,Leutgeb; Jill K.,31,0,32,1
1681908373898,BIPN 148,A03,205413,Leutgeb; Jill K.,30,0,32,2
1681908373898,BIPN 148,A04,205414,Leutgeb; Jill K.,30,0,32,2
1681908374927,BIPN 160,A01,192115,Marino; Marc J,19,0,32,13
1681908374927,BIPN 160,A02,192148,Marino; Marc J,27,0,32,5
1681908374927,BIPN 160,A03,192158,Marino; Marc J,31,0,32,1
1681908374927,BIPN 160,A04,192190,Marino; Marc J,32,0,32,0
1681908374927,BIPN 160,A05,192287,Marino; Marc J,32,0,32,0
1681908374927,BIPN 160,A06,192288,Marino; Marc J,32,0,32,0
1681908376042,BIPN 194,A00,206038,Staff,28,0,32,4
1681908377066,BISP 194,A00,192289,Leutgeb; Stefan,13,0,32,19
1681908377066,BISP 194,B00,245332,Nieh; James Charles,27,0,32,5
1681908378089,CAT 124,A01,202247,Staff,15,0,15,0
1681908379115,CAT 125,A00,202248,Staff,19,0,20,1
1681908379115,CAT 125,B00,202253,Staff,20,0,20,0
1681908379115,CAT 125,C00,202257,Staff,19,0,20,1
1681908380144,CAT 125GS,A01,202273,Bronstein; Phoebe Malan,20,0,20,0
1681908381180,CAT 125R,A00,202284,Staff,17,0,20,3
1681908381180,CAT 125R,C00,202286,Staff,10,0,20,10
1681908381180,CAT 125R,D00,202291,Staff,18,0,20,2
1681908381180,CAT 125R,E00,202295,Staff,13,0,20,7
1681908381180,CAT 125R,F00,202302,Staff,12,0,20,8
1681908382204,CENG 100,A00,204724,Opatkiewicz; Justin Paul,25,0,25,0
1681908383247,CGS 2A,A01,180420,Staff,31,0,36,5
1681908384272,CGS 101,A00,180421,Staff,16,0,20,4
1681908385299,CGS 112,A00,180422,Staff,10,0,16,6
1681908386326,CGS 113,A00,180423,Staff,18,0,20,2
1681908387354,CGS 137,A00,180424,Staff,12,0,12,0
1681908388379,CGS 147,A00,180425,Staff,10,0,10,0
1681908389409,CHEM 6A,A01,179556,Staff,97,0,100,3
1681908389409,CHEM 6A,A02,179558,Staff,0,0,0,0
1681908390434,CHEM 6B,A01,179560,Staff,100,0,100,0
1681908391467,CHEM 6C,A01,179565,Jazzar; Rodolphe,95,0,100,5
1681908392491,CHEM 7L,A01,179586,Schurmeier; Kimberly,13,0,24,11
1681908392491,CHEM 7L,A02,179587,Schurmeier; Kimberly,23,0,24,1
1681908392491,CHEM 7L,A03,179590,Schurmeier; Kimberly,22,0,24,2
1681908392491,CHEM 7L,A04,179591,Schurmeier; Kimberly,22,0,24,2
1681908392491,CHEM 7L,B01,179598,Schurmeier; Kimberly,17,0,24,7
1681908392491,CHEM 7L,B02,179599,Schurmeier; Kimberly,24,0,24,0
1681908392491,CHEM 7L,B03,179606,Schurmeier; Kimberly,23,0,24,1
1681908392491,CHEM 7L,B04,179607,Schurmeier; Kimberly,23,0,24,1
1681908393517,CHEM 11,A01,179609,Stallings; Dontarie M,88,0,100,12
1681908394543,CHEM 40A,A01,179621,Staff,41,0,50,9
1681908394543,CHEM 40A,A02,179622,Staff,47,0,50,3
1681908395567,CHEM 40B,A01,179630,Weizman; Haim,48,0,50,2
1681908395567,CHEM 40B,A02,179631,Weizman; Haim,45,0,50,5
1681908396593,CHEM 41A,A01,179660,Klosterman; Jeremy K,93,0,100,7
1681908397621,CHEM 43A,A01,179683,Klosterman; Jeremy K,0,0,24,24
1681908397621,CHEM 43A,A02,179688,Klosterman; Jeremy K,14,0,24,10
1681908397621,CHEM 43A,A03,179689,Klosterman; Jeremy K,20,0,24,4
1681908397621,CHEM 43A,A04,179691,Klosterman; Jeremy K,18,0,24,6
1681908398650,CHEM 114A,A01,179693,Stallings; Dontarie M,77,0,100,23
1681908399677,CHEM 143B,A01,179698,Weizman; Haim,17,0,24,7
1681908399677,CHEM 143B,A02,179700,Weizman; Haim,24,0,24,0
1681908400701,CHIN 169A,A00,179701,Wang; Xiao,20,0,20,0
1681908401734,COGS 2,A01,179750,Boyle; Mary E. T.,17,0,30,13
1681908402765,COGS 9,A01,179759,Jones; Cameron Robert,43,0,50,7
1681908403794,COGS 14A,A01,179854,Staff,18,0,50,32
1681908404823,COGS 14B,A01,179856,Staff,54,0,60,6
1681908405847,COGS 17,A01,179874,Staff,71,0,75,4
1681908406875,COGS 18,A01,179884,Staff,63,0,80,17
1681908407904,COGS 100,A01,179886,Staff,40,0,60,20
1681908408933,COGS 101B,A01,179892,Staff,1,0,30,29
1681908409960,COGS 101C,A01,179894,Staff,28,0,30,2
1681908410988,COGS 107A,A01,179896,Boyle; Mary E. T.,31,0,40,9
1681908412013,COGS 108,A01,179898,Simpkins; Charles Alexander,0,17,60,60
1681908413042,COGS 109,A01,179900,Staff,34,0,40,6
1681908414067,COGS 118A,A01,179946,Staff,9,0,40,31
1681908415091,COGS 153,A00,179978,Staff,1,0,30,29
1681908416115,COGS 156,A01,179981,Staff,27,0,30,3
1681908418170,COGS 172,A01,179987,Staff,13,0,30,17
1681908420227,COGS 186,A01,179991,Staff,13,0,30,17
1681908421252,COMM 10,A01,180001,Staff,15,0,25,10
1681908421252,COMM 10,A02,180004,Staff,20,0,25,5
1681908422285,COMM 100A,A01,180016,Staff,18,0,25,7
1681908422285,COMM 100A,A02,180020,Staff,24,0,25,1
1681908423314,COMM 101T,A00,180029,Halm; Gavin Patrick,23,0,35,12
1681908424337,COMM 106V,A00,180043,Staff,34,0,35,1
1681908425371,COMM 109P,A00,180044,Staff,31,0,35,4
1681908426403,COMM 113T,A00,180045,Havis; Allan,37,0,45,8
1681908427435,COMM 132,A00,180046,McKenna; Denise,23,0,30,7
1681908428461,COMM 143,A00,180047,Staff,19,0,30,11
1681908429486,COMM 190,A00,180048,Conner; Thomas Hartnell,20,0,23,3
1681908430518,CSE 8A,A50,180053,Cao; Yingjun,25,0,50,25
1681908430518,CSE 8A,B50,180180,Staff,50,0,50,0
1681908431542,CSE 11,A01,180190,Cao; Yingjun,31,0,50,19
1681908432573,CSE 20,A01,180192,Briones; Jor-el Thomas Caparas,23,0,30,7
1681908433596,CSE 21,A01,194538,Briones; Jor-el Thomas Caparas,50,0,60,10
1681908434624,CSE 30,A01,180324,Eldon; John,79,0,100,21
1681908435649,CSE 101,A01,201353,Staff,0,20,40,40
1681908436673,CSE 134B,A01,180326,Powell; Thomas Allan,74,0,100,26
1681908437698,CSE 140,A01,180328,Staff,46,0,75,29
1681908438727,CSE 140L,A01,180344,Eldon; John,69,0,100,31
1681908439760,CSE 150A,A01,180411,Staff,0,7,50,50
1681908440787,CSE 151A,A01,180414,Staff,0,6,50,50
1681908441819,CSE 175,A01,222521,Kumar; Rakesh,50,0,50,0
1681908442843,CSE 190,A00,201419,Staff,45,0,49,4
1681908443868,CSS 1,A01,194536,Staff,38,0,50,12
1681908444894,DSC 30,A01,202385,Staff,48,0,50,2
1681908445926,DSC 40A,A01,202387,Albuyeh; Rod,50,0,50,0
1681908446958,DSC 190,A01,202389,Silberman; Jack,21,0,21,0
1681908447987,DSGN 100,A01,179993,Staff,16,0,30,14
1681908449016,ECE 65,A50,180708,Staff,10,0,20,10
1681908449016,ECE 65,A51,180739,Staff,19,0,20,1
1681908450047,ECON 1,A01,180427,Famulari; Melissa,67,0,70,3
1681908451080,ECON 2,A01,180450,Levkoff; Steven B.,64,0,70,6
1681908452111,ECON 4,A01,203351,Anderson; John Charles,7,0,10,3
1681908453139,ECON 100A,A01,180472,Famulari; Melissa,65,0,70,5
1681908454162,ECON 120A,A01,180549,Staff,64,0,70,6
1681908455189,ECON 120B,A01,180655,Ma; Xinwei,46,0,70,24
1681908456221,ECON 129,A00,203333,Eckert; Fabian Paul,15,0,35,20
1681908457246,ECON 131,A00,180656,Staff,9,0,35,26
1681908458271,ECON 172B,A01,180672,Levkoff; Steven B.,32,0,35,3
1681908459296,ECON 178,A01,203342,Zhu; Ying,11,0,35,24
1681908460327,EDS 108GS,A00,202383,Wishard Guerra; Alison G.,20,0,20,0
1681908461356,EDS 111GS,A00,202347,Wishard Guerra; Alison G.,20,0,20,0
1681908462381,EDS 112,A01,202323,Staff,56,0,60,4
1681908463403,EDS 113,A00,202340,Staff,33,0,35,2
1681908464428,EDS 118,A00,201231,Staff,20,0,30,10
1681908465452,EDS 119,A00,204994,Staff,8,0,10,2
1681908466485,EDS 124BR,A00,202324,Eguchi; Emi,5,0,25,20
1681908467517,EDS 126,A01,203208,Jones; Makeba,26,0,30,4
1681908468543,EDS 135,A01,202333,Staff,18,0,20,2
1681908469573,EDS 180,A00,202311,Staff,47,0,50,3
1681908470596,ERC 190GS,A01,253747,Staff,28,0,28,0
1681908471622,ETHN 104,A00,180742,Staff,24,0,35,11
1681908472646,ETHN 118,A00,180745,Staff,28,0,35,7
1681908473670,ETHN 127,A00,180747,Staff,12,0,16,4
1681908474700,ETHN 137,A00,180880,Staff,12,0,12,0
1681908475728,ETHN 147,A00,180890,Staff,8,0,10,2
1681908476753,ETHN 154,A00,180891,Staff,7,0,8,1
1681908477784,ETHN 168,A00,180892,Staff,9,0,10,1
1681908478813,GLBH 20,A00,201051,Hannah; Seth Donal,0,1,0,1
1681908479913,GLBH 111,A01,209338,Burgos; Jose L.,0,0,0,0
1681908480941,GLBH 150,A00,258300,Staff,0,3,0,0
1681908481969,GLBH 181,A00,201207,Staff,15,0,40,25
1681908482992,HIEU 109,A00,180898,Staff,20,0,20,0
1681908484016,HIEU 111,A00,180899,Staff,1,0,20,19
1681908485044,HIEU 124,A00,180900,Staff,18,0,20,2
1681908486071,HILA 122,A00,180901,Staff,18,0,20,2
1681908487097,HILA 132,A00,180902,Vitz; Matthew,2,0,20,18
1681908488122,HILD 10,A01,180896,Staff,15,0,20,5
1681908489153,HILD 30GS,A00,180897,Edington; Claire Ellen,0,0,0,0
1681908490178,HISC 105,A00,180903,Staff,20,0,20,0
1681908491206,HISC 117,A00,180904,Staff,11,0,20,9
1681908492230,HIUS 108B,A00,181005,Staff,18,0,20,2
1681908493253,HIUS 113,A00,181093,Staff,4,0,20,16
1681908494287,HUM 3,A01,181190,Patterson; Patrick H.,40,0,50,10
1681908494287,HUM 3,B01,181195,Staff,47,0,50,3
1681908495315,HUM 3GS,A00,181196,Herbst; Matthew,0,0,0,0
1681908496343,HUM 4,A01,181227,West; Geoffrey Scott,34,0,50,16
1681908496343,HUM 4,B01,181282,Staff,43,0,50,7
1681908497381,HUM 4GS,A00,181377,Lyon; Antony J.,0,0,0,0
1681908498411,HUM 5,A01,181536,Zavodny; Tatiana Sophia,31,0,50,19
1681908498411,HUM 5,B01,181908,Staff,36,0,50,14
1681908499436,INTL 190,A00,181909,Segui; Alan S,0,0,0,6
1681908499436,INTL 190,B00,181961,Segui; Alan S,0,0,0,7
1681908500463,JAPN 20AR,A01,182113,Ross; Kayoko F,15,0,20,5
1681908501495,LATI 50,A01,202391,Martin-Cabrera; Luis,19,0,30,11
1681908501495,LATI 50,A02,202392,Martin-Cabrera; Luis,26,0,30,4
1681908502519,LATI 180,A00,202393,Kokinis; Troy Andreas,25,0,25,0
1681908503543,LIFR 1A,A00,182119,Staff,14,0,14,0
1681908504575,LIFR 1AX,A00,182324,Staff,14,0,14,0
1681908505599,LIFR 1B,A00,182259,Staff,14,0,14,0
1681908506623,LIFR 1BX,A00,182273,Staff,14,0,14,0
1681908507650,LIGN 8,A00,182330,Staff,137,0,150,13
1681908508679,LIGN 9GS,A00,182362,Staff,20,0,20,0
1681908509705,LIGN 119,A00,204992,Takahashi; Maho,12,0,15,3
1681908510735,LIGN 130,A01,182384,Staff,47,0,50,3
1681908511760,LIGN 149GS,A00,182390,Staff,20,0,20,0
1681908512784,LIGN 170,A00,182404,Staff,24,0,30,6
1681908513810,LISP 1D,A00,182281,Staff,7,0,14,7
1681908513810,LISP 1D,B00,182287,Staff,14,0,14,0
1681908513810,LISP 1D,C00,182295,Staff,11,0,14,3
1681908513810,LISP 1D,D00,182301,Staff,14,0,14,0
1681908514838,LISP 1DX,A00,182309,Staff,20,0,28,8
1681908514838,LISP 1DX,B00,182316,Staff,26,0,28,2
1681908515864,LTAF 120GS,A00,182412,Zhiri; Oumelbanine,20,0,20,0
1681908516889,LTCS 172GS,A00,182437,Bronstein; Phoebe Malan,20,0,20,0
1681908517918,LTEA 138,A00,182457,Staff,22,0,40,18
1681908518947,LTEN 114,A01,182490,Staff,23,0,25,2
1681908519973,LTEN 130GS,A00,182491,Lyon; Antony J.,20,0,20,0
1681908520998,LTEN 169,A00,182493,Cuong; Marisol,20,0,25,5
1681908522023,LTEN 178,A00,182501,Staff,14,0,15,1
1681908523051,LTEN 181,A00,182515,Staff,22,0,25,3
1681908524080,LTEN 185GS,A00,197655,Forbes; Camille,20,0,20,0
1681908525104,LTSP 100B,A00,202208,Bessett; Ryan Matthew,24,0,25,1
1681908526133,LTWL 100,A00,182516,Myerston Santana; Jacobo,23,0,30,7
1681908527162,LTWR 100GS,A00,182518,Forbes; Camille,20,0,20,0
1681908528187,LTWR 102,A00,182522,Staff,15,0,15,0
1681908528187,LTWR 102,B00,182525,Staff,14,0,15,1
1681908529213,LTWR 115,A00,182526,Staff,12,0,15,3
1681908530239,MAE 8,A01,182528,Pham; Hieu Tan,68,0,70,2
1681908531269,MAE 11,A00,182529,Bahadori; Mohammad Yousef,94,0,100,6
1681908532303,MAE 20,A00,182530,Evdokimenko; Ekaterina,68,0,70,2
1681908533327,MAE 30A,A00,182532,Staff,44,0,45,1
1681908534352,MAE 101A,A00,182533,Bahadori; Mohammad Yousef,97,0,100,3
1681908535380,MAE 101C,A00,182538,Staff,62,0,70,8
1681908536405,MAE 104,A00,182539,Staff,45,0,50,5
1681908537435,MAE 131A,A00,182540,Ghazinejad; Maziar,41,0,45,4
1681908538462,MAE 143A,A00,182548,Bewley; Thomas R,43,0,50,7
1681908539489,MAE 150,A00,182549,Staff,28,0,40,12
1681908540513,MAE 160,A00,182550,Evdokimenko; Ekaterina,43,0,60,17
1681908541543,MATH 3C,A01,182725,Staff,27,0,30,3
1681908542571,MATH 10A,A01,182729,Staff,25,0,30,5
1681908542571,MATH 10A,B01,182732,Staff,26,0,30,4
1681908543597,MATH 10B,A01,182737,Staff,21,0,30,9
1681908543597,MATH 10B,A02,182738,Staff,27,0,30,3
1681908543597,MATH 10B,B01,182744,Staff,27,0,30,3
1681908543597,MATH 10B,B02,182745,Staff,27,0,30,3
1681908544622,MATH 18,A01,182750,Anzaldo; Leesa B,28,0,30,2
1681908544622,MATH 18,A02,182751,Anzaldo; Leesa B,29,0,30,1
1681908544622,MATH 18,A03,182753,Anzaldo; Leesa B,28,0,30,2
1681908544622,MATH 18,A04,182757,Anzaldo; Leesa B,29,0,30,1
1681908544622,MATH 18,B01,182761,Anzaldo; Leesa B,27,0,30,3
1681908544622,MATH 18,B02,182764,Anzaldo; Leesa B,27,0,30,3
1681908544622,MATH 18,B03,182765,Anzaldo; Leesa B,30,0,30,0
1681908544622,MATH 18,B04,182766,Anzaldo; Leesa B,30,0,30,0
1681908545652,MATH 20A,A01,182771,Suk; Andrew Hoon,28,0,30,2
1681908546697,MATH 20B,A01,182775,Bach; Quang Tran,30,0,30,0
1681908546697,MATH 20B,A02,182777,Bach; Quang Tran,29,0,30,1
1681908546697,MATH 20B,B01,182780,Bach; Quang Tran,27,0,30,3
1681908546697,MATH 20B,B02,182782,Bach; Quang Tran,30,0,30,0
1681908547720,MATH 20C,A01,182787,Staff,25,0,30,5
1681908547720,MATH 20C,A02,182790,Staff,29,0,30,1
1681908547720,MATH 20C,B01,182792,Staff,25,0,30,5
1681908547720,MATH 20C,B02,182796,Staff,27,0,30,3
1681908548744,MATH 20D,A01,182799,Staff,29,0,30,1
1681908548744,MATH 20D,A02,182802,Staff,30,0,30,0
1681908548744,MATH 20D,A03,182803,Staff,30,0,30,0
1681908549781,MATH 20E,A01,182809,Verstraete; Jacques Allan,24,0,30,6
1681908549781,MATH 20E,A02,182811,Verstraete; Jacques Allan,28,0,30,2
1681908549781,MATH 20E,B01,182814,Verstraete; Jacques Allan,23,0,30,7
1681908549781,MATH 20E,B02,182815,Verstraete; Jacques Allan,30,0,30,0
1681908550805,MATH 103A,A01,182820,Staff,9,0,30,21
1681908550805,MATH 103A,A02,182821,Staff,27,0,30,3
1681908550805,MATH 103A,A03,182822,Staff,23,0,30,7
1681908550805,MATH 103A,B01,182825,Staff,23,0,30,7
1681908550805,MATH 103A,B02,182826,Staff,30,0,30,0
1681908550805,MATH 103A,B03,182830,Staff,30,0,30,0
1681908551840,MATH 109,A01,182836,Chow; Bennett,24,0,30,6
1681908551840,MATH 109,A02,182838,Chow; Bennett,29,0,30,1
1681908551840,MATH 109,A03,182894,Chow; Bennett,29,0,30,1
1681908551840,MATH 109,B01,182908,Chow; Bennett,28,0,30,2
1681908551840,MATH 109,B02,182909,Chow; Bennett,30,0,30,0
1681908551840,MATH 109,B03,182910,Chow; Bennett,27,0,30,3
1681908552865,MATH 142A,A01,182925,Staff,11,0,30,19
1681908552865,MATH 142A,A02,182935,Staff,25,0,30,5
1681908552865,MATH 142A,A03,182967,Staff,26,0,30,4
1681908552865,MATH 142A,B01,183125,Staff,24,0,30,6
1681908552865,MATH 142A,B02,183157,Staff,28,0,30,2
1681908552865,MATH 142A,B03,183158,Staff,29,0,30,1
1681908553896,MATH 183,A01,183160,Arias-Castro; Ery,23,0,30,7
1681908553896,MATH 183,A02,183161,Arias-Castro; Ery,29,0,30,1
1681908553896,MATH 183,B01,183163,Arias-Castro; Ery,28,0,30,2
1681908553896,MATH 183,B02,183164,Arias-Castro; Ery,28,0,30,2
1681908554927,MATH 193A,A01,183167,Staff,4,0,35,31
1681908554927,MATH 193A,A02,183168,Staff,28,0,35,7
1681908554927,MATH 193A,A03,183169,Staff,34,0,35,1
1681908554927,MATH 193A,A04,183170,Staff,28,0,35,7
1681908555956,MGT 4,A01,202395,Anderson; John Charles,75,0,80,5
1681908556983,MGT 5,A00,202396,Houskeeper; Robert,80,0,90,10
1681908558007,MGT 103,A00,202397,Eberhard; Craig A,55,0,90,35
1681908559034,MGT 131A,A00,202398,Houskeeper; Robert,85,0,90,5
1681908560058,MGT 135,A00,202399,Anderson; John Charles,82,0,90,8
1681908561082,MGT 162R,A00,202403,Gneezy; Uri,150,0,200,50
1681908562106,MGT 172,A00,202404,Hedges; Kathleen,50,0,90,40
1681908563134,MGT 181,A00,202405,Dunn; Louis Jean,84,0,90,6
1681908564163,MMW 14,A01,183200,Staff,16,0,28,12
1681908564163,MMW 14,A02,183201,Staff,26,0,28,2
1681908564163,MMW 14,A03,183202,Staff,24,0,28,4
1681908564163,MMW 14,A04,183203,Staff,25,0,28,3
1681908564163,MMW 14,A05,183204,Staff,26,0,28,2
1681908564163,MMW 14,A06,183205,Staff,27,0,28,1
1681908564163,MMW 14,B01,183207,Staff,26,0,28,2
1681908564163,MMW 14,B02,183208,Staff,28,0,28,0
1681908564163,MMW 14,B03,183209,Staff,28,0,28,0
1681908564163,MMW 14,B04,183210,Staff,28,0,28,0
1681908564163,MMW 14,B05,183211,Staff,28,0,28,0
1681908564163,MMW 14,B06,183212,Staff,28,0,28,0
1681908565188,MMW 14GS,A00,183213,Zhiri; Oumelbanine,28,0,28,0
1681908566211,MMW 15GS,B00,183215,Rahimi; Babak,28,0,28,0
1681908567239,MMW 121,A01,183217,Patterson; Patrick H.,14,0,28,14
1681908567239,MMW 121,A02,183218,Patterson; Patrick H.,25,0,28,3
1681908568268,MUS 1A,A01,182554,Staff,8,0,35,27
1681908569292,MUS 5,A01,182558,Staff,20,0,35,15
1681908570315,MUS 6,A01,182562,Staff,25,0,35,10
1681908571342,MUS 8GS,A00,182563,Borgo; David Garcia,25,0,25,0
1681908572371,MUS 13,A01,182567,Staff,24,0,25,1
1681908573400,MUS 15,A01,182570,Staff,32,0,35,3
1681908573400,MUS 15,B01,182575,Staff,10,0,35,25
1681908574424,MUS 80,A00,182578,Staff,23,0,25,2
1681908574424,MUS 80,B00,182581,Staff,20,0,25,5
1681908575448,MUS 113,A00,182582,Staff,25,0,25,0
1681908576471,MUS 114,A00,182583,Staff,4,0,25,21
1681908577498,MUS 150GS,A01,182588,Borgo; David Garcia,25,0,25,0
1681908578527,PHIL 1,A00,182590,Staff,35,0,40,5
1681908579553,PHIL 10,A01,182596,Grush; Rick Scott,31,0,35,4
1681908579553,PHIL 10,A02,182597,Grush; Rick Scott,34,0,35,1
1681908580578,PHIL 15,A01,182601,Staff,31,0,35,4
1681908580578,PHIL 15,A02,182602,Staff,33,0,35,2
1681908581606,PHIL 27,A01,182604,Staff,30,0,35,5
1681908581606,PHIL 27,A02,182607,Staff,35,0,35,0
1681908582629,PHIL 32,A01,182609,Staff,35,0,35,0
1681908582629,PHIL 32,A02,182612,Staff,35,0,35,0
1681908583742,PHIL 130,A00,182614,Staff,63,0,70,7
1681908584767,PHIL 136,A00,182616,Cohen; Jonathan David,66,0,70,4
1681908585796,PHIL 155,A00,182617,Vargas; Manuel Rogelio,60,0,70,10
1681908586824,PHIL 163,A01,182620,Staff,15,0,20,5
1681908586824,PHIL 163,A02,182624,Staff,10,0,20,10
1681908587856,PHIL 164,A00,182627,Staff,30,0,40,10
1681908588882,PHIL 173,A00,182628,Staff,36,0,40,4
1681908589906,PHYS 1A,A00,183221,Staff,54,0,60,6
1681908590930,PHYS 1AL,001,183222,Staff,25,0,30,5
1681908590930,PHYS 1AL,002,183223,Staff,28,0,30,2
1681908591955,PHYS 1B,A00,183231,Staff,44,0,60,16
1681908592983,PHYS 1BL,001,183232,Staff,20,0,30,10
1681908592983,PHYS 1BL,002,183233,Staff,29,0,30,1
1681908594012,PHYS 1C,A00,183240,Staff,30,0,60,30
1681908595040,PHYS 1CL,001,183241,Staff,13,0,30,17
1681908595040,PHYS 1CL,002,183242,Staff,22,0,30,8
1681908596066,PHYS 2AR,A01,183250,Staff,44,0,50,6
1681908597090,PHYS 2B,A01,183252,Staff,106,0,115,9
1681908598120,PHYS 2BL,A01,183254,Staff,21,0,24,3
1681908598120,PHYS 2BL,A02,183255,Staff,22,0,24,2
1681908599154,PHYS 2C,A01,183522,Staff,105,0,115,10
1681908600182,PHYS 4A,A01,183524,Staff,49,0,50,1
1681908601206,POLI 5,A00,183525,Staff,44,0,50,6
1681908602230,POLI 12,A00,183540,Staff,48,0,50,2
1681908603257,POLI 13R,A00,183541,Forman; Fonna,42,0,50,8
1681908604287,POLI 30,A00,183542,Mignozzetti; Umberto,47,0,50,3
1681908605318,POLI 100A,A00,183543,Staff,45,0,50,5
1681908606347,POLI 100E,A00,223598,Staff,32,0,35,3
1681908607371,POLI 103A,A00,183564,Kousser; Thad,38,0,50,12
1681908608393,POLI 104B,A00,201329,Staff,29,0,35,6
1681908609419,POLI 113BR,A00,183576,Hoston; Germaine,28,0,50,22
1681908610447,POLI 114BR,A00,183588,Staff,27,0,30,3
1681908611474,POLI 117R,A00,183595,Forman; Fonna,9,0,20,11
1681908612501,POLI 120H,A00,183596,Fisk; David Lee,13,0,20,7
1681908613528,POLI 130AA,A00,183597,Staff,14,0,20,6
1681908614551,POLI 134AA,A00,183598,Staff,19,0,20,1
1681908615574,POLI 135,A00,183599,Fisk; David Lee,20,0,25,5
1681908616601,POLI 142P,A00,183623,Staff,37,0,40,3
1681908617628,POLI 144D,A00,183624,Staff,22,0,25,3
1681908618655,POLI 151,A00,183625,Staff,15,0,20,5
1681908619680,POLI 162,A00,183626,Mignozzetti; Umberto,18,0,20,2
1681908620708,PSYC 1,A00,253748,Staff,86,0,90,4
1681908621737,PSYC 2,A00,183627,Moranton; Nirelia Melbina-,25,0,35,10
1681908622763,PSYC 3,A00,183628,Staff,43,0,45,2
1681908624821,PSYC 60,A01,183631,Lowe; Angela Beth,35,0,40,5
1681908625851,PSYC 70,A01,253757,Staff,37,0,45,8
1681908626875,PSYC 101,A00,183632,Heyman; Gail D.,48,0,60,12
1681908627905,PSYC 105,A00,183848,Lowe; Angela Beth,50,0,60,10
1681908628931,PSYC 106,A00,183849,Dobkins; Karen R.,45,0,60,15
1681908629956,PSYC 108,A00,253750,Staff,24,0,60,36
1681908630980,PSYC 114,A01,184275,Winkielman; Piotr,0,6,30,30
1681908632011,PSYC 122,A00,183856,Moranton; Nirelia Melbina-,0,10,30,30
1681908633038,PSYC 124,A00,183865,Chapman; Eddie Nathaniel,52,0,80,28
1681908634063,PSYC 137,A00,183880,Staff,19,0,25,6
1681908636116,PSYC 154,A00,183910,Lacefield; Katharine I,0,2,90,90
1681908638164,PSYC 162,A00,183946,Wixted; John T,61,0,90,29
1681908639199,PSYC 172,A00,183947,Gorman; Michael R.,14,0,30,16
1681908640228,PSYC 178,A00,183963,Glaser; Dale,20,0,40,20
1681908641252,PSYC 181GS,A00,183964,Anagnostaras; Stephan,10,0,10,0
1681908642280,PSYC 186GS,A01,257660,Staff,10,0,10,0
1681908643303,PSYC 193,B00,253749,Staff,23,0,25,2
1681908645353,PSYC 193L,A01,184122,Staff,33,0,35,2
1681908645353,PSYC 193L,C01,184167,Winkielman; Piotr,16,0,30,14
1681908646378,RELI 188GS,A00,182629,Rahimi; Babak,20,0,20,0
1681908647403,SE 101A,A00,182646,Staff,26,0,30,4
1681908648431,SE 101C,A00,182650,Staff,18,0,20,2
1681908649455,SE 110A,A00,182651,Staff,28,0,28,0
1681908650480,SE 130A,A00,182652,Staff,39,0,40,1
1681908651504,SIO 46GS,A00,182636,Cook; Geoffrey W,28,0,28,0
1681908652532,SIO 109R,A00,194459,Staff,5,0,20,15
1681908653557,SIO 121GS,A00,182639,Cook; Geoffrey W,28,0,28,0
1681908654584,SIO 132,A01,182642,Staff,32,0,40,8
1681908655611,SIO 139,A00,182644,Kacev; David,36,0,40,4
1681908656634,SOCI 2,A01,258404,Staff,34,0,36,2
1681908656634,SOCI 2,A02,258405,Staff,35,0,36,1
1681908657659,SOCI 60,A01,258408,Staff,29,0,30,1
1681908657659,SOCI 60,A02,258413,Staff,30,0,30,0
1681908658682,SOCI 100,A01,258415,Staff,29,0,30,1
1681908658682,SOCI 100,A02,258416,Staff,28,0,30,2
1681908664841,SOCI 127,A00,258421,Staff,22,0,30,8
1681908665866,SOCI 132,A00,258422,Staff,45,0,50,5
1681908666890,SOCI 133,A00,258423,Staff,26,0,30,4
1681908667913,SOCI 138GS,A00,258424,Staff,15,0,15,0
1681908668938,SOCI 145,A00,258425,Staff,25,0,30,5
1681908669967,SOCI 148,A00,258426,Staff,26,0,30,4
1681908670991,SOCI 153,A00,199217,Staff,29,0,30,1
1681908672014,SOCI 160,A00,258427,Staff,28,0,30,2
1681908673040,SOCI 160E,A00,258435,Staff,56,0,60,4
1681908674066,SOCI 189GS,A00,258436,Staff,15,0,15,0
1681908675090,SOCI 190GS,A00,258437,Staff,15,0,15,0
1681908676122,SYN 2,001,182658,Staff,9,0,16,7
1681908676122,SYN 2,002,201439,Staff,15,0,16,1
1681908676122,SYN 2,003,201443,Staff,16,0,16,0
1681908677144,SYN 100,A01,182657,Staff,17,0,20,3
1681908678176,TDAC 1,A00,184381,Salovey; Todd,16,0,20,4
1681908678176,TDAC 1,B00,184385,Harting; Carla Kelso,19,0,20,1
1681908678176,TDAC 1,C00,184394,Staff,19,0,20,1
1681908679202,TDAC 101,A00,184483,Harting; Carla Kelso,19,0,20,1
1681908680225,TDDE 111,A00,184496,Staff,14,0,15,1
1681908681257,TDDE 131,A00,184504,Staff,20,0,20,0
1681908681257,TDDE 131,B00,184505,Staff,17,0,18,1
1681908681257,TDDE 131,C00,184534,Staff,49,0,50,1
1681908681257,TDDE 131,D00,184564,Staff,15,0,15,0
1681908681257,TDDE 131,E00,204725,Staff,19,0,20,1
1681908682283,TDGE 1,A01,184414,Salovey; Todd,37,0,50,13
1681908683311,TDGE 5,A01,184419,Staff,23,0,24,1
1681908684339,TDGE 10,A00,184428,Fulton; Julia,31,0,50,19
1681908685367,TDGE 124,A00,184565,Fulton; Julia,7,0,50,43
1681908686393,TDGE 125,B00,184567,Meyer; Ursula,9,0,25,16
1681908687493,TDHT 101,A00,184568,Staff,21,0,25,4
1681908687493,TDHT 101,B00,184569,Staff,20,0,20,0
1681908688519,TDHT 114,A00,184570,Staff,49,0,50,1
1681908689546,TDMV 1,A00,184437,Arcidiacono; Kristin,23,0,30,7
1681908689546,TDMV 1,B00,184448,Caligagan; Maria T.,22,0,30,8
1681908690570,TDMV 2,A00,184449,Weinberg; Sadie,27,0,30,3
1681908690570,TDMV 2,B00,184453,Arcidiacono; Kristin,29,0,30,1
1681908691593,TDMV 110,A00,184571,Weinberg; Sadie,30,0,30,0
1681908692622,TDMV 142,A00,184572,Caligagan; Tony,27,0,30,3
1681908692622,TDMV 142,B00,184573,Caligagan; Maria T.,27,0,30,3
1681908693652,TDTR 20,A00,184482,Jun; Grace Shin Hae,25,0,25,0
1681908694676,USP 2,A01,184290,Hinds; Juli Beth,24,0,25,1
1681908695705,USP 3,A01,184295,Staff,20,0,25,5
1681908696729,USP 4,A00,184304,McTague; Sarah,15,0,25,10
1681908697753,USP 100,A00,184315,Staff,17,0,25,8
1681908698779,USP 105,A00,184326,Staff,21,0,25,4
1681908699803,USP 151,A00,184327,Staff,20,0,25,5
1681908700826,USP 170,A00,184380,Hinds; Juli Beth,14,0,25,11
1681908701862,VIS 21B,A01,182660,Staff,28,0,31,3
1681908701862,VIS 21B,A02,182662,Staff,30,0,31,1
1681908702888,VIS 103D,A00,182663,Staff,74,0,75,1
1681908703917,VIS 105D,A00,182667,Li; Huai,15,0,22,7
1681908704947,VIS 122GS,A00,182668,Herbst; Matthew,20,0,20,0
1681908705970,VIS 128C,A00,182673,Staff,70,0,75,5
1681908706993,VIS 130,A00,182675,Staff,20,0,22,2
1681908708016,VIS 160A,A00,182678,Stalbaum; Brett,4,0,10,6
1681908710069,WCWP 10B,A00,201679,Staff,15,0,15,0
1681908710069,WCWP 10B,B00,201695,Staff,15,0,15,0
1681908711093,WCWP 100,A00,201716,Staff,15,0,15,0
1681908711093,WCWP 100,B00,201717,Staff,11,0,15,4
1681908713169,ANSC 105GS,A00,258289,Staff,0,0,0,0
1681908714194,ANSC 125GS,A00,258295,Staff,0,0,0,0
1681908715222,ANSC 150,A00,258267,Staff,30,0,40,10
1681908716250,ANSC 190GS,A00,258280,Staff,0,0,0,0
1681908717274,ANTH 1,A00,258264,Staff,38,0,40,2
1681908718299,ANTH 2,A01,258259,Staff,72,0,76,4
1681908719323,ANTH 23,A01,258228,Staff,36,0,40,4
1681908720347,ANTH 101,A01,258236,Staff,39,0,40,1
1681908721372,ANTH 102,A00,258272,Staff,59,0,60,1
1681908722399,ANTH 105,A00,258244,Staff,31,0,35,4
1681908723426,BENG 130,A00,253975,Staff,38,0,40,2
1681908724464,BIBC 102,A01,191866,Flagg; Matthew Paul,19,0,32,13
1681908724464,BIBC 102,A02,191867,Flagg; Matthew Paul,22,0,32,10
1681908724464,BIBC 102,A03,191868,Flagg; Matthew Paul,30,0,32,2
1681908724464,BIBC 102,A04,191936,Flagg; Matthew Paul,26,0,32,6
1681908724464,BIBC 102,A05,191937,Flagg; Matthew Paul,11,0,32,21
1681908725492,BICD 100,A01,191939,Cooper; Andrew Michael,28,0,32,4
1681908725492,BICD 100,A02,191940,Cooper; Andrew Michael,32,0,32,0
1681908725492,BICD 100,A03,191941,Cooper; Andrew Michael,32,0,32,0
1681908725492,BICD 100,A04,191942,Cooper; Andrew Michael,32,0,32,0
1681908725492,BICD 100,A05,191943,Cooper; Andrew Michael,32,0,32,0
1681908726525,BIEB 126,A01,191945,Cleland; Elsa Eleanor,1,0,32,31
1681908726525,BIEB 126,A02,191946,Cleland; Elsa Eleanor,28,0,32,4
1681908726525,BIEB 126,A03,191947,Cleland; Elsa Eleanor,29,0,32,3
1681908726525,BIEB 126,A04,191948,Cleland; Elsa Eleanor,23,0,32,9
1681908726525,BIEB 126,A05,191996,Cleland; Elsa Eleanor,28,0,32,4
1681908727550,BIEB 136GS,A00,191997,Shurin; Jonathan & Holway; David A.,0,0,0,0
1681908728581,BIEB 137GS,A01,191999,Shurin; Jonathan & Holway; David A.,0,0,0,0
1681908729606,BILD 1,A01,205385,Staff,31,0,32,1
1681908729606,BILD 1,A02,205386,Staff,30,0,32,2
1681908729606,BILD 1,A03,205387,Staff,32,0,32,0
1681908729606,BILD 1,A04,205388,Staff,28,0,32,4
1681908730636,BILD 2,A01,191774,Staff,28,0,32,4
1681908730636,BILD 2,A02,191775,Staff,30,0,32,2
1681908730636,BILD 2,A03,191777,Staff,30,0,32,2
1681908730636,BILD 2,A04,191856,Staff,31,0,32,1
1681908730636,BILD 2,A05,191857,Staff,32,0,32,0
1681908730636,BILD 2,A06,191858,Staff,32,0,32,0
1681908730636,BILD 2,A07,191859,Staff,31,0,32,1
1681908731667,BILD 3,A01,205391,Staff,29,0,32,3
1681908731667,BILD 3,A02,205393,Staff,32,0,32,0
1681908731667,BILD 3,A03,205394,Staff,28,0,32,4
1681908731667,BILD 3,A04,205395,Staff,32,0,32,0
1681908732696,BILD 20,A01,191861,Staff,32,0,32,0
1681908732696,BILD 20,A02,191862,Staff,32,0,32,0
1681908733721,BILD 30,A01,191864,Staff,31,0,32,1
1681908734745,BIMM 100,A01,192019,Staff,0,0,32,32
1681908734745,BIMM 100,A02,192020,Staff,23,0,32,9
1681908734745,BIMM 100,A03,192035,Staff,22,0,32,10
1681908735770,BIMM 110,A01,192037,Tat; John,0,0,32,32
1681908735770,BIMM 110,A02,192038,Tat; John,10,0,32,22
1681908736800,BIMM 120,A01,192040,Pickett; Brooke Elizabeth,2,0,32,30
1681908736800,BIMM 120,A02,192041,Pickett; Brooke Elizabeth,16,0,32,16
1681908736800,BIMM 120,A03,192042,Pickett; Brooke Elizabeth,16,0,32,16
1681908737841,BIPN 100,A01,192044,Armour; Jon Christopher,26,0,32,6
1681908737841,BIPN 100,A02,192059,Armour; Jon Christopher,30,0,32,2
1681908737841,BIPN 100,A03,192064,Armour; Jon Christopher,31,0,32,1
1681908737841,BIPN 100,A04,192073,Armour; Jon Christopher,28,0,32,4
1681908738878,BIPN 148,A01,205411,Leutgeb; Jill K.,16,0,32,16
1681908738878,BIPN 148,A02,205412,Leutgeb; Jill K.,31,0,32,1
1681908738878,BIPN 148,A03,205413,Leutgeb; Jill K.,30,0,32,2
1681908738878,BIPN 148,A04,205414,Leutgeb; Jill K.,30,0,32,2
1681908739906,BIPN 160,A01,192115,Marino; Marc J,19,0,32,13
1681908739906,BIPN 160,A02,192148,Marino; Marc J,27,0,32,5
1681908739906,BIPN 160,A03,192158,Marino; Marc J,31,0,32,1
1681908739906,BIPN 160,A04,192190,Marino; Marc J,32,0,32,0
1681908739906,BIPN 160,A05,192287,Marino; Marc J,32,0,32,0
1681908739906,BIPN 160,A06,192288,Marino; Marc J,32,0,32,0
1681908740932,BIPN 194,A00,206038,Staff,28,0,32,4
1681908741964,BISP 194,A00,192289,Leutgeb; Stefan,13,0,32,19
1681908741964,BISP 194,B00,245332,Nieh; James Charles,27,0,32,5
1681908742993,CAT 124,A01,202247,Staff,15,0,15,0
1681908744022,CAT 125,A00,202248,Staff,19,0,20,1
1681908744022,CAT 125,B00,202253,Staff,20,0,20,0
1681908744022,CAT 125,C00,202257,Staff,19,0,20,1
1681908745048,CAT 125GS,A01,202273,Bronstein; Phoebe Malan,20,0,20,0
1681908746081,CAT 125R,A00,202284,Staff,17,0,20,3
1681908746081,CAT 125R,C00,202286,Staff,10,0,20,10
1681908746081,CAT 125R,D00,202291,Staff,18,0,20,2
1681908746081,CAT 125R,E00,202295,Staff,13,0,20,7
1681908746081,CAT 125R,F00,202302,Staff,12,0,20,8
1681908747108,CENG 100,A00,204724,Opatkiewicz; Justin Paul,25,0,25,0
1681908748134,CGS 2A,A01,180420,Staff,31,0,36,5
1681908749163,CGS 101,A00,180421,Staff,16,0,20,4
1681908750189,CGS 112,A00,180422,Staff,10,0,16,6
1681908751219,CGS 113,A00,180423,Staff,18,0,20,2
1681908752248,CGS 137,A00,180424,Staff,12,0,12,0
1681908753274,CGS 147,A00,180425,Staff,10,0,10,0
1681908754304,CHEM 6A,A01,179556,Staff,97,0,100,3
1681908754304,CHEM 6A,A02,179558,Staff,0,0,0,0
1681908755330,CHEM 6B,A01,179560,Staff,100,0,100,0
1681908756354,CHEM 6C,A01,179565,Jazzar; Rodolphe,95,0,100,5
1681908757384,CHEM 7L,A01,179586,Schurmeier; Kimberly,13,0,24,11
1681908757384,CHEM 7L,A02,179587,Schurmeier; Kimberly,23,0,24,1
1681908757384,CHEM 7L,A03,179590,Schurmeier; Kimberly,22,0,24,2
1681908757384,CHEM 7L,A04,179591,Schurmeier; Kimberly,22,0,24,2
1681908757384,CHEM 7L,B01,179598,Schurmeier; Kimberly,17,0,24,7
1681908757384,CHEM 7L,B02,179599,Schurmeier; Kimberly,24,0,24,0
1681908757384,CHEM 7L,B03,179606,Schurmeier; Kimberly,23,0,24,1
1681908757384,CHEM 7L,B04,179607,Schurmeier; Kimberly,23,0,24,1
1681908758414,CHEM 11,A01,179609,Stallings; Dontarie M,88,0,100,12
1681908759444,CHEM 40A,A01,179621,Staff,41,0,50,9
1681908759444,CHEM 40A,A02,179622,Staff,47,0,50,3
1681908760469,CHEM 40B,A01,179630,Weizman; Haim,48,0,50,2
1681908760469,CHEM 40B,A02,179631,Weizman; Haim,45,0,50,5
1681908761494,CHEM 41A,A01,179660,Klosterman; Jeremy K,93,0,100,7
1681908762533,CHEM 43A,A01,179683,Klosterman; Jeremy K,0,0,24,24
1681908762533,CHEM 43A,A02,179688,Klosterman; Jeremy K,14,0,24,10
1681908762533,CHEM 43A,A03,179689,Klosterman; Jeremy K,20,0,24,4
1681908762533,CHEM 43A,A04,179691,Klosterman; Jeremy K,18,0,24,6
1681908763559,CHEM 114A,A01,179693,Stallings; Dontarie M,77,0,100,23
1681908764594,CHEM 143B,A01,179698,Weizman; Haim,17,0,24,7
1681908764594,CHEM 143B,A02,179700,Weizman; Haim,24,0,24,0
1681908765625,CHIN 169A,A00,179701,Wang; Xiao,20,0,20,0
1681908766650,COGS 2,A01,179750,Boyle; Mary E. T.,17,0,30,13
1681908767677,COGS 9,A01,179759,Jones; Cameron Robert,43,0,50,7
1681908768701,COGS 14A,A01,179854,Staff,18,0,50,32
1681908769730,COGS 14B,A01,179856,Staff,54,0,60,6
1681908770759,COGS 17,A01,179874,Staff,71,0,75,4
1681908771784,COGS 18,A01,179884,Staff,63,0,80,17
1681908772814,COGS 100,A01,179886,Staff,40,0,60,20
1681908773846,COGS 101B,A01,179892,Staff,1,0,30,29
1681908774928,COGS 101C,A01,179894,Staff,28,0,30,2
1681908775953,COGS 107A,A01,179896,Boyle; Mary E. T.,31,0,40,9
1681908776976,COGS 108,A01,179898,Simpkins; Charles Alexander,0,17,60,60
1681908778005,COGS 109,A01,179900,Staff,34,0,40,6
1681908779029,COGS 118A,A01,179946,Staff,9,0,40,31
1681908780058,COGS 153,A00,179978,Staff,1,0,30,29
1681908781082,COGS 156,A01,179981,Staff,27,0,30,3
1681908783134,COGS 172,A01,179987,Staff,13,0,30,17
1681908785191,COGS 186,A01,179991,Staff,13,0,30,17
1681908786215,COMM 10,A01,180001,Staff,15,0,25,10
1681908786215,COMM 10,A02,180004,Staff,20,0,25,5
1681908787243,COMM 100A,A01,180016,Staff,18,0,25,7
1681908787243,COMM 100A,A02,180020,Staff,24,0,25,1
1681908788271,COMM 101T,A00,180029,Halm; Gavin Patrick,23,0,35,12
1681908789294,COMM 106V,A00,180043,Staff,34,0,35,1
1681908790322,COMM 109P,A00,180044,Staff,31,0,35,4
1681908791434,COMM 113T,A00,180045,Havis; Allan,37,0,45,8
1681908792461,COMM 132,A00,180046,McKenna; Denise,23,0,30,7
1681908793484,COMM 143,A00,180047,Staff,19,0,30,11
1681908794507,COMM 190,A00,180048,Conner; Thomas Hartnell,20,0,23,3
1681908795538,CSE 8A,A50,180053,Cao; Yingjun,25,0,50,25
1681908795538,CSE 8A,B50,180180,Staff,50,0,50,0
1681908796573,CSE 11,A01,180190,Cao; Yingjun,31,0,50,19
1681908797596,CSE 20,A01,180192,Briones; Jor-el Thomas Caparas,23,0,30,7
1681908798620,CSE 21,A01,194538,Briones; Jor-el Thomas Caparas,50,0,60,10
1681908799648,CSE 30,A01,180324,Eldon; John,79,0,100,21
1681908800673,CSE 101,A01,201353,Staff,0,20,40,40
1681908801698,CSE 134B,A01,180326,Powell; Thomas Allan,74,0,100,26
1681908802722,CSE 140,A01,180328,Staff,46,0,75,29
1681908803745,CSE 140L,A01,180344,Eldon; John,69,0,100,31
1681908804774,CSE 150A,A01,180411,Staff,0,7,50,50
1681908805801,CSE 151A,A01,180414,Staff,0,6,50,50
1681908806824,CSE 175,A01,222521,Kumar; Rakesh,50,0,50,0
1681908807852,CSE 190,A00,201419,Staff,45,0,49,4
1681908808880,CSS 1,A01,194536,Staff,38,0,50,12
1681908809906,DSC 30,A01,202385,Staff,48,0,50,2
1681908810930,DSC 40A,A01,202387,Albuyeh; Rod,50,0,50,0
1681908811954,DSC 190,A01,202389,Silberman; Jack,21,0,21,0
1681908812985,DSGN 100,A01,179993,Staff,16,0,30,14
1681908814013,ECE 65,A50,180708,Staff,10,0,20,10
1681908814013,ECE 65,A51,180739,Staff,19,0,20,1
1681908815043,ECON 1,A01,180427,Famulari; Melissa,67,0,70,3
1681908816067,ECON 2,A01,180450,Levkoff; Steven B.,64,0,70,6
1681908817091,ECON 4,A01,203351,Anderson; John Charles,7,0,10,3
1681908818115,ECON 100A,A01,180472,Famulari; Melissa,65,0,70,5
1681908819142,ECON 120A,A01,180549,Staff,64,0,70,6
1681908820165,ECON 120B,A01,180655,Ma; Xinwei,46,0,70,24
1681908821188,ECON 129,A00,203333,Eckert; Fabian Paul,15,0,35,20
1681908822217,ECON 131,A00,180656,Staff,9,0,35,26
1681908823240,ECON 172B,A01,180672,Levkoff; Steven B.,32,0,35,3
1681908824267,ECON 178,A01,203342,Zhu; Ying,11,0,35,24
1681908825291,EDS 108GS,A00,202383,Wishard Guerra; Alison G.,20,0,20,0
1681908826317,EDS 111GS,A00,202347,Wishard Guerra; Alison G.,20,0,20,0
1681908827341,EDS 112,A01,202323,Staff,56,0,60,4
1681908828369,EDS 113,A00,202340,Staff,33,0,35,2
1681908829395,EDS 118,A00,201231,Staff,20,0,30,10
1681908830420,EDS 119,A00,204994,Staff,8,0,10,2
1681908831445,EDS 124BR,A00,202324,Eguchi; Emi,5,0,25,20
1681908832468,EDS 126,A01,203208,Jones; Makeba,26,0,30,4
1681908833499,EDS 135,A01,202333,Staff,18,0,20,2
1681908834523,EDS 180,A00,202311,Staff,47,0,50,3
1681908835549,ERC 190GS,A01,253747,Staff,28,0,28,0
1681908836573,ETHN 104,A00,180742,Staff,24,0,35,11
1681908837597,ETHN 118,A00,180745,Staff,28,0,35,7
1681908838624,ETHN 127,A00,180747,Staff,12,0,16,4
1681908839650,ETHN 137,A00,180880,Staff,12,0,12,0
1681908840673,ETHN 147,A00,180890,Staff,8,0,10,2
1681908841701,ETHN 154,A00,180891,Staff,7,0,8,1
1681908842732,ETHN 168,A00,180892,Staff,9,0,10,1
1681908843754,GLBH 20,A00,201051,Hannah; Seth Donal,0,1,0,1
1681908844779,GLBH 111,A01,209338,Burgos; Jose L.,0,0,0,0
1681908845806,GLBH 150,A00,258300,Staff,0,3,0,0
1681908846833,GLBH 181,A00,201207,Staff,15,0,40,25
1681908847862,HIEU 109,A00,180898,Staff,20,0,20,0
1681908848889,HIEU 111,A00,180899,Staff,1,0,20,19
1681908849915,HIEU 124,A00,180900,Staff,18,0,20,2
1681908850942,HILA 122,A00,180901,Staff,18,0,20,2
1681908851970,HILA 132,A00,180902,Vitz; Matthew,2,0,20,18
1681908852997,HILD 10,A01,180896,Staff,15,0,20,5
1681908854022,HILD 30GS,A00,180897,Edington; Claire Ellen,0,0,0,0
1681908855051,HISC 105,A00,180903,Staff,20,0,20,0
1681908856075,HISC 117,A00,180904,Staff,11,0,20,9
1681908857097,HIUS 108B,A00,181005,Staff,18,0,20,2
1681908858127,HIUS 113,A00,181093,Staff,4,0,20,16
1681908859156,HUM 3,A01,181190,Patterson; Patrick H.,40,0,50,10
1681908859156,HUM 3,B01,181195,Staff,47,0,50,3
1681908860180,HUM 3GS,A00,181196,Herbst; Matthew,0,0,0,0
1681908861210,HUM 4,A01,181227,West; Geoffrey Scott,34,0,50,16
1681908861210,HUM 4,B01,181282,Staff,43,0,50,7
1681908862236,HUM 4GS,A00,181377,Lyon; Antony J.,0,0,0,0
1681908863266,HUM 5,A01,181536,Zavodny; Tatiana Sophia,31,0,50,19
1681908863266,HUM 5,B01,181908,Staff,36,0,50,14
1681908864291,INTL 190,A00,181909,Segui; Alan S,0,0,0,6
1681908864291,INTL 190,B00,181961,Segui; Alan S,0,0,0,7
1681908865326,JAPN 20AR,A01,182113,Ross; Kayoko F,15,0,20,5
1681908866355,LATI 50,A01,202391,Martin-Cabrera; Luis,19,0,30,11
1681908866355,LATI 50,A02,202392,Martin-Cabrera; Luis,26,0,30,4
1681908867381,LATI 180,A00,202393,Kokinis; Troy Andreas,25,0,25,0
1681908868405,LIFR 1A,A00,182119,Staff,14,0,14,0
1681908869429,LIFR 1AX,A00,182324,Staff,14,0,14,0
1681908870451,LIFR 1B,A00,182259,Staff,14,0,14,0
1681908871475,LIFR 1BX,A00,182273,Staff,14,0,14,0
1681908872499,LIGN 8,A00,182330,Staff,137,0,150,13
1681908873526,LIGN 9GS,A00,182362,Staff,20,0,20,0
1681908874554,LIGN 119,A00,204992,Takahashi; Maho,12,0,15,3
1681908875578,LIGN 130,A01,182384,Staff,47,0,50,3
1681908876603,LIGN 149GS,A00,182390,Staff,20,0,20,0
1681908877626,LIGN 170,A00,182404,Staff,24,0,30,6
1681908878661,LISP 1D,A00,182281,Staff,7,0,14,7
1681908878661,LISP 1D,B00,182287,Staff,14,0,14,0
1681908878661,LISP 1D,C00,182295,Staff,11,0,14,3
1681908878661,LISP 1D,D00,182301,Staff,14,0,14,0
1681908879692,LISP 1DX,A00,182309,Staff,20,0,28,8
1681908879692,LISP 1DX,B00,182316,Staff,26,0,28,2
1681908880715,LTAF 120GS,A00,182412,Zhiri; Oumelbanine,20,0,20,0
1681908881738,LTCS 172GS,A00,182437,Bronstein; Phoebe Malan,20,0,20,0
1681908882763,LTEA 138,A00,182457,Staff,22,0,40,18
1681908883787,LTEN 114,A01,182490,Staff,23,0,25,2
1681908884811,LTEN 130GS,A00,182491,Lyon; Antony J.,20,0,20,0
1681908885835,LTEN 169,A00,182493,Cuong; Marisol,20,0,25,5
1681908886857,LTEN 178,A00,182501,Staff,14,0,15,1
1681908887886,LTEN 181,A00,182515,Staff,22,0,25,3
1681908888909,LTEN 185GS,A00,197655,Forbes; Camille,20,0,20,0
1681908889936,LTSP 100B,A00,202208,Bessett; Ryan Matthew,24,0,25,1
1681908890960,LTWL 100,A00,182516,Myerston Santana; Jacobo,23,0,30,7
1681908891984,LTWR 100GS,A00,182518,Forbes; Camille,20,0,20,0
1681908893011,LTWR 102,A00,182522,Staff,15,0,15,0
1681908893011,LTWR 102,B00,182525,Staff,14,0,15,1
1681908894039,LTWR 115,A00,182526,Staff,12,0,15,3
1681908895139,MAE 8,A01,182528,Pham; Hieu Tan,68,0,70,2
1681908896172,MAE 11,A00,182529,Bahadori; Mohammad Yousef,94,0,100,6
1681908897202,MAE 20,A00,182530,Evdokimenko; Ekaterina,68,0,70,2
1681908898228,MAE 30A,A00,182532,Staff,44,0,45,1
1681908899254,MAE 101A,A00,182533,Bahadori; Mohammad Yousef,97,0,100,3
1681908900286,MAE 101C,A00,182538,Staff,62,0,70,8
1681908901320,MAE 104,A00,182539,Staff,45,0,50,5
1681908902345,MAE 131A,A00,182540,Ghazinejad; Maziar,41,0,45,4
1681908903369,MAE 143A,A00,182548,Bewley; Thomas R,43,0,50,7
1681908904393,MAE 150,A00,182549,Staff,28,0,40,12
1681908905422,MAE 160,A00,182550,Evdokimenko; Ekaterina,43,0,60,17
1681908906445,MATH 3C,A01,182725,Staff,27,0,30,3
1681908907470,MATH 10A,A01,182729,Staff,25,0,30,5
1681908907470,MATH 10A,B01,182732,Staff,26,0,30,4
1681908908500,MATH 10B,A01,182737,Staff,21,0,30,9
1681908908500,MATH 10B,A02,182738,Staff,27,0,30,3
1681908908500,MATH 10B,B01,182744,Staff,27,0,30,3
1681908908500,MATH 10B,B02,182745,Staff,27,0,30,3
1681908909530,MATH 18,A01,182750,Anzaldo; Leesa B,28,0,30,2
1681908909530,MATH 18,A02,182751,Anzaldo; Leesa B,29,0,30,1
1681908909530,MATH 18,A03,182753,Anzaldo; Leesa B,28,0,30,2
1681908909530,MATH 18,A04,182757,Anzaldo; Leesa B,29,0,30,1
1681908909530,MATH 18,B01,182761,Anzaldo; Leesa B,27,0,30,3
1681908909530,MATH 18,B02,182764,Anzaldo; Leesa B,27,0,30,3
1681908909530,MATH 18,B03,182765,Anzaldo; Leesa B,30,0,30,0
1681908909530,MATH 18,B04,182766,Anzaldo; Leesa B,30,0,30,0
1681908910558,MATH 20A,A01,182771,Suk; Andrew Hoon,28,0,30,2
1681908911585,MATH 20B,A01,182775,Bach; Quang Tran,30,0,30,0
1681908911585,MATH 20B,A02,182777,Bach; Quang Tran,29,0,30,1
1681908911585,MATH 20B,B01,182780,Bach; Quang Tran,27,0,30,3
1681908911585,MATH 20B,B02,182782,Bach; Quang Tran,30,0,30,0
1681908912609,MATH 20C,A01,182787,Staff,25,0,30,5
1681908912609,MATH 20C,A02,182790,Staff,29,0,30,1
1681908912609,MATH 20C,B01,182792,Staff,25,0,30,5
1681908912609,MATH 20C,B02,182796,Staff,27,0,30,3
1681908913632,MATH 20D,A01,182799,Staff,29,0,30,1
1681908913632,MATH 20D,A02,182802,Staff,30,0,30,0
1681908913632,MATH 20D,A03,182803,Staff,30,0,30,0
1681908914656,MATH 20E,A01,182809,Verstraete; Jacques Allan,24,0,30,6
1681908914656,MATH 20E,A02,182811,Verstraete; Jacques Allan,28,0,30,2
1681908914656,MATH 20E,B01,182814,Verstraete; Jacques Allan,23,0,30,7
1681908914656,MATH 20E,B02,182815,Verstraete; Jacques Allan,30,0,30,0
1681908915685,MATH 103A,A01,182820,Staff,9,0,30,21
1681908915685,MATH 103A,A02,182821,Staff,27,0,30,3
1681908915685,MATH 103A,A03,182822,Staff,23,0,30,7
1681908915685,MATH 103A,B01,182825,Staff,23,0,30,7
1681908915685,MATH 103A,B02,182826,Staff,30,0,30,0
1681908915685,MATH 103A,B03,182830,Staff,30,0,30,0
1681908916711,MATH 109,A01,182836,Chow; Bennett,24,0,30,6
1681908916711,MATH 109,A02,182838,Chow; Bennett,29,0,30,1
1681908916711,MATH 109,A03,182894,Chow; Bennett,29,0,30,1
1681908916711,MATH 109,B01,182908,Chow; Bennett,28,0,30,2
1681908916711,MATH 109,B02,182909,Chow; Bennett,30,0,30,0
1681908916711,MATH 109,B03,182910,Chow; Bennett,27,0,30,3
1681908917736,MATH 142A,A01,182925,Staff,11,0,30,19
1681908917736,MATH 142A,A02,182935,Staff,25,0,30,5
1681908917736,MATH 142A,A03,182967,Staff,26,0,30,4
1681908917736,MATH 142A,B01,183125,Staff,24,0,30,6
1681908917736,MATH 142A,B02,183157,Staff,28,0,30,2
1681908917736,MATH 142A,B03,183158,Staff,29,0,30,1
1681908918760,MATH 183,A01,183160,Arias-Castro; Ery,23,0,30,7
1681908918760,MATH 183,A02,183161,Arias-Castro; Ery,29,0,30,1
1681908918760,MATH 183,B01,183163,Arias-Castro; Ery,28,0,30,2
1681908918760,MATH 183,B02,183164,Arias-Castro; Ery,28,0,30,2
1681908919783,MATH 193A,A01,183167,Staff,4,0,35,31
1681908919783,MATH 193A,A02,183168,Staff,28,0,35,7
1681908919783,MATH 193A,A03,183169,Staff,34,0,35,1
1681908919783,MATH 193A,A04,183170,Staff,28,0,35,7
1681908920807,MGT 4,A01,202395,Anderson; John Charles,75,0,80,5
1681908921832,MGT 5,A00,202396,Houskeeper; Robert,80,0,90,10
1681908922855,MGT 103,A00,202397,Eberhard; Craig A,55,0,90,35
1681908923883,MGT 131A,A00,202398,Houskeeper; Robert,85,0,90,5
1681908924908,MGT 135,A00,202399,Anderson; John Charles,82,0,90,8
1681908925936,MGT 162R,A00,202403,Gneezy; Uri,150,0,200,50
1681908926960,MGT 172,A00,202404,Hedges; Kathleen,50,0,90,40
1681908927983,MGT 181,A00,202405,Dunn; Louis Jean,84,0,90,6
1681908929010,MMW 14,A01,183200,Staff,16,0,28,12
1681908929010,MMW 14,A02,183201,Staff,26,0,28,2
1681908929010,MMW 14,A03,183202,Staff,24,0,28,4
1681908929010,MMW 14,A04,183203,Staff,25,0,28,3
1681908929010,MMW 14,A05,183204,Staff,26,0,28,2
1681908929010,MMW 14,A06,183205,Staff,27,0,28,1
1681908929010,MMW 14,B01,183207,Staff,26,0,28,2
1681908929010,MMW 14,B02,183208,Staff,28,0,28,0
1681908929010,MMW 14,B03,183209,Staff,28,0,28,0
1681908929010,MMW 14,B04,183210,Staff,28,0,28,0
1681908929010,MMW 14,B05,183211,Staff,28,0,28,0
1681908929010,MMW 14,B06,183212,Staff,28,0,28,0
1681908930037,MMW 14GS,A00,183213,Zhiri; Oumelbanine,28,0,28,0
1681908931062,MMW 15GS,B00,183215,Rahimi; Babak,28,0,28,0
1681908932089,MMW 121,A01,183217,Patterson; Patrick H.,14,0,28,14
1681908932089,MMW 121,A02,183218,Patterson; Patrick H.,25,0,28,3
1681908933114,MUS 1A,A01,182554,Staff,8,0,35,27
1681908934138,MUS 5,A01,182558,Staff,20,0,35,15
1681908935164,MUS 6,A01,182562,Staff,25,0,35,10
1681908936193,MUS 8GS,A00,182563,Borgo; David Garcia,25,0,25,0
1681908937221,MUS 13,A01,182567,Staff,24,0,25,1
1681908938246,MUS 15,A01,182570,Staff,32,0,35,3
1681908938246,MUS 15,B01,182575,Staff,10,0,35,25
1681908939275,MUS 80,A00,182578,Staff,23,0,25,2
1681908939275,MUS 80,B00,182581,Staff,20,0,25,5
1681908940302,MUS 113,A00,182582,Staff,25,0,25,0
1681908941328,MUS 114,A00,182583,Staff,4,0,25,21
1681908942358,MUS 150GS,A01,182588,Borgo; David Garcia,25,0,25,0
1681908943381,PHIL 1,A00,182590,Staff,35,0,40,5
1681908944409,PHIL 10,A01,182596,Grush; Rick Scott,31,0,35,4
1681908944409,PHIL 10,A02,182597,Grush; Rick Scott,34,0,35,1
1681908945433,PHIL 15,A01,182601,Staff,31,0,35,4
1681908945433,PHIL 15,A02,182602,Staff,33,0,35,2
1681908946458,PHIL 27,A01,182604,Staff,30,0,35,5
1681908946458,PHIL 27,A02,182607,Staff,35,0,35,0
1681908947485,PHIL 32,A01,182609,Staff,35,0,35,0
1681908947485,PHIL 32,A02,182612,Staff,35,0,35,0
1681908948508,PHIL 130,A00,182614,Staff,63,0,70,7
1681908949535,PHIL 136,A00,182616,Cohen; Jonathan David,66,0,70,4
1681908950558,PHIL 155,A00,182617,Vargas; Manuel Rogelio,60,0,70,10
1681908951584,PHIL 163,A01,182620,Staff,15,0,20,5
1681908951584,PHIL 163,A02,182624,Staff,10,0,20,10
1681908952611,PHIL 164,A00,182627,Staff,30,0,40,10
1681908953637,PHIL 173,A00,182628,Staff,36,0,40,4
1681908954660,PHYS 1A,A00,183221,Staff,54,0,60,6
1681908955694,PHYS 1AL,001,183222,Staff,25,0,30,5
1681908955694,PHYS 1AL,002,183223,Staff,28,0,30,2
1681908956723,PHYS 1B,A00,183231,Staff,44,0,60,16
1681908957748,PHYS 1BL,001,183232,Staff,20,0,30,10
1681908957748,PHYS 1BL,002,183233,Staff,29,0,30,1
1681908958775,PHYS 1C,A00,183240,Staff,30,0,60,30
1681908959802,PHYS 1CL,001,183241,Staff,13,0,30,17
1681908959802,PHYS 1CL,002,183242,Staff,22,0,30,8
1681908960826,PHYS 2AR,A01,183250,Staff,44,0,50,6
1681908961848,PHYS 2B,A01,183252,Staff,106,0,115,9
1681908962910,PHYS 2BL,A01,183254,Staff,21,0,24,3
1681908962910,PHYS 2BL,A02,183255,Staff,22,0,24,2
1681908963936,PHYS 2C,A01,183522,Staff,105,0,115,10
1681908964963,PHYS 4A,A01,183524,Staff,49,0,50,1
1681908965990,POLI 5,A00,183525,Staff,44,0,50,6
1681908967013,POLI 12,A00,183540,Staff,48,0,50,2
1681908968038,POLI 13R,A00,183541,Forman; Fonna,42,0,50,8
1681908969066,POLI 30,A00,183542,Mignozzetti; Umberto,47,0,50,3
1681908970100,POLI 100A,A00,183543,Staff,45,0,50,5
1681908971129,POLI 100E,A00,223598,Staff,32,0,35,3
1681908972157,POLI 103A,A00,183564,Kousser; Thad,38,0,50,12
1681908973185,POLI 104B,A00,201329,Staff,29,0,35,6
1681908974208,POLI 113BR,A00,183576,Hoston; Germaine,28,0,50,22
1681908975232,POLI 114BR,A00,183588,Staff,27,0,30,3
1681908976260,POLI 117R,A00,183595,Forman; Fonna,9,0,20,11
1681908977285,POLI 120H,A00,183596,Fisk; David Lee,13,0,20,7
1681908978310,POLI 130AA,A00,183597,Staff,14,0,20,6
1681908979338,POLI 134AA,A00,183598,Staff,19,0,20,1
1681908980361,POLI 135,A00,183599,Fisk; David Lee,20,0,25,5
1681908981387,POLI 142P,A00,183623,Staff,37,0,40,3
1681908982413,POLI 144D,A00,183624,Staff,22,0,25,3
1681908983438,POLI 151,A00,183625,Staff,15,0,20,5
1681908984469,POLI 162,A00,183626,Mignozzetti; Umberto,18,0,20,2
1681908985494,PSYC 1,A00,253748,Staff,86,0,90,4
1681908986522,PSYC 2,A00,183627,Moranton; Nirelia Melbina-,25,0,35,10
1681908987545,PSYC 3,A00,183628,Staff,43,0,45,2
1681908989596,PSYC 60,A01,183631,Lowe; Angela Beth,35,0,40,5
1681908990621,PSYC 70,A01,253757,Staff,37,0,45,8
1681908991647,PSYC 101,A00,183632,Heyman; Gail D.,48,0,60,12
1681908992671,PSYC 105,A00,183848,Lowe; Angela Beth,50,0,60,10
1681908993699,PSYC 106,A00,183849,Dobkins; Karen R.,45,0,60,15
1681908994722,PSYC 108,A00,253750,Staff,24,0,60,36
1681908995750,PSYC 114,A01,184275,Winkielman; Piotr,0,6,30,30
1681908996774,PSYC 122,A00,183856,Moranton; Nirelia Melbina-,0,10,30,30
1681908997798,PSYC 124,A00,183865,Chapman; Eddie Nathaniel,52,0,80,28
1681908998908,PSYC 137,A00,183880,Staff,19,0,25,6
1681909000961,PSYC 154,A00,183910,Lacefield; Katharine I,0,2,90,90
1681909003016,PSYC 162,A00,183946,Wixted; John T,61,0,90,29
1681909004048,PSYC 172,A00,183947,Gorman; Michael R.,14,0,30,16
1681909005079,PSYC 178,A00,183963,Glaser; Dale,20,0,40,20
1681909006102,PSYC 181GS,A00,183964,Anagnostaras; Stephan,10,0,10,0
1681909007125,PSYC 186GS,A01,257660,Staff,10,0,10,0
1681909008149,PSYC 193,B00,253749,Staff,23,0,25,2
1681909010209,PSYC 193L,A01,184122,Staff,33,0,35,2
1681909010209,PSYC 193L,C01,184167,Winkielman; Piotr,16,0,30,14
1681909011232,RELI 188GS,A00,182629,Rahimi; Babak,20,0,20,0
1681909012260,SE 101A,A00,182646,Staff,26,0,30,4
1681909013286,SE 101C,A00,182650,Staff,18,0,20,2
1681909014313,SE 110A,A00,182651,Staff,28,0,28,0
1681909015338,SE 130A,A00,182652,Staff,39,0,40,1
1681909016359,SIO 46GS,A00,182636,Cook; Geoffrey W,28,0,28,0
1681909017392,SIO 109R,A00,194459,Staff,5,0,20,15
1681909018420,SIO 121GS,A00,182639,Cook; Geoffrey W,28,0,28,0
1681909019442,SIO 132,A01,182642,Staff,32,0,40,8
1681909020466,SIO 139,A00,182644,Kacev; David,36,0,40,4
1681909021490,SOCI 2,A01,258404,Staff,34,0,36,2
1681909021490,SOCI 2,A02,258405,Staff,35,0,36,1
1681909022514,SOCI 60,A01,258408,Staff,29,0,30,1
1681909022514,SOCI 60,A02,258413,Staff,30,0,30,0
1681909023540,SOCI 100,A01,258415,Staff,29,0,30,1
1681909023540,SOCI 100,A02,258416,Staff,28,0,30,2
1681909029696,SOCI 127,A00,258421,Staff,22,0,30,8
1681909030723,SOCI 132,A00,258422,Staff,45,0,50,5
1681909031753,SOCI 133,A00,258423,Staff,26,0,30,4
1681909032782,SOCI 138GS,A00,258424,Staff,15,0,15,0
1681909033809,SOCI 145,A00,258425,Staff,25,0,30,5
1681909034836,SOCI 148,A00,258426,Staff,26,0,30,4
1681909035860,SOCI 153,A00,199217,Staff,29,0,30,1
1681909036882,SOCI 160,A00,258427,Staff,28,0,30,2
1681909037905,SOCI 160E,A00,258435,Staff,56,0,60,4
1681909038932,SOCI 189GS,A00,258436,Staff,15,0,15,0
1681909039955,SOCI 190GS,A00,258437,Staff,15,0,15,0
1681909040979,SYN 2,001,182658,Staff,9,0,16,7
1681909040979,SYN 2,002,201439,Staff,15,0,16,1
1681909040979,SYN 2,003,201443,Staff,16,0,16,0
1681909042007,SYN 100,A01,182657,Staff,17,0,20,3
1681909043033,TDAC 1,A00,184381,Salovey; Todd,16,0,20,4
1681909043033,TDAC 1,B00,184385,Harting; Carla Kelso,19,0,20,1
1681909043033,TDAC 1,C00,184394,Staff,19,0,20,1
1681909044059,TDAC 101,A00,184483,Harting; Carla Kelso,19,0,20,1
1681909045085,TDDE 111,A00,184496,Staff,14,0,15,1
1681909046109,TDDE 131,A00,184504,Staff,20,0,20,0
1681909046109,TDDE 131,B00,184505,Staff,17,0,18,1
1681909046109,TDDE 131,C00,184534,Staff,49,0,50,1
1681909046109,TDDE 131,D00,184564,Staff,15,0,15,0
1681909046109,TDDE 131,E00,204725,Staff,19,0,20,1
1681909047134,TDGE 1,A01,184414,Salovey; Todd,37,0,50,13
1681909048159,TDGE 5,A01,184419,Staff,23,0,24,1
1681909049184,TDGE 10,A00,184428,Fulton; Julia,31,0,50,19
1681909050207,TDGE 124,A00,184565,Fulton; Julia,7,0,50,43
1681909051234,TDGE 125,B00,184567,Meyer; Ursula,9,0,25,16
1681909052261,TDHT 101,A00,184568,Staff,21,0,25,4
1681909052261,TDHT 101,B00,184569,Staff,20,0,20,0
1681909053290,TDHT 114,A00,184570,Staff,49,0,50,1
1681909054314,TDMV 1,A00,184437,Arcidiacono; Kristin,23,0,30,7
1681909054314,TDMV 1,B00,184448,Caligagan; Maria T.,22,0,30,8
1681909055337,TDMV 2,A00,184449,Weinberg; Sadie,27,0,30,3
1681909055337,TDMV 2,B00,184453,Arcidiacono; Kristin,29,0,30,1
1681909056361,TDMV 110,A00,184571,Weinberg; Sadie,30,0,30,0
1681909057388,TDMV 142,A00,184572,Caligagan; Tony,27,0,30,3
1681909057388,TDMV 142,B00,184573,Caligagan; Maria T.,27,0,30,3
1681909058413,TDTR 20,A00,184482,Jun; Grace Shin Hae,25,0,25,0
1681909059437,USP 2,A01,184290,Hinds; Juli Beth,24,0,25,1
1681909060467,USP 3,A01,184295,Staff,20,0,25,5
1681909061495,USP 4,A00,184304,McTague; Sarah,15,0,25,10
1681909062518,USP 100,A00,184315,Staff,17,0,25,8
1681909063541,USP 105,A00,184326,Staff,21,0,25,4
1681909064565,USP 151,A00,184327,Staff,20,0,25,5
1681909065594,USP 170,A00,184380,Hinds; Juli Beth,14,0,25,11
1681909066621,VIS 21B,A01,182660,Staff,28,0,31,3
1681909066621,VIS 21B,A02,182662,Staff,30,0,31,1
1681909067650,VIS 103D,A00,182663,Staff,74,0,75,1
1681909068674,VIS 105D,A00,182667,Li; Huai,15,0,22,7
1681909069697,VIS 122GS,A00,182668,Herbst; Matthew,20,0,20,0
1681909070726,VIS 128C,A00,182673,Staff,70,0,75,5
1681909071754,VIS 130,A00,182675,Staff,20,0,22,2
1681909072782,VIS 160A,A00,182678,Stalbaum; Brett,4,0,10,6
1681909074834,WCWP 10B,A00,201679,Staff,15,0,15,0
1681909074834,WCWP 10B,B00,201695,Staff,15,0,15,0
1681909075857,WCWP 100,A00,201716,Staff,15,0,15,0
1681909075857,WCWP 100,B00,201717,Staff,11,0,15,4
1681909077964,ANSC 105GS,A00,258289,Staff,0,0,0,0
1681909078989,ANSC 125GS,A00,258295,Staff,0,0,0,0
1681909080011,ANSC 150,A00,258267,Staff,30,0,40,10
1681909081036,ANSC 190GS,A00,258280,Staff,0,0,0,0
1681909082068,ANTH 1,A00,258264,Staff,38,0,40,2
1681909083092,ANTH 2,A01,258259,Staff,72,0,76,4
1681909084116,ANTH 23,A01,258228,Staff,36,0,40,4
1681909085139,ANTH 101,A01,258236,Staff,39,0,40,1
1681909086176,ANTH 102,A00,258272,Staff,59,0,60,1
1681909087203,ANTH 105,A00,258244,Staff,31,0,35,4
1681909088225,BENG 130,A00,253975,Staff,38,0,40,2
1681909089248,BIBC 102,A01,191866,Flagg; Matthew Paul,19,0,32,13
1681909089248,BIBC 102,A02,191867,Flagg; Matthew Paul,22,0,32,10
1681909089248,BIBC 102,A03,191868,Flagg; Matthew Paul,30,0,32,2
1681909089248,BIBC 102,A04,191936,Flagg; Matthew Paul,26,0,32,6
1681909089248,BIBC 102,A05,191937,Flagg; Matthew Paul,11,0,32,21
1681909090270,BICD 100,A01,191939,Cooper; Andrew Michael,28,0,32,4
1681909090270,BICD 100,A02,191940,Cooper; Andrew Michael,32,0,32,0
1681909090270,BICD 100,A03,191941,Cooper; Andrew Michael,32,0,32,0
1681909090270,BICD 100,A04,191942,Cooper; Andrew Michael,32,0,32,0
1681909090270,BICD 100,A05,191943,Cooper; Andrew Michael,32,0,32,0
1681909091294,BIEB 126,A01,191945,Cleland; Elsa Eleanor,1,0,32,31
1681909091294,BIEB 126,A02,191946,Cleland; Elsa Eleanor,28,0,32,4
1681909091294,BIEB 126,A03,191947,Cleland; Elsa Eleanor,29,0,32,3
1681909091294,BIEB 126,A04,191948,Cleland; Elsa Eleanor,23,0,32,9
1681909091294,BIEB 126,A05,191996,Cleland; Elsa Eleanor,28,0,32,4
1681909092319,BIEB 136GS,A00,191997,Shurin; Jonathan & Holway; David A.,0,0,0,0
1681909093346,BIEB 137GS,A01,191999,Shurin; Jonathan & Holway; David A.,0,0,0,0
1681909094371,BILD 1,A01,205385,Staff,31,0,32,1
1681909094371,BILD 1,A02,205386,Staff,30,0,32,2
1681909094371,BILD 1,A03,205387,Staff,32,0,32,0
1681909094371,BILD 1,A04,205388,Staff,28,0,32,4
1681909095397,BILD 2,A01,191774,Staff,28,0,32,4
1681909095397,BILD 2,A02,191775,Staff,30,0,32,2
1681909095397,BILD 2,A03,191777,Staff,30,0,32,2
1681909095397,BILD 2,A04,191856,Staff,31,0,32,1
1681909095397,BILD 2,A05,191857,Staff,32,0,32,0
1681909095397,BILD 2,A06,191858,Staff,32,0,32,0
1681909095397,BILD 2,A07,191859,Staff,31,0,32,1
1681909096422,BILD 3,A01,205391,Staff,29,0,32,3
1681909096422,BILD 3,A02,205393,Staff,32,0,32,0
1681909096422,BILD 3,A03,205394,Staff,28,0,32,4
1681909096422,BILD 3,A04,205395,Staff,32,0,32,0
1681909097446,BILD 20,A01,191861,Staff,32,0,32,0
1681909097446,BILD 20,A02,191862,Staff,32,0,32,0
1681909098470,BILD 30,A01,191864,Staff,31,0,32,1
1681909099497,BIMM 100,A01,192019,Staff,0,0,32,32
1681909099497,BIMM 100,A02,192020,Staff,23,0,32,9
1681909099497,BIMM 100,A03,192035,Staff,22,0,32,10
1681909100521,BIMM 110,A01,192037,Tat; John,0,0,32,32
1681909100521,BIMM 110,A02,192038,Tat; John,10,0,32,22
1681909101550,BIMM 120,A01,192040,Pickett; Brooke Elizabeth,2,0,32,30
1681909101550,BIMM 120,A02,192041,Pickett; Brooke Elizabeth,16,0,32,16
1681909101550,BIMM 120,A03,192042,Pickett; Brooke Elizabeth,16,0,32,16
1681909102646,BIPN 100,A01,192044,Armour; Jon Christopher,26,0,32,6
1681909102646,BIPN 100,A02,192059,Armour; Jon Christopher,30,0,32,2
1681909102646,BIPN 100,A03,192064,Armour; Jon Christopher,31,0,32,1
1681909102646,BIPN 100,A04,192073,Armour; Jon Christopher,28,0,32,4
1681909103671,BIPN 148,A01,205411,Leutgeb; Jill K.,16,0,32,16
1681909103671,BIPN 148,A02,205412,Leutgeb; Jill K.,31,0,32,1
1681909103671,BIPN 148,A03,205413,Leutgeb; Jill K.,30,0,32,2
1681909103671,BIPN 148,A04,205414,Leutgeb; Jill K.,30,0,32,2
1681909104694,BIPN 160,A01,192115,Marino; Marc J,19,0,32,13
1681909104694,BIPN 160,A02,192148,Marino; Marc J,27,0,32,5
1681909104694,BIPN 160,A03,192158,Marino; Marc J,31,0,32,1
1681909104694,BIPN 160,A04,192190,Marino; Marc J,32,0,32,0
1681909104694,BIPN 160,A05,192287,Marino; Marc J,32,0,32,0
1681909104694,BIPN 160,A06,192288,Marino; Marc J,32,0,32,0
1681909105719,BIPN 194,A00,206038,Staff,28,0,32,4
1681909106744,BISP 194,A00,192289,Leutgeb; Stefan,13,0,32,19
1681909106744,BISP 194,B00,245332,Nieh; James Charles,27,0,32,5
1681909107766,CAT 124,A01,202247,Staff,15,0,15,0
1681909108794,CAT 125,A00,202248,Staff,19,0,20,1
1681909108794,CAT 125,B00,202253,Staff,20,0,20,0
1681909108794,CAT 125,C00,202257,Staff,19,0,20,1
1681909109817,CAT 125GS,A01,202273,Bronstein; Phoebe Malan,20,0,20,0
1681909110842,CAT 125R,A00,202284,Staff,17,0,20,3
1681909110842,CAT 125R,C00,202286,Staff,10,0,20,10
1681909110842,CAT 125R,D00,202291,Staff,18,0,20,2
1681909110842,CAT 125R,E00,202295,Staff,13,0,20,7
1681909110842,CAT 125R,F00,202302,Staff,12,0,20,8
1681909111874,CENG 100,A00,204724,Opatkiewicz; Justin Paul,25,0,25,0
1681909112898,CGS 2A,A01,180420,Staff,31,0,36,5
1681909113920,CGS 101,A00,180421,Staff,16,0,20,4
1681909114943,CGS 112,A00,180422,Staff,10,0,16,6
1681909115978,CGS 113,A00,180423,Staff,18,0,20,2
1681909117003,CGS 137,A00,180424,Staff,12,0,12,0
1681909118028,CGS 147,A00,180425,Staff,10,0,10,0
1681909119052,CHEM 6A,A01,179556,Staff,97,0,100,3
1681909119052,CHEM 6A,A02,179558,Staff,0,0,0,0
1681909120078,CHEM 6B,A01,179560,Staff,100,0,100,0
1681909121101,CHEM 6C,A01,179565,Jazzar; Rodolphe,95,0,100,5
1681909122125,CHEM 7L,A01,179586,Schurmeier; Kimberly,13,0,24,11
1681909122125,CHEM 7L,A02,179587,Schurmeier; Kimberly,23,0,24,1
1681909122125,CHEM 7L,A03,179590,Schurmeier; Kimberly,22,0,24,2
1681909122125,CHEM 7L,A04,179591,Schurmeier; Kimberly,22,0,24,2
1681909122125,CHEM 7L,B01,179598,Schurmeier; Kimberly,17,0,24,7
1681909122125,CHEM 7L,B02,179599,Schurmeier; Kimberly,24,0,24,0
1681909122125,CHEM 7L,B03,179606,Schurmeier; Kimberly,23,0,24,1
1681909122125,CHEM 7L,B04,179607,Schurmeier; Kimberly,23,0,24,1
1681909123153,CHEM 11,A01,179609,Stallings; Dontarie M,88,0,100,12
1681909124181,CHEM 40A,A01,179621,Staff,41,0,50,9
1681909124181,CHEM 40A,A02,179622,Staff,47,0,50,3
1681909125208,CHEM 40B,A01,179630,Weizman; Haim,48,0,50,2
1681909125208,CHEM 40B,A02,179631,Weizman; Haim,45,0,50,5
1681909126237,CHEM 41A,A01,179660,Klosterman; Jeremy K,93,0,100,7
1681909127262,CHEM 43A,A01,179683,Klosterman; Jeremy K,0,0,24,24
1681909127262,CHEM 43A,A02,179688,Klosterman; Jeremy K,14,0,24,10
1681909127262,CHEM 43A,A03,179689,Klosterman; Jeremy K,20,0,24,4
1681909127262,CHEM 43A,A04,179691,Klosterman; Jeremy K,18,0,24,6
1681909128287,CHEM 114A,A01,179693,Stallings; Dontarie M,77,0,100,23
1681909129312,CHEM 143B,A01,179698,Weizman; Haim,17,0,24,7
1681909129312,CHEM 143B,A02,179700,Weizman; Haim,24,0,24,0
1681909130340,CHIN 169A,A00,179701,Wang; Xiao,20,0,20,0
1681909131369,COGS 2,A01,179750,Boyle; Mary E. T.,17,0,30,13
1681909132393,COGS 9,A01,179759,Jones; Cameron Robert,43,0,50,7
1681909133420,COGS 14A,A01,179854,Staff,18,0,50,32
1681909134447,COGS 14B,A01,179856,Staff,54,0,60,6
1681909135471,COGS 17,A01,179874,Staff,71,0,75,4
1681909136493,COGS 18,A01,179884,Staff,63,0,80,17
1681909137515,COGS 100,A01,179886,Staff,40,0,60,20
1681909138539,COGS 101B,A01,179892,Staff,1,0,30,29
1681909139564,COGS 101C,A01,179894,Staff,28,0,30,2
1681909140600,COGS 107A,A01,179896,Boyle; Mary E. T.,31,0,40,9
1681909141624,COGS 108,A01,179898,Simpkins; Charles Alexander,0,17,60,60
1681909142646,COGS 109,A01,179900,Staff,34,0,40,6
1681909143668,COGS 118A,A01,179946,Staff,9,0,40,31
1681909144698,COGS 153,A00,179978,Staff,1,0,30,29
1681909145721,COGS 156,A01,179981,Staff,27,0,30,3
1681909147783,COGS 172,A01,179987,Staff,13,0,30,17
1681909149833,COGS 186,A01,179991,Staff,13,0,30,17
1681909150857,COMM 10,A01,180001,Staff,15,0,25,10
1681909150857,COMM 10,A02,180004,Staff,20,0,25,5
1681909151884,COMM 100A,A01,180016,Staff,18,0,25,7
1681909151884,COMM 100A,A02,180020,Staff,24,0,25,1
1681909152907,COMM 101T,A00,180029,Halm; Gavin Patrick,23,0,35,12
1681909153930,COMM 106V,A00,180043,Staff,34,0,35,1
1681909154957,COMM 109P,A00,180044,Staff,31,0,35,4
1681909155982,COMM 113T,A00,180045,Havis; Allan,37,0,45,8
1681909157012,COMM 132,A00,180046,McKenna; Denise,23,0,30,7
1681909158039,COMM 143,A00,180047,Staff,19,0,30,11
1681909159064,COMM 190,A00,180048,Conner; Thomas Hartnell,20,0,23,3
1681909160087,CSE 8A,A50,180053,Cao; Yingjun,25,0,50,25
1681909160087,CSE 8A,B50,180180,Staff,50,0,50,0
1681909161114,CSE 11,A01,180190,Cao; Yingjun,31,0,50,19
1681909162137,CSE 20,A01,180192,Briones; Jor-el Thomas Caparas,23,0,30,7
1681909163162,CSE 21,A01,194538,Briones; Jor-el Thomas Caparas,50,0,60,10
1681909164186,CSE 30,A01,180324,Eldon; John,79,0,100,21
1681909165212,CSE 101,A01,201353,Staff,0,20,40,40
1681909166240,CSE 134B,A01,180326,Powell; Thomas Allan,74,0,100,26
1681909167266,CSE 140,A01,180328,Staff,46,0,75,29
1681909168292,CSE 140L,A01,180344,Eldon; John,69,0,100,31
1681909169321,CSE 150A,A01,180411,Staff,0,7,50,50
1681909170345,CSE 151A,A01,180414,Staff,0,6,50,50
1681909171375,CSE 175,A01,222521,Kumar; Rakesh,50,0,50,0
1681909172401,CSE 190,A00,201419,Staff,45,0,49,4
1681909173426,CSS 1,A01,194536,Staff,38,0,50,12
1681909174450,DSC 30,A01,202385,Staff,48,0,50,2
1681909175474,DSC 40A,A01,202387,Albuyeh; Rod,50,0,50,0
1681909176500,DSC 190,A01,202389,Silberman; Jack,21,0,21,0
1681909177524,DSGN 100,A01,179993,Staff,16,0,30,14
1681909178547,ECE 65,A50,180708,Staff,10,0,20,10
1681909178547,ECE 65,A51,180739,Staff,19,0,20,1
1681909179572,ECON 1,A01,180427,Famulari; Melissa,67,0,70,3
1681909180595,ECON 2,A01,180450,Levkoff; Steven B.,64,0,70,6
1681909181622,ECON 4,A01,203351,Anderson; John Charles,7,0,10,3
1681909182649,ECON 100A,A01,180472,Famulari; Melissa,65,0,70,5
1681909183681,ECON 120A,A01,180549,Staff,64,0,70,6
1681909184709,ECON 120B,A01,180655,Ma; Xinwei,46,0,70,24
1681909185742,ECON 129,A00,203333,Eckert; Fabian Paul,15,0,35,20
1681909186765,ECON 131,A00,180656,Staff,9,0,35,26
1681909187788,ECON 172B,A01,180672,Levkoff; Steven B.,32,0,35,3
1681909188812,ECON 178,A01,203342,Zhu; Ying,11,0,35,24
1681909189838,EDS 108GS,A00,202383,Wishard Guerra; Alison G.,20,0,20,0
1681909190864,EDS 111GS,A00,202347,Wishard Guerra; Alison G.,20,0,20,0
1681909191887,EDS 112,A01,202323,Staff,56,0,60,4
1681909192912,EDS 113,A00,202340,Staff,33,0,35,2
1681909193940,EDS 118,A00,201231,Staff,20,0,30,10
1681909194965,EDS 119,A00,204994,Staff,8,0,10,2
1681909195989,EDS 124BR,A00,202324,Eguchi; Emi,5,0,25,20
1681909197014,EDS 126,A01,203208,Jones; Makeba,26,0,30,4
1681909198040,EDS 135,A01,202333,Staff,18,0,20,2
1681909199066,EDS 180,A00,202311,Staff,47,0,50,3
1681909200092,ERC 190GS,A01,253747,Staff,28,0,28,0
1681909201116,ETHN 104,A00,180742,Staff,24,0,35,11
1681909202142,ETHN 118,A00,180745,Staff,28,0,35,7
1681909203172,ETHN 127,A00,180747,Staff,12,0,16,4
1681909204200,ETHN 137,A00,180880,Staff,12,0,12,0
1681909205225,ETHN 147,A00,180890,Staff,8,0,10,2
1681909206342,ETHN 154,A00,180891,Staff,7,0,8,1
1681909207372,ETHN 168,A00,180892,Staff,9,0,10,1
1681909208405,GLBH 20,A00,201051,Hannah; Seth Donal,0,1,0,1
1681909209434,GLBH 111,A01,209338,Burgos; Jose L.,0,0,0,0
1681909210461,GLBH 150,A00,258300,Staff,0,3,0,0
1681909211488,GLBH 181,A00,201207,Staff,15,0,40,25
1681909212525,HIEU 109,A00,180898,Staff,20,0,20,0
1681909213556,HIEU 111,A00,180899,Staff,1,0,20,19
1681909214586,HIEU 124,A00,180900,Staff,18,0,20,2
1681909215613,HILA 122,A00,180901,Staff,18,0,20,2
1681909216646,HILA 132,A00,180902,Vitz; Matthew,2,0,20,18
1681909217670,HILD 10,A01,180896,Staff,15,0,20,5
1681909218695,HILD 30GS,A00,180897,Edington; Claire Ellen,0,0,0,0
1681909219722,HISC 105,A00,180903,Staff,20,0,20,0
1681909220748,HISC 117,A00,180904,Staff,11,0,20,9
1681909221772,HIUS 108B,A00,181005,Staff,18,0,20,2
1681909222796,HIUS 113,A00,181093,Staff,4,0,20,16
1681909223820,HUM 3,A01,181190,Patterson; Patrick H.,40,0,50,10
1681909223820,HUM 3,B01,181195,Staff,47,0,50,3
1681909224846,HUM 3GS,A00,181196,Herbst; Matthew,0,0,0,0
1681909225871,HUM 4,A01,181227,West; Geoffrey Scott,34,0,50,16
1681909225871,HUM 4,B01,181282,Staff,43,0,50,7
1681909226895,HUM 4GS,A00,181377,Lyon; Antony J.,0,0,0,0
1681909227921,HUM 5,A01,181536,Zavodny; Tatiana Sophia,31,0,50,19
1681909227921,HUM 5,B01,181908,Staff,36,0,50,14
1681909228946,INTL 190,A00,181909,Segui; Alan S,0,0,0,6
1681909228946,INTL 190,B00,181961,Segui; Alan S,0,0,0,7
1681909229974,JAPN 20AR,A01,182113,Ross; Kayoko F,15,0,20,5
1681909231006,LATI 50,A01,202391,Martin-Cabrera; Luis,19,0,30,11
1681909231006,LATI 50,A02,202392,Martin-Cabrera; Luis,26,0,30,4
1681909232030,LATI 180,A00,202393,Kokinis; Troy Andreas,25,0,25,0
1681909233054,LIFR 1A,A00,182119,Staff,14,0,14,0
1681909234084,LIFR 1AX,A00,182324,Staff,14,0,14,0
1681909235110,LIFR 1B,A00,182259,Staff,14,0,14,0
1681909236137,LIFR 1BX,A00,182273,Staff,14,0,14,0
1681909237161,LIGN 8,A00,182330,Staff,137,0,150,13
1681909238189,LIGN 9GS,A00,182362,Staff,20,0,20,0
1681909239219,LIGN 119,A00,204992,Takahashi; Maho,12,0,15,3
1681909240243,LIGN 130,A01,182384,Staff,47,0,50,3
1681909241280,LIGN 149GS,A00,182390,Staff,20,0,20,0
1681909242310,LIGN 170,A00,182404,Staff,24,0,30,6
1681909243334,LISP 1D,A00,182281,Staff,7,0,14,7
1681909243334,LISP 1D,B00,182287,Staff,14,0,14,0
1681909243334,LISP 1D,C00,182295,Staff,11,0,14,3
1681909243334,LISP 1D,D00,182301,Staff,14,0,14,0
1681909244360,LISP 1DX,A00,182309,Staff,20,0,28,8
1681909244360,LISP 1DX,B00,182316,Staff,26,0,28,2
1681909245388,LTAF 120GS,A00,182412,Zhiri; Oumelbanine,20,0,20,0
1681909246414,LTCS 172GS,A00,182437,Bronstein; Phoebe Malan,20,0,20,0
1681909247437,LTEA 138,A00,182457,Staff,22,0,40,18
1681909248459,LTEN 114,A01,182490,Staff,23,0,25,2
1681909249482,LTEN 130GS,A00,182491,Lyon; Antony J.,20,0,20,0
1681909250508,LTEN 169,A00,182493,Cuong; Marisol,20,0,25,5
1681909251535,LTEN 178,A00,182501,Staff,14,0,15,1
1681909252561,LTEN 181,A00,182515,Staff,22,0,25,3
1681909253584,LTEN 185GS,A00,197655,Forbes; Camille,20,0,20,0
1681909254614,LTSP 100B,A00,202208,Bessett; Ryan Matthew,24,0,25,1
1681909255640,LTWL 100,A00,182516,Myerston Santana; Jacobo,23,0,30,7
1681909256666,LTWR 100GS,A00,182518,Forbes; Camille,20,0,20,0
1681909257690,LTWR 102,A00,182522,Staff,15,0,15,0
1681909257690,LTWR 102,B00,182525,Staff,14,0,15,1
1681909258712,LTWR 115,A00,182526,Staff,12,0,15,3
1681909259738,MAE 8,A01,182528,Pham; Hieu Tan,68,0,70,2
1681909260760,MAE 11,A00,182529,Bahadori; Mohammad Yousef,94,0,100,6
1681909261783,MAE 20,A00,182530,Evdokimenko; Ekaterina,68,0,70,2
1681909262815,MAE 30A,A00,182532,Staff,44,0,45,1
1681909263839,MAE 101A,A00,182533,Bahadori; Mohammad Yousef,97,0,100,3
1681909264868,MAE 101C,A00,182538,Staff,62,0,70,8
1681909265892,MAE 104,A00,182539,Staff,45,0,50,5
1681909266926,MAE 131A,A00,182540,Ghazinejad; Maziar,41,0,45,4
1681909267955,MAE 143A,A00,182548,Bewley; Thomas R,43,0,50,7
1681909268980,MAE 150,A00,182549,Staff,28,0,40,12
1681909270004,MAE 160,A00,182550,Evdokimenko; Ekaterina,43,0,60,17
1681909271033,MATH 3C,A01,182725,Staff,27,0,30,3
1681909272061,MATH 10A,A01,182729,Staff,25,0,30,5
1681909272061,MATH 10A,B01,182732,Staff,26,0,30,4
1681909273090,MATH 10B,A01,182737,Staff,21,0,30,9
1681909273090,MATH 10B,A02,182738,Staff,27,0,30,3
1681909273090,MATH 10B,B01,182744,Staff,27,0,30,3
1681909273090,MATH 10B,B02,182745,Staff,27,0,30,3
1681909274121,MATH 18,A01,182750,Anzaldo; Leesa B,28,0,30,2
1681909274121,MATH 18,A02,182751,Anzaldo; Leesa B,29,0,30,1
1681909274121,MATH 18,A03,182753,Anzaldo; Leesa B,28,0,30,2
1681909274121,MATH 18,A04,182757,Anzaldo; Leesa B,29,0,30,1
1681909274121,MATH 18,B01,182761,Anzaldo; Leesa B,27,0,30,3
1681909274121,MATH 18,B02,182764,Anzaldo; Leesa B,27,0,30,3
1681909274121,MATH 18,B03,182765,Anzaldo; Leesa B,30,0,30,0
1681909274121,MATH 18,B04,182766,Anzaldo; Leesa B,30,0,30,0
1681909275145,MATH 20A,A01,182771,Suk; Andrew Hoon,28,0,30,2
1681909276178,MATH 20B,A01,182775,Bach; Quang Tran,30,0,30,0
1681909276178,MATH 20B,A02,182777,Bach; Quang Tran,29,0,30,1
1681909276178,MATH 20B,B01,182780,Bach; Quang Tran,27,0,30,3
1681909276178,MATH 20B,B02,182782,Bach; Quang Tran,30,0,30,0
1681909277202,MATH 20C,A01,182787,Staff,25,0,30,5
1681909277202,MATH 20C,A02,182790,Staff,29,0,30,1
1681909277202,MATH 20C,B01,182792,Staff,25,0,30,5
1681909277202,MATH 20C,B02,182796,Staff,27,0,30,3
1681909278230,MATH 20D,A01,182799,Staff,29,0,30,1
1681909278230,MATH 20D,A02,182802,Staff,30,0,30,0
1681909278230,MATH 20D,A03,182803,Staff,30,0,30,0
1681909279262,MATH 20E,A01,182809,Verstraete; Jacques Allan,24,0,30,6
1681909279262,MATH 20E,A02,182811,Verstraete; Jacques Allan,28,0,30,2
1681909279262,MATH 20E,B01,182814,Verstraete; Jacques Allan,23,0,30,7
1681909279262,MATH 20E,B02,182815,Verstraete; Jacques Allan,30,0,30,0
1681909280287,MATH 103A,A01,182820,Staff,9,0,30,21
1681909280287,MATH 103A,A02,182821,Staff,27,0,30,3
1681909280287,MATH 103A,A03,182822,Staff,23,0,30,7
1681909280287,MATH 103A,B01,182825,Staff,23,0,30,7
1681909280287,MATH 103A,B02,182826,Staff,30,0,30,0
1681909280287,MATH 103A,B03,182830,Staff,30,0,30,0
1681909281311,MATH 109,A01,182836,Chow; Bennett,24,0,30,6
1681909281311,MATH 109,A02,182838,Chow; Bennett,29,0,30,1
1681909281311,MATH 109,A03,182894,Chow; Bennett,29,0,30,1
1681909281311,MATH 109,B01,182908,Chow; Bennett,28,0,30,2
1681909281311,MATH 109,B02,182909,Chow; Bennett,30,0,30,0
1681909281311,MATH 109,B03,182910,Chow; Bennett,27,0,30,3
1681909282336,MATH 142A,A01,182925,Staff,11,0,30,19
1681909282336,MATH 142A,A02,182935,Staff,25,0,30,5
1681909282336,MATH 142A,A03,182967,Staff,26,0,30,4
1681909282336,MATH 142A,B01,183125,Staff,24,0,30,6
1681909282336,MATH 142A,B02,183157,Staff,28,0,30,2
1681909282336,MATH 142A,B03,183158,Staff,29,0,30,1
1681909283367,MATH 183,A01,183160,Arias-Castro; Ery,23,0,30,7
1681909283367,MATH 183,A02,183161,Arias-Castro; Ery,29,0,30,1
1681909283367,MATH 183,B01,183163,Arias-Castro; Ery,28,0,30,2
1681909283367,MATH 183,B02,183164,Arias-Castro; Ery,28,0,30,2
1681909284394,MATH 193A,A01,183167,Staff,4,0,35,31
1681909284394,MATH 193A,A02,183168,Staff,28,0,35,7
1681909284394,MATH 193A,A03,183169,Staff,34,0,35,1
1681909284394,MATH 193A,A04,183170,Staff,28,0,35,7
1681909285421,MGT 4,A01,202395,Anderson; John Charles,75,0,80,5
1681909286444,MGT 5,A00,202396,Houskeeper; Robert,80,0,90,10
1681909287468,MGT 103,A00,202397,Eberhard; Craig A,55,0,90,35
1681909288492,MGT 131A,A00,202398,Houskeeper; Robert,85,0,90,5
1681909289516,MGT 135,A00,202399,Anderson; John Charles,82,0,90,8
1681909290539,MGT 162R,A00,202403,Gneezy; Uri,150,0,200,50
1681909291567,MGT 172,A00,202404,Hedges; Kathleen,50,0,90,40
1681909292591,MGT 181,A00,202405,Dunn; Louis Jean,84,0,90,6
1681909293615,MMW 14,A01,183200,Staff,16,0,28,12
1681909293615,MMW 14,A02,183201,Staff,26,0,28,2
1681909293615,MMW 14,A03,183202,Staff,24,0,28,4
1681909293615,MMW 14,A04,183203,Staff,25,0,28,3
1681909293615,MMW 14,A05,183204,Staff,26,0,28,2
1681909293615,MMW 14,A06,183205,Staff,27,0,28,1
1681909293615,MMW 14,B01,183207,Staff,26,0,28,2
1681909293615,MMW 14,B02,183208,Staff,28,0,28,0
1681909293615,MMW 14,B03,183209,Staff,28,0,28,0
1681909293615,MMW 14,B04,183210,Staff,28,0,28,0
1681909293615,MMW 14,B05,183211,Staff,28,0,28,0
1681909293615,MMW 14,B06,183212,Staff,28,0,28,0
1681909294638,MMW 14GS,A00,183213,Zhiri; Oumelbanine,28,0,28,0
1681909295664,MMW 15GS,B00,183215,Rahimi; Babak,28,0,28,0
1681909296688,MMW 121,A01,183217,Patterson; Patrick H.,14,0,28,14
1681909296688,MMW 121,A02,183218,Patterson; Patrick H.,25,0,28,3
1681909297711,MUS 1A,A01,182554,Staff,8,0,35,27
1681909298734,MUS 5,A01,182558,Staff,20,0,35,15
1681909299761,MUS 6,A01,182562,Staff,25,0,35,10
1681909300786,MUS 8GS,A00,182563,Borgo; David Garcia,25,0,25,0
1681909301809,MUS 13,A01,182567,Staff,24,0,25,1
1681909302837,MUS 15,A01,182570,Staff,32,0,35,3
1681909302837,MUS 15,B01,182575,Staff,10,0,35,25
1681909303861,MUS 80,A00,182578,Staff,23,0,25,2
1681909303861,MUS 80,B00,182581,Staff,20,0,25,5
1681909304887,MUS 113,A00,182582,Staff,25,0,25,0
1681909305915,MUS 114,A00,182583,Staff,4,0,25,21
1681909306941,MUS 150GS,A01,182588,Borgo; David Garcia,25,0,25,0
1681909307964,PHIL 1,A00,182590,Staff,35,0,40,5
1681909308993,PHIL 10,A01,182596,Grush; Rick Scott,31,0,35,4
1681909308993,PHIL 10,A02,182597,Grush; Rick Scott,34,0,35,1
1681909310090,PHIL 15,A01,182601,Staff,31,0,35,4
1681909310090,PHIL 15,A02,182602,Staff,33,0,35,2
1681909311118,PHIL 27,A01,182604,Staff,30,0,35,5
1681909311118,PHIL 27,A02,182607,Staff,35,0,35,0
1681909312141,PHIL 32,A01,182609,Staff,35,0,35,0
1681909312141,PHIL 32,A02,182612,Staff,35,0,35,0
1681909313165,PHIL 130,A00,182614,Staff,63,0,70,7
1681909314192,PHIL 136,A00,182616,Cohen; Jonathan David,66,0,70,4
1681909315215,PHIL 155,A00,182617,Vargas; Manuel Rogelio,60,0,70,10
1681909316371,PHIL 163,A01,182620,Staff,15,0,20,5
1681909316371,PHIL 163,A02,182624,Staff,10,0,20,10
1681909317396,PHIL 164,A00,182627,Staff,30,0,40,10
1681909318420,PHIL 173,A00,182628,Staff,36,0,40,4
1681909319450,PHYS 1A,A00,183221,Staff,54,0,60,6
1681909320479,PHYS 1AL,001,183222,Staff,25,0,30,5
1681909320479,PHYS 1AL,002,183223,Staff,28,0,30,2
1681909321503,PHYS 1B,A00,183231,Staff,44,0,60,16
1681909322526,PHYS 1BL,001,183232,Staff,20,0,30,10
1681909322526,PHYS 1BL,002,183233,Staff,29,0,30,1
1681909323550,PHYS 1C,A00,183240,Staff,30,0,60,30
1681909324578,PHYS 1CL,001,183241,Staff,13,0,30,17
1681909324578,PHYS 1CL,002,183242,Staff,22,0,30,8
1681909325606,PHYS 2AR,A01,183250,Staff,44,0,50,6
1681909326631,PHYS 2B,A01,183252,Staff,106,0,115,9
1681909327655,PHYS 2BL,A01,183254,Staff,21,0,24,3
1681909327655,PHYS 2BL,A02,183255,Staff,22,0,24,2
1681909328679,PHYS 2C,A01,183522,Staff,105,0,115,10
1681909329706,PHYS 4A,A01,183524,Staff,49,0,50,1
1681909330732,POLI 5,A00,183525,Staff,44,0,50,6
1681909331756,POLI 12,A00,183540,Staff,48,0,50,2
1681909332786,POLI 13R,A00,183541,Forman; Fonna,42,0,50,8
1681909333810,POLI 30,A00,183542,Mignozzetti; Umberto,47,0,50,3
1681909334833,POLI 100A,A00,183543,Staff,45,0,50,5
1681909335865,POLI 100E,A00,223598,Staff,32,0,35,3
1681909336888,POLI 103A,A00,183564,Kousser; Thad,38,0,50,12
1681909337914,POLI 104B,A00,201329,Staff,29,0,35,6
1681909338938,POLI 113BR,A00,183576,Hoston; Germaine,28,0,50,22
1681909339962,POLI 114BR,A00,183588,Staff,27,0,30,3
1681909340985,POLI 117R,A00,183595,Forman; Fonna,9,0,20,11
1681909342012,POLI 120H,A00,183596,Fisk; David Lee,13,0,20,7
1681909343036,POLI 130AA,A00,183597,Staff,14,0,20,6
1681909344071,POLI 134AA,A00,183598,Staff,19,0,20,1
1681909345101,POLI 135,A00,183599,Fisk; David Lee,20,0,25,5
1681909346128,POLI 142P,A00,183623,Staff,37,0,40,3
1681909347153,POLI 144D,A00,183624,Staff,22,0,25,3
1681909348179,POLI 151,A00,183625,Staff,15,0,20,5
1681909349203,POLI 162,A00,183626,Mignozzetti; Umberto,18,0,20,2
1681909350227,PSYC 1,A00,253748,Staff,86,0,90,4
1681909351251,PSYC 2,A00,183627,Moranton; Nirelia Melbina-,25,0,35,10
1681909352276,PSYC 3,A00,183628,Staff,43,0,45,2
1681909354325,PSYC 60,A01,183631,Lowe; Angela Beth,35,0,40,5
1681909355349,PSYC 70,A01,253757,Staff,37,0,45,8
1681909356376,PSYC 101,A00,183632,Heyman; Gail D.,48,0,60,12
1681909357403,PSYC 105,A00,183848,Lowe; Angela Beth,50,0,60,10
1681909358425,PSYC 106,A00,183849,Dobkins; Karen R.,45,0,60,15
1681909359450,PSYC 108,A00,253750,Staff,24,0,60,36
1681909360478,PSYC 114,A01,184275,Winkielman; Piotr,0,6,30,30
1681909361508,PSYC 122,A00,183856,Moranton; Nirelia Melbina-,0,10,30,30
1681909362531,PSYC 124,A00,183865,Chapman; Eddie Nathaniel,52,0,80,28
1681909363560,PSYC 137,A00,183880,Staff,19,0,25,6
1681909365609,PSYC 154,A00,183910,Lacefield; Katharine I,0,2,90,90
1681909367657,PSYC 162,A00,183946,Wixted; John T,61,0,90,29
1681909368684,PSYC 172,A00,183947,Gorman; Michael R.,14,0,30,16
1681909369711,PSYC 178,A00,183963,Glaser; Dale,20,0,40,20
1681909370734,PSYC 181GS,A00,183964,Anagnostaras; Stephan,10,0,10,0
1681909371756,PSYC 186GS,A01,257660,Staff,10,0,10,0
1681909372779,PSYC 193,B00,253749,Staff,23,0,25,2
1681909374831,PSYC 193L,A01,184122,Staff,33,0,35,2
1681909374831,PSYC 193L,C01,184167,Winkielman; Piotr,16,0,30,14
1681909375854,RELI 188GS,A00,182629,Rahimi; Babak,20,0,20,0
1681909376878,SE 101A,A00,182646,Staff,26,0,30,4
1681909377902,SE 101C,A00,182650,Staff,18,0,20,2
1681909378925,SE 110A,A00,182651,Staff,28,0,28,0
1681909379949,SE 130A,A00,182652,Staff,39,0,40,1
1681909380974,SIO 46GS,A00,182636,Cook; Geoffrey W,28,0,28,0
1681909381998,SIO 109R,A00,194459,Staff,5,0,20,15
1681909383025,SIO 121GS,A00,182639,Cook; Geoffrey W,28,0,28,0
1681909384053,SIO 132,A01,182642,Staff,32,0,40,8
1681909385079,SIO 139,A00,182644,Kacev; David,36,0,40,4
1681909386108,SOCI 2,A01,258404,Staff,34,0,36,2
1681909386108,SOCI 2,A02,258405,Staff,35,0,36,1
1681909387138,SOCI 60,A01,258408,Staff,29,0,30,1
1681909387138,SOCI 60,A02,258413,Staff,30,0,30,0
1681909388161,SOCI 100,A01,258415,Staff,29,0,30,1
1681909388161,SOCI 100,A02,258416,Staff,28,0,30,2
1681909394320,SOCI 127,A00,258421,Staff,22,0,30,8
1681909395345,SOCI 132,A00,258422,Staff,45,0,50,5
1681909396373,SOCI 133,A00,258423,Staff,26,0,30,4
1681909397396,SOCI 138GS,A00,258424,Staff,15,0,15,0
1681909398419,SOCI 145,A00,258425,Staff,25,0,30,5
1681909399445,SOCI 148,A00,258426,Staff,26,0,30,4
1681909400468,SOCI 153,A00,199217,Staff,29,0,30,1
1681909401493,SOCI 160,A00,258427,Staff,28,0,30,2
1681909402516,SOCI 160E,A00,258435,Staff,56,0,60,4
1681909403539,SOCI 189GS,A00,258436,Staff,15,0,15,0
1681909404565,SOCI 190GS,A00,258437,Staff,15,0,15,0
1681909405594,SYN 2,001,182658,Staff,9,0,16,7
1681909405594,SYN 2,002,201439,Staff,15,0,16,1
1681909405594,SYN 2,003,201443,Staff,16,0,16,0
1681909406618,SYN 100,A01,182657,Staff,17,0,20,3
1681909407641,TDAC 1,A00,184381,Salovey; Todd,16,0,20,4
1681909407641,TDAC 1,B00,184385,Harting; Carla Kelso,19,0,20,1
1681909407641,TDAC 1,C00,184394,Staff,19,0,20,1
1681909408667,TDAC 101,A00,184483,Harting; Carla Kelso,19,0,20,1
1681909409689,TDDE 111,A00,184496,Staff,14,0,15,1
1681909410717,TDDE 131,A00,184504,Staff,20,0,20,0
1681909410717,TDDE 131,B00,184505,Staff,17,0,18,1
1681909410717,TDDE 131,C00,184534,Staff,49,0,50,1
1681909410717,TDDE 131,D00,184564,Staff,15,0,15,0
1681909410717,TDDE 131,E00,204725,Staff,19,0,20,1
1681909411740,TDGE 1,A01,184414,Salovey; Todd,37,0,50,13
1681909412766,TDGE 5,A01,184419,Staff,23,0,24,1
1681909413866,TDGE 10,A00,184428,Fulton; Julia,31,0,50,19
1681909414892,TDGE 124,A00,184565,Fulton; Julia,7,0,50,43
1681909415916,TDGE 125,B00,184567,Meyer; Ursula,9,0,25,16
1681909416939,TDHT 101,A00,184568,Staff,21,0,25,4
1681909416939,TDHT 101,B00,184569,Staff,20,0,20,0
1681909417965,TDHT 114,A00,184570,Staff,49,0,50,1
1681909418990,TDMV 1,A00,184437,Arcidiacono; Kristin,23,0,30,7
1681909418990,TDMV 1,B00,184448,Caligagan; Maria T.,22,0,30,8
1681909420021,TDMV 2,A00,184449,Weinberg; Sadie,27,0,30,3
1681909420021,TDMV 2,B00,184453,Arcidiacono; Kristin,29,0,30,1
1681909421045,TDMV 110,A00,184571,Weinberg; Sadie,30,0,30,0
1681909422073,TDMV 142,A00,184572,Caligagan; Tony,27,0,30,3
1681909422073,TDMV 142,B00,184573,Caligagan; Maria T.,27,0,30,3
1681909423097,TDTR 20,A00,184482,Jun; Grace Shin Hae,25,0,25,0
1681909424120,USP 2,A01,184290,Hinds; Juli Beth,24,0,25,1
1681909425144,USP 3,A01,184295,Staff,20,0,25,5
1681909426169,USP 4,A00,184304,McTague; Sarah,15,0,25,10
1681909427192,USP 100,A00,184315,Staff,17,0,25,8
1681909428216,USP 105,A00,184326,Staff,21,0,25,4
1681909429244,USP 151,A00,184327,Staff,20,0,25,5
1681909430267,USP 170,A00,184380,Hinds; Juli Beth,14,0,25,11
1681909431294,VIS 21B,A01,182660,Staff,28,0,31,3
1681909431294,VIS 21B,A02,182662,Staff,30,0,31,1
1681909432319,VIS 103D,A00,182663,Staff,74,0,75,1
1681909433342,VIS 105D,A00,182667,Li; Huai,15,0,22,7
1681909434368,VIS 122GS,A00,182668,Herbst; Matthew,20,0,20,0
1681909435394,VIS 128C,A00,182673,Staff,70,0,75,5
1681909436421,VIS 130,A00,182675,Staff,20,0,22,2
1681909437445,VIS 160A,A00,182678,Stalbaum; Brett,4,0,10,6
1681909439493,WCWP 10B,A00,201679,Staff,15,0,15,0
1681909439493,WCWP 10B,B00,201695,Staff,15,0,15,0
1681909440518,WCWP 100,A00,201716,Staff,15,0,15,0
1681909440518,WCWP 100,B00,201717,Staff,11,0,15,4
1681909442592,ANSC 105GS,A00,258289,Staff,0,0,0,0
1681909443615,ANSC 125GS,A00,258295,Staff,0,0,0,0
1681909444638,ANSC 150,A00,258267,Staff,30,0,40,10
1681909445664,ANSC 190GS,A00,258280,Staff,0,0,0,0
1681909446691,ANTH 1,A00,258264,Staff,38,0,40,2
1681909447717,ANTH 2,A01,258259,Staff,72,0,76,4
1681909448743,ANTH 23,A01,258228,Staff,36,0,40,4
1681909449770,ANTH 101,A01,258236,Staff,39,0,40,1
1681909450798,ANTH 102,A00,258272,Staff,59,0,60,1
1681909451822,ANTH 105,A00,258244,Staff,31,0,35,4
1681909452853,BENG 130,A00,253975,Staff,38,0,40,2
1681909453876,BIBC 102,A01,191866,Flagg; Matthew Paul,19,0,32,13
1681909453876,BIBC 102,A02,191867,Flagg; Matthew Paul,22,0,32,10
1681909453876,BIBC 102,A03,191868,Flagg; Matthew Paul,30,0,32,2
1681909453876,BIBC 102,A04,191936,Flagg; Matthew Paul,26,0,32,6
1681909453876,BIBC 102,A05,191937,Flagg; Matthew Paul,11,0,32,21
1681909454900,BICD 100,A01,191939,Cooper; Andrew Michael,28,0,32,4
1681909454900,BICD 100,A02,191940,Cooper; Andrew Michael,32,0,32,0
1681909454900,BICD 100,A03,191941,Cooper; Andrew Michael,32,0,32,0
1681909454900,BICD 100,A04,191942,Cooper; Andrew Michael,32,0,32,0
1681909454900,BICD 100,A05,191943,Cooper; Andrew Michael,32,0,32,0
1681909455924,BIEB 126,A01,191945,Cleland; Elsa Eleanor,1,0,32,31
1681909455924,BIEB 126,A02,191946,Cleland; Elsa Eleanor,28,0,32,4
1681909455924,BIEB 126,A03,191947,Cleland; Elsa Eleanor,29,0,32,3
1681909455924,BIEB 126,A04,191948,Cleland; Elsa Eleanor,23,0,32,9
1681909455924,BIEB 126,A05,191996,Cleland; Elsa Eleanor,28,0,32,4
1681909456947,BIEB 136GS,A00,191997,Shurin; Jonathan & Holway; David A.,0,0,0,0
1681909457970,BIEB 137GS,A01,191999,Shurin; Jonathan & Holway; David A.,0,0,0,0
1681909458999,BILD 1,A01,205385,Staff,31,0,32,1
1681909458999,BILD 1,A02,205386,Staff,30,0,32,2
1681909458999,BILD 1,A03,205387,Staff,32,0,32,0
1681909458999,BILD 1,A04,205388,Staff,28,0,32,4
1681909460023,BILD 2,A01,191774,Staff,28,0,32,4
1681909460023,BILD 2,A02,191775,Staff,30,0,32,2
1681909460023,BILD 2,A03,191777,Staff,30,0,32,2
1681909460023,BILD 2,A04,191856,Staff,31,0,32,1
1681909460023,BILD 2,A05,191857,Staff,32,0,32,0
1681909460023,BILD 2,A06,191858,Staff,32,0,32,0
1681909460023,BILD 2,A07,191859,Staff,31,0,32,1
1681909461051,BILD 3,A01,205391,Staff,29,0,32,3
1681909461051,BILD 3,A02,205393,Staff,32,0,32,0
1681909461051,BILD 3,A03,205394,Staff,28,0,32,4
1681909461051,BILD 3,A04,205395,Staff,32,0,32,0
1681909462075,BILD 20,A01,191861,Staff,32,0,32,0
1681909462075,BILD 20,A02,191862,Staff,32,0,32,0
1681909463101,BILD 30,A01,191864,Staff,31,0,32,1
1681909464123,BIMM 100,A01,192019,Staff,0,0,32,32
1681909464123,BIMM 100,A02,192020,Staff,23,0,32,9
1681909464123,BIMM 100,A03,192035,Staff,22,0,32,10
1681909465151,BIMM 110,A01,192037,Tat; John,0,0,32,32
1681909465151,BIMM 110,A02,192038,Tat; John,10,0,32,22
1681909466177,BIMM 120,A01,192040,Pickett; Brooke Elizabeth,2,0,32,30
1681909466177,BIMM 120,A02,192041,Pickett; Brooke Elizabeth,16,0,32,16
1681909466177,BIMM 120,A03,192042,Pickett; Brooke Elizabeth,16,0,32,16
1681909467207,BIPN 100,A01,192044,Armour; Jon Christopher,26,0,32,6
1681909467207,BIPN 100,A02,192059,Armour; Jon Christopher,30,0,32,2
1681909467207,BIPN 100,A03,192064,Armour; Jon Christopher,31,0,32,1
1681909467207,BIPN 100,A04,192073,Armour; Jon Christopher,28,0,32,4
1681909468230,BIPN 148,A01,205411,Leutgeb; Jill K.,16,0,32,16
1681909468230,BIPN 148,A02,205412,Leutgeb; Jill K.,31,0,32,1
1681909468230,BIPN 148,A03,205413,Leutgeb; Jill K.,30,0,32,2
1681909468230,BIPN 148,A04,205414,Leutgeb; Jill K.,30,0,32,2
1681909469282,BIPN 160,A01,192115,Marino; Marc J,19,0,32,13
1681909469282,BIPN 160,A02,192148,Marino; Marc J,27,0,32,5
1681909469282,BIPN 160,A03,192158,Marino; Marc J,31,0,32,1
1681909469282,BIPN 160,A04,192190,Marino; Marc J,32,0,32,0
1681909469282,BIPN 160,A05,192287,Marino; Marc J,32,0,32,0
1681909469282,BIPN 160,A06,192288,Marino; Marc J,32,0,32,0
1681909470310,BIPN 194,A00,206038,Staff,28,0,32,4
1681909471335,BISP 194,A00,192289,Leutgeb; Stefan,13,0,32,19
1681909471335,BISP 194,B00,245332,Nieh; James Charles,27,0,32,5
1681909472365,CAT 124,A01,202247,Staff,15,0,15,0
1681909473391,CAT 125,A00,202248,Staff,19,0,20,1
1681909473391,CAT 125,B00,202253,Staff,20,0,20,0
1681909473391,CAT 125,C00,202257,Staff,19,0,20,1
1681909474429,CAT 125GS,A01,202273,Bronstein; Phoebe Malan,20,0,20,0
1681909475454,CAT 125R,A00,202284,Staff,17,0,20,3
1681909475454,CAT 125R,C00,202286,Staff,10,0,20,10
1681909475454,CAT 125R,D00,202291,Staff,18,0,20,2
1681909475454,CAT 125R,E00,202295,Staff,13,0,20,7
1681909475454,CAT 125R,F00,202302,Staff,12,0,20,8
1681909476479,CENG 100,A00,204724,Opatkiewicz; Justin Paul,25,0,25,0
1681909477506,CGS 2A,A01,180420,Staff,31,0,36,5
1681909478529,CGS 101,A00,180421,Staff,16,0,20,4
1681909479552,CGS 112,A00,180422,Staff,10,0,16,6
1681909480585,CGS 113,A00,180423,Staff,18,0,20,2
1681909481612,CGS 137,A00,180424,Staff,12,0,12,0
1681909482635,CGS 147,A00,180425,Staff,10,0,10,0
1681909483658,CHEM 6A,A01,179556,Staff,97,0,100,3
1681909483658,CHEM 6A,A02,179558,Staff,0,0,0,0
1681909484682,CHEM 6B,A01,179560,Staff,100,0,100,0
1681909485708,CHEM 6C,A01,179565,Jazzar; Rodolphe,95,0,100,5
1681909486734,CHEM 7L,A01,179586,Schurmeier; Kimberly,13,0,24,11
1681909486734,CHEM 7L,A02,179587,Schurmeier; Kimberly,23,0,24,1
1681909486734,CHEM 7L,A03,179590,Schurmeier; Kimberly,22,0,24,2
1681909486734,CHEM 7L,A04,179591,Schurmeier; Kimberly,22,0,24,2
1681909486734,CHEM 7L,B01,179598,Schurmeier; Kimberly,17,0,24,7
1681909486734,CHEM 7L,B02,179599,Schurmeier; Kimberly,24,0,24,0
1681909486734,CHEM 7L,B03,179606,Schurmeier; Kimberly,23,0,24,1
1681909486734,CHEM 7L,B04,179607,Schurmeier; Kimberly,23,0,24,1
1681909487762,CHEM 11,A01,179609,Stallings; Dontarie M,88,0,100,12
1681909488787,CHEM 40A,A01,179621,Staff,41,0,50,9
1681909488787,CHEM 40A,A02,179622,Staff,47,0,50,3
1681909489810,CHEM 40B,A01,179630,Weizman; Haim,48,0,50,2
1681909489810,CHEM 40B,A02,179631,Weizman; Haim,45,0,50,5
1681909490839,CHEM 41A,A01,179660,Klosterman; Jeremy K,93,0,100,7
1681909491863,CHEM 43A,A01,179683,Klosterman; Jeremy K,0,0,24,24
1681909491863,CHEM 43A,A02,179688,Klosterman; Jeremy K,14,0,24,10
1681909491863,CHEM 43A,A03,179689,Klosterman; Jeremy K,20,0,24,4
1681909491863,CHEM 43A,A04,179691,Klosterman; Jeremy K,18,0,24,6
1681909492890,CHEM 114A,A01,179693,Stallings; Dontarie M,77,0,100,23
1681909493919,CHEM 143B,A01,179698,Weizman; Haim,17,0,24,7
1681909493919,CHEM 143B,A02,179700,Weizman; Haim,24,0,24,0
1681909494945,CHIN 169A,A00,179701,Wang; Xiao,20,0,20,0
1681909495969,COGS 2,A01,179750,Boyle; Mary E. T.,17,0,30,13
1681909496992,COGS 9,A01,179759,Jones; Cameron Robert,43,0,50,7
1681909498015,COGS 14A,A01,179854,Staff,18,0,50,32
1681909499039,COGS 14B,A01,179856,Staff,54,0,60,6
1681909500061,COGS 17,A01,179874,Staff,71,0,75,4
1681909501086,COGS 18,A01,179884,Staff,63,0,80,17
1681909502112,COGS 100,A01,179886,Staff,40,0,60,20
1681909503135,COGS 101B,A01,179892,Staff,1,0,30,29
1681909504160,COGS 101C,A01,179894,Staff,28,0,30,2
1681909505186,COGS 107A,A01,179896,Boyle; Mary E. T.,31,0,40,9
1681909506209,COGS 108,A01,179898,Simpkins; Charles Alexander,0,17,60,60
1681909507234,COGS 109,A01,179900,Staff,34,0,40,6
1681909508258,COGS 118A,A01,179946,Staff,9,0,40,31
1681909509281,COGS 153,A00,179978,Staff,1,0,30,29
1681909510305,COGS 156,A01,179981,Staff,27,0,30,3
1681909512355,COGS 172,A01,179987,Staff,13,0,30,17
1681909514404,COGS 186,A01,179991,Staff,13,0,30,17
1681909515430,COMM 10,A01,180001,Staff,15,0,25,10
1681909515430,COMM 10,A02,180004,Staff,20,0,25,5
1681909516457,COMM 100A,A01,180016,Staff,18,0,25,7
1681909516457,COMM 100A,A02,180020,Staff,24,0,25,1
1681909517572,COMM 101T,A00,180029,Halm; Gavin Patrick,23,0,35,12
1681909518597,COMM 106V,A00,180043,Staff,34,0,35,1
1681909519624,COMM 109P,A00,180044,Staff,31,0,35,4
1681909520650,COMM 113T,A00,180045,Havis; Allan,37,0,45,8
1681909521673,COMM 132,A00,180046,McKenna; Denise,23,0,30,7
1681909522700,COMM 143,A00,180047,Staff,19,0,30,11
1681909523726,COMM 190,A00,180048,Conner; Thomas Hartnell,20,0,23,3
1681909524750,CSE 8A,A50,180053,Cao; Yingjun,25,0,50,25
1681909524750,CSE 8A,B50,180180,Staff,50,0,50,0
1681909525772,CSE 11,A01,180190,Cao; Yingjun,31,0,50,19
1681909526796,CSE 20,A01,180192,Briones; Jor-el Thomas Caparas,23,0,30,7
1681909527821,CSE 21,A01,194538,Briones; Jor-el Thomas Caparas,50,0,60,10
1681909528848,CSE 30,A01,180324,Eldon; John,79,0,100,21
1681909529878,CSE 101,A01,201353,Staff,0,20,40,40
1681909530900,CSE 134B,A01,180326,Powell; Thomas Allan,74,0,100,26
1681909531928,CSE 140,A01,180328,Staff,46,0,75,29
1681909532953,CSE 140L,A01,180344,Eldon; John,69,0,100,31
1681909533980,CSE 150A,A01,180411,Staff,0,7,50,50
1681909535014,CSE 151A,A01,180414,Staff,0,6,50,50
1681909536041,CSE 175,A01,222521,Kumar; Rakesh,50,0,50,0
1681909537066,CSE 190,A00,201419,Staff,45,0,49,4
1681909538090,CSS 1,A01,194536,Staff,38,0,50,12
1681909539120,DSC 30,A01,202385,Staff,48,0,50,2
1681909540143,DSC 40A,A01,202387,Albuyeh; Rod,50,0,50,0
1681909541168,DSC 190,A01,202389,Silberman; Jack,21,0,21,0
1681909542191,DSGN 100,A01,179993,Staff,16,0,30,14
1681909543216,ECE 65,A50,180708,Staff,10,0,20,10
1681909543216,ECE 65,A51,180739,Staff,19,0,20,1
1681909544243,ECON 1,A01,180427,Famulari; Melissa,67,0,70,3
1681909545267,ECON 2,A01,180450,Levkoff; Steven B.,64,0,70,6
1681909546295,ECON 4,A01,203351,Anderson; John Charles,7,0,10,3
1681909547323,ECON 100A,A01,180472,Famulari; Melissa,65,0,70,5
1681909548346,ECON 120A,A01,180549,Staff,64,0,70,6
1681909549370,ECON 120B,A01,180655,Ma; Xinwei,46,0,70,24
1681909550397,ECON 129,A00,203333,Eckert; Fabian Paul,15,0,35,20
1681909551420,ECON 131,A00,180656,Staff,9,0,35,26
1681909552446,ECON 172B,A01,180672,Levkoff; Steven B.,32,0,35,3
1681909553468,ECON 178,A01,203342,Zhu; Ying,11,0,35,24
1681909554494,EDS 108GS,A00,202383,Wishard Guerra; Alison G.,20,0,20,0
1681909555521,EDS 111GS,A00,202347,Wishard Guerra; Alison G.,20,0,20,0
1681909556544,EDS 112,A01,202323,Staff,56,0,60,4
1681909557568,EDS 113,A00,202340,Staff,33,0,35,2
1681909558590,EDS 118,A00,201231,Staff,20,0,30,10
1681909559615,EDS 119,A00,204994,Staff,8,0,10,2
1681909560652,EDS 124BR,A00,202324,Eguchi; Emi,5,0,25,20
1681909561680,EDS 126,A01,203208,Jones; Makeba,26,0,30,4
1681909562708,EDS 135,A01,202333,Staff,18,0,20,2
1681909563734,EDS 180,A00,202311,Staff,47,0,50,3
1681909564763,ERC 190GS,A01,253747,Staff,28,0,28,0
1681909565789,ETHN 104,A00,180742,Staff,24,0,35,11
1681909566812,ETHN 118,A00,180745,Staff,28,0,35,7
1681909567836,ETHN 127,A00,180747,Staff,12,0,16,4
1681909568863,ETHN 137,A00,180880,Staff,12,0,12,0
1681909569888,ETHN 147,A00,180890,Staff,8,0,10,2
1681909570915,ETHN 154,A00,180891,Staff,7,0,8,1
1681909571939,ETHN 168,A00,180892,Staff,9,0,10,1
1681909572966,GLBH 20,A00,201051,Hannah; Seth Donal,0,1,0,1
1681909573989,GLBH 111,A01,209338,Burgos; Jose L.,0,0,0,0
1681909575014,GLBH 150,A00,258300,Staff,0,3,0,0
1681909576040,GLBH 181,A00,201207,Staff,15,0,40,25
1681909577064,HIEU 109,A00,180898,Staff,20,0,20,0
1681909578087,HIEU 111,A00,180899,Staff,1,0,20,19
1681909579114,HIEU 124,A00,180900,Staff,18,0,20,2
1681909580137,HILA 122,A00,180901,Staff,18,0,20,2
1681909581164,HILA 132,A00,180902,Vitz; Matthew,2,0,20,18
1681909582186,HILD 10,A01,180896,Staff,15,0,20,5
1681909583209,HILD 30GS,A00,180897,Edington; Claire Ellen,0,0,0,0
1681909584232,HISC 105,A00,180903,Staff,20,0,20,0
1681909585257,HISC 117,A00,180904,Staff,11,0,20,9
1681909586282,HIUS 108B,A00,181005,Staff,18,0,20,2
1681909587312,HIUS 113,A00,181093,Staff,4,0,20,16
1681909588337,HUM 3,A01,181190,Patterson; Patrick H.,40,0,50,10
1681909588337,HUM 3,B01,181195,Staff,47,0,50,3
1681909589360,HUM 3GS,A00,181196,Herbst; Matthew,0,0,0,0
1681909590385,HUM 4,A01,181227,West; Geoffrey Scott,34,0,50,16
1681909590385,HUM 4,B01,181282,Staff,43,0,50,7
1681909591408,HUM 4GS,A00,181377,Lyon; Antony J.,0,0,0,0
1681909592433,HUM 5,A01,181536,Zavodny; Tatiana Sophia,31,0,50,19
1681909592433,HUM 5,B01,181908,Staff,36,0,50,14
1681909593457,INTL 190,A00,181909,Segui; Alan S,0,0,0,6
1681909593457,INTL 190,B00,181961,Segui; Alan S,0,0,0,7
1681909594495,JAPN 20AR,A01,182113,Ross; Kayoko F,15,0,20,5
1681909595518,LATI 50,A01,202391,Martin-Cabrera; Luis,19,0,30,11
1681909595518,LATI 50,A02,202392,Martin-Cabrera; Luis,26,0,30,4
1681909596544,LATI 180,A00,202393,Kokinis; Troy Andreas,25,0,25,0
1681909597575,LIFR 1A,A00,182119,Staff,14,0,14,0
1681909598602,LIFR 1AX,A00,182324,Staff,14,0,14,0
1681909599626,LIFR 1B,A00,182259,Staff,14,0,14,0
1681909600650,LIFR 1BX,A00,182273,Staff,14,0,14,0
1681909601676,LIGN 8,A00,182330,Staff,137,0,150,13
1681909602699,LIGN 9GS,A00,182362,Staff,20,0,20,0
1681909603729,LIGN 119,A00,204992,Takahashi; Maho,12,0,15,3
1681909604755,LIGN 130,A01,182384,Staff,47,0,50,3
1681909605778,LIGN 149GS,A00,182390,Staff,20,0,20,0
1681909606802,LIGN 170,A00,182404,Staff,24,0,30,6
1681909607830,LISP 1D,A00,182281,Staff,7,0,14,7
1681909607830,LISP 1D,B00,182287,Staff,14,0,14,0
1681909607830,LISP 1D,C00,182295,Staff,11,0,14,3
1681909607830,LISP 1D,D00,182301,Staff,14,0,14,0
1681909608853,LISP 1DX,A00,182309,Staff,20,0,28,8
1681909608853,LISP 1DX,B00,182316,Staff,26,0,28,2
1681909609881,LTAF 120GS,A00,182412,Zhiri; Oumelbanine,20,0,20,0
1681909610906,LTCS 172GS,A00,182437,Bronstein; Phoebe Malan,20,0,20,0
1681909611932,LTEA 138,A00,182457,Staff,22,0,40,18
1681909612959,LTEN 114,A01,182490,Staff,23,0,25,2
1681909613982,LTEN 130GS,A00,182491,Lyon; Antony J.,20,0,20,0
1681909615007,LTEN 169,A00,182493,Cuong; Marisol,20,0,25,5
1681909616033,LTEN 178,A00,182501,Staff,14,0,15,1
1681909617059,LTEN 181,A00,182515,Staff,22,0,25,3
1681909618091,LTEN 185GS,A00,197655,Forbes; Camille,20,0,20,0
1681909619115,LTSP 100B,A00,202208,Bessett; Ryan Matthew,24,0,25,1
1681909620139,LTWL 100,A00,182516,Myerston Santana; Jacobo,23,0,30,7
1681909621236,LTWR 100GS,A00,182518,Forbes; Camille,20,0,20,0
1681909622259,LTWR 102,A00,182522,Staff,15,0,15,0
1681909622259,LTWR 102,B00,182525,Staff,14,0,15,1
1681909623283,LTWR 115,A00,182526,Staff,12,0,15,3
1681909624314,MAE 8,A01,182528,Pham; Hieu Tan,68,0,70,2
1681909625342,MAE 11,A00,182529,Bahadori; Mohammad Yousef,94,0,100,6
1681909626372,MAE 20,A00,182530,Evdokimenko; Ekaterina,68,0,70,2
1681909627396,MAE 30A,A00,182532,Staff,44,0,45,1
1681909628422,MAE 101A,A00,182533,Bahadori; Mohammad Yousef,97,0,100,3
1681909629449,MAE 101C,A00,182538,Staff,62,0,70,8
1681909630475,MAE 104,A00,182539,Staff,45,0,50,5
1681909631501,MAE 131A,A00,182540,Ghazinejad; Maziar,41,0,45,4
1681909632528,MAE 143A,A00,182548,Bewley; Thomas R,43,0,50,7
1681909633557,MAE 150,A00,182549,Staff,28,0,40,12
1681909634581,MAE 160,A00,182550,Evdokimenko; Ekaterina,43,0,60,17
1681909635605,MATH 3C,A01,182725,Staff,27,0,30,3
1681909636631,MATH 10A,A01,182729,Staff,25,0,30,5
1681909636631,MATH 10A,B01,182732,Staff,26,0,30,4
1681909637655,MATH 10B,A01,182737,Staff,21,0,30,9
1681909637655,MATH 10B,A02,182738,Staff,27,0,30,3
1681909637655,MATH 10B,B01,182744,Staff,27,0,30,3
1681909637655,MATH 10B,B02,182745,Staff,27,0,30,3
1681909638680,MATH 18,A01,182750,Anzaldo; Leesa B,28,0,30,2
1681909638680,MATH 18,A02,182751,Anzaldo; Leesa B,29,0,30,1
1681909638680,MATH 18,A03,182753,Anzaldo; Leesa B,28,0,30,2
1681909638680,MATH 18,A04,182757,Anzaldo; Leesa B,29,0,30,1
1681909638680,MATH 18,B01,182761,Anzaldo; Leesa B,27,0,30,3
1681909638680,MATH 18,B02,182764,Anzaldo; Leesa B,27,0,30,3
1681909638680,MATH 18,B03,182765,Anzaldo; Leesa B,30,0,30,0
1681909638680,MATH 18,B04,182766,Anzaldo; Leesa B,30,0,30,0
1681909639703,MATH 20A,A01,182771,Suk; Andrew Hoon,28,0,30,2
1681909640727,MATH 20B,A01,182775,Bach; Quang Tran,30,0,30,0
1681909640727,MATH 20B,A02,182777,Bach; Quang Tran,29,0,30,1
1681909640727,MATH 20B,B01,182780,Bach; Quang Tran,27,0,30,3
1681909640727,MATH 20B,B02,182782,Bach; Quang Tran,30,0,30,0
1681909641752,MATH 20C,A01,182787,Staff,25,0,30,5
1681909641752,MATH 20C,A02,182790,Staff,29,0,30,1
1681909641752,MATH 20C,B01,182792,Staff,25,0,30,5
1681909641752,MATH 20C,B02,182796,Staff,27,0,30,3
1681909642775,MATH 20D,A01,182799,Staff,29,0,30,1
1681909642775,MATH 20D,A02,182802,Staff,30,0,30,0
1681909642775,MATH 20D,A03,182803,Staff,30,0,30,0
1681909643811,MATH 20E,A01,182809,Verstraete; Jacques Allan,24,0,30,6
1681909643811,MATH 20E,A02,182811,Verstraete; Jacques Allan,28,0,30,2
1681909643811,MATH 20E,B01,182814,Verstraete; Jacques Allan,23,0,30,7
1681909643811,MATH 20E,B02,182815,Verstraete; Jacques Allan,30,0,30,0
1681909644839,MATH 103A,A01,182820,Staff,9,0,30,21
1681909644839,MATH 103A,A02,182821,Staff,27,0,30,3
1681909644839,MATH 103A,A03,182822,Staff,23,0,30,7
1681909644839,MATH 103A,B01,182825,Staff,23,0,30,7
1681909644839,MATH 103A,B02,182826,Staff,30,0,30,0
1681909644839,MATH 103A,B03,182830,Staff,30,0,30,0
1681909645867,MATH 109,A01,182836,Chow; Bennett,24,0,30,6
1681909645867,MATH 109,A02,182838,Chow; Bennett,29,0,30,1
1681909645867,MATH 109,A03,182894,Chow; Bennett,29,0,30,1
1681909645867,MATH 109,B01,182908,Chow; Bennett,28,0,30,2
1681909645867,MATH 109,B02,182909,Chow; Bennett,30,0,30,0
1681909645867,MATH 109,B03,182910,Chow; Bennett,27,0,30,3
1681909646891,MATH 142A,A01,182925,Staff,11,0,30,19
1681909646891,MATH 142A,A02,182935,Staff,25,0,30,5
1681909646891,MATH 142A,A03,182967,Staff,26,0,30,4
1681909646891,MATH 142A,B01,183125,Staff,24,0,30,6
1681909646891,MATH 142A,B02,183157,Staff,28,0,30,2
1681909646891,MATH 142A,B03,183158,Staff,29,0,30,1
1681909647914,MATH 183,A01,183160,Arias-Castro; Ery,23,0,30,7
1681909647914,MATH 183,A02,183161,Arias-Castro; Ery,29,0,30,1
1681909647914,MATH 183,B01,183163,Arias-Castro; Ery,28,0,30,2
1681909647914,MATH 183,B02,183164,Arias-Castro; Ery,28,0,30,2
1681909648947,MATH 193A,A01,183167,Staff,4,0,35,31
1681909648947,MATH 193A,A02,183168,Staff,28,0,35,7
1681909648947,MATH 193A,A03,183169,Staff,34,0,35,1
1681909648947,MATH 193A,A04,183170,Staff,28,0,35,7
1681909649974,MGT 4,A01,202395,Anderson; John Charles,75,0,80,5
1681909651001,MGT 5,A00,202396,Houskeeper; Robert,80,0,90,10
1681909652034,MGT 103,A00,202397,Eberhard; Craig A,55,0,90,35
1681909653060,MGT 131A,A00,202398,Houskeeper; Robert,85,0,90,5
1681909654087,MGT 135,A00,202399,Anderson; John Charles,82,0,90,8
1681909655113,MGT 162R,A00,202403,Gneezy; Uri,150,0,200,50
1681909656136,MGT 172,A00,202404,Hedges; Kathleen,50,0,90,40
1681909657162,MGT 181,A00,202405,Dunn; Louis Jean,84,0,90,6
1681909658190,MMW 14,A01,183200,Staff,16,0,28,12
1681909658190,MMW 14,A02,183201,Staff,26,0,28,2
1681909658190,MMW 14,A03,183202,Staff,24,0,28,4
1681909658190,MMW 14,A04,183203,Staff,25,0,28,3
1681909658190,MMW 14,A05,183204,Staff,26,0,28,2
1681909658190,MMW 14,A06,183205,Staff,27,0,28,1
1681909658190,MMW 14,B01,183207,Staff,26,0,28,2
1681909658190,MMW 14,B02,183208,Staff,28,0,28,0
1681909658190,MMW 14,B03,183209,Staff,28,0,28,0
1681909658190,MMW 14,B04,183210,Staff,28,0,28,0
1681909658190,MMW 14,B05,183211,Staff,28,0,28,0
1681909658190,MMW 14,B06,183212,Staff,28,0,28,0
1681909659216,MMW 14GS,A00,183213,Zhiri; Oumelbanine,28,0,28,0
1681909660248,MMW 15GS,B00,183215,Rahimi; Babak,28,0,28,0
1681909661273,MMW 121,A01,183217,Patterson; Patrick H.,14,0,28,14
1681909661273,MMW 121,A02,183218,Patterson; Patrick H.,25,0,28,3
1681909662296,MUS 1A,A01,182554,Staff,8,0,35,27
1681909663319,MUS 5,A01,182558,Staff,20,0,35,15
1681909664342,MUS 6,A01,182562,Staff,25,0,35,10
1681909665365,MUS 8GS,A00,182563,Borgo; David Garcia,25,0,25,0
1681909666390,MUS 13,A01,182567,Staff,24,0,25,1
1681909667417,MUS 15,A01,182570,Staff,32,0,35,3
1681909667417,MUS 15,B01,182575,Staff,10,0,35,25
1681909668440,MUS 80,A00,182578,Staff,23,0,25,2
1681909668440,MUS 80,B00,182581,Staff,20,0,25,5
1681909669467,MUS 113,A00,182582,Staff,25,0,25,0
1681909670490,MUS 114,A00,182583,Staff,4,0,25,21
1681909671514,MUS 150GS,A01,182588,Borgo; David Garcia,25,0,25,0
1681909672541,PHIL 1,A00,182590,Staff,35,0,40,5
1681909673567,PHIL 10,A01,182596,Grush; Rick Scott,31,0,35,4
1681909673567,PHIL 10,A02,182597,Grush; Rick Scott,34,0,35,1
1681909674595,PHIL 15,A01,182601,Staff,31,0,35,4
1681909674595,PHIL 15,A02,182602,Staff,33,0,35,2
1681909675622,PHIL 27,A01,182604,Staff,30,0,35,5
1681909675622,PHIL 27,A02,182607,Staff,35,0,35,0
1681909676647,PHIL 32,A01,182609,Staff,35,0,35,0
1681909676647,PHIL 32,A02,182612,Staff,35,0,35,0
1681909677670,PHIL 130,A00,182614,Staff,63,0,70,7
1681909678695,PHIL 136,A00,182616,Cohen; Jonathan David,66,0,70,4
1681909679729,PHIL 155,A00,182617,Vargas; Manuel Rogelio,60,0,70,10
1681909680825,PHIL 163,A01,182620,Staff,15,0,20,5
1681909680825,PHIL 163,A02,182624,Staff,10,0,20,10
1681909681849,PHIL 164,A00,182627,Staff,30,0,40,10
1681909682876,PHIL 173,A00,182628,Staff,36,0,40,4
1681909683901,PHYS 1A,A00,183221,Staff,54,0,60,6
1681909684925,PHYS 1AL,001,183222,Staff,25,0,30,5
1681909684925,PHYS 1AL,002,183223,Staff,28,0,30,2
1681909685950,PHYS 1B,A00,183231,Staff,44,0,60,16
1681909686978,PHYS 1BL,001,183232,Staff,20,0,30,10
1681909686978,PHYS 1BL,002,183233,Staff,29,0,30,1
1681909688002,PHYS 1C,A00,183240,Staff,30,0,60,30
1681909689026,PHYS 1CL,001,183241,Staff,13,0,30,17
1681909689026,PHYS 1CL,002,183242,Staff,22,0,30,8
1681909690049,PHYS 2AR,A01,183250,Staff,44,0,50,6
1681909691078,PHYS 2B,A01,183252,Staff,106,0,115,9
1681909692102,PHYS 2BL,A01,183254,Staff,21,0,24,3
1681909692102,PHYS 2BL,A02,183255,Staff,22,0,24,2
1681909693131,PHYS 2C,A01,183522,Staff,105,0,115,10
1681909694158,PHYS 4A,A01,183524,Staff,49,0,50,1
1681909695185,POLI 5,A00,183525,Staff,44,0,50,6
1681909696213,POLI 12,A00,183540,Staff,48,0,50,2
1681909697235,POLI 13R,A00,183541,Forman; Fonna,42,0,50,8
1681909698257,POLI 30,A00,183542,Mignozzetti; Umberto,47,0,50,3
1681909699283,POLI 100A,A00,183543,Staff,45,0,50,5
1681909700311,POLI 100E,A00,223598,Staff,32,0,35,3
1681909701338,POLI 103A,A00,183564,Kousser; Thad,38,0,50,12
1681909702364,POLI 104B,A00,201329,Staff,29,0,35,6
1681909703388,POLI 113BR,A00,183576,Hoston; Germaine,28,0,50,22
1681909704417,POLI 114BR,A00,183588,Staff,27,0,30,3
1681909705442,POLI 117R,A00,183595,Forman; Fonna,9,0,20,11
1681909706466,POLI 120H,A00,183596,Fisk; David Lee,13,0,20,7
1681909707493,POLI 130AA,A00,183597,Staff,14,0,20,6
1681909708516,POLI 134AA,A00,183598,Staff,19,0,20,1
1681909709539,POLI 135,A00,183599,Fisk; David Lee,20,0,25,5
1681909710563,POLI 142P,A00,183623,Staff,37,0,40,3
1681909711591,POLI 144D,A00,183624,Staff,22,0,25,3
1681909712615,POLI 151,A00,183625,Staff,15,0,20,5
1681909713637,POLI 162,A00,183626,Mignozzetti; Umberto,18,0,20,2
1681909714661,PSYC 1,A00,253748,Staff,86,0,90,4
1681909715685,PSYC 2,A00,183627,Moranton; Nirelia Melbina-,25,0,35,10
1681909716707,PSYC 3,A00,183628,Staff,43,0,45,2
1681909718759,PSYC 60,A01,183631,Lowe; Angela Beth,35,0,40,5
1681909719786,PSYC 70,A01,253757,Staff,37,0,45,8
1681909720811,PSYC 101,A00,183632,Heyman; Gail D.,48,0,60,12
1681909721839,PSYC 105,A00,183848,Lowe; Angela Beth,50,0,60,10
1681909722862,PSYC 106,A00,183849,Dobkins; Karen R.,45,0,60,15
1681909723885,PSYC 108,A00,253750,Staff,24,0,60,36
1681909724999,PSYC 114,A01,184275,Winkielman; Piotr,0,6,30,30
1681909726026,PSYC 122,A00,183856,Moranton; Nirelia Melbina-,0,10,30,30
1681909727052,PSYC 124,A00,183865,Chapman; Eddie Nathaniel,52,0,80,28
1681909728076,PSYC 137,A00,183880,Staff,19,0,25,6
1681909730127,PSYC 154,A00,183910,Lacefield; Katharine I,0,2,90,90
1681909732180,PSYC 162,A00,183946,Wixted; John T,61,0,90,29
1681909733205,PSYC 172,A00,183947,Gorman; Michael R.,14,0,30,16
1681909734231,PSYC 178,A00,183963,Glaser; Dale,20,0,40,20
1681909735257,PSYC 181GS,A00,183964,Anagnostaras; Stephan,10,0,10,0
1681909736281,PSYC 186GS,A01,257660,Staff,10,0,10,0
1681909737305,PSYC 193,B00,253749,Staff,23,0,25,2
1681909739356,PSYC 193L,A01,184122,Staff,33,0,35,2
1681909739356,PSYC 193L,C01,184167,Winkielman; Piotr,16,0,30,14
1681909740379,RELI 188GS,A00,182629,Rahimi; Babak,20,0,20,0
1681909741409,SE 101A,A00,182646,Staff,26,0,30,4
1681909742436,SE 101C,A00,182650,Staff,18,0,20,2
1681909743459,SE 110A,A00,182651,Staff,28,0,28,0
1681909744486,SE 130A,A00,182652,Staff,39,0,40,1
1681909745509,SIO 46GS,A00,182636,Cook; Geoffrey W,28,0,28,0
1681909746535,SIO 109R,A00,194459,Staff,5,0,20,15
1681909747561,SIO 121GS,A00,182639,Cook; Geoffrey W,28,0,28,0
1681909748584,SIO 132,A01,182642,Staff,32,0,40,8
1681909749610,SIO 139,A00,182644,Kacev; David,36,0,40,4
1681909750634,SOCI 2,A01,258404,Staff,34,0,36,2
1681909750634,SOCI 2,A02,258405,Staff,35,0,36,1
1681909751663,SOCI 60,A01,258408,Staff,29,0,30,1
1681909751663,SOCI 60,A02,258413,Staff,30,0,30,0
1681909752687,SOCI 100,A01,258415,Staff,29,0,30,1
1681909752687,SOCI 100,A02,258416,Staff,28,0,30,2
1681909758836,SOCI 127,A00,258421,Staff,22,0,30,8
1681909759863,SOCI 132,A00,258422,Staff,45,0,50,5
1681909760886,SOCI 133,A00,258423,Staff,26,0,30,4
1681909761909,SOCI 138GS,A00,258424,Staff,15,0,15,0
1681909762935,SOCI 145,A00,258425,Staff,25,0,30,5
1681909763962,SOCI 148,A00,258426,Staff,26,0,30,4
1681909764990,SOCI 153,A00,199217,Staff,29,0,30,1
1681909766015,SOCI 160,A00,258427,Staff,28,0,30,2
1681909767038,SOCI 160E,A00,258435,Staff,56,0,60,4
1681909768068,SOCI 189GS,A00,258436,Staff,15,0,15,0
1681909769091,SOCI 190GS,A00,258437,Staff,15,0,15,0
1681909770114,SYN 2,001,182658,Staff,9,0,16,7
1681909770114,SYN 2,002,201439,Staff,15,0,16,1
1681909770114,SYN 2,003,201443,Staff,16,0,16,0
1681909771137,SYN 100,A01,182657,Staff,17,0,20,3
1681909772161,TDAC 1,A00,184381,Salovey; Todd,16,0,20,4
1681909772161,TDAC 1,B00,184385,Harting; Carla Kelso,19,0,20,1
1681909772161,TDAC 1,C00,184394,Staff,19,0,20,1
1681909773185,TDAC 101,A00,184483,Harting; Carla Kelso,19,0,20,1
1681909774217,TDDE 111,A00,184496,Staff,14,0,15,1
1681909775250,TDDE 131,A00,184504,Staff,20,0,20,0
1681909775250,TDDE 131,B00,184505,Staff,17,0,18,1
1681909775250,TDDE 131,C00,184534,Staff,49,0,50,1
1681909775250,TDDE 131,D00,184564,Staff,15,0,15,0
1681909775250,TDDE 131,E00,204725,Staff,19,0,20,1
1681909776273,TDGE 1,A01,184414,Salovey; Todd,37,0,50,13
1681909777297,TDGE 5,A01,184419,Staff,23,0,24,1
1681909778323,TDGE 10,A00,184428,Fulton; Julia,31,0,50,19
1681909779345,TDGE 124,A00,184565,Fulton; Julia,7,0,50,43
1681909780369,TDGE 125,B00,184567,Meyer; Ursula,9,0,25,16
1681909781396,TDHT 101,A00,184568,Staff,21,0,25,4
1681909781396,TDHT 101,B00,184569,Staff,20,0,20,0
1681909782422,TDHT 114,A00,184570,Staff,49,0,50,1
1681909783449,TDMV 1,A00,184437,Arcidiacono; Kristin,23,0,30,7
1681909783449,TDMV 1,B00,184448,Caligagan; Maria T.,22,0,30,8
1681909784473,TDMV 2,A00,184449,Weinberg; Sadie,27,0,30,3
1681909784473,TDMV 2,B00,184453,Arcidiacono; Kristin,29,0,30,1
1681909785496,TDMV 110,A00,184571,Weinberg; Sadie,30,0,30,0
1681909786519,TDMV 142,A00,184572,Caligagan; Tony,27,0,30,3
1681909786519,TDMV 142,B00,184573,Caligagan; Maria T.,27,0,30,3
1681909787542,TDTR 20,A00,184482,Jun; Grace Shin Hae,25,0,25,0
1681909788566,USP 2,A01,184290,Hinds; Juli Beth,24,0,25,1
1681909789592,USP 3,A01,184295,Staff,20,0,25,5
1681909790615,USP 4,A00,184304,McTague; Sarah,15,0,25,10
1681909791639,USP 100,A00,184315,Staff,17,0,25,8
1681909792662,USP 105,A00,184326,Staff,21,0,25,4
1681909793685,USP 151,A00,184327,Staff,20,0,25,5
1681909794717,USP 170,A00,184380,Hinds; Juli Beth,14,0,25,11
1681909795741,VIS 21B,A01,182660,Staff,28,0,31,3
1681909795741,VIS 21B,A02,182662,Staff,30,0,31,1
1681909796764,VIS 103D,A00,182663,Staff,74,0,75,1
1681909797786,VIS 105D,A00,182667,Li; Huai,15,0,22,7
1681909798809,VIS 122GS,A00,182668,Herbst; Matthew,20,0,20,0
1681909799835,VIS 128C,A00,182673,Staff,70,0,75,5
1681909800857,VIS 130,A00,182675,Staff,20,0,22,2
1681909801890,VIS 160A,A00,182678,Stalbaum; Brett,4,0,10,6
1681909803941,WCWP 10B,A00,201679,Staff,15,0,15,0
1681909803941,WCWP 10B,B00,201695,Staff,15,0,15,0
1681909804974,WCWP 100,A00,201716,Staff,15,0,15,0
1681909804974,WCWP 100,B00,201717,Staff,11,0,15,4
1681909807074,ANSC 105GS,A00,258289,Staff,0,0,0,0
1681909808097,ANSC 125GS,A00,258295,Staff,0,0,0,0
1681909809120,ANSC 150,A00,258267,Staff,30,0,40,10
1681909810144,ANSC 190GS,A00,258280,Staff,0,0,0,0
1681909811172,ANTH 1,A00,258264,Staff,38,0,40,2
1681909812208,ANTH 2,A01,258259,Staff,72,0,76,4
1681909813231,ANTH 23,A01,258228,Staff,36,0,40,4
1681909814258,ANTH 101,A01,258236,Staff,39,0,40,1
1681909815288,ANTH 102,A00,258272,Staff,59,0,60,1
1681909816310,ANTH 105,A00,258244,Staff,31,0,35,4
1681909817338,BENG 130,A00,253975,Staff,38,0,40,2
1681909818363,BIBC 102,A01,191866,Flagg; Matthew Paul,19,0,32,13
1681909818363,BIBC 102,A02,191867,Flagg; Matthew Paul,22,0,32,10
1681909818363,BIBC 102,A03,191868,Flagg; Matthew Paul,30,0,32,2
1681909818363,BIBC 102,A04,191936,Flagg; Matthew Paul,26,0,32,6
1681909818363,BIBC 102,A05,191937,Flagg; Matthew Paul,11,0,32,21
1681909819387,BICD 100,A01,191939,Cooper; Andrew Michael,28,0,32,4
1681909819387,BICD 100,A02,191940,Cooper; Andrew Michael,32,0,32,0
1681909819387,BICD 100,A03,191941,Cooper; Andrew Michael,32,0,32,0
1681909819387,BICD 100,A04,191942,Cooper; Andrew Michael,32,0,32,0
1681909819387,BICD 100,A05,191943,Cooper; Andrew Michael,32,0,32,0
1681909820411,BIEB 126,A01,191945,Cleland; Elsa Eleanor,1,0,32,31
1681909820411,BIEB 126,A02,191946,Cleland; Elsa Eleanor,28,0,32,4
1681909820411,BIEB 126,A03,191947,Cleland; Elsa Eleanor,29,0,32,3
1681909820411,BIEB 126,A04,191948,Cleland; Elsa Eleanor,23,0,32,9
1681909820411,BIEB 126,A05,191996,Cleland; Elsa Eleanor,28,0,32,4
1681909821434,BIEB 136GS,A00,191997,Shurin; Jonathan & Holway; David A.,0,0,0,0
1681909822462,BIEB 137GS,A01,191999,Shurin; Jonathan & Holway; David A.,0,0,0,0
1681909823489,BILD 1,A01,205385,Staff,31,0,32,1
1681909823489,BILD 1,A02,205386,Staff,30,0,32,2
1681909823489,BILD 1,A03,205387,Staff,32,0,32,0
1681909823489,BILD 1,A04,205388,Staff,28,0,32,4
1681909824517,BILD 2,A01,191774,Staff,28,0,32,4
1681909824517,BILD 2,A02,191775,Staff,30,0,32,2
1681909824517,BILD 2,A03,191777,Staff,30,0,32,2
1681909824517,BILD 2,A04,191856,Staff,31,0,32,1
1681909824517,BILD 2,A05,191857,Staff,32,0,32,0
1681909824517,BILD 2,A06,191858,Staff,32,0,32,0
1681909824517,BILD 2,A07,191859,Staff,31,0,32,1
1681909825542,BILD 3,A01,205391,Staff,29,0,32,3
1681909825542,BILD 3,A02,205393,Staff,32,0,32,0
1681909825542,BILD 3,A03,205394,Staff,28,0,32,4
1681909825542,BILD 3,A04,205395,Staff,32,0,32,0
1681909826567,BILD 20,A01,191861,Staff,32,0,32,0
1681909826567,BILD 20,A02,191862,Staff,32,0,32,0
1681909827594,BILD 30,A01,191864,Staff,31,0,32,1
1681909828695,BIMM 100,A01,192019,Staff,0,0,32,32
1681909828695,BIMM 100,A02,192020,Staff,23,0,32,9
1681909828695,BIMM 100,A03,192035,Staff,22,0,32,10
1681909829726,BIMM 110,A01,192037,Tat; John,0,0,32,32
1681909829726,BIMM 110,A02,192038,Tat; John,10,0,32,22
1681909830749,BIMM 120,A01,192040,Pickett; Brooke Elizabeth,2,0,32,30
1681909830749,BIMM 120,A02,192041,Pickett; Brooke Elizabeth,16,0,32,16
1681909830749,BIMM 120,A03,192042,Pickett; Brooke Elizabeth,16,0,32,16
1681909831777,BIPN 100,A01,192044,Armour; Jon Christopher,26,0,32,6
1681909831777,BIPN 100,A02,192059,Armour; Jon Christopher,30,0,32,2
1681909831777,BIPN 100,A03,192064,Armour; Jon Christopher,31,0,32,1
1681909831777,BIPN 100,A04,192073,Armour; Jon Christopher,28,0,32,4
1681909832801,BIPN 148,A01,205411,Leutgeb; Jill K.,16,0,32,16
1681909832801,BIPN 148,A02,205412,Leutgeb; Jill K.,31,0,32,1
1681909832801,BIPN 148,A03,205413,Leutgeb; Jill K.,30,0,32,2
1681909832801,BIPN 148,A04,205414,Leutgeb; Jill K.,30,0,32,2
1681909833830,BIPN 160,A01,192115,Marino; Marc J,19,0,32,13
1681909833830,BIPN 160,A02,192148,Marino; Marc J,27,0,32,5
1681909833830,BIPN 160,A03,192158,Marino; Marc J,31,0,32,1
1681909833830,BIPN 160,A04,192190,Marino; Marc J,32,0,32,0
1681909833830,BIPN 160,A05,192287,Marino; Marc J,32,0,32,0
1681909833830,BIPN 160,A06,192288,Marino; Marc J,32,0,32,0
1681909834855,BIPN 194,A00,206038,Staff,28,0,32,4
1681909835883,BISP 194,A00,192289,Leutgeb; Stefan,13,0,32,19
1681909835883,BISP 194,B00,245332,Nieh; James Charles,27,0,32,5
1681909836906,CAT 124,A01,202247,Staff,15,0,15,0
1681909837930,CAT 125,A00,202248,Staff,19,0,20,1
1681909837930,CAT 125,B00,202253,Staff,20,0,20,0
1681909837930,CAT 125,C00,202257,Staff,19,0,20,1
1681909838962,CAT 125GS,A01,202273,Bronstein; Phoebe Malan,20,0,20,0
1681909839993,CAT 125R,A00,202284,Staff,17,0,20,3
1681909839993,CAT 125R,C00,202286,Staff,10,0,20,10
1681909839993,CAT 125R,D00,202291,Staff,18,0,20,2
1681909839993,CAT 125R,E00,202295,Staff,13,0,20,7
1681909839993,CAT 125R,F00,202302,Staff,12,0,20,8
1681909841021,CENG 100,A00,204724,Opatkiewicz; Justin Paul,25,0,25,0
1681909842046,CGS 2A,A01,180420,Staff,31,0,36,5
1681909843070,CGS 101,A00,180421,Staff,16,0,20,4
1681909844093,CGS 112,A00,180422,Staff,10,0,16,6
1681909845116,CGS 113,A00,180423,Staff,18,0,20,2
1681909846142,CGS 137,A00,180424,Staff,12,0,12,0
1681909847166,CGS 147,A00,180425,Staff,10,0,10,0
1681909848190,CHEM 6A,A01,179556,Staff,97,0,100,3
1681909848190,CHEM 6A,A02,179558,Staff,0,0,0,0
1681909849222,CHEM 6B,A01,179560,Staff,100,0,100,0
1681909850250,CHEM 6C,A01,179565,Jazzar; Rodolphe,95,0,100,5
1681909851275,CHEM 7L,A01,179586,Schurmeier; Kimberly,13,0,24,11
1681909851275,CHEM 7L,A02,179587,Schurmeier; Kimberly,23,0,24,1
1681909851275,CHEM 7L,A03,179590,Schurmeier; Kimberly,22,0,24,2
1681909851275,CHEM 7L,A04,179591,Schurmeier; Kimberly,22,0,24,2
1681909851275,CHEM 7L,B01,179598,Schurmeier; Kimberly,17,0,24,7
1681909851275,CHEM 7L,B02,179599,Schurmeier; Kimberly,24,0,24,0
1681909851275,CHEM 7L,B03,179606,Schurmeier; Kimberly,23,0,24,1
1681909851275,CHEM 7L,B04,179607,Schurmeier; Kimberly,23,0,24,1
1681909852300,CHEM 11,A01,179609,Stallings; Dontarie M,88,0,100,12
1681909853324,CHEM 40A,A01,179621,Staff,41,0,50,9
1681909853324,CHEM 40A,A02,179622,Staff,47,0,50,3
1681909854349,CHEM 40B,A01,179630,Weizman; Haim,48,0,50,2
1681909854349,CHEM 40B,A02,179631,Weizman; Haim,45,0,50,5
1681909855373,CHEM 41A,A01,179660,Klosterman; Jeremy K,93,0,100,7
1681909856398,CHEM 43A,A01,179683,Klosterman; Jeremy K,0,0,24,24
1681909856398,CHEM 43A,A02,179688,Klosterman; Jeremy K,14,0,24,10
1681909856398,CHEM 43A,A03,179689,Klosterman; Jeremy K,20,0,24,4
1681909856398,CHEM 43A,A04,179691,Klosterman; Jeremy K,18,0,24,6
1681909857421,CHEM 114A,A01,179693,Stallings; Dontarie M,77,0,100,23
1681909858445,CHEM 143B,A01,179698,Weizman; Haim,17,0,24,7
1681909858445,CHEM 143B,A02,179700,Weizman; Haim,24,0,24,0
1681909859474,CHIN 169A,A00,179701,Wang; Xiao,20,0,20,0
1681909860502,COGS 2,A01,179750,Boyle; Mary E. T.,17,0,30,13
1681909861526,COGS 9,A01,179759,Jones; Cameron Robert,43,0,50,7
1681909862549,COGS 14A,A01,179854,Staff,18,0,50,32
1681909863579,COGS 14B,A01,179856,Staff,54,0,60,6
1681909864602,COGS 17,A01,179874,Staff,71,0,75,4
1681909865625,COGS 18,A01,179884,Staff,63,0,80,17
1681909866649,COGS 100,A01,179886,Staff,40,0,60,20
1681909867677,COGS 101B,A01,179892,Staff,1,0,30,29
1681909868700,COGS 101C,A01,179894,Staff,28,0,30,2
1681909869727,COGS 107A,A01,179896,Boyle; Mary E. T.,31,0,40,9
1681909870754,COGS 108,A01,179898,Simpkins; Charles Alexander,0,17,60,60
1681909871780,COGS 109,A01,179900,Staff,34,0,40,6
1681909872808,COGS 118A,A01,179946,Staff,9,0,40,31
1681909873833,COGS 153,A00,179978,Staff,1,0,30,29
1681909874859,COGS 156,A01,179981,Staff,27,0,30,3
1681909876910,COGS 172,A01,179987,Staff,13,0,30,17
1681909878960,COGS 186,A01,179991,Staff,13,0,30,17
1681909879983,COMM 10,A01,180001,Staff,15,0,25,10
1681909879983,COMM 10,A02,180004,Staff,20,0,25,5
1681909881011,COMM 100A,A01,180016,Staff,18,0,25,7
1681909881011,COMM 100A,A02,180020,Staff,24,0,25,1
1681909882035,COMM 101T,A00,180029,Halm; Gavin Patrick,23,0,35,12
1681909883062,COMM 106V,A00,180043,Staff,34,0,35,1
1681909884086,COMM 109P,A00,180044,Staff,31,0,35,4
1681909885109,COMM 113T,A00,180045,Havis; Allan,37,0,45,8
1681909886134,COMM 132,A00,180046,McKenna; Denise,23,0,30,7
1681909887161,COMM 143,A00,180047,Staff,19,0,30,11
1681909888189,COMM 190,A00,180048,Conner; Thomas Hartnell,20,0,23,3
1681909889215,CSE 8A,A50,180053,Cao; Yingjun,25,0,50,25
1681909889215,CSE 8A,B50,180180,Staff,50,0,50,0
1681909890240,CSE 11,A01,180190,Cao; Yingjun,31,0,50,19
1681909891264,CSE 20,A01,180192,Briones; Jor-el Thomas Caparas,23,0,30,7
1681909892288,CSE 21,A01,194538,Briones; Jor-el Thomas Caparas,50,0,60,10
1681909893314,CSE 30,A01,180324,Eldon; John,79,0,100,21
1681909894337,CSE 101,A01,201353,Staff,0,20,40,40
1681909895364,CSE 134B,A01,180326,Powell; Thomas Allan,74,0,100,26
1681909896389,CSE 140,A01,180328,Staff,46,0,75,29
1681909897415,CSE 140L,A01,180344,Eldon; John,69,0,100,31
1681909898439,CSE 150A,A01,180411,Staff,0,7,50,50
1681909899463,CSE 151A,A01,180414,Staff,0,6,50,50
1681909900496,CSE 175,A01,222521,Kumar; Rakesh,50,0,50,0
1681909901522,CSE 190,A00,201419,Staff,45,0,49,4
1681909902546,CSS 1,A01,194536,Staff,38,0,50,12
1681909903573,DSC 30,A01,202385,Staff,48,0,50,2
1681909904597,DSC 40A,A01,202387,Albuyeh; Rod,50,0,50,0
1681909905639,DSC 190,A01,202389,Silberman; Jack,21,0,21,0
1681909906666,DSGN 100,A01,179993,Staff,16,0,30,14
1681909907694,ECE 65,A50,180708,Staff,10,0,20,10
1681909907694,ECE 65,A51,180739,Staff,19,0,20,1
1681909908717,ECON 1,A01,180427,Famulari; Melissa,67,0,70,3
1681909909741,ECON 2,A01,180450,Levkoff; Steven B.,64,0,70,6
1681909910772,ECON 4,A01,203351,Anderson; John Charles,7,0,10,3
1681909911801,ECON 100A,A01,180472,Famulari; Melissa,65,0,70,5
1681909912833,ECON 120A,A01,180549,Staff,64,0,70,6
1681909913857,ECON 120B,A01,180655,Ma; Xinwei,46,0,70,24
1681909914881,ECON 129,A00,203333,Eckert; Fabian Paul,15,0,35,20
1681909915934,ECON 131,A00,180656,Staff,9,0,35,26
1681909916963,ECON 172B,A01,180672,Levkoff; Steven B.,32,0,35,3
1681909917992,ECON 178,A01,203342,Zhu; Ying,11,0,35,24
1681909919017,EDS 108GS,A00,202383,Wishard Guerra; Alison G.,20,0,20,0
1681909920043,EDS 111GS,A00,202347,Wishard Guerra; Alison G.,20,0,20,0
1681909921072,EDS 112,A01,202323,Staff,56,0,60,4
1681909922095,EDS 113,A00,202340,Staff,33,0,35,2
1681909923123,EDS 118,A00,201231,Staff,20,0,30,10
1681909924151,EDS 119,A00,204994,Staff,8,0,10,2
1681909925178,EDS 124BR,A00,202324,Eguchi; Emi,5,0,25,20
1681909926209,EDS 126,A01,203208,Jones; Makeba,26,0,30,4
1681909927241,EDS 135,A01,202333,Staff,18,0,20,2
1681909928265,EDS 180,A00,202311,Staff,47,0,50,3
1681909929291,ERC 190GS,A01,253747,Staff,28,0,28,0
1681909930322,ETHN 104,A00,180742,Staff,24,0,35,11
1681909931347,ETHN 118,A00,180745,Staff,28,0,35,7
1681909932447,ETHN 127,A00,180747,Staff,12,0,16,4
1681909933471,ETHN 137,A00,180880,Staff,12,0,12,0
1681909934507,ETHN 147,A00,180890,Staff,8,0,10,2
1681909935530,ETHN 154,A00,180891,Staff,7,0,8,1
1681909936557,ETHN 168,A00,180892,Staff,9,0,10,1
1681909937580,GLBH 20,A00,201051,Hannah; Seth Donal,0,1,0,1
1681909938611,GLBH 111,A01,209338,Burgos; Jose L.,0,0,0,0
1681909939638,GLBH 150,A00,258300,Staff,0,3,0,0
1681909940661,GLBH 181,A00,201207,Staff,15,0,40,25
1681909941686,HIEU 109,A00,180898,Staff,20,0,20,0
1681909942715,HIEU 111,A00,180899,Staff,1,0,20,19
1681909943741,HIEU 124,A00,180900,Staff,18,0,20,2
1681909944767,HILA 122,A00,180901,Staff,18,0,20,2
1681909945794,HILA 132,A00,180902,Vitz; Matthew,2,0,20,18
1681909946820,HILD 10,A01,180896,Staff,15,0,20,5
1681909947845,HILD 30GS,A00,180897,Edington; Claire Ellen,0,0,0,0
1681909948872,HISC 105,A00,180903,Staff,20,0,20,0
1681909949896,HISC 117,A00,180904,Staff,11,0,20,9
1681909950920,HIUS 108B,A00,181005,Staff,18,0,20,2
1681909951943,HIUS 113,A00,181093,Staff,4,0,20,16
1681909952969,HUM 3,A01,181190,Patterson; Patrick H.,40,0,50,10
1681909952969,HUM 3,B01,181195,Staff,47,0,50,3
1681909953993,HUM 3GS,A00,181196,Herbst; Matthew,0,0,0,0
1681909955017,HUM 4,A01,181227,West; Geoffrey Scott,34,0,50,16
1681909955017,HUM 4,B01,181282,Staff,43,0,50,7
1681909956041,HUM 4GS,A00,181377,Lyon; Antony J.,0,0,0,0
1681909957066,HUM 5,A01,181536,Zavodny; Tatiana Sophia,31,0,50,19
1681909957066,HUM 5,B01,181908,Staff,36,0,50,14
1681909958091,INTL 190,A00,181909,Segui; Alan S,0,0,0,6
1681909958091,INTL 190,B00,181961,Segui; Alan S,0,0,0,7
1681909959116,JAPN 20AR,A01,182113,Ross; Kayoko F,15,0,20,5
1681909960145,LATI 50,A01,202391,Martin-Cabrera; Luis,19,0,30,11
1681909960145,LATI 50,A02,202392,Martin-Cabrera; Luis,26,0,30,4
1681909961172,LATI 180,A00,202393,Kokinis; Troy Andreas,25,0,25,0
1681909962195,LIFR 1A,A00,182119,Staff,14,0,14,0
1681909963219,LIFR 1AX,A00,182324,Staff,14,0,14,0
1681909964249,LIFR 1B,A00,182259,Staff,14,0,14,0
1681909965272,LIFR 1BX,A00,182273,Staff,14,0,14,0
1681909966299,LIGN 8,A00,182330,Staff,137,0,150,13
1681909967322,LIGN 9GS,A00,182362,Staff,20,0,20,0
1681909968351,LIGN 119,A00,204992,Takahashi; Maho,12,0,15,3
1681909969389,LIGN 130,A01,182384,Staff,47,0,50,3
1681909970416,LIGN 149GS,A00,182390,Staff,20,0,20,0
1681909971440,LIGN 170,A00,182404,Staff,24,0,30,6
1681909972470,LISP 1D,A00,182281,Staff,7,0,14,7
1681909972470,LISP 1D,B00,182287,Staff,14,0,14,0
1681909972470,LISP 1D,C00,182295,Staff,11,0,14,3
1681909972470,LISP 1D,D00,182301,Staff,14,0,14,0
1681909973494,LISP 1DX,A00,182309,Staff,20,0,28,8
1681909973494,LISP 1DX,B00,182316,Staff,26,0,28,2
1681909974517,LTAF 120GS,A00,182412,Zhiri; Oumelbanine,20,0,20,0
1681909975540,LTCS 172GS,A00,182437,Bronstein; Phoebe Malan,20,0,20,0
1681909976562,LTEA 138,A00,182457,Staff,22,0,40,18
1681909977590,LTEN 114,A01,182490,Staff,23,0,25,2
1681909978613,LTEN 130GS,A00,182491,Lyon; Antony J.,20,0,20,0
1681909979636,LTEN 169,A00,182493,Cuong; Marisol,20,0,25,5
1681909980662,LTEN 178,A00,182501,Staff,14,0,15,1
1681909981689,LTEN 181,A00,182515,Staff,22,0,25,3
1681909982713,LTEN 185GS,A00,197655,Forbes; Camille,20,0,20,0
1681909983741,LTSP 100B,A00,202208,Bessett; Ryan Matthew,24,0,25,1
1681909984768,LTWL 100,A00,182516,Myerston Santana; Jacobo,23,0,30,7
1681909985793,LTWR 100GS,A00,182518,Forbes; Camille,20,0,20,0
1681909986818,LTWR 102,A00,182522,Staff,15,0,15,0
1681909986818,LTWR 102,B00,182525,Staff,14,0,15,1
1681909987842,LTWR 115,A00,182526,Staff,12,0,15,3
1681909988872,MAE 8,A01,182528,Pham; Hieu Tan,68,0,70,2
1681909989897,MAE 11,A00,182529,Bahadori; Mohammad Yousef,94,0,100,6
1681909990923,MAE 20,A00,182530,Evdokimenko; Ekaterina,68,0,70,2
1681909991949,MAE 30A,A00,182532,Staff,44,0,45,1
1681909992973,MAE 101A,A00,182533,Bahadori; Mohammad Yousef,97,0,100,3
1681909994002,MAE 101C,A00,182538,Staff,62,0,70,8
1681909995025,MAE 104,A00,182539,Staff,45,0,50,5
1681909996049,MAE 131A,A00,182540,Ghazinejad; Maziar,41,0,45,4
1681909997073,MAE 143A,A00,182548,Bewley; Thomas R,43,0,50,7
1681909998100,MAE 150,A00,182549,Staff,28,0,40,12
1681909999124,MAE 160,A00,182550,Evdokimenko; Ekaterina,43,0,60,17
1681910000159,MATH 3C,A01,182725,Staff,27,0,30,3
1681910001184,MATH 10A,A01,182729,Staff,25,0,30,5
1681910001184,MATH 10A,B01,182732,Staff,26,0,30,4
1681910002213,MATH 10B,A01,182737,Staff,21,0,30,9
1681910002213,MATH 10B,A02,182738,Staff,27,0,30,3
1681910002213,MATH 10B,B01,182744,Staff,27,0,30,3
1681910002213,MATH 10B,B02,182745,Staff,27,0,30,3
1681910003243,MATH 18,A01,182750,Anzaldo; Leesa B,28,0,30,2
1681910003243,MATH 18,A02,182751,Anzaldo; Leesa B,29,0,30,1
1681910003243,MATH 18,A03,182753,Anzaldo; Leesa B,28,0,30,2
1681910003243,MATH 18,A04,182757,Anzaldo; Leesa B,29,0,30,1
1681910003243,MATH 18,B01,182761,Anzaldo; Leesa B,27,0,30,3
1681910003243,MATH 18,B02,182764,Anzaldo; Leesa B,27,0,30,3
1681910003243,MATH 18,B03,182765,Anzaldo; Leesa B,30,0,30,0
1681910003243,MATH 18,B04,182766,Anzaldo; Leesa B,30,0,30,0
1681910004273,MATH 20A,A01,182771,Suk; Andrew Hoon,28,0,30,2
1681910005301,MATH 20B,A01,182775,Bach; Quang Tran,30,0,30,0
1681910005301,MATH 20B,A02,182777,Bach; Quang Tran,29,0,30,1
1681910005301,MATH 20B,B01,182780,Bach; Quang Tran,27,0,30,3
1681910005301,MATH 20B,B02,182782,Bach; Quang Tran,30,0,30,0
1681910006340,MATH 20C,A01,182787,Staff,25,0,30,5
1681910006340,MATH 20C,A02,182790,Staff,29,0,30,1
1681910006340,MATH 20C,B01,182792,Staff,25,0,30,5
1681910006340,MATH 20C,B02,182796,Staff,27,0,30,3
1681910007364,MATH 20D,A01,182799,Staff,29,0,30,1
1681910007364,MATH 20D,A02,182802,Staff,30,0,30,0
1681910007364,MATH 20D,A03,182803,Staff,30,0,30,0
1681910008393,MATH 20E,A01,182809,Verstraete; Jacques Allan,24,0,30,6
1681910008393,MATH 20E,A02,182811,Verstraete; Jacques Allan,28,0,30,2
1681910008393,MATH 20E,B01,182814,Verstraete; Jacques Allan,23,0,30,7
1681910008393,MATH 20E,B02,182815,Verstraete; Jacques Allan,30,0,30,0
1681910009416,MATH 103A,A01,182820,Staff,9,0,30,21
1681910009416,MATH 103A,A02,182821,Staff,27,0,30,3
1681910009416,MATH 103A,A03,182822,Staff,23,0,30,7
1681910009416,MATH 103A,B01,182825,Staff,23,0,30,7
1681910009416,MATH 103A,B02,182826,Staff,30,0,30,0
1681910009416,MATH 103A,B03,182830,Staff,30,0,30,0
1681910010442,MATH 109,A01,182836,Chow; Bennett,24,0,30,6
1681910010442,MATH 109,A02,182838,Chow; Bennett,29,0,30,1
1681910010442,MATH 109,A03,182894,Chow; Bennett,29,0,30,1
1681910010442,MATH 109,B01,182908,Chow; Bennett,28,0,30,2
1681910010442,MATH 109,B02,182909,Chow; Bennett,30,0,30,0
1681910010442,MATH 109,B03,182910,Chow; Bennett,27,0,30,3
1681910011472,MATH 142A,A01,182925,Staff,11,0,30,19
1681910011472,MATH 142A,A02,182935,Staff,25,0,30,5
1681910011472,MATH 142A,A03,182967,Staff,26,0,30,4
1681910011472,MATH 142A,B01,183125,Staff,24,0,30,6
1681910011472,MATH 142A,B02,183157,Staff,28,0,30,2
1681910011472,MATH 142A,B03,183158,Staff,29,0,30,1
1681910012498,MATH 183,A01,183160,Arias-Castro; Ery,23,0,30,7
1681910012498,MATH 183,A02,183161,Arias-Castro; Ery,29,0,30,1
1681910012498,MATH 183,B01,183163,Arias-Castro; Ery,28,0,30,2
1681910012498,MATH 183,B02,183164,Arias-Castro; Ery,28,0,30,2
1681910013521,MATH 193A,A01,183167,Staff,4,0,35,31
1681910013521,MATH 193A,A02,183168,Staff,28,0,35,7
1681910013521,MATH 193A,A03,183169,Staff,34,0,35,1
1681910013521,MATH 193A,A04,183170,Staff,28,0,35,7
1681910014544,MGT 4,A01,202395,Anderson; John Charles,75,0,80,5
1681910015571,MGT 5,A00,202396,Houskeeper; Robert,80,0,90,10
1681910016594,MGT 103,A00,202397,Eberhard; Craig A,55,0,90,35
1681910017618,MGT 131A,A00,202398,Houskeeper; Robert,85,0,90,5
1681910018645,MGT 135,A00,202399,Anderson; John Charles,82,0,90,8
1681910019668,MGT 162R,A00,202403,Gneezy; Uri,150,0,200,50
1681910020701,MGT 172,A00,202404,Hedges; Kathleen,50,0,90,40
1681910021728,MGT 181,A00,202405,Dunn; Louis Jean,84,0,90,6
1681910022756,MMW 14,A01,183200,Staff,16,0,28,12
1681910022756,MMW 14,A02,183201,Staff,26,0,28,2
1681910022756,MMW 14,A03,183202,Staff,24,0,28,4
1681910022756,MMW 14,A04,183203,Staff,25,0,28,3
1681910022756,MMW 14,A05,183204,Staff,26,0,28,2
1681910022756,MMW 14,A06,183205,Staff,27,0,28,1
1681910022756,MMW 14,B01,183207,Staff,26,0,28,2
1681910022756,MMW 14,B02,183208,Staff,28,0,28,0
1681910022756,MMW 14,B03,183209,Staff,28,0,28,0
1681910022756,MMW 14,B04,183210,Staff,28,0,28,0
1681910022756,MMW 14,B05,183211,Staff,28,0,28,0
1681910022756,MMW 14,B06,183212,Staff,28,0,28,0
1681910023779,MMW 14GS,A00,183213,Zhiri; Oumelbanine,28,0,28,0
1681910024802,MMW 15GS,B00,183215,Rahimi; Babak,28,0,28,0
1681910025825,MMW 121,A01,183217,Patterson; Patrick H.,14,0,28,14
1681910025825,MMW 121,A02,183218,Patterson; Patrick H.,25,0,28,3
1681910026848,MUS 1A,A01,182554,Staff,8,0,35,27
1681910027877,MUS 5,A01,182558,Staff,20,0,35,15
1681910028899,MUS 6,A01,182562,Staff,25,0,35,10
1681910029924,MUS 8GS,A00,182563,Borgo; David Garcia,25,0,25,0
1681910030953,MUS 13,A01,182567,Staff,24,0,25,1
1681910031978,MUS 15,A01,182570,Staff,32,0,35,3
1681910031978,MUS 15,B01,182575,Staff,10,0,35,25
1681910033002,MUS 80,A00,182578,Staff,23,0,25,2
1681910033002,MUS 80,B00,182581,Staff,20,0,25,5
1681910034033,MUS 113,A00,182582,Staff,25,0,25,0
1681910035057,MUS 114,A00,182583,Staff,4,0,25,21
1681910036157,MUS 150GS,A01,182588,Borgo; David Garcia,25,0,25,0
1681910037194,PHIL 1,A00,182590,Staff,35,0,40,5
1681910038220,PHIL 10,A01,182596,Grush; Rick Scott,31,0,35,4
1681910038220,PHIL 10,A02,182597,Grush; Rick Scott,34,0,35,1
1681910039247,PHIL 15,A01,182601,Staff,31,0,35,4
1681910039247,PHIL 15,A02,182602,Staff,33,0,35,2
1681910040271,PHIL 27,A01,182604,Staff,30,0,35,5
1681910040271,PHIL 27,A02,182607,Staff,35,0,35,0
1681910041300,PHIL 32,A01,182609,Staff,35,0,35,0
1681910041300,PHIL 32,A02,182612,Staff,35,0,35,0
1681910042332,PHIL 130,A00,182614,Staff,63,0,70,7
1681910043357,PHIL 136,A00,182616,Cohen; Jonathan David,66,0,70,4
1681910044385,PHIL 155,A00,182617,Vargas; Manuel Rogelio,60,0,70,10
1681910045418,PHIL 163,A01,182620,Staff,15,0,20,5
1681910045418,PHIL 163,A02,182624,Staff,10,0,20,10
1681910046454,PHIL 164,A00,182627,Staff,30,0,40,10
1681910047477,PHIL 173,A00,182628,Staff,36,0,40,4
1681910048501,PHYS 1A,A00,183221,Staff,54,0,60,6
1681910049530,PHYS 1AL,001,183222,Staff,25,0,30,5
1681910049530,PHYS 1AL,002,183223,Staff,28,0,30,2
1681910050557,PHYS 1B,A00,183231,Staff,44,0,60,16
1681910051584,PHYS 1BL,001,183232,Staff,20,0,30,10
1681910051584,PHYS 1BL,002,183233,Staff,29,0,30,1
1681910052611,PHYS 1C,A00,183240,Staff,30,0,60,30
1681910053640,PHYS 1CL,001,183241,Staff,13,0,30,17
1681910053640,PHYS 1CL,002,183242,Staff,22,0,30,8
1681910054662,PHYS 2AR,A01,183250,Staff,44,0,50,6
1681910055688,PHYS 2B,A01,183252,Staff,106,0,115,9
1681910056717,PHYS 2BL,A01,183254,Staff,21,0,24,3
1681910056717,PHYS 2BL,A02,183255,Staff,22,0,24,2
1681910057754,PHYS 2C,A01,183522,Staff,105,0,115,10
1681910058785,PHYS 4A,A01,183524,Staff,49,0,50,1
1681910059811,POLI 5,A00,183525,Staff,44,0,50,6
1681910060834,POLI 12,A00,183540,Staff,48,0,50,2
1681910061866,POLI 13R,A00,183541,Forman; Fonna,42,0,50,8
1681910062889,POLI 30,A00,183542,Mignozzetti; Umberto,47,0,50,3
1681910063914,POLI 100A,A00,183543,Staff,45,0,50,5
1681910064941,POLI 100E,A00,223598,Staff,32,0,35,3
1681910065968,POLI 103A,A00,183564,Kousser; Thad,38,0,50,12
1681910066991,POLI 104B,A00,201329,Staff,29,0,35,6
1681910068018,POLI 113BR,A00,183576,Hoston; Germaine,28,0,50,22
1681910069044,POLI 114BR,A00,183588,Staff,27,0,30,3
1681910070074,POLI 117R,A00,183595,Forman; Fonna,9,0,20,11
1681910071098,POLI 120H,A00,183596,Fisk; David Lee,13,0,20,7
1681910072125,POLI 130AA,A00,183597,Staff,14,0,20,6
1681910073148,POLI 134AA,A00,183598,Staff,19,0,20,1
1681910074171,POLI 135,A00,183599,Fisk; David Lee,20,0,25,5
1681910075194,POLI 142P,A00,183623,Staff,37,0,40,3
1681910076223,POLI 144D,A00,183624,Staff,22,0,25,3
1681910077250,POLI 151,A00,183625,Staff,15,0,20,5
1681910078277,POLI 162,A00,183626,Mignozzetti; Umberto,18,0,20,2
1681910079299,PSYC 1,A00,253748,Staff,86,0,90,4
1681910080330,PSYC 2,A00,183627,Moranton; Nirelia Melbina-,25,0,35,10
1681910081354,PSYC 3,A00,183628,Staff,43,0,45,2
1681910083402,PSYC 60,A01,183631,Lowe; Angela Beth,35,0,40,5
1681910084429,PSYC 70,A01,253757,Staff,37,0,45,8
1681910085458,PSYC 101,A00,183632,Heyman; Gail D.,48,0,60,12
1681910086484,PSYC 105,A00,183848,Lowe; Angela Beth,50,0,60,10
1681910087507,PSYC 106,A00,183849,Dobkins; Karen R.,45,0,60,15
1681910088531,PSYC 108,A00,253750,Staff,24,0,60,36
1681910089555,PSYC 114,A01,184275,Winkielman; Piotr,0,6,30,30
1681910090578,PSYC 122,A00,183856,Moranton; Nirelia Melbina-,0,10,30,30
1681910091600,PSYC 124,A00,183865,Chapman; Eddie Nathaniel,52,0,80,28
1681910092624,PSYC 137,A00,183880,Staff,19,0,25,6
1681910094672,PSYC 154,A00,183910,Lacefield; Katharine I,0,2,90,90
1681910096719,PSYC 162,A00,183946,Wixted; John T,61,0,90,29
1681910097751,PSYC 172,A00,183947,Gorman; Michael R.,14,0,30,16
1681910098777,PSYC 178,A00,183963,Glaser; Dale,20,0,40,20
1681910099799,PSYC 181GS,A00,183964,Anagnostaras; Stephan,10,0,10,0
1681910100823,PSYC 186GS,A01,257660,Staff,10,0,10,0
1681910101849,PSYC 193,B00,253749,Staff,23,0,25,2
1681910103899,PSYC 193L,A01,184122,Staff,33,0,35,2
1681910103899,PSYC 193L,C01,184167,Winkielman; Piotr,16,0,30,14
1681910104924,RELI 188GS,A00,182629,Rahimi; Babak,20,0,20,0
1681910105950,SE 101A,A00,182646,Staff,26,0,30,4
1681910106976,SE 101C,A00,182650,Staff,18,0,20,2
1681910108000,SE 110A,A00,182651,Staff,28,0,28,0
1681910109024,SE 130A,A00,182652,Staff,39,0,40,1
1681910110052,SIO 46GS,A00,182636,Cook; Geoffrey W,28,0,28,0
1681910111078,SIO 109R,A00,194459,Staff,5,0,20,15
1681910112107,SIO 121GS,A00,182639,Cook; Geoffrey W,28,0,28,0
1681910113134,SIO 132,A01,182642,Staff,32,0,40,8
1681910114158,SIO 139,A00,182644,Kacev; David,36,0,40,4
1681910115183,SOCI 2,A01,258404,Staff,34,0,36,2
1681910115183,SOCI 2,A02,258405,Staff,35,0,36,1
1681910116206,SOCI 60,A01,258408,Staff,29,0,30,1
1681910116206,SOCI 60,A02,258413,Staff,30,0,30,0
1681910117237,SOCI 100,A01,258415,Staff,29,0,30,1
1681910117237,SOCI 100,A02,258416,Staff,28,0,30,2
1681910123389,SOCI 127,A00,258421,Staff,22,0,30,8
1681910124417,SOCI 132,A00,258422,Staff,45,0,50,5
1681910125440,SOCI 133,A00,258423,Staff,26,0,30,4
1681910126463,SOCI 138GS,A00,258424,Staff,15,0,15,0
1681910127485,SOCI 145,A00,258425,Staff,25,0,30,5
1681910128516,SOCI 148,A00,258426,Staff,26,0,30,4
1681910129539,SOCI 153,A00,199217,Staff,29,0,30,1
1681910130562,SOCI 160,A00,258427,Staff,28,0,30,2
1681910131585,SOCI 160E,A00,258435,Staff,56,0,60,4
1681910132616,SOCI 189GS,A00,258436,Staff,15,0,15,0
1681910133644,SOCI 190GS,A00,258437,Staff,15,0,15,0
1681910134672,SYN 2,001,182658,Staff,9,0,16,7
1681910134672,SYN 2,002,201439,Staff,15,0,16,1
1681910134672,SYN 2,003,201443,Staff,16,0,16,0
1681910135696,SYN 100,A01,182657,Staff,17,0,20,3
1681910136721,TDAC 1,A00,184381,Salovey; Todd,16,0,20,4
1681910136721,TDAC 1,B00,184385,Harting; Carla Kelso,19,0,20,1
1681910136721,TDAC 1,C00,184394,Staff,19,0,20,1
1681910137744,TDAC 101,A00,184483,Harting; Carla Kelso,19,0,20,1
1681910138768,TDDE 111,A00,184496,Staff,14,0,15,1
1681910139865,TDDE 131,A00,184504,Staff,20,0,20,0
1681910139865,TDDE 131,B00,184505,Staff,17,0,18,1
1681910139865,TDDE 131,C00,184534,Staff,49,0,50,1
1681910139865,TDDE 131,D00,184564,Staff,15,0,15,0
1681910139865,TDDE 131,E00,204725,Staff,19,0,20,1
1681910140890,TDGE 1,A01,184414,Salovey; Todd,37,0,50,13
1681910141915,TDGE 5,A01,184419,Staff,23,0,24,1
1681910142949,TDGE 10,A00,184428,Fulton; Julia,31,0,50,19
1681910143976,TDGE 124,A00,184565,Fulton; Julia,7,0,50,43
1681910144999,TDGE 125,B00,184567,Meyer; Ursula,9,0,25,16
1681910146026,TDHT 101,A00,184568,Staff,21,0,25,4
1681910146026,TDHT 101,B00,184569,Staff,20,0,20,0
1681910147053,TDHT 114,A00,184570,Staff,49,0,50,1
1681910148087,TDMV 1,A00,184437,Arcidiacono; Kristin,23,0,30,7
1681910148087,TDMV 1,B00,184448,Caligagan; Maria T.,22,0,30,8
1681910149118,TDMV 2,A00,184449,Weinberg; Sadie,27,0,30,3
1681910149118,TDMV 2,B00,184453,Arcidiacono; Kristin,29,0,30,1
1681910150143,TDMV 110,A00,184571,Weinberg; Sadie,30,0,30,0
1681910151169,TDMV 142,A00,184572,Caligagan; Tony,27,0,30,3
1681910151169,TDMV 142,B00,184573,Caligagan; Maria T.,27,0,30,3
1681910152201,TDTR 20,A00,184482,Jun; Grace Shin Hae,25,0,25,0
1681910153236,USP 2,A01,184290,Hinds; Juli Beth,24,0,25,1
1681910154258,USP 3,A01,184295,Staff,20,0,25,5
1681910155282,USP 4,A00,184304,McTague; Sarah,15,0,25,10
1681910156309,USP 100,A00,184315,Staff,17,0,25,8
1681910157336,USP 105,A00,184326,Staff,21,0,25,4
1681910158363,USP 151,A00,184327,Staff,20,0,25,5
1681910159394,USP 170,A00,184380,Hinds; Juli Beth,14,0,25,11
1681910160418,VIS 21B,A01,182660,Staff,28,0,31,3
1681910160418,VIS 21B,A02,182662,Staff,30,0,31,1
1681910161445,VIS 103D,A00,182663,Staff,74,0,75,1
1681910162477,VIS 105D,A00,182667,Li; Huai,15,0,22,7
1681910163501,VIS 122GS,A00,182668,Herbst; Matthew,20,0,20,0
1681910164529,VIS 128C,A00,182673,Staff,69,0,75,6
1681910165554,VIS 130,A00,182675,Staff,20,0,22,2
1681910166581,VIS 160A,A00,182678,Stalbaum; Brett,4,0,10,6
1681910168634,WCWP 10B,A00,201679,Staff,15,0,15,0
1681910168634,WCWP 10B,B00,201695,Staff,15,0,15,0
1681910169663,WCWP 100,A00,201716,Staff,15,0,15,0
1681910169663,WCWP 100,B00,201717,Staff,11,0,15,4
1681910171741,ANSC 105GS,A00,258289,Staff,0,0,0,0
1681910172774,ANSC 125GS,A00,258295,Staff,0,0,0,0
1681910173799,ANSC 150,A00,258267,Staff,30,0,40,10
1681910174823,ANSC 190GS,A00,258280,Staff,0,0,0,0
1681910175850,ANTH 1,A00,258264,Staff,38,0,40,2
1681910176874,ANTH 2,A01,258259,Staff,72,0,76,4
1681910177897,ANTH 23,A01,258228,Staff,36,0,40,4
1681910178919,ANTH 101,A01,258236,Staff,39,0,40,1
1681910179946,ANTH 102,A00,258272,Staff,59,0,60,1
1681910180974,ANTH 105,A00,258244,Staff,31,0,35,4
1681910181999,BENG 130,A00,253975,Staff,38,0,40,2
1681910183025,BIBC 102,A01,191866,Flagg; Matthew Paul,19,0,32,13
1681910183025,BIBC 102,A02,191867,Flagg; Matthew Paul,22,0,32,10
1681910183025,BIBC 102,A03,191868,Flagg; Matthew Paul,30,0,32,2
1681910183025,BIBC 102,A04,191936,Flagg; Matthew Paul,26,0,32,6
1681910183025,BIBC 102,A05,191937,Flagg; Matthew Paul,11,0,32,21
1681910184051,BICD 100,A01,191939,Cooper; Andrew Michael,28,0,32,4
1681910184051,BICD 100,A02,191940,Cooper; Andrew Michael,32,0,32,0
1681910184051,BICD 100,A03,191941,Cooper; Andrew Michael,32,0,32,0
1681910184051,BICD 100,A04,191942,Cooper; Andrew Michael,32,0,32,0
1681910184051,BICD 100,A05,191943,Cooper; Andrew Michael,32,0,32,0
1681910185076,BIEB 126,A01,191945,Cleland; Elsa Eleanor,1,0,32,31
1681910185076,BIEB 126,A02,191946,Cleland; Elsa Eleanor,28,0,32,4
1681910185076,BIEB 126,A03,191947,Cleland; Elsa Eleanor,29,0,32,3
1681910185076,BIEB 126,A04,191948,Cleland; Elsa Eleanor,23,0,32,9
1681910185076,BIEB 126,A05,191996,Cleland; Elsa Eleanor,28,0,32,4
1681910186103,BIEB 136GS,A00,191997,Shurin; Jonathan & Holway; David A.,0,0,0,0
1681910187130,BIEB 137GS,A01,191999,Shurin; Jonathan & Holway; David A.,0,0,0,0
1681910188159,BILD 1,A01,205385,Staff,31,0,32,1
1681910188159,BILD 1,A02,205386,Staff,30,0,32,2
1681910188159,BILD 1,A03,205387,Staff,32,0,32,0
1681910188159,BILD 1,A04,205388,Staff,28,0,32,4
1681910189188,BILD 2,A01,191774,Staff,28,0,32,4
1681910189188,BILD 2,A02,191775,Staff,30,0,32,2
1681910189188,BILD 2,A03,191777,Staff,30,0,32,2
1681910189188,BILD 2,A04,191856,Staff,31,0,32,1
1681910189188,BILD 2,A05,191857,Staff,32,0,32,0
1681910189188,BILD 2,A06,191858,Staff,32,0,32,0
1681910189188,BILD 2,A07,191859,Staff,31,0,32,1
1681910190212,BILD 3,A01,205391,Staff,29,0,32,3
1681910190212,BILD 3,A02,205393,Staff,32,0,32,0
1681910190212,BILD 3,A03,205394,Staff,28,0,32,4
1681910190212,BILD 3,A04,205395,Staff,32,0,32,0
1681910191241,BILD 20,A01,191861,Staff,32,0,32,0
1681910191241,BILD 20,A02,191862,Staff,32,0,32,0
1681910192268,BILD 30,A01,191864,Staff,31,0,32,1
1681910193297,BIMM 100,A01,192019,Staff,0,0,32,32
1681910193297,BIMM 100,A02,192020,Staff,23,0,32,9
1681910193297,BIMM 100,A03,192035,Staff,22,0,32,10
1681910194321,BIMM 110,A01,192037,Tat; John,0,0,32,32
1681910194321,BIMM 110,A02,192038,Tat; John,10,0,32,22
1681910195345,BIMM 120,A01,192040,Pickett; Brooke Elizabeth,2,0,32,30
1681910195345,BIMM 120,A02,192041,Pickett; Brooke Elizabeth,16,0,32,16
1681910195345,BIMM 120,A03,192042,Pickett; Brooke Elizabeth,16,0,32,16
1681910196369,BIPN 100,A01,192044,Armour; Jon Christopher,26,0,32,6
1681910196369,BIPN 100,A02,192059,Armour; Jon Christopher,30,0,32,2
1681910196369,BIPN 100,A03,192064,Armour; Jon Christopher,31,0,32,1
1681910196369,BIPN 100,A04,192073,Armour; Jon Christopher,28,0,32,4
1681910197397,BIPN 148,A01,205411,Leutgeb; Jill K.,16,0,32,16
1681910197397,BIPN 148,A02,205412,Leutgeb; Jill K.,31,0,32,1
1681910197397,BIPN 148,A03,205413,Leutgeb; Jill K.,30,0,32,2
1681910197397,BIPN 148,A04,205414,Leutgeb; Jill K.,30,0,32,2
1681910198428,BIPN 160,A01,192115,Marino; Marc J,19,0,32,13
1681910198428,BIPN 160,A02,192148,Marino; Marc J,27,0,32,5
1681910198428,BIPN 160,A03,192158,Marino; Marc J,31,0,32,1
1681910198428,BIPN 160,A04,192190,Marino; Marc J,32,0,32,0
1681910198428,BIPN 160,A05,192287,Marino; Marc J,32,0,32,0
1681910198428,BIPN 160,A06,192288,Marino; Marc J,32,0,32,0
1681910199452,BIPN 194,A00,206038,Staff,28,0,32,4
1681910200477,BISP 194,A00,192289,Leutgeb; Stefan,13,0,32,19
1681910200477,BISP 194,B00,245332,Nieh; James Charles,27,0,32,5
1681910201503,CAT 124,A01,202247,Staff,15,0,15,0
1681910202532,CAT 125,A00,202248,Staff,19,0,20,1
1681910202532,CAT 125,B00,202253,Staff,20,0,20,0
1681910202532,CAT 125,C00,202257,Staff,19,0,20,1
1681910203559,CAT 125GS,A01,202273,Bronstein; Phoebe Malan,20,0,20,0
1681910204584,CAT 125R,A00,202284,Staff,17,0,20,3
1681910204584,CAT 125R,C00,202286,Staff,10,0,20,10
1681910204584,CAT 125R,D00,202291,Staff,18,0,20,2
1681910204584,CAT 125R,E00,202295,Staff,13,0,20,7
1681910204584,CAT 125R,F00,202302,Staff,12,0,20,8
1681910205608,CENG 100,A00,204724,Opatkiewicz; Justin Paul,25,0,25,0
1681910206635,CGS 2A,A01,180420,Staff,31,0,36,5
1681910207657,CGS 101,A00,180421,Staff,16,0,20,4
1681910208683,CGS 112,A00,180422,Staff,10,0,16,6
1681910209709,CGS 113,A00,180423,Staff,18,0,20,2
1681910210731,CGS 137,A00,180424,Staff,12,0,12,0
1681910211759,CGS 147,A00,180425,Staff,10,0,10,0
1681910212785,CHEM 6A,A01,179556,Staff,97,0,100,3
1681910212785,CHEM 6A,A02,179558,Staff,0,0,0,0
1681910213813,CHEM 6B,A01,179560,Staff,100,0,100,0
1681910214842,CHEM 6C,A01,179565,Jazzar; Rodolphe,95,0,100,5
1681910215869,CHEM 7L,A01,179586,Schurmeier; Kimberly,13,0,24,11
1681910215869,CHEM 7L,A02,179587,Schurmeier; Kimberly,23,0,24,1
1681910215869,CHEM 7L,A03,179590,Schurmeier; Kimberly,22,0,24,2
1681910215869,CHEM 7L,A04,179591,Schurmeier; Kimberly,22,0,24,2
1681910215869,CHEM 7L,B01,179598,Schurmeier; Kimberly,17,0,24,7
1681910215869,CHEM 7L,B02,179599,Schurmeier; Kimberly,24,0,24,0
1681910215869,CHEM 7L,B03,179606,Schurmeier; Kimberly,23,0,24,1
1681910215869,CHEM 7L,B04,179607,Schurmeier; Kimberly,23,0,24,1
1681910216901,CHEM 11,A01,179609,Stallings; Dontarie M,88,0,100,12
1681910217924,CHEM 40A,A01,179621,Staff,41,0,50,9
1681910217924,CHEM 40A,A02,179622,Staff,47,0,50,3
1681910218950,CHEM 40B,A01,179630,Weizman; Haim,48,0,50,2
1681910218950,CHEM 40B,A02,179631,Weizman; Haim,45,0,50,5
1681910219983,CHEM 41A,A01,179660,Klosterman; Jeremy K,93,0,100,7
1681910221012,CHEM 43A,A01,179683,Klosterman; Jeremy K,0,0,24,24
1681910221012,CHEM 43A,A02,179688,Klosterman; Jeremy K,14,0,24,10
1681910221012,CHEM 43A,A03,179689,Klosterman; Jeremy K,20,0,24,4
1681910221012,CHEM 43A,A04,179691,Klosterman; Jeremy K,18,0,24,6
1681910222040,CHEM 114A,A01,179693,Stallings; Dontarie M,77,0,100,23
1681910223066,CHEM 143B,A01,179698,Weizman; Haim,17,0,24,7
1681910223066,CHEM 143B,A02,179700,Weizman; Haim,24,0,24,0
1681910224093,CHIN 169A,A00,179701,Wang; Xiao,20,0,20,0
1681910225117,COGS 2,A01,179750,Boyle; Mary E. T.,17,0,30,13
1681910226157,COGS 9,A01,179759,Jones; Cameron Robert,43,0,50,7
1681910227191,COGS 14A,A01,179854,Staff,18,0,50,32
1681910228218,COGS 14B,A01,179856,Staff,54,0,60,6
1681910229242,COGS 17,A01,179874,Staff,71,0,75,4
1681910230265,COGS 18,A01,179884,Staff,63,0,80,17
1681910231297,COGS 100,A01,179886,Staff,40,0,60,20
1681910232321,COGS 101B,A01,179892,Staff,1,0,30,29
1681910233345,COGS 101C,A01,179894,Staff,28,0,30,2
1681910234371,COGS 107A,A01,179896,Boyle; Mary E. T.,31,0,40,9
1681910235395,COGS 108,A01,179898,Simpkins; Charles Alexander,0,17,60,60
1681910236420,COGS 109,A01,179900,Staff,34,0,40,6
1681910237449,COGS 118A,A01,179946,Staff,9,0,40,31
1681910238472,COGS 153,A00,179978,Staff,1,0,30,29
1681910239498,COGS 156,A01,179981,Staff,27,0,30,3
1681910241557,COGS 172,A01,179987,Staff,13,0,30,17
1681910243679,COGS 186,A01,179991,Staff,13,0,30,17
1681910244706,COMM 10,A01,180001,Staff,15,0,25,10
1681910244706,COMM 10,A02,180004,Staff,20,0,25,5
1681910245733,COMM 100A,A01,180016,Staff,18,0,25,7
1681910245733,COMM 100A,A02,180020,Staff,24,0,25,1
1681910246756,COMM 101T,A00,180029,Halm; Gavin Patrick,23,0,35,12
1681910247780,COMM 106V,A00,180043,Staff,34,0,35,1
1681910248805,COMM 109P,A00,180044,Staff,31,0,35,4
1681910249833,COMM 113T,A00,180045,Havis; Allan,37,0,45,8
1681910250855,COMM 132,A00,180046,McKenna; Denise,23,0,30,7
1681910251879,COMM 143,A00,180047,Staff,19,0,30,11
1681910252904,COMM 190,A00,180048,Conner; Thomas Hartnell,20,0,23,3
1681910253935,CSE 8A,A50,180053,Cao; Yingjun,25,0,50,25
1681910253935,CSE 8A,B50,180180,Staff,50,0,50,0
1681910254960,CSE 11,A01,180190,Cao; Yingjun,31,0,50,19
1681910255984,CSE 20,A01,180192,Briones; Jor-el Thomas Caparas,23,0,30,7
1681910257011,CSE 21,A01,194538,Briones; Jor-el Thomas Caparas,50,0,60,10
1681910258038,CSE 30,A01,180324,Eldon; John,79,0,100,21
1681910259066,CSE 101,A01,201353,Staff,0,20,40,40
1681910260092,CSE 134B,A01,180326,Powell; Thomas Allan,74,0,100,26
1681910261116,CSE 140,A01,180328,Staff,46,0,75,29
1681910262139,CSE 140L,A01,180344,Eldon; John,69,0,100,31
1681910263165,CSE 150A,A01,180411,Staff,0,7,50,50
1681910264189,CSE 151A,A01,180414,Staff,0,6,50,50
1681910265214,CSE 175,A01,222521,Kumar; Rakesh,50,0,50,0
1681910266240,CSE 190,A00,201419,Staff,45,0,49,4
1681910267268,CSS 1,A01,194536,Staff,38,0,50,12
1681910268292,DSC 30,A01,202385,Staff,48,0,50,2
1681910269323,DSC 40A,A01,202387,Albuyeh; Rod,50,0,50,0
1681910270354,DSC 190,A01,202389,Silberman; Jack,21,0,21,0
1681910271377,DSGN 100,A01,179993,Staff,16,0,30,14
1681910272406,ECE 65,A50,180708,Staff,10,0,20,10
1681910272406,ECE 65,A51,180739,Staff,19,0,20,1
1681910273429,ECON 1,A01,180427,Famulari; Melissa,67,0,70,3
1681910274455,ECON 2,A01,180450,Levkoff; Steven B.,64,0,70,6
1681910275482,ECON 4,A01,203351,Anderson; John Charles,7,0,10,3
1681910276521,ECON 100A,A01,180472,Famulari; Melissa,65,0,70,5
1681910277547,ECON 120A,A01,180549,Staff,64,0,70,6
1681910278571,ECON 120B,A01,180655,Ma; Xinwei,46,0,70,24
1681910279597,ECON 129,A00,203333,Eckert; Fabian Paul,15,0,35,20
1681910280621,ECON 131,A00,180656,Staff,9,0,35,26
1681910281646,ECON 172B,A01,180672,Levkoff; Steven B.,32,0,35,3
1681910282670,ECON 178,A01,203342,Zhu; Ying,11,0,35,24
1681910283698,EDS 108GS,A00,202383,Wishard Guerra; Alison G.,20,0,20,0
1681910284726,EDS 111GS,A00,202347,Wishard Guerra; Alison G.,20,0,20,0
1681910285748,EDS 112,A01,202323,Staff,56,0,60,4
1681910286770,EDS 113,A00,202340,Staff,33,0,35,2
1681910287795,EDS 118,A00,201231,Staff,20,0,30,10
1681910288822,EDS 119,A00,204994,Staff,8,0,10,2
1681910289849,EDS 124BR,A00,202324,Eguchi; Emi,5,0,25,20
1681910290882,EDS 126,A01,203208,Jones; Makeba,26,0,30,4
1681910291908,EDS 135,A01,202333,Staff,18,0,20,2
1681910292933,EDS 180,A00,202311,Staff,47,0,50,3
1681910293957,ERC 190GS,A01,253747,Staff,28,0,28,0
1681910294984,ETHN 104,A00,180742,Staff,24,0,35,11
1681910296007,ETHN 118,A00,180745,Staff,28,0,35,7
1681910297030,ETHN 127,A00,180747,Staff,12,0,16,4
1681910298054,ETHN 137,A00,180880,Staff,12,0,12,0
1681910299081,ETHN 147,A00,180890,Staff,8,0,10,2
1681910300104,ETHN 154,A00,180891,Staff,7,0,8,1
1681910301127,ETHN 168,A00,180892,Staff,9,0,10,1
1681910302156,GLBH 20,A00,201051,Hannah; Seth Donal,0,1,0,1
1681910303182,GLBH 111,A01,209338,Burgos; Jose L.,0,0,0,0
1681910304206,GLBH 150,A00,258300,Staff,0,3,0,0
1681910305234,GLBH 181,A00,201207,Staff,15,0,40,25
1681910306258,HIEU 109,A00,180898,Staff,20,0,20,0
1681910307282,HIEU 111,A00,180899,Staff,1,0,20,19
1681910308308,HIEU 124,A00,180900,Staff,18,0,20,2
1681910309334,HILA 122,A00,180901,Staff,18,0,20,2
1681910310358,HILA 132,A00,180902,Vitz; Matthew,2,0,20,18
1681910311383,HILD 10,A01,180896,Staff,15,0,20,5
1681910312409,HILD 30GS,A00,180897,Edington; Claire Ellen,0,0,0,0
1681910313432,HISC 105,A00,180903,Staff,20,0,20,0
1681910314461,HISC 117,A00,180904,Staff,11,0,20,9
1681910315493,HIUS 108B,A00,181005,Staff,18,0,20,2
1681910316517,HIUS 113,A00,181093,Staff,4,0,20,16
1681910317545,HUM 3,A01,181190,Patterson; Patrick H.,40,0,50,10
1681910317545,HUM 3,B01,181195,Staff,47,0,50,3
1681910318566,HUM 3GS,A00,181196,Herbst; Matthew,0,0,0,0
1681910319589,HUM 4,A01,181227,West; Geoffrey Scott,34,0,50,16
1681910319589,HUM 4,B01,181282,Staff,43,0,50,7
1681910320612,HUM 4GS,A00,181377,Lyon; Antony J.,0,0,0,0
1681910321636,HUM 5,A01,181536,Zavodny; Tatiana Sophia,31,0,50,19
1681910321636,HUM 5,B01,181908,Staff,36,0,50,14
1681910322675,INTL 190,A00,181909,Segui; Alan S,0,0,0,6
1681910322675,INTL 190,B00,181961,Segui; Alan S,0,0,0,7
1681910323698,JAPN 20AR,A01,182113,Ross; Kayoko F,15,0,20,5
1681910324722,LATI 50,A01,202391,Martin-Cabrera; Luis,19,0,30,11
1681910324722,LATI 50,A02,202392,Martin-Cabrera; Luis,26,0,30,4
1681910325751,LATI 180,A00,202393,Kokinis; Troy Andreas,25,0,25,0
1681910326778,LIFR 1A,A00,182119,Staff,14,0,14,0
1681910327802,LIFR 1AX,A00,182324,Staff,14,0,14,0
1681910328826,LIFR 1B,A00,182259,Staff,14,0,14,0
1681910329853,LIFR 1BX,A00,182273,Staff,14,0,14,0
1681910330879,LIGN 8,A00,182330,Staff,137,0,150,13
1681910331902,LIGN 9GS,A00,182362,Staff,20,0,20,0
1681910332927,LIGN 119,A00,204992,Takahashi; Maho,12,0,15,3
1681910333951,LIGN 130,A01,182384,Staff,47,0,50,3
1681910334978,LIGN 149GS,A00,182390,Staff,20,0,20,0
1681910336005,LIGN 170,A00,182404,Staff,24,0,30,6
1681910337029,LISP 1D,A00,182281,Staff,7,0,14,7
1681910337029,LISP 1D,B00,182287,Staff,14,0,14,0
1681910337029,LISP 1D,C00,182295,Staff,11,0,14,3
1681910337029,LISP 1D,D00,182301,Staff,14,0,14,0
1681910338054,LISP 1DX,A00,182309,Staff,20,0,28,8
1681910338054,LISP 1DX,B00,182316,Staff,26,0,28,2
1681910339081,LTAF 120GS,A00,182412,Zhiri; Oumelbanine,20,0,20,0
1681910340104,LTCS 172GS,A00,182437,Bronstein; Phoebe Malan,20,0,20,0
1681910341135,LTEA 138,A00,182457,Staff,22,0,40,18
1681910342163,LTEN 114,A01,182490,Staff,23,0,25,2
1681910343191,LTEN 130GS,A00,182491,Lyon; Antony J.,20,0,20,0
1681910344219,LTEN 169,A00,182493,Cuong; Marisol,20,0,25,5
1681910345242,LTEN 178,A00,182501,Staff,14,0,15,1
1681910346265,LTEN 181,A00,182515,Staff,22,0,25,3
1681910347367,LTEN 185GS,A00,197655,Forbes; Camille,20,0,20,0
1681910348391,LTSP 100B,A00,202208,Bessett; Ryan Matthew,24,0,25,1
1681910349415,LTWL 100,A00,182516,Myerston Santana; Jacobo,23,0,30,7
1681910350440,LTWR 100GS,A00,182518,Forbes; Camille,20,0,20,0
1681910351464,LTWR 102,A00,182522,Staff,15,0,15,0
1681910351464,LTWR 102,B00,182525,Staff,14,0,15,1
1681910352497,LTWR 115,A00,182526,Staff,12,0,15,3
1681910353519,MAE 8,A01,182528,Pham; Hieu Tan,68,0,70,2
1681910354553,MAE 11,A00,182529,Bahadori; Mohammad Yousef,94,0,100,6
1681910355581,MAE 20,A00,182530,Evdokimenko; Ekaterina,68,0,70,2
1681910356604,MAE 30A,A00,182532,Staff,44,0,45,1
1681910357635,MAE 101A,A00,182533,Bahadori; Mohammad Yousef,97,0,100,3
1681910358660,MAE 101C,A00,182538,Staff,62,0,70,8
1681910359685,MAE 104,A00,182539,Staff,45,0,50,5
1681910360711,MAE 131A,A00,182540,Ghazinejad; Maziar,41,0,45,4
1681910361736,MAE 143A,A00,182548,Bewley; Thomas R,43,0,50,7
1681910362760,MAE 150,A00,182549,Staff,28,0,40,12
1681910363797,MAE 160,A00,182550,Evdokimenko; Ekaterina,43,0,60,17
1681910364819,MATH 3C,A01,182725,Staff,27,0,30,3
1681910365848,MATH 10A,A01,182729,Staff,25,0,30,5
1681910365848,MATH 10A,B01,182732,Staff,26,0,30,4
1681910366873,MATH 10B,A01,182737,Staff,21,0,30,9
1681910366873,MATH 10B,A02,182738,Staff,27,0,30,3
1681910366873,MATH 10B,B01,182744,Staff,27,0,30,3
1681910366873,MATH 10B,B02,182745,Staff,27,0,30,3
1681910367904,MATH 18,A01,182750,Anzaldo; Leesa B,28,0,30,2
1681910367904,MATH 18,A02,182751,Anzaldo; Leesa B,29,0,30,1
1681910367904,MATH 18,A03,182753,Anzaldo; Leesa B,28,0,30,2
1681910367904,MATH 18,A04,182757,Anzaldo; Leesa B,29,0,30,1
1681910367904,MATH 18,B01,182761,Anzaldo; Leesa B,27,0,30,3
1681910367904,MATH 18,B02,182764,Anzaldo; Leesa B,27,0,30,3
1681910367904,MATH 18,B03,182765,Anzaldo; Leesa B,30,0,30,0
1681910367904,MATH 18,B04,182766,Anzaldo; Leesa B,30,0,30,0
1681910368931,MATH 20A,A01,182771,Suk; Andrew Hoon,28,0,30,2
1681910369957,MATH 20B,A01,182775,Bach; Quang Tran,30,0,30,0
1681910369957,MATH 20B,A02,182777,Bach; Quang Tran,29,0,30,1
1681910369957,MATH 20B,B01,182780,Bach; Quang Tran,27,0,30,3
1681910369957,MATH 20B,B02,182782,Bach; Quang Tran,30,0,30,0
1681910370984,MATH 20C,A01,182787,Staff,25,0,30,5
1681910370984,MATH 20C,A02,182790,Staff,29,0,30,1
1681910370984,MATH 20C,B01,182792,Staff,25,0,30,5
1681910370984,MATH 20C,B02,182796,Staff,27,0,30,3
1681910372010,MATH 20D,A01,182799,Staff,29,0,30,1
1681910372010,MATH 20D,A02,182802,Staff,30,0,30,0
1681910372010,MATH 20D,A03,182803,Staff,30,0,30,0
1681910373041,MATH 20E,A01,182809,Verstraete; Jacques Allan,24,0,30,6
1681910373041,MATH 20E,A02,182811,Verstraete; Jacques Allan,28,0,30,2
1681910373041,MATH 20E,B01,182814,Verstraete; Jacques Allan,23,0,30,7
1681910373041,MATH 20E,B02,182815,Verstraete; Jacques Allan,30,0,30,0
1681910374071,MATH 103A,A01,182820,Staff,9,0,30,21
1681910374071,MATH 103A,A02,182821,Staff,27,0,30,3
1681910374071,MATH 103A,A03,182822,Staff,23,0,30,7
1681910374071,MATH 103A,B01,182825,Staff,23,0,30,7
1681910374071,MATH 103A,B02,182826,Staff,30,0,30,0
1681910374071,MATH 103A,B03,182830,Staff,30,0,30,0
1681910375095,MATH 109,A01,182836,Chow; Bennett,24,0,30,6
1681910375095,MATH 109,A02,182838,Chow; Bennett,29,0,30,1
1681910375095,MATH 109,A03,182894,Chow; Bennett,29,0,30,1
1681910375095,MATH 109,B01,182908,Chow; Bennett,28,0,30,2
1681910375095,MATH 109,B02,182909,Chow; Bennett,30,0,30,0
1681910375095,MATH 109,B03,182910,Chow; Bennett,27,0,30,3
1681910376123,MATH 142A,A01,182925,Staff,11,0,30,19
1681910376123,MATH 142A,A02,182935,Staff,25,0,30,5
1681910376123,MATH 142A,A03,182967,Staff,26,0,30,4
1681910376123,MATH 142A,B01,183125,Staff,24,0,30,6
1681910376123,MATH 142A,B02,183157,Staff,28,0,30,2
1681910376123,MATH 142A,B03,183158,Staff,29,0,30,1
1681910377152,MATH 183,A01,183160,Arias-Castro; Ery,23,0,30,7
1681910377152,MATH 183,A02,183161,Arias-Castro; Ery,29,0,30,1
1681910377152,MATH 183,B01,183163,Arias-Castro; Ery,28,0,30,2
1681910377152,MATH 183,B02,183164,Arias-Castro; Ery,28,0,30,2
1681910378176,MATH 193A,A01,183167,Staff,4,0,35,31
1681910378176,MATH 193A,A02,183168,Staff,28,0,35,7
1681910378176,MATH 193A,A03,183169,Staff,34,0,35,1
1681910378176,MATH 193A,A04,183170,Staff,28,0,35,7
1681910379201,MGT 4,A01,202395,Anderson; John Charles,75,0,80,5
1681910380236,MGT 5,A00,202396,Houskeeper; Robert,80,0,90,10
1681910381259,MGT 103,A00,202397,Eberhard; Craig A,55,0,90,35
1681910382285,MGT 131A,A00,202398,Houskeeper; Robert,85,0,90,5
1681910383308,MGT 135,A00,202399,Anderson; John Charles,82,0,90,8
1681910384333,MGT 162R,A00,202403,Gneezy; Uri,150,0,200,50
1681910385365,MGT 172,A00,202404,Hedges; Kathleen,50,0,90,40
1681910386393,MGT 181,A00,202405,Dunn; Louis Jean,84,0,90,6
1681910387417,MMW 14,A01,183200,Staff,16,0,28,12
1681910387417,MMW 14,A02,183201,Staff,26,0,28,2
1681910387417,MMW 14,A03,183202,Staff,24,0,28,4
1681910387417,MMW 14,A04,183203,Staff,25,0,28,3
1681910387417,MMW 14,A05,183204,Staff,26,0,28,2
1681910387417,MMW 14,A06,183205,Staff,27,0,28,1
1681910387417,MMW 14,B01,183207,Staff,26,0,28,2
1681910387417,MMW 14,B02,183208,Staff,28,0,28,0
1681910387417,MMW 14,B03,183209,Staff,28,0,28,0
1681910387417,MMW 14,B04,183210,Staff,28,0,28,0
1681910387417,MMW 14,B05,183211,Staff,28,0,28,0
1681910387417,MMW 14,B06,183212,Staff,28,0,28,0
1681910388440,MMW 14GS,A00,183213,Zhiri; Oumelbanine,28,0,28,0
1681910389463,MMW 15GS,B00,183215,Rahimi; Babak,28,0,28,0
1681910390485,MMW 121,A01,183217,Patterson; Patrick H.,14,0,28,14
1681910390485,MMW 121,A02,183218,Patterson; Patrick H.,25,0,28,3
1681910391509,MUS 1A,A01,182554,Staff,8,0,35,27
1681910392541,MUS 5,A01,182558,Staff,20,0,35,15
1681910393563,MUS 6,A01,182562,Staff,25,0,35,10
1681910394588,MUS 8GS,A00,182563,Borgo; David Garcia,25,0,25,0
1681910395613,MUS 13,A01,182567,Staff,24,0,25,1
1681910396636,MUS 15,A01,182570,Staff,32,0,35,3
1681910396636,MUS 15,B01,182575,Staff,10,0,35,25
1681910397662,MUS 80,A00,182578,Staff,23,0,25,2
1681910397662,MUS 80,B00,182581,Staff,20,0,25,5
1681910398689,MUS 113,A00,182582,Staff,25,0,25,0
1681910399721,MUS 114,A00,182583,Staff,4,0,25,21
1681910400752,MUS 150GS,A01,182588,Borgo; David Garcia,25,0,25,0
1681910401775,PHIL 1,A00,182590,Staff,35,0,40,5
1681910402801,PHIL 10,A01,182596,Grush; Rick Scott,31,0,35,4
1681910402801,PHIL 10,A02,182597,Grush; Rick Scott,34,0,35,1
1681910403828,PHIL 15,A01,182601,Staff,31,0,35,4
1681910403828,PHIL 15,A02,182602,Staff,33,0,35,2
1681910404851,PHIL 27,A01,182604,Staff,30,0,35,5
1681910404851,PHIL 27,A02,182607,Staff,35,0,35,0
1681910405875,PHIL 32,A01,182609,Staff,35,0,35,0
1681910405875,PHIL 32,A02,182612,Staff,35,0,35,0
1681910406900,PHIL 130,A00,182614,Staff,63,0,70,7
1681910407926,PHIL 136,A00,182616,Cohen; Jonathan David,66,0,70,4
1681910408957,PHIL 155,A00,182617,Vargas; Manuel Rogelio,60,0,70,10
1681910409982,PHIL 163,A01,182620,Staff,15,0,20,5
1681910409982,PHIL 163,A02,182624,Staff,10,0,20,10
1681910411010,PHIL 164,A00,182627,Staff,30,0,40,10
1681910412034,PHIL 173,A00,182628,Staff,36,0,40,4
1681910413058,PHYS 1A,A00,183221,Staff,54,0,60,6
1681910414082,PHYS 1AL,001,183222,Staff,25,0,30,5
1681910414082,PHYS 1AL,002,183223,Staff,28,0,30,2
1681910415109,PHYS 1B,A00,183231,Staff,44,0,60,16
1681910416135,PHYS 1BL,001,183232,Staff,20,0,30,10
1681910416135,PHYS 1BL,002,183233,Staff,29,0,30,1
1681910417158,PHYS 1C,A00,183240,Staff,30,0,60,30
1681910418180,PHYS 1CL,001,183241,Staff,13,0,30,17
1681910418180,PHYS 1CL,002,183242,Staff,22,0,30,8
1681910419206,PHYS 2AR,A01,183250,Staff,44,0,50,6
1681910420233,PHYS 2B,A01,183252,Staff,106,0,115,9
1681910421260,PHYS 2BL,A01,183254,Staff,21,0,24,3
1681910421260,PHYS 2BL,A02,183255,Staff,22,0,24,2
1681910422289,PHYS 2C,A01,183522,Staff,105,0,115,10
1681910423315,PHYS 4A,A01,183524,Staff,49,0,50,1
1681910424338,POLI 5,A00,183525,Staff,44,0,50,6
1681910425362,POLI 12,A00,183540,Staff,48,0,50,2
1681910426388,POLI 13R,A00,183541,Forman; Fonna,42,0,50,8
1681910427411,POLI 30,A00,183542,Mignozzetti; Umberto,47,0,50,3
1681910428437,POLI 100A,A00,183543,Staff,45,0,50,5
1681910429465,POLI 100E,A00,223598,Staff,32,0,35,3
1681910430492,POLI 103A,A00,183564,Kousser; Thad,38,0,50,12
1681910431516,POLI 104B,A00,201329,Staff,29,0,35,6
1681910432539,POLI 113BR,A00,183576,Hoston; Germaine,28,0,50,22
1681910433562,POLI 114BR,A00,183588,Staff,27,0,30,3
1681910434586,POLI 117R,A00,183595,Forman; Fonna,9,0,20,11
1681910435608,POLI 120H,A00,183596,Fisk; David Lee,13,0,20,7
1681910436634,POLI 130AA,A00,183597,Staff,14,0,20,6
1681910437657,POLI 134AA,A00,183598,Staff,19,0,20,1
1681910438682,POLI 135,A00,183599,Fisk; David Lee,20,0,25,5
1681910439708,POLI 142P,A00,183623,Staff,37,0,40,3
1681910440734,POLI 144D,A00,183624,Staff,22,0,25,3
1681910441758,POLI 151,A00,183625,Staff,15,0,20,5
1681910442786,POLI 162,A00,183626,Mignozzetti; Umberto,18,0,20,2
1681910443810,PSYC 1,A00,253748,Staff,86,0,90,4
1681910444839,PSYC 2,A00,183627,Moranton; Nirelia Melbina-,25,0,35,10
1681910445862,PSYC 3,A00,183628,Staff,43,0,45,2
1681910447916,PSYC 60,A01,183631,Lowe; Angela Beth,35,0,40,5
1681910448942,PSYC 70,A01,253757,Staff,37,0,45,8
1681910449966,PSYC 101,A00,183632,Heyman; Gail D.,48,0,60,12
1681910451071,PSYC 105,A00,183848,Lowe; Angela Beth,50,0,60,10
1681910452098,PSYC 106,A00,183849,Dobkins; Karen R.,45,0,60,15
1681910453122,PSYC 108,A00,253750,Staff,24,0,60,36
1681910454146,PSYC 114,A01,184275,Winkielman; Piotr,0,6,30,30
1681910455173,PSYC 122,A00,183856,Moranton; Nirelia Melbina-,0,10,30,30
1681910456199,PSYC 124,A00,183865,Chapman; Eddie Nathaniel,52,0,80,28
1681910457230,PSYC 137,A00,183880,Staff,19,0,25,6
1681910459285,PSYC 154,A00,183910,Lacefield; Katharine I,0,2,90,90
1681910461332,PSYC 162,A00,183946,Wixted; John T,61,0,90,29
1681910462356,PSYC 172,A00,183947,Gorman; Michael R.,14,0,30,16
1681910463384,PSYC 178,A00,183963,Glaser; Dale,20,0,40,20
1681910464408,PSYC 181GS,A00,183964,Anagnostaras; Stephan,10,0,10,0
1681910465433,PSYC 186GS,A01,257660,Staff,10,0,10,0
1681910466465,PSYC 193,B00,253749,Staff,23,0,25,2
1681910468557,PSYC 193L,A01,184122,Staff,33,0,35,2
1681910468557,PSYC 193L,C01,184167,Winkielman; Piotr,16,0,30,14
1681910469584,RELI 188GS,A00,182629,Rahimi; Babak,20,0,20,0
1681910470606,SE 101A,A00,182646,Staff,26,0,30,4
1681910471631,SE 101C,A00,182650,Staff,18,0,20,2
1681910472656,SE 110A,A00,182651,Staff,28,0,28,0
1681910473683,SE 130A,A00,182652,Staff,39,0,40,1
1681910474709,SIO 46GS,A00,182636,Cook; Geoffrey W,28,0,28,0
1681910475734,SIO 109R,A00,194459,Staff,5,0,20,15
1681910476764,SIO 121GS,A00,182639,Cook; Geoffrey W,28,0,28,0
1681910477792,SIO 132,A01,182642,Staff,32,0,40,8
1681910478818,SIO 139,A00,182644,Kacev; David,36,0,40,4
1681910479845,SOCI 2,A01,258404,Staff,34,0,36,2
1681910479845,SOCI 2,A02,258405,Staff,35,0,36,1
1681910480872,SOCI 60,A01,258408,Staff,29,0,30,1
1681910480872,SOCI 60,A02,258413,Staff,30,0,30,0
1681910481899,SOCI 100,A01,258415,Staff,29,0,30,1
1681910481899,SOCI 100,A02,258416,Staff,28,0,30,2
1681910488047,SOCI 127,A00,258421,Staff,22,0,30,8
1681910489074,SOCI 132,A00,258422,Staff,45,0,50,5
1681910490097,SOCI 133,A00,258423,Staff,26,0,30,4
1681910491125,SOCI 138GS,A00,258424,Staff,15,0,15,0
1681910492151,SOCI 145,A00,258425,Staff,25,0,30,5
1681910493175,SOCI 148,A00,258426,Staff,26,0,30,4
1681910494199,SOCI 153,A00,199217,Staff,29,0,30,1
1681910495222,SOCI 160,A00,258427,Staff,28,0,30,2
1681910496248,SOCI 160E,A00,258435,Staff,56,0,60,4
1681910497276,SOCI 189GS,A00,258436,Staff,15,0,15,0
1681910498302,SOCI 190GS,A00,258437,Staff,15,0,15,0
1681910499329,SYN 2,001,182658,Staff,9,0,16,7
1681910499329,SYN 2,002,201439,Staff,15,0,16,1
1681910499329,SYN 2,003,201443,Staff,16,0,16,0
1681910500355,SYN 100,A01,182657,Staff,17,0,20,3
1681910501379,TDAC 1,A00,184381,Salovey; Todd,16,0,20,4
1681910501379,TDAC 1,B00,184385,Harting; Carla Kelso,19,0,20,1
1681910501379,TDAC 1,C00,184394,Staff,19,0,20,1
1681910502402,TDAC 101,A00,184483,Harting; Carla Kelso,19,0,20,1
1681910503425,TDDE 111,A00,184496,Staff,14,0,15,1
1681910504464,TDDE 131,A00,184504,Staff,20,0,20,0
1681910504464,TDDE 131,B00,184505,Staff,17,0,18,1
1681910504464,TDDE 131,C00,184534,Staff,49,0,50,1
1681910504464,TDDE 131,D00,184564,Staff,15,0,15,0
1681910504464,TDDE 131,E00,204725,Staff,19,0,20,1
1681910505487,TDGE 1,A01,184414,Salovey; Todd,37,0,50,13
1681910506513,TDGE 5,A01,184419,Staff,23,0,24,1
1681910507536,TDGE 10,A00,184428,Fulton; Julia,31,0,50,19
1681910508560,TDGE 124,A00,184565,Fulton; Julia,7,0,50,43
1681910509588,TDGE 125,B00,184567,Meyer; Ursula,9,0,25,16
1681910510613,TDHT 101,A00,184568,Staff,21,0,25,4
1681910510613,TDHT 101,B00,184569,Staff,20,0,20,0
1681910511637,TDHT 114,A00,184570,Staff,49,0,50,1
1681910512659,TDMV 1,A00,184437,Arcidiacono; Kristin,23,0,30,7
1681910512659,TDMV 1,B00,184448,Caligagan; Maria T.,22,0,30,8
1681910513684,TDMV 2,A00,184449,Weinberg; Sadie,27,0,30,3
1681910513684,TDMV 2,B00,184453,Arcidiacono; Kristin,29,0,30,1
1681910514713,TDMV 110,A00,184571,Weinberg; Sadie,30,0,30,0
1681910515741,TDMV 142,A00,184572,Caligagan; Tony,27,0,30,3
1681910515741,TDMV 142,B00,184573,Caligagan; Maria T.,27,0,30,3
1681910516766,TDTR 20,A00,184482,Jun; Grace Shin Hae,25,0,25,0
1681910517789,USP 2,A01,184290,Hinds; Juli Beth,24,0,25,1
1681910518813,USP 3,A01,184295,Staff,20,0,25,5
1681910519843,USP 4,A00,184304,McTague; Sarah,15,0,25,10
1681910520866,USP 100,A00,184315,Staff,17,0,25,8
1681910521890,USP 105,A00,184326,Staff,21,0,25,4
1681910522914,USP 151,A00,184327,Staff,20,0,25,5
1681910523938,USP 170,A00,184380,Hinds; Juli Beth,14,0,25,11
1681910524965,VIS 21B,A01,182660,Staff,28,0,31,3
1681910524965,VIS 21B,A02,182662,Staff,30,0,31,1
1681910525991,VIS 103D,A00,182663,Staff,74,0,75,1
1681910527017,VIS 105D,A00,182667,Li; Huai,15,0,22,7
1681910528040,VIS 122GS,A00,182668,Herbst; Matthew,20,0,20,0
1681910529070,VIS 128C,A00,182673,Staff,69,0,75,6
1681910530094,VIS 130,A00,182675,Staff,20,0,22,2
1681910531117,VIS 160A,A00,182678,Stalbaum; Brett,4,0,10,6
1681910533170,WCWP 10B,A00,201679,Staff,15,0,15,0
1681910533170,WCWP 10B,B00,201695,Staff,15,0,15,0
1681910534194,WCWP 100,A00,201716,Staff,15,0,15,0
1681910534194,WCWP 100,B00,201717,Staff,11,0,15,4
1681910536298,ANSC 105GS,A00,258289,Staff,0,0,0,0
1681910537325,ANSC 125GS,A00,258295,Staff,0,0,0,0
1681910538354,ANSC 150,A00,258267,Staff,30,0,40,10
1681910539383,ANSC 190GS,A00,258280,Staff,0,0,0,0
1681910540408,ANTH 1,A00,258264,Staff,38,0,40,2
1681910541434,ANTH 2,A01,258259,Staff,72,0,76,4
1681910542458,ANTH 23,A01,258228,Staff,36,0,40,4
1681910543484,ANTH 101,A01,258236,Staff,39,0,40,1
1681910544509,ANTH 102,A00,258272,Staff,59,0,60,1
1681910545533,ANTH 105,A00,258244,Staff,31,0,35,4
1681910546561,BENG 130,A00,253975,Staff,38,0,40,2
1681910547586,BIBC 102,A01,191866,Flagg; Matthew Paul,19,0,32,13
1681910547586,BIBC 102,A02,191867,Flagg; Matthew Paul,22,0,32,10
1681910547586,BIBC 102,A03,191868,Flagg; Matthew Paul,30,0,32,2
1681910547586,BIBC 102,A04,191936,Flagg; Matthew Paul,26,0,32,6
1681910547586,BIBC 102,A05,191937,Flagg; Matthew Paul,11,0,32,21
1681910548612,BICD 100,A01,191939,Cooper; Andrew Michael,28,0,32,4
1681910548612,BICD 100,A02,191940,Cooper; Andrew Michael,32,0,32,0
1681910548612,BICD 100,A03,191941,Cooper; Andrew Michael,32,0,32,0
1681910548612,BICD 100,A04,191942,Cooper; Andrew Michael,32,0,32,0
1681910548612,BICD 100,A05,191943,Cooper; Andrew Michael,32,0,32,0
1681910549639,BIEB 126,A01,191945,Cleland; Elsa Eleanor,1,0,32,31
1681910549639,BIEB 126,A02,191946,Cleland; Elsa Eleanor,28,0,32,4
1681910549639,BIEB 126,A03,191947,Cleland; Elsa Eleanor,29,0,32,3
1681910549639,BIEB 126,A04,191948,Cleland; Elsa Eleanor,23,0,32,9
1681910549639,BIEB 126,A05,191996,Cleland; Elsa Eleanor,28,0,32,4
1681910550666,BIEB 136GS,A00,191997,Shurin; Jonathan & Holway; David A.,0,0,0,0
1681910551691,BIEB 137GS,A01,191999,Shurin; Jonathan & Holway; David A.,0,0,0,0
1681910552717,BILD 1,A01,205385,Staff,31,0,32,1
1681910552717,BILD 1,A02,205386,Staff,30,0,32,2
1681910552717,BILD 1,A03,205387,Staff,32,0,32,0
1681910552717,BILD 1,A04,205388,Staff,28,0,32,4
1681910553741,BILD 2,A01,191774,Staff,28,0,32,4
1681910553741,BILD 2,A02,191775,Staff,30,0,32,2
1681910553741,BILD 2,A03,191777,Staff,30,0,32,2
1681910553741,BILD 2,A04,191856,Staff,31,0,32,1
1681910553741,BILD 2,A05,191857,Staff,32,0,32,0
1681910553741,BILD 2,A06,191858,Staff,32,0,32,0
1681910553741,BILD 2,A07,191859,Staff,31,0,32,1
1681910554841,BILD 3,A01,205391,Staff,29,0,32,3
1681910554841,BILD 3,A02,205393,Staff,32,0,32,0
1681910554841,BILD 3,A03,205394,Staff,28,0,32,4
1681910554841,BILD 3,A04,205395,Staff,32,0,32,0
1681910555869,BILD 20,A01,191861,Staff,32,0,32,0
1681910555869,BILD 20,A02,191862,Staff,32,0,32,0
1681910556896,BILD 30,A01,191864,Staff,31,0,32,1
1681910557923,BIMM 100,A01,192019,Staff,0,0,32,32
1681910557923,BIMM 100,A02,192020,Staff,23,0,32,9
1681910557923,BIMM 100,A03,192035,Staff,22,0,32,10
1681910558946,BIMM 110,A01,192037,Tat; John,0,0,32,32
1681910558946,BIMM 110,A02,192038,Tat; John,10,0,32,22
1681910559973,BIMM 120,A01,192040,Pickett; Brooke Elizabeth,2,0,32,30
1681910559973,BIMM 120,A02,192041,Pickett; Brooke Elizabeth,16,0,32,16
1681910559973,BIMM 120,A03,192042,Pickett; Brooke Elizabeth,16,0,32,16
1681910560999,BIPN 100,A01,192044,Armour; Jon Christopher,26,0,32,6
1681910560999,BIPN 100,A02,192059,Armour; Jon Christopher,30,0,32,2
1681910560999,BIPN 100,A03,192064,Armour; Jon Christopher,31,0,32,1
1681910560999,BIPN 100,A04,192073,Armour; Jon Christopher,28,0,32,4
1681910562027,BIPN 148,A01,205411,Leutgeb; Jill K.,16,0,32,16
1681910562027,BIPN 148,A02,205412,Leutgeb; Jill K.,31,0,32,1
1681910562027,BIPN 148,A03,205413,Leutgeb; Jill K.,30,0,32,2
1681910562027,BIPN 148,A04,205414,Leutgeb; Jill K.,30,0,32,2
1681910563057,BIPN 160,A01,192115,Marino; Marc J,19,0,32,13
1681910563057,BIPN 160,A02,192148,Marino; Marc J,27,0,32,5
1681910563057,BIPN 160,A03,192158,Marino; Marc J,31,0,32,1
1681910563057,BIPN 160,A04,192190,Marino; Marc J,32,0,32,0
1681910563057,BIPN 160,A05,192287,Marino; Marc J,32,0,32,0
1681910563057,BIPN 160,A06,192288,Marino; Marc J,32,0,32,0
1681910564086,BIPN 194,A00,206038,Staff,28,0,32,4
1681910565112,BISP 194,A00,192289,Leutgeb; Stefan,13,0,32,19
1681910565112,BISP 194,B00,245332,Nieh; James Charles,27,0,32,5
1681910566141,CAT 124,A01,202247,Staff,15,0,15,0
1681910567165,CAT 125,A00,202248,Staff,19,0,20,1
1681910567165,CAT 125,B00,202253,Staff,20,0,20,0
1681910567165,CAT 125,C00,202257,Staff,19,0,20,1
1681910568195,CAT 125GS,A01,202273,Bronstein; Phoebe Malan,20,0,20,0
1681910569228,CAT 125R,A00,202284,Staff,17,0,20,3
1681910569228,CAT 125R,C00,202286,Staff,10,0,20,10
1681910569228,CAT 125R,D00,202291,Staff,18,0,20,2
1681910569228,CAT 125R,E00,202295,Staff,13,0,20,7
1681910569228,CAT 125R,F00,202302,Staff,12,0,20,8
1681910570256,CENG 100,A00,204724,Opatkiewicz; Justin Paul,25,0,25,0
1681910571286,CGS 2A,A01,180420,Staff,31,0,36,5
1681910572310,CGS 101,A00,180421,Staff,16,0,20,4
1681910573335,CGS 112,A00,180422,Staff,10,0,16,6
1681910574365,CGS 113,A00,180423,Staff,18,0,20,2
1681910575397,CGS 137,A00,180424,Staff,12,0,12,0
1681910576446,CGS 147,A00,180425,Staff,10,0,10,0
1681910577484,CHEM 6A,A01,179556,Staff,97,0,100,3
1681910577484,CHEM 6A,A02,179558,Staff,0,0,0,0
1681910578511,CHEM 6B,A01,179560,Staff,100,0,100,0
1681910579535,CHEM 6C,A01,179565,Jazzar; Rodolphe,95,0,100,5
1681910580571,CHEM 7L,A01,179586,Schurmeier; Kimberly,13,0,24,11
1681910580571,CHEM 7L,A02,179587,Schurmeier; Kimberly,23,0,24,1
1681910580571,CHEM 7L,A03,179590,Schurmeier; Kimberly,22,0,24,2
1681910580571,CHEM 7L,A04,179591,Schurmeier; Kimberly,22,0,24,2
1681910580571,CHEM 7L,B01,179598,Schurmeier; Kimberly,17,0,24,7
1681910580571,CHEM 7L,B02,179599,Schurmeier; Kimberly,24,0,24,0
1681910580571,CHEM 7L,B03,179606,Schurmeier; Kimberly,23,0,24,1
1681910580571,CHEM 7L,B04,179607,Schurmeier; Kimberly,23,0,24,1
1681910581595,CHEM 11,A01,179609,Stallings; Dontarie M,88,0,100,12
1681910582620,CHEM 40A,A01,179621,Staff,41,0,50,9
1681910582620,CHEM 40A,A02,179622,Staff,47,0,50,3
1681910583645,CHEM 40B,A01,179630,Weizman; Haim,48,0,50,2
1681910583645,CHEM 40B,A02,179631,Weizman; Haim,45,0,50,5
1681910584671,CHEM 41A,A01,179660,Klosterman; Jeremy K,93,0,100,7
1681910585696,CHEM 43A,A01,179683,Klosterman; Jeremy K,0,0,24,24
1681910585696,CHEM 43A,A02,179688,Klosterman; Jeremy K,14,0,24,10
1681910585696,CHEM 43A,A03,179689,Klosterman; Jeremy K,20,0,24,4
1681910585696,CHEM 43A,A04,179691,Klosterman; Jeremy K,18,0,24,6
1681910586720,CHEM 114A,A01,179693,Stallings; Dontarie M,77,0,100,23
1681910587747,CHEM 143B,A01,179698,Weizman; Haim,17,0,24,7
1681910587747,CHEM 143B,A02,179700,Weizman; Haim,24,0,24,0
1681910588772,CHIN 169A,A00,179701,Wang; Xiao,20,0,20,0
1681910589801,COGS 2,A01,179750,Boyle; Mary E. T.,17,0,30,13
1681910590829,COGS 9,A01,179759,Jones; Cameron Robert,43,0,50,7
1681910591853,COGS 14A,A01,179854,Staff,18,0,50,32
1681910592877,COGS 14B,A01,179856,Staff,54,0,60,6
1681910593899,COGS 17,A01,179874,Staff,71,0,75,4
1681910594924,COGS 18,A01,179884,Staff,63,0,80,17
1681910595948,COGS 100,A01,179886,Staff,40,0,60,20
1681910596973,COGS 101B,A01,179892,Staff,1,0,30,29
1681910598000,COGS 101C,A01,179894,Staff,28,0,30,2
1681910599026,COGS 107A,A01,179896,Boyle; Mary E. T.,31,0,40,9
1681910600054,COGS 108,A01,179898,Simpkins; Charles Alexander,0,17,60,60
1681910601080,COGS 109,A01,179900,Staff,34,0,40,6
1681910602104,COGS 118A,A01,179946,Staff,9,0,40,31
1681910603135,COGS 153,A00,179978,Staff,1,0,30,29
1681910604162,COGS 156,A01,179981,Staff,27,0,30,3
1681910606211,COGS 172,A01,179987,Staff,13,0,30,17
1681910608264,COGS 186,A01,179991,Staff,13,0,30,17
1681910609289,COMM 10,A01,180001,Staff,15,0,25,10
1681910609289,COMM 10,A02,180004,Staff,20,0,25,5
1681910610313,COMM 100A,A01,180016,Staff,18,0,25,7
1681910610313,COMM 100A,A02,180020,Staff,24,0,25,1
1681910611338,COMM 101T,A00,180029,Halm; Gavin Patrick,23,0,35,12
1681910612365,COMM 106V,A00,180043,Staff,34,0,35,1
1681910613393,COMM 109P,A00,180044,Staff,31,0,35,4
1681910614424,COMM 113T,A00,180045,Havis; Allan,37,0,45,8
1681910615450,COMM 132,A00,180046,McKenna; Denise,23,0,30,7
1681910616477,COMM 143,A00,180047,Staff,19,0,30,11
1681910617513,COMM 190,A00,180048,Conner; Thomas Hartnell,20,0,23,3
1681910618538,CSE 8A,A50,180053,Cao; Yingjun,25,0,50,25
1681910618538,CSE 8A,B50,180180,Staff,50,0,50,0
1681910619564,CSE 11,A01,180190,Cao; Yingjun,31,0,50,19
1681910620588,CSE 20,A01,180192,Briones; Jor-el Thomas Caparas,23,0,30,7
1681910621614,CSE 21,A01,194538,Briones; Jor-el Thomas Caparas,50,0,60,10
1681910622641,CSE 30,A01,180324,Eldon; John,79,0,100,21
1681910623674,CSE 101,A01,201353,Staff,0,20,40,40
1681910624699,CSE 134B,A01,180326,Powell; Thomas Allan,74,0,100,26
1681910625723,CSE 140,A01,180328,Staff,46,0,75,29
1681910626751,CSE 140L,A01,180344,Eldon; John,69,0,100,31
1681910627777,CSE 150A,A01,180411,Staff,0,7,50,50
1681910628803,CSE 151A,A01,180414,Staff,0,6,50,50
1681910629837,CSE 175,A01,222521,Kumar; Rakesh,50,0,50,0
1681910630861,CSE 190,A00,201419,Staff,45,0,49,4
1681910631883,CSS 1,A01,194536,Staff,38,0,50,12
1681910632908,DSC 30,A01,202385,Staff,48,0,50,2
1681910633942,DSC 40A,A01,202387,Albuyeh; Rod,50,0,50,0
1681910634980,DSC 190,A01,202389,Silberman; Jack,21,0,21,0
1681910636002,DSGN 100,A01,179993,Staff,16,0,30,14
1681910637028,ECE 65,A50,180708,Staff,10,0,20,10
1681910637028,ECE 65,A51,180739,Staff,19,0,20,1
1681910638052,ECON 1,A01,180427,Famulari; Melissa,67,0,70,3
1681910639077,ECON 2,A01,180450,Levkoff; Steven B.,64,0,70,6
1681910640102,ECON 4,A01,203351,Anderson; John Charles,7,0,10,3
1681910641127,ECON 100A,A01,180472,Famulari; Melissa,65,0,70,5
1681910642155,ECON 120A,A01,180549,Staff,64,0,70,6
1681910643179,ECON 120B,A01,180655,Ma; Xinwei,46,0,70,24
1681910644207,ECON 129,A00,203333,Eckert; Fabian Paul,15,0,35,20
1681910645231,ECON 131,A00,180656,Staff,9,0,35,26
1681910646254,ECON 172B,A01,180672,Levkoff; Steven B.,32,0,35,3
1681910647282,ECON 178,A01,203342,Zhu; Ying,11,0,35,24
1681910648305,EDS 108GS,A00,202383,Wishard Guerra; Alison G.,20,0,20,0
1681910649337,EDS 111GS,A00,202347,Wishard Guerra; Alison G.,20,0,20,0
1681910650364,EDS 112,A01,202323,Staff,56,0,60,4
1681910651388,EDS 113,A00,202340,Staff,33,0,35,2
1681910652416,EDS 118,A00,201231,Staff,20,0,30,10
1681910653446,EDS 119,A00,204994,Staff,8,0,10,2
1681910654468,EDS 124BR,A00,202324,Eguchi; Emi,5,0,25,20
1681910655491,EDS 126,A01,203208,Jones; Makeba,26,0,30,4
1681910656518,EDS 135,A01,202333,Staff,18,0,20,2
1681910657542,EDS 180,A00,202311,Staff,47,0,50,3
1681910658653,ERC 190GS,A01,253747,Staff,28,0,28,0
1681910659677,ETHN 104,A00,180742,Staff,24,0,35,11
1681910660710,ETHN 118,A00,180745,Staff,28,0,35,7
1681910661737,ETHN 127,A00,180747,Staff,12,0,16,4
1681910662761,ETHN 137,A00,180880,Staff,12,0,12,0
1681910663784,ETHN 147,A00,180890,Staff,8,0,10,2
1681910664810,ETHN 154,A00,180891,Staff,7,0,8,1
1681910665835,ETHN 168,A00,180892,Staff,9,0,10,1
1681910666863,GLBH 20,A00,201051,Hannah; Seth Donal,0,1,0,1
1681910667886,GLBH 111,A01,209338,Burgos; Jose L.,0,0,0,0
1681910668909,GLBH 150,A00,258300,Staff,0,3,0,0
1681910669933,GLBH 181,A00,201207,Staff,15,0,40,25
1681910670959,HIEU 109,A00,180898,Staff,20,0,20,0
1681910671987,HIEU 111,A00,180899,Staff,1,0,20,19
1681910673009,HIEU 124,A00,180900,Staff,18,0,20,2
1681910674034,HILA 122,A00,180901,Staff,18,0,20,2
1681910675057,HILA 132,A00,180902,Vitz; Matthew,2,0,20,18
1681910676081,HILD 10,A01,180896,Staff,15,0,20,5
1681910677107,HILD 30GS,A00,180897,Edington; Claire Ellen,0,0,0,0
1681910678137,HISC 105,A00,180903,Staff,20,0,20,0
1681910679161,HISC 117,A00,180904,Staff,11,0,20,9
1681910680194,HIUS 108B,A00,181005,Staff,18,0,20,2
1681910681220,HIUS 113,A00,181093,Staff,4,0,20,16
1681910682246,HUM 3,A01,181190,Patterson; Patrick H.,40,0,50,10
1681910682246,HUM 3,B01,181195,Staff,47,0,50,3
1681910683269,HUM 3GS,A00,181196,Herbst; Matthew,0,0,0,0
1681910684294,HUM 4,A01,181227,West; Geoffrey Scott,34,0,50,16
1681910684294,HUM 4,B01,181282,Staff,43,0,50,7
1681910685319,HUM 4GS,A00,181377,Lyon; Antony J.,0,0,0,0
1681910686350,HUM 5,A01,181536,Zavodny; Tatiana Sophia,31,0,50,19
1681910686350,HUM 5,B01,181908,Staff,36,0,50,14
1681910687375,INTL 190,A00,181909,Segui; Alan S,0,0,0,6
1681910687375,INTL 190,B00,181961,Segui; Alan S,0,0,0,7
1681910688399,JAPN 20AR,A01,182113,Ross; Kayoko F,15,0,20,5
1681910689425,LATI 50,A01,202391,Martin-Cabrera; Luis,19,0,30,11
1681910689425,LATI 50,A02,202392,Martin-Cabrera; Luis,26,0,30,4
1681910690452,LATI 180,A00,202393,Kokinis; Troy Andreas,25,0,25,0
1681910691477,LIFR 1A,A00,182119,Staff,14,0,14,0
1681910692506,LIFR 1AX,A00,182324,Staff,14,0,14,0
1681910693530,LIFR 1B,A00,182259,Staff,14,0,14,0
1681910694554,LIFR 1BX,A00,182273,Staff,14,0,14,0
1681910695578,LIGN 8,A00,182330,Staff,137,0,150,13
1681910696600,LIGN 9GS,A00,182362,Staff,20,0,20,0
1681910697625,LIGN 119,A00,204992,Takahashi; Maho,12,0,15,3
1681910698648,LIGN 130,A01,182384,Staff,47,0,50,3
1681910699670,LIGN 149GS,A00,182390,Staff,20,0,20,0
1681910700696,LIGN 170,A00,182404,Staff,24,0,30,6
1681910701729,LISP 1D,A00,182281,Staff,7,0,14,7
1681910701729,LISP 1D,B00,182287,Staff,14,0,14,0
1681910701729,LISP 1D,C00,182295,Staff,11,0,14,3
1681910701729,LISP 1D,D00,182301,Staff,14,0,14,0
1681910702752,LISP 1DX,A00,182309,Staff,20,0,28,8
1681910702752,LISP 1DX,B00,182316,Staff,26,0,28,2
1681910703784,LTAF 120GS,A00,182412,Zhiri; Oumelbanine,20,0,20,0
1681910704812,LTCS 172GS,A00,182437,Bronstein; Phoebe Malan,20,0,20,0
1681910705848,LTEA 138,A00,182457,Staff,22,0,40,18
1681910706872,LTEN 114,A01,182490,Staff,23,0,25,2
1681910707898,LTEN 130GS,A00,182491,Lyon; Antony J.,20,0,20,0
1681910708925,LTEN 169,A00,182493,Cuong; Marisol,20,0,25,5
1681910709948,LTEN 178,A00,182501,Staff,14,0,15,1
1681910710973,LTEN 181,A00,182515,Staff,22,0,25,3
1681910711998,LTEN 185GS,A00,197655,Forbes; Camille,20,0,20,0
1681910713023,LTSP 100B,A00,202208,Bessett; Ryan Matthew,24,0,25,1
1681910714047,LTWL 100,A00,182516,Myerston Santana; Jacobo,23,0,30,7
1681910715070,LTWR 100GS,A00,182518,Forbes; Camille,20,0,20,0
1681910716097,LTWR 102,A00,182522,Staff,15,0,15,0
1681910716097,LTWR 102,B00,182525,Staff,14,0,15,1
1681910717123,LTWR 115,A00,182526,Staff,12,0,15,3
1681910718155,MAE 8,A01,182528,Pham; Hieu Tan,68,0,70,2
1681910719178,MAE 11,A00,182529,Bahadori; Mohammad Yousef,94,0,100,6
1681910720201,MAE 20,A00,182530,Evdokimenko; Ekaterina,68,0,70,2
1681910721233,MAE 30A,A00,182532,Staff,44,0,45,1
1681910722268,MAE 101A,A00,182533,Bahadori; Mohammad Yousef,97,0,100,3
1681910723301,MAE 101C,A00,182538,Staff,62,0,70,8
1681910724333,MAE 104,A00,182539,Staff,45,0,50,5
1681910725361,MAE 131A,A00,182540,Ghazinejad; Maziar,41,0,45,4
1681910726383,MAE 143A,A00,182548,Bewley; Thomas R,43,0,50,7
1681910727406,MAE 150,A00,182549,Staff,28,0,40,12
1681910728428,MAE 160,A00,182550,Evdokimenko; Ekaterina,43,0,60,17
1681910729454,MATH 3C,A01,182725,Staff,27,0,30,3
1681910730481,MATH 10A,A01,182729,Staff,25,0,30,5
1681910730481,MATH 10A,B01,182732,Staff,26,0,30,4
1681910731506,MATH 10B,A01,182737,Staff,21,0,30,9
1681910731506,MATH 10B,A02,182738,Staff,27,0,30,3
1681910731506,MATH 10B,B01,182744,Staff,27,0,30,3
1681910731506,MATH 10B,B02,182745,Staff,27,0,30,3
1681910732529,MATH 18,A01,182750,Anzaldo; Leesa B,28,0,30,2
1681910732529,MATH 18,A02,182751,Anzaldo; Leesa B,29,0,30,1
1681910732529,MATH 18,A03,182753,Anzaldo; Leesa B,28,0,30,2
1681910732529,MATH 18,A04,182757,Anzaldo; Leesa B,29,0,30,1
1681910732529,MATH 18,B01,182761,Anzaldo; Leesa B,27,0,30,3
1681910732529,MATH 18,B02,182764,Anzaldo; Leesa B,27,0,30,3
1681910732529,MATH 18,B03,182765,Anzaldo; Leesa B,30,0,30,0
1681910732529,MATH 18,B04,182766,Anzaldo; Leesa B,30,0,30,0
1681910733557,MATH 20A,A01,182771,Suk; Andrew Hoon,28,0,30,2
1681910734586,MATH 20B,A01,182775,Bach; Quang Tran,30,0,30,0
1681910734586,MATH 20B,A02,182777,Bach; Quang Tran,29,0,30,1
1681910734586,MATH 20B,B01,182780,Bach; Quang Tran,27,0,30,3
1681910734586,MATH 20B,B02,182782,Bach; Quang Tran,30,0,30,0
1681910735609,MATH 20C,A01,182787,Staff,25,0,30,5
1681910735609,MATH 20C,A02,182790,Staff,29,0,30,1
1681910735609,MATH 20C,B01,182792,Staff,25,0,30,5
1681910735609,MATH 20C,B02,182796,Staff,27,0,30,3
1681910736633,MATH 20D,A01,182799,Staff,29,0,30,1
1681910736633,MATH 20D,A02,182802,Staff,30,0,30,0
1681910736633,MATH 20D,A03,182803,Staff,30,0,30,0
1681910737661,MATH 20E,A01,182809,Verstraete; Jacques Allan,24,0,30,6
1681910737661,MATH 20E,A02,182811,Verstraete; Jacques Allan,28,0,30,2
1681910737661,MATH 20E,B01,182814,Verstraete; Jacques Allan,23,0,30,7
1681910737661,MATH 20E,B02,182815,Verstraete; Jacques Allan,30,0,30,0
1681910738685,MATH 103A,A01,182820,Staff,9,0,30,21
1681910738685,MATH 103A,A02,182821,Staff,27,0,30,3
1681910738685,MATH 103A,A03,182822,Staff,23,0,30,7
1681910738685,MATH 103A,B01,182825,Staff,23,0,30,7
1681910738685,MATH 103A,B02,182826,Staff,30,0,30,0
1681910738685,MATH 103A,B03,182830,Staff,30,0,30,0
1681910739711,MATH 109,A01,182836,Chow; Bennett,24,0,30,6
1681910739711,MATH 109,A02,182838,Chow; Bennett,29,0,30,1
1681910739711,MATH 109,A03,182894,Chow; Bennett,29,0,30,1
1681910739711,MATH 109,B01,182908,Chow; Bennett,28,0,30,2
1681910739711,MATH 109,B02,182909,Chow; Bennett,30,0,30,0
1681910739711,MATH 109,B03,182910,Chow; Bennett,27,0,30,3
1681910740739,MATH 142A,A01,182925,Staff,11,0,30,19
1681910740739,MATH 142A,A02,182935,Staff,25,0,30,5
1681910740739,MATH 142A,A03,182967,Staff,26,0,30,4
1681910740739,MATH 142A,B01,183125,Staff,24,0,30,6
1681910740739,MATH 142A,B02,183157,Staff,28,0,30,2
1681910740739,MATH 142A,B03,183158,Staff,29,0,30,1
1681910741762,MATH 183,A01,183160,Arias-Castro; Ery,23,0,30,7
1681910741762,MATH 183,A02,183161,Arias-Castro; Ery,29,0,30,1
1681910741762,MATH 183,B01,183163,Arias-Castro; Ery,28,0,30,2
1681910741762,MATH 183,B02,183164,Arias-Castro; Ery,28,0,30,2
1681910742788,MATH 193A,A01,183167,Staff,4,0,35,31
1681910742788,MATH 193A,A02,183168,Staff,28,0,35,7
1681910742788,MATH 193A,A03,183169,Staff,34,0,35,1
1681910742788,MATH 193A,A04,183170,Staff,28,0,35,7
1681910743815,MGT 4,A01,202395,Anderson; John Charles,75,0,80,5
1681910744840,MGT 5,A00,202396,Houskeeper; Robert,80,0,90,10
1681910745865,MGT 103,A00,202397,Eberhard; Craig A,55,0,90,35
1681910746889,MGT 131A,A00,202398,Houskeeper; Robert,85,0,90,5
1681910747915,MGT 135,A00,202399,Anderson; John Charles,82,0,90,8
1681910748945,MGT 162R,A00,202403,Gneezy; Uri,150,0,200,50
1681910749971,MGT 172,A00,202404,Hedges; Kathleen,50,0,90,40
1681910750993,MGT 181,A00,202405,Dunn; Louis Jean,84,0,90,6
1681910752016,MMW 14,A01,183200,Staff,16,0,28,12
1681910752016,MMW 14,A02,183201,Staff,26,0,28,2
1681910752016,MMW 14,A03,183202,Staff,24,0,28,4
1681910752016,MMW 14,A04,183203,Staff,25,0,28,3
1681910752016,MMW 14,A05,183204,Staff,26,0,28,2
1681910752016,MMW 14,A06,183205,Staff,27,0,28,1
1681910752016,MMW 14,B01,183207,Staff,26,0,28,2
1681910752016,MMW 14,B02,183208,Staff,28,0,28,0
1681910752016,MMW 14,B03,183209,Staff,28,0,28,0
1681910752016,MMW 14,B04,183210,Staff,28,0,28,0
1681910752016,MMW 14,B05,183211,Staff,28,0,28,0
1681910752016,MMW 14,B06,183212,Staff,28,0,28,0
1681910753041,MMW 14GS,A00,183213,Zhiri; Oumelbanine,28,0,28,0
1681910754067,MMW 15GS,B00,183215,Rahimi; Babak,28,0,28,0
1681910755095,MMW 121,A01,183217,Patterson; Patrick H.,14,0,28,14
1681910755095,MMW 121,A02,183218,Patterson; Patrick H.,25,0,28,3
1681910756119,MUS 1A,A01,182554,Staff,8,0,35,27
1681910757144,MUS 5,A01,182558,Staff,20,0,35,15
1681910758167,MUS 6,A01,182562,Staff,25,0,35,10
1681910759190,MUS 8GS,A00,182563,Borgo; David Garcia,25,0,25,0
1681910760213,MUS 13,A01,182567,Staff,24,0,25,1
1681910761242,MUS 15,A01,182570,Staff,32,0,35,3
1681910761242,MUS 15,B01,182575,Staff,10,0,35,25
1681910762345,MUS 80,A00,182578,Staff,23,0,25,2
1681910762345,MUS 80,B00,182581,Staff,20,0,25,5
1681910763369,MUS 113,A00,182582,Staff,25,0,25,0
1681910764393,MUS 114,A00,182583,Staff,4,0,25,21
1681910765417,MUS 150GS,A01,182588,Borgo; David Garcia,25,0,25,0
1681910766441,PHIL 1,A00,182590,Staff,35,0,40,5
1681910767463,PHIL 10,A01,182596,Grush; Rick Scott,31,0,35,4
1681910767463,PHIL 10,A02,182597,Grush; Rick Scott,34,0,35,1
1681910768495,PHIL 15,A01,182601,Staff,31,0,35,4
1681910768495,PHIL 15,A02,182602,Staff,33,0,35,2
1681910769519,PHIL 27,A01,182604,Staff,30,0,35,5
1681910769519,PHIL 27,A02,182607,Staff,35,0,35,0
1681910770543,PHIL 32,A01,182609,Staff,35,0,35,0
1681910770543,PHIL 32,A02,182612,Staff,35,0,35,0
1681910771567,PHIL 130,A00,182614,Staff,63,0,70,7
1681910772590,PHIL 136,A00,182616,Cohen; Jonathan David,66,0,70,4
1681910773613,PHIL 155,A00,182617,Vargas; Manuel Rogelio,60,0,70,10
1681910774645,PHIL 163,A01,182620,Staff,15,0,20,5
1681910774645,PHIL 163,A02,182624,Staff,10,0,20,10
1681910775668,PHIL 164,A00,182627,Staff,30,0,40,10
1681910776690,PHIL 173,A00,182628,Staff,36,0,40,4
1681910777715,PHYS 1A,A00,183221,Staff,54,0,60,6
1681910778742,PHYS 1AL,001,183222,Staff,25,0,30,5
1681910778742,PHYS 1AL,002,183223,Staff,28,0,30,2
1681910779767,PHYS 1B,A00,183231,Staff,44,0,60,16
1681910780794,PHYS 1BL,001,183232,Staff,20,0,30,10
1681910780794,PHYS 1BL,002,183233,Staff,29,0,30,1
1681910781820,PHYS 1C,A00,183240,Staff,30,0,60,30
1681910782844,PHYS 1CL,001,183241,Staff,13,0,30,17
1681910782844,PHYS 1CL,002,183242,Staff,22,0,30,8
1681910783868,PHYS 2AR,A01,183250,Staff,44,0,50,6
1681910784890,PHYS 2B,A01,183252,Staff,106,0,115,9
1681910785913,PHYS 2BL,A01,183254,Staff,21,0,24,3
1681910785913,PHYS 2BL,A02,183255,Staff,22,0,24,2
1681910786937,PHYS 2C,A01,183522,Staff,105,0,115,10
1681910787961,PHYS 4A,A01,183524,Staff,49,0,50,1
1681910788988,POLI 5,A00,183525,Staff,44,0,50,6
1681910790014,POLI 12,A00,183540,Staff,48,0,50,2
1681910791039,POLI 13R,A00,183541,Forman; Fonna,42,0,50,8
1681910792063,POLI 30,A00,183542,Mignozzetti; Umberto,47,0,50,3
1681910793087,POLI 100A,A00,183543,Staff,45,0,50,5
1681910794116,POLI 100E,A00,223598,Staff,32,0,35,3
1681910795142,POLI 103A,A00,183564,Kousser; Thad,38,0,50,12
1681910796164,POLI 104B,A00,201329,Staff,29,0,35,6
1681910797188,POLI 113BR,A00,183576,Hoston; Germaine,28,0,50,22
1681910798212,POLI 114BR,A00,183588,Staff,27,0,30,3
1681910799235,POLI 117R,A00,183595,Forman; Fonna,9,0,20,11
1681910800264,POLI 120H,A00,183596,Fisk; David Lee,13,0,20,7
1681910801289,POLI 130AA,A00,183597,Staff,14,0,20,6
1681910802312,POLI 134AA,A00,183598,Staff,19,0,20,1
1681910803335,POLI 135,A00,183599,Fisk; David Lee,20,0,25,5
1681910804360,POLI 142P,A00,183623,Staff,37,0,40,3
1681910805386,POLI 144D,A00,183624,Staff,22,0,25,3
1681910806413,POLI 151,A00,183625,Staff,15,0,20,5
1681910807436,POLI 162,A00,183626,Mignozzetti; Umberto,18,0,20,2
1681910808474,PSYC 1,A00,253748,Staff,86,0,90,4
1681910809503,PSYC 2,A00,183627,Moranton; Nirelia Melbina-,25,0,35,10
1681910810530,PSYC 3,A00,183628,Staff,43,0,45,2
1681910812579,PSYC 60,A01,183631,Lowe; Angela Beth,35,0,40,5
1681910813604,PSYC 70,A01,253757,Staff,37,0,45,8
1681910814627,PSYC 101,A00,183632,Heyman; Gail D.,48,0,60,12
1681910815653,PSYC 105,A00,183848,Lowe; Angela Beth,50,0,60,10
1681910816683,PSYC 106,A00,183849,Dobkins; Karen R.,45,0,60,15
1681910817716,PSYC 108,A00,253750,Staff,24,0,60,36
1681910818743,PSYC 114,A01,184275,Winkielman; Piotr,0,6,30,30
1681910819775,PSYC 122,A00,183856,Moranton; Nirelia Melbina-,0,10,30,30
1681910820797,PSYC 124,A00,183865,Chapman; Eddie Nathaniel,52,0,80,28
1681910821821,PSYC 137,A00,183880,Staff,19,0,25,6
1681910823876,PSYC 154,A00,183910,Lacefield; Katharine I,0,2,90,90
1681910825925,PSYC 162,A00,183946,Wixted; John T,61,0,90,29
1681910826953,PSYC 172,A00,183947,Gorman; Michael R.,14,0,30,16
1681910827979,PSYC 178,A00,183963,Glaser; Dale,20,0,40,20
1681910829002,PSYC 181GS,A00,183964,Anagnostaras; Stephan,10,0,10,0
1681910830026,PSYC 186GS,A01,257660,Staff,10,0,10,0
1681910831053,PSYC 193,B00,253749,Staff,23,0,25,2
1681910833100,PSYC 193L,A01,184122,Staff,33,0,35,2
1681910833100,PSYC 193L,C01,184167,Winkielman; Piotr,16,0,30,14
1681910834123,RELI 188GS,A00,182629,Rahimi; Babak,20,0,20,0
1681910835150,SE 101A,A00,182646,Staff,26,0,30,4
1681910836174,SE 101C,A00,182650,Staff,18,0,20,2
1681910837197,SE 110A,A00,182651,Staff,28,0,28,0
1681910838220,SE 130A,A00,182652,Staff,39,0,40,1
1681910839244,SIO 46GS,A00,182636,Cook; Geoffrey W,28,0,28,0
1681910840269,SIO 109R,A00,194459,Staff,5,0,20,15
1681910841292,SIO 121GS,A00,182639,Cook; Geoffrey W,28,0,28,0
1681910842319,SIO 132,A01,182642,Staff,32,0,40,8
1681910843342,SIO 139,A00,182644,Kacev; David,36,0,40,4
1681910844367,SOCI 2,A01,258404,Staff,34,0,36,2
1681910844367,SOCI 2,A02,258405,Staff,35,0,36,1
1681910845395,SOCI 60,A01,258408,Staff,29,0,30,1
1681910845395,SOCI 60,A02,258413,Staff,30,0,30,0
1681910846428,SOCI 100,A01,258415,Staff,29,0,30,1
1681910846428,SOCI 100,A02,258416,Staff,28,0,30,2
1681910852580,SOCI 127,A00,258421,Staff,22,0,30,8
1681910853604,SOCI 132,A00,258422,Staff,45,0,50,5
1681910854631,SOCI 133,A00,258423,Staff,26,0,30,4
1681910855655,SOCI 138GS,A00,258424,Staff,15,0,15,0
1681910856683,SOCI 145,A00,258425,Staff,25,0,30,5
1681910857710,SOCI 148,A00,258426,Staff,26,0,30,4
1681910858734,SOCI 153,A00,199217,Staff,29,0,30,1
1681910859756,SOCI 160,A00,258427,Staff,28,0,30,2
1681910860783,SOCI 160E,A00,258435,Staff,56,0,60,4
1681910861808,SOCI 189GS,A00,258436,Staff,15,0,15,0
1681910862831,SOCI 190GS,A00,258437,Staff,15,0,15,0
1681910863855,SYN 2,001,182658,Staff,9,0,16,7
1681910863855,SYN 2,002,201439,Staff,15,0,16,1
1681910863855,SYN 2,003,201443,Staff,16,0,16,0
1681910864882,SYN 100,A01,182657,Staff,17,0,20,3
1681910865983,TDAC 1,A00,184381,Salovey; Todd,16,0,20,4
1681910865983,TDAC 1,B00,184385,Harting; Carla Kelso,19,0,20,1
1681910865983,TDAC 1,C00,184394,Staff,19,0,20,1
1681910867007,TDAC 101,A00,184483,Harting; Carla Kelso,19,0,20,1
1681910868031,TDDE 111,A00,184496,Staff,14,0,15,1
1681910869060,TDDE 131,A00,184504,Staff,20,0,20,0
1681910869060,TDDE 131,B00,184505,Staff,17,0,18,1
1681910869060,TDDE 131,C00,184534,Staff,49,0,50,1
1681910869060,TDDE 131,D00,184564,Staff,15,0,15,0
1681910869060,TDDE 131,E00,204725,Staff,19,0,20,1
1681910870084,TDGE 1,A01,184414,Salovey; Todd,37,0,50,13
1681910871108,TDGE 5,A01,184419,Staff,23,0,24,1
1681910872136,TDGE 10,A00,184428,Fulton; Julia,31,0,50,19
1681910873163,TDGE 124,A00,184565,Fulton; Julia,7,0,50,43
1681910874186,TDGE 125,B00,184567,Meyer; Ursula,9,0,25,16
1681910875211,TDHT 101,A00,184568,Staff,21,0,25,4
1681910875211,TDHT 101,B00,184569,Staff,20,0,20,0
1681910876237,TDHT 114,A00,184570,Staff,49,0,50,1
1681910877260,TDMV 1,A00,184437,Arcidiacono; Kristin,23,0,30,7
1681910877260,TDMV 1,B00,184448,Caligagan; Maria T.,22,0,30,8
1681910878284,TDMV 2,A00,184449,Weinberg; Sadie,27,0,30,3
1681910878284,TDMV 2,B00,184453,Arcidiacono; Kristin,29,0,30,1
1681910879308,TDMV 110,A00,184571,Weinberg; Sadie,30,0,30,0
1681910880334,TDMV 142,A00,184572,Caligagan; Tony,27,0,30,3
1681910880334,TDMV 142,B00,184573,Caligagan; Maria T.,27,0,30,3
1681910881362,TDTR 20,A00,184482,Jun; Grace Shin Hae,25,0,25,0
1681910882383,USP 2,A01,184290,Hinds; Juli Beth,24,0,25,1
1681910883407,USP 3,A01,184295,Staff,20,0,25,5
1681910884435,USP 4,A00,184304,McTague; Sarah,15,0,25,10
1681910885459,USP 100,A00,184315,Staff,17,0,25,8
1681910886483,USP 105,A00,184326,Staff,21,0,25,4
1681910887517,USP 151,A00,184327,Staff,20,0,25,5
1681910888546,USP 170,A00,184380,Hinds; Juli Beth,14,0,25,11
1681910889573,VIS 21B,A01,182660,Staff,28,0,31,3
1681910889573,VIS 21B,A02,182662,Staff,30,0,31,1
1681910890596,VIS 103D,A00,182663,Staff,74,0,75,1
1681910891623,VIS 105D,A00,182667,Li; Huai,15,0,22,7
1681910892647,VIS 122GS,A00,182668,Herbst; Matthew,20,0,20,0
1681910893681,VIS 128C,A00,182673,Staff,69,0,75,6
1681910894703,VIS 130,A00,182675,Staff,20,0,22,2
1681910895739,VIS 160A,A00,182678,Stalbaum; Brett,4,0,10,6
1681910897787,WCWP 10B,A00,201679,Staff,15,0,15,0
1681910897787,WCWP 10B,B00,201695,Staff,15,0,15,0
1681910898810,WCWP 100,A00,201716,Staff,15,0,15,0
1681910898810,WCWP 100,B00,201717,Staff,11,0,15,4
1681910900881,ANSC 105GS,A00,258289,Staff,0,0,0,0
1681910901905,ANSC 125GS,A00,258295,Staff,0,0,0,0
1681910902928,ANSC 150,A00,258267,Staff,30,0,40,10
1681910903954,ANSC 190GS,A00,258280,Staff,0,0,0,0
1681910904977,ANTH 1,A00,258264,Staff,38,0,40,2
1681910906006,ANTH 2,A01,258259,Staff,72,0,76,4
1681910907029,ANTH 23,A01,258228,Staff,36,0,40,4
1681910908055,ANTH 101,A01,258236,Staff,39,0,40,1
1681910909090,ANTH 102,A00,258272,Staff,59,0,60,1
1681910910116,ANTH 105,A00,258244,Staff,31,0,35,4
1681910911138,BENG 130,A00,253975,Staff,38,0,40,2
1681910912166,BIBC 102,A01,191866,Flagg; Matthew Paul,19,0,32,13
1681910912166,BIBC 102,A02,191867,Flagg; Matthew Paul,22,0,32,10
1681910912166,BIBC 102,A03,191868,Flagg; Matthew Paul,30,0,32,2
1681910912166,BIBC 102,A04,191936,Flagg; Matthew Paul,26,0,32,6
1681910912166,BIBC 102,A05,191937,Flagg; Matthew Paul,11,0,32,21
1681910913190,BICD 100,A01,191939,Cooper; Andrew Michael,28,0,32,4
1681910913190,BICD 100,A02,191940,Cooper; Andrew Michael,32,0,32,0
1681910913190,BICD 100,A03,191941,Cooper; Andrew Michael,32,0,32,0
1681910913190,BICD 100,A04,191942,Cooper; Andrew Michael,32,0,32,0
1681910913190,BICD 100,A05,191943,Cooper; Andrew Michael,32,0,32,0
1681910914213,BIEB 126,A01,191945,Cleland; Elsa Eleanor,1,0,32,31
1681910914213,BIEB 126,A02,191946,Cleland; Elsa Eleanor,28,0,32,4
1681910914213,BIEB 126,A03,191947,Cleland; Elsa Eleanor,29,0,32,3
1681910914213,BIEB 126,A04,191948,Cleland; Elsa Eleanor,23,0,32,9
1681910914213,BIEB 126,A05,191996,Cleland; Elsa Eleanor,28,0,32,4
1681910915240,BIEB 136GS,A00,191997,Shurin; Jonathan & Holway; David A.,0,0,0,0
1681910916266,BIEB 137GS,A01,191999,Shurin; Jonathan & Holway; David A.,0,0,0,0
1681910917289,BILD 1,A01,205385,Staff,31,0,32,1
1681910917289,BILD 1,A02,205386,Staff,30,0,32,2
1681910917289,BILD 1,A03,205387,Staff,32,0,32,0
1681910917289,BILD 1,A04,205388,Staff,28,0,32,4
1681910918311,BILD 2,A01,191774,Staff,28,0,32,4
1681910918311,BILD 2,A02,191775,Staff,30,0,32,2
1681910918311,BILD 2,A03,191777,Staff,30,0,32,2
1681910918311,BILD 2,A04,191856,Staff,31,0,32,1
1681910918311,BILD 2,A05,191857,Staff,32,0,32,0
1681910918311,BILD 2,A06,191858,Staff,32,0,32,0
1681910918311,BILD 2,A07,191859,Staff,31,0,32,1
1681910919337,BILD 3,A01,205391,Staff,29,0,32,3
1681910919337,BILD 3,A02,205393,Staff,32,0,32,0
1681910919337,BILD 3,A03,205394,Staff,28,0,32,4
1681910919337,BILD 3,A04,205395,Staff,32,0,32,0
1681910920365,BILD 20,A01,191861,Staff,32,0,32,0
1681910920365,BILD 20,A02,191862,Staff,32,0,32,0
1681910921391,BILD 30,A01,191864,Staff,31,0,32,1
1681910922415,BIMM 100,A01,192019,Staff,0,0,32,32
1681910922415,BIMM 100,A02,192020,Staff,23,0,32,9
1681910922415,BIMM 100,A03,192035,Staff,22,0,32,10
1681910923437,BIMM 110,A01,192037,Tat; John,0,0,32,32
1681910923437,BIMM 110,A02,192038,Tat; John,10,0,32,22
1681910924463,BIMM 120,A01,192040,Pickett; Brooke Elizabeth,2,0,32,30
1681910924463,BIMM 120,A02,192041,Pickett; Brooke Elizabeth,16,0,32,16
1681910924463,BIMM 120,A03,192042,Pickett; Brooke Elizabeth,16,0,32,16
1681910925486,BIPN 100,A01,192044,Armour; Jon Christopher,26,0,32,6
1681910925486,BIPN 100,A02,192059,Armour; Jon Christopher,30,0,32,2
1681910925486,BIPN 100,A03,192064,Armour; Jon Christopher,31,0,32,1
1681910925486,BIPN 100,A04,192073,Armour; Jon Christopher,28,0,32,4
1681910926509,BIPN 148,A01,205411,Leutgeb; Jill K.,16,0,32,16
1681910926509,BIPN 148,A02,205412,Leutgeb; Jill K.,31,0,32,1
1681910926509,BIPN 148,A03,205413,Leutgeb; Jill K.,30,0,32,2
1681910926509,BIPN 148,A04,205414,Leutgeb; Jill K.,30,0,32,2
1681910927532,BIPN 160,A01,192115,Marino; Marc J,19,0,32,13
1681910927532,BIPN 160,A02,192148,Marino; Marc J,27,0,32,5
1681910927532,BIPN 160,A03,192158,Marino; Marc J,31,0,32,1
1681910927532,BIPN 160,A04,192190,Marino; Marc J,32,0,32,0
1681910927532,BIPN 160,A05,192287,Marino; Marc J,32,0,32,0
1681910927532,BIPN 160,A06,192288,Marino; Marc J,32,0,32,0
1681910928555,BIPN 194,A00,206038,Staff,28,0,32,4
1681910929580,BISP 194,A00,192289,Leutgeb; Stefan,13,0,32,19
1681910929580,BISP 194,B00,245332,Nieh; James Charles,27,0,32,5
1681910930606,CAT 124,A01,202247,Staff,15,0,15,0
1681910931630,CAT 125,A00,202248,Staff,19,0,20,1
1681910931630,CAT 125,B00,202253,Staff,20,0,20,0
1681910931630,CAT 125,C00,202257,Staff,19,0,20,1
1681910933190,CAT 125GS,A01,202273,Bronstein; Phoebe Malan,20,0,20,0
1681910934219,CAT 125R,A00,202284,Staff,17,0,20,3
1681910934219,CAT 125R,C00,202286,Staff,10,0,20,10
1681910934219,CAT 125R,D00,202291,Staff,18,0,20,2
1681910934219,CAT 125R,E00,202295,Staff,13,0,20,7
1681910934219,CAT 125R,F00,202302,Staff,12,0,20,8
1681910935251,CENG 100,A00,204724,Opatkiewicz; Justin Paul,25,0,25,0
1681910936279,CGS 2A,A01,180420,Staff,31,0,36,5
1681910937305,CGS 101,A00,180421,Staff,16,0,20,4
1681910938328,CGS 112,A00,180422,Staff,10,0,16,6
1681910939354,CGS 113,A00,180423,Staff,18,0,20,2
1681910940382,CGS 137,A00,180424,Staff,12,0,12,0
1681910941405,CGS 147,A00,180425,Staff,10,0,10,0
1681910942429,CHEM 6A,A01,179556,Staff,97,0,100,3
1681910942429,CHEM 6A,A02,179558,Staff,0,0,0,0
1681910943456,CHEM 6B,A01,179560,Staff,100,0,100,0
1681910944478,CHEM 6C,A01,179565,Jazzar; Rodolphe,95,0,100,5
1681910945501,CHEM 7L,A01,179586,Schurmeier; Kimberly,13,0,24,11
1681910945501,CHEM 7L,A02,179587,Schurmeier; Kimberly,23,0,24,1
1681910945501,CHEM 7L,A03,179590,Schurmeier; Kimberly,22,0,24,2
1681910945501,CHEM 7L,A04,179591,Schurmeier; Kimberly,22,0,24,2
1681910945501,CHEM 7L,B01,179598,Schurmeier; Kimberly,17,0,24,7
1681910945501,CHEM 7L,B02,179599,Schurmeier; Kimberly,24,0,24,0
1681910945501,CHEM 7L,B03,179606,Schurmeier; Kimberly,23,0,24,1
1681910945501,CHEM 7L,B04,179607,Schurmeier; Kimberly,23,0,24,1
1681910946525,CHEM 11,A01,179609,Stallings; Dontarie M,88,0,100,12
1681910947548,CHEM 40A,A01,179621,Staff,41,0,50,9
1681910947548,CHEM 40A,A02,179622,Staff,47,0,50,3
1681910948572,CHEM 40B,A01,179630,Weizman; Haim,48,0,50,2
1681910948572,CHEM 40B,A02,179631,Weizman; Haim,45,0,50,5
1681910949599,CHEM 41A,A01,179660,Klosterman; Jeremy K,93,0,100,7
1681910950628,CHEM 43A,A01,179683,Klosterman; Jeremy K,0,0,24,24
1681910950628,CHEM 43A,A02,179688,Klosterman; Jeremy K,14,0,24,10
1681910950628,CHEM 43A,A03,179689,Klosterman; Jeremy K,20,0,24,4
1681910950628,CHEM 43A,A04,179691,Klosterman; Jeremy K,18,0,24,6
1681910951652,CHEM 114A,A01,179693,Stallings; Dontarie M,77,0,100,23
1681910952682,CHEM 143B,A01,179698,Weizman; Haim,17,0,24,7
1681910952682,CHEM 143B,A02,179700,Weizman; Haim,24,0,24,0
1681910953705,CHIN 169A,A00,179701,Wang; Xiao,20,0,20,0
1681910954729,COGS 2,A01,179750,Boyle; Mary E. T.,17,0,30,13
1681910955759,COGS 9,A01,179759,Jones; Cameron Robert,43,0,50,7
1681910956789,COGS 14A,A01,179854,Staff,18,0,50,32
1681910957813,COGS 14B,A01,179856,Staff,54,0,60,6
1681910958836,COGS 17,A01,179874,Staff,71,0,75,4
1681910959862,COGS 18,A01,179884,Staff,63,0,80,17
1681910960888,COGS 100,A01,179886,Staff,40,0,60,20
1681910961912,COGS 101B,A01,179892,Staff,1,0,30,29
1681910962949,COGS 101C,A01,179894,Staff,28,0,30,2
1681910963972,COGS 107A,A01,179896,Boyle; Mary E. T.,31,0,40,9
1681910964999,COGS 108,A01,179898,Simpkins; Charles Alexander,0,17,60,60
1681910966025,COGS 109,A01,179900,Staff,34,0,40,6
1681910967051,COGS 118A,A01,179946,Staff,9,0,40,31
1681910968075,COGS 153,A00,179978,Staff,1,0,30,29
1681910969100,COGS 156,A01,179981,Staff,27,0,30,3
1681910971244,COGS 172,A01,179987,Staff,13,0,30,17
1681910973293,COGS 186,A01,179991,Staff,13,0,30,17
1681910974321,COMM 10,A01,180001,Staff,15,0,25,10
1681910974321,COMM 10,A02,180004,Staff,20,0,25,5
1681910975343,COMM 100A,A01,180016,Staff,18,0,25,7
1681910975343,COMM 100A,A02,180020,Staff,24,0,25,1
1681910976370,COMM 101T,A00,180029,Halm; Gavin Patrick,23,0,35,12
1681910977400,COMM 106V,A00,180043,Staff,34,0,35,1
1681910978425,COMM 109P,A00,180044,Staff,31,0,35,4
1681910979450,COMM 113T,A00,180045,Havis; Allan,37,0,45,8
1681910980473,COMM 132,A00,180046,McKenna; Denise,23,0,30,7
1681910981500,COMM 143,A00,180047,Staff,19,0,30,11
1681910982525,COMM 190,A00,180048,Conner; Thomas Hartnell,20,0,23,3
1681910983553,CSE 8A,A50,180053,Cao; Yingjun,25,0,50,25
1681910983553,CSE 8A,B50,180180,Staff,50,0,50,0
1681910984576,CSE 11,A01,180190,Cao; Yingjun,31,0,50,19
1681910985600,CSE 20,A01,180192,Briones; Jor-el Thomas Caparas,23,0,30,7
1681910986624,CSE 21,A01,194538,Briones; Jor-el Thomas Caparas,50,0,60,10
1681910987650,CSE 30,A01,180324,Eldon; John,79,0,100,21
1681910988673,CSE 101,A01,201353,Staff,0,20,40,40
1681910989700,CSE 134B,A01,180326,Powell; Thomas Allan,74,0,100,26
1681910990725,CSE 140,A01,180328,Staff,46,0,75,29
1681910991748,CSE 140L,A01,180344,Eldon; John,69,0,100,31
1681910992783,CSE 150A,A01,180411,Staff,0,7,50,50
1681910993806,CSE 151A,A01,180414,Staff,0,6,50,50
1681910994835,CSE 175,A01,222521,Kumar; Rakesh,50,0,50,0
1681910995859,CSE 190,A00,201419,Staff,45,0,49,4
1681910996883,CSS 1,A01,194536,Staff,38,0,50,12
1681910997911,DSC 30,A01,202385,Staff,48,0,50,2
1681910998938,DSC 40A,A01,202387,Albuyeh; Rod,50,0,50,0
1681910999966,DSC 190,A01,202389,Silberman; Jack,21,0,21,0
1681911001000,DSGN 100,A01,179993,Staff,16,0,30,14
1681911002022,ECE 65,A50,180708,Staff,10,0,20,10
1681911002022,ECE 65,A51,180739,Staff,19,0,20,1
1681911003048,ECON 1,A01,180427,Famulari; Melissa,67,0,70,3
1681911004070,ECON 2,A01,180450,Levkoff; Steven B.,64,0,70,6
1681911005093,ECON 4,A01,203351,Anderson; John Charles,7,0,10,3
1681911006118,ECON 100A,A01,180472,Famulari; Melissa,65,0,70,5
1681911007146,ECON 120A,A01,180549,Staff,64,0,70,6
1681911008169,ECON 120B,A01,180655,Ma; Xinwei,46,0,70,24
1681911009193,ECON 129,A00,203333,Eckert; Fabian Paul,15,0,35,20
1681911010215,ECON 131,A00,180656,Staff,9,0,35,26
1681911011242,ECON 172B,A01,180672,Levkoff; Steven B.,32,0,35,3
1681911012269,ECON 178,A01,203342,Zhu; Ying,11,0,35,24
1681911013295,EDS 108GS,A00,202383,Wishard Guerra; Alison G.,20,0,20,0
1681911014320,EDS 111GS,A00,202347,Wishard Guerra; Alison G.,20,0,20,0
1681911015344,EDS 112,A01,202323,Staff,56,0,60,4
1681911016373,EDS 113,A00,202340,Staff,33,0,35,2
1681911017402,EDS 118,A00,201231,Staff,20,0,30,10
1681911018425,EDS 119,A00,204994,Staff,8,0,10,2
1681911019448,EDS 124BR,A00,202324,Eguchi; Emi,5,0,25,20
1681911020472,EDS 126,A01,203208,Jones; Makeba,26,0,30,4
1681911021496,EDS 135,A01,202333,Staff,18,0,20,2
1681911022522,EDS 180,A00,202311,Staff,47,0,50,3
1681911023546,ERC 190GS,A01,253747,Staff,28,0,28,0
1681911024576,ETHN 104,A00,180742,Staff,24,0,35,11
1681911025600,ETHN 118,A00,180745,Staff,28,0,35,7
1681911026626,ETHN 127,A00,180747,Staff,12,0,16,4
1681911027649,ETHN 137,A00,180880,Staff,12,0,12,0
1681911028673,ETHN 147,A00,180890,Staff,8,0,10,2
1681911029710,ETHN 154,A00,180891,Staff,7,0,8,1
1681911030736,ETHN 168,A00,180892,Staff,9,0,10,1
1681911031761,GLBH 20,A00,201051,Hannah; Seth Donal,0,1,0,1
1681911032784,GLBH 111,A01,209338,Burgos; Jose L.,0,0,0,0
1681911033809,GLBH 150,A00,258300,Staff,0,3,0,0
1681911034834,GLBH 181,A00,201207,Staff,15,0,40,25
1681911035861,HIEU 109,A00,180898,Staff,20,0,20,0
1681911036886,HIEU 111,A00,180899,Staff,1,0,20,19
1681911037913,HIEU 124,A00,180900,Staff,18,0,20,2
1681911038936,HILA 122,A00,180901,Staff,18,0,20,2
1681911039959,HILA 132,A00,180902,Vitz; Matthew,2,0,20,18
1681911040983,HILD 10,A01,180896,Staff,15,0,20,5
1681911042011,HILD 30GS,A00,180897,Edington; Claire Ellen,0,0,0,0
1681911043033,HISC 105,A00,180903,Staff,20,0,20,0
1681911044060,HISC 117,A00,180904,Staff,11,0,20,9
1681911045085,HIUS 108B,A00,181005,Staff,18,0,20,2
1681911046109,HIUS 113,A00,181093,Staff,4,0,20,16
1681911047133,HUM 3,A01,181190,Patterson; Patrick H.,40,0,50,10
1681911047133,HUM 3,B01,181195,Staff,47,0,50,3
1681911048157,HUM 3GS,A00,181196,Herbst; Matthew,0,0,0,0
1681911049184,HUM 4,A01,181227,West; Geoffrey Scott,34,0,50,16
1681911049184,HUM 4,B01,181282,Staff,43,0,50,7
1681911050211,HUM 4GS,A00,181377,Lyon; Antony J.,0,0,0,0
1681911051239,HUM 5,A01,181536,Zavodny; Tatiana Sophia,31,0,50,19
1681911051239,HUM 5,B01,181908,Staff,36,0,50,14
1681911052263,INTL 190,A00,181909,Segui; Alan S,0,0,0,6
1681911052263,INTL 190,B00,181961,Segui; Alan S,0,0,0,7
1681911053298,JAPN 20AR,A01,182113,Ross; Kayoko F,15,0,20,5
1681911054321,LATI 50,A01,202391,Martin-Cabrera; Luis,19,0,30,11
1681911054321,LATI 50,A02,202392,Martin-Cabrera; Luis,26,0,30,4
1681911055347,LATI 180,A00,202393,Kokinis; Troy Andreas,25,0,25,0
1681911056375,LIFR 1A,A00,182119,Staff,14,0,14,0
1681911057403,LIFR 1AX,A00,182324,Staff,14,0,14,0
1681911058429,LIFR 1B,A00,182259,Staff,14,0,14,0
1681911059455,LIFR 1BX,A00,182273,Staff,14,0,14,0
1681911060477,LIGN 8,A00,182330,Staff,137,0,150,13
1681911061508,LIGN 9GS,A00,182362,Staff,20,0,20,0
1681911062535,LIGN 119,A00,204992,Takahashi; Maho,12,0,15,3
1681911063557,LIGN 130,A01,182384,Staff,47,0,50,3
1681911064581,LIGN 149GS,A00,182390,Staff,20,0,20,0
1681911065608,LIGN 170,A00,182404,Staff,24,0,30,6
1681911066638,LISP 1D,A00,182281,Staff,7,0,14,7
1681911066638,LISP 1D,B00,182287,Staff,14,0,14,0
1681911066638,LISP 1D,C00,182295,Staff,11,0,14,3
1681911066638,LISP 1D,D00,182301,Staff,14,0,14,0
1681911067663,LISP 1DX,A00,182309,Staff,20,0,28,8
1681911067663,LISP 1DX,B00,182316,Staff,26,0,28,2
1681911068688,LTAF 120GS,A00,182412,Zhiri; Oumelbanine,20,0,20,0
1681911069711,LTCS 172GS,A00,182437,Bronstein; Phoebe Malan,20,0,20,0
1681911070740,LTEA 138,A00,182457,Staff,22,0,40,18
1681911071766,LTEN 114,A01,182490,Staff,23,0,25,2
1681911072793,LTEN 130GS,A00,182491,Lyon; Antony J.,20,0,20,0
1681911073889,LTEN 169,A00,182493,Cuong; Marisol,20,0,25,5
1681911074918,LTEN 178,A00,182501,Staff,14,0,15,1
1681911075942,LTEN 181,A00,182515,Staff,22,0,25,3
1681911076970,LTEN 185GS,A00,197655,Forbes; Camille,20,0,20,0
1681911077994,LTSP 100B,A00,202208,Bessett; Ryan Matthew,24,0,25,1
1681911079021,LTWL 100,A00,182516,Myerston Santana; Jacobo,23,0,30,7
1681911080045,LTWR 100GS,A00,182518,Forbes; Camille,20,0,20,0
1681911081067,LTWR 102,A00,182522,Staff,15,0,15,0
1681911081067,LTWR 102,B00,182525,Staff,14,0,15,1
1681911082093,LTWR 115,A00,182526,Staff,12,0,15,3
1681911083117,MAE 8,A01,182528,Pham; Hieu Tan,68,0,70,2
1681911084142,MAE 11,A00,182529,Bahadori; Mohammad Yousef,94,0,100,6
1681911085167,MAE 20,A00,182530,Evdokimenko; Ekaterina,68,0,70,2
1681911086194,MAE 30A,A00,182532,Staff,44,0,45,1
1681911087221,MAE 101A,A00,182533,Bahadori; Mohammad Yousef,97,0,100,3
1681911088246,MAE 101C,A00,182538,Staff,62,0,70,8
1681911089275,MAE 104,A00,182539,Staff,45,0,50,5
1681911090310,MAE 131A,A00,182540,Ghazinejad; Maziar,41,0,45,4
1681911091336,MAE 143A,A00,182548,Bewley; Thomas R,43,0,50,7
1681911092360,MAE 150,A00,182549,Staff,28,0,40,12
1681911093384,MAE 160,A00,182550,Evdokimenko; Ekaterina,43,0,60,17
1681911094407,MATH 3C,A01,182725,Staff,27,0,30,3
1681911095434,MATH 10A,A01,182729,Staff,25,0,30,5
1681911095434,MATH 10A,B01,182732,Staff,26,0,30,4
1681911096463,MATH 10B,A01,182737,Staff,21,0,30,9
1681911096463,MATH 10B,A02,182738,Staff,27,0,30,3
1681911096463,MATH 10B,B01,182744,Staff,27,0,30,3
1681911096463,MATH 10B,B02,182745,Staff,27,0,30,3
1681911097517,MATH 18,A01,182750,Anzaldo; Leesa B,28,0,30,2
1681911097517,MATH 18,A02,182751,Anzaldo; Leesa B,29,0,30,1
1681911097517,MATH 18,A03,182753,Anzaldo; Leesa B,28,0,30,2
1681911097517,MATH 18,A04,182757,Anzaldo; Leesa B,29,0,30,1
1681911097517,MATH 18,B01,182761,Anzaldo; Leesa B,27,0,30,3
1681911097517,MATH 18,B02,182764,Anzaldo; Leesa B,27,0,30,3
1681911097517,MATH 18,B03,182765,Anzaldo; Leesa B,30,0,30,0
1681911097517,MATH 18,B04,182766,Anzaldo; Leesa B,30,0,30,0
1681911098548,MATH 20A,A01,182771,Suk; Andrew Hoon,28,0,30,2
1681911099578,MATH 20B,A01,182775,Bach; Quang Tran,30,0,30,0
1681911099578,MATH 20B,A02,182777,Bach; Quang Tran,29,0,30,1
1681911099578,MATH 20B,B01,182780,Bach; Quang Tran,27,0,30,3
1681911099578,MATH 20B,B02,182782,Bach; Quang Tran,30,0,30,0
1681911100607,MATH 20C,A01,182787,Staff,25,0,30,5
1681911100607,MATH 20C,A02,182790,Staff,29,0,30,1
1681911100607,MATH 20C,B01,182792,Staff,25,0,30,5
1681911100607,MATH 20C,B02,182796,Staff,27,0,30,3
1681911101631,MATH 20D,A01,182799,Staff,29,0,30,1
1681911101631,MATH 20D,A02,182802,Staff,30,0,30,0
1681911101631,MATH 20D,A03,182803,Staff,30,0,30,0
1681911102659,MATH 20E,A01,182809,Verstraete; Jacques Allan,24,0,30,6
1681911102659,MATH 20E,A02,182811,Verstraete; Jacques Allan,28,0,30,2
1681911102659,MATH 20E,B01,182814,Verstraete; Jacques Allan,23,0,30,7
1681911102659,MATH 20E,B02,182815,Verstraete; Jacques Allan,30,0,30,0
1681911103685,MATH 103A,A01,182820,Staff,9,0,30,21
1681911103685,MATH 103A,A02,182821,Staff,27,0,30,3
1681911103685,MATH 103A,A03,182822,Staff,23,0,30,7
1681911103685,MATH 103A,B01,182825,Staff,23,0,30,7
1681911103685,MATH 103A,B02,182826,Staff,30,0,30,0
1681911103685,MATH 103A,B03,182830,Staff,30,0,30,0
1681911104710,MATH 109,A01,182836,Chow; Bennett,24,0,30,6
1681911104710,MATH 109,A02,182838,Chow; Bennett,29,0,30,1
1681911104710,MATH 109,A03,182894,Chow; Bennett,29,0,30,1
1681911104710,MATH 109,B01,182908,Chow; Bennett,28,0,30,2
1681911104710,MATH 109,B02,182909,Chow; Bennett,30,0,30,0
1681911104710,MATH 109,B03,182910,Chow; Bennett,27,0,30,3
1681911105737,MATH 142A,A01,182925,Staff,11,0,30,19
1681911105737,MATH 142A,A02,182935,Staff,25,0,30,5
1681911105737,MATH 142A,A03,182967,Staff,26,0,30,4
1681911105737,MATH 142A,B01,183125,Staff,24,0,30,6
1681911105737,MATH 142A,B02,183157,Staff,28,0,30,2
1681911105737,MATH 142A,B03,183158,Staff,29,0,30,1
1681911106762,MATH 183,A01,183160,Arias-Castro; Ery,23,0,30,7
1681911106762,MATH 183,A02,183161,Arias-Castro; Ery,29,0,30,1
1681911106762,MATH 183,B01,183163,Arias-Castro; Ery,28,0,30,2
1681911106762,MATH 183,B02,183164,Arias-Castro; Ery,28,0,30,2
1681911107788,MATH 193A,A01,183167,Staff,4,0,35,31
1681911107788,MATH 193A,A02,183168,Staff,28,0,35,7
1681911107788,MATH 193A,A03,183169,Staff,34,0,35,1
1681911107788,MATH 193A,A04,183170,Staff,28,0,35,7
1681911108813,MGT 4,A01,202395,Anderson; John Charles,75,0,80,5
1681911109839,MGT 5,A00,202396,Houskeeper; Robert,80,0,90,10
1681911110865,MGT 103,A00,202397,Eberhard; Craig A,55,0,90,35
1681911111888,MGT 131A,A00,202398,Houskeeper; Robert,85,0,90,5
1681911112914,MGT 135,A00,202399,Anderson; John Charles,82,0,90,8
1681911113937,MGT 162R,A00,202403,Gneezy; Uri,150,0,200,50
1681911114963,MGT 172,A00,202404,Hedges; Kathleen,50,0,90,40
1681911115991,MGT 181,A00,202405,Dunn; Louis Jean,84,0,90,6
1681911117017,MMW 14,A01,183200,Staff,16,0,28,12
1681911117017,MMW 14,A02,183201,Staff,26,0,28,2
1681911117017,MMW 14,A03,183202,Staff,24,0,28,4
1681911117017,MMW 14,A04,183203,Staff,25,0,28,3
1681911117017,MMW 14,A05,183204,Staff,26,0,28,2
1681911117017,MMW 14,A06,183205,Staff,27,0,28,1
1681911117017,MMW 14,B01,183207,Staff,26,0,28,2
1681911117017,MMW 14,B02,183208,Staff,28,0,28,0
1681911117017,MMW 14,B03,183209,Staff,28,0,28,0
1681911117017,MMW 14,B04,183210,Staff,28,0,28,0
1681911117017,MMW 14,B05,183211,Staff,28,0,28,0
1681911117017,MMW 14,B06,183212,Staff,28,0,28,0
1681911118044,MMW 14GS,A00,183213,Zhiri; Oumelbanine,28,0,28,0
1681911119069,MMW 15GS,B00,183215,Rahimi; Babak,28,0,28,0
1681911120093,MMW 121,A01,183217,Patterson; Patrick H.,14,0,28,14
1681911120093,MMW 121,A02,183218,Patterson; Patrick H.,25,0,28,3
1681911121126,MUS 1A,A01,182554,Staff,8,0,35,27
1681911122154,MUS 5,A01,182558,Staff,20,0,35,15
1681911123183,MUS 6,A01,182562,Staff,25,0,35,10
1681911124207,MUS 8GS,A00,182563,Borgo; David Garcia,25,0,25,0
1681911125238,MUS 13,A01,182567,Staff,24,0,25,1
1681911126264,MUS 15,A01,182570,Staff,32,0,35,3
1681911126264,MUS 15,B01,182575,Staff,10,0,35,25
1681911127291,MUS 80,A00,182578,Staff,23,0,25,2
1681911127291,MUS 80,B00,182581,Staff,20,0,25,5
1681911128314,MUS 113,A00,182582,Staff,25,0,25,0
1681911129337,MUS 114,A00,182583,Staff,4,0,25,21
1681911130361,MUS 150GS,A01,182588,Borgo; David Garcia,25,0,25,0
1681911131385,PHIL 1,A00,182590,Staff,35,0,40,5
1681911132413,PHIL 10,A01,182596,Grush; Rick Scott,31,0,35,4
1681911132413,PHIL 10,A02,182597,Grush; Rick Scott,34,0,35,1
1681911133435,PHIL 15,A01,182601,Staff,31,0,35,4
1681911133435,PHIL 15,A02,182602,Staff,33,0,35,2
1681911134458,PHIL 27,A01,182604,Staff,30,0,35,5
1681911134458,PHIL 27,A02,182607,Staff,35,0,35,0
1681911135484,PHIL 32,A01,182609,Staff,35,0,35,0
1681911135484,PHIL 32,A02,182612,Staff,35,0,35,0
1681911136520,PHIL 130,A00,182614,Staff,63,0,70,7
1681911137542,PHIL 136,A00,182616,Cohen; Jonathan David,66,0,70,4
1681911138572,PHIL 155,A00,182617,Vargas; Manuel Rogelio,60,0,70,10
1681911139602,PHIL 163,A01,182620,Staff,15,0,20,5
1681911139602,PHIL 163,A02,182624,Staff,10,0,20,10
1681911140627,PHIL 164,A00,182627,Staff,30,0,40,10
1681911141653,PHIL 173,A00,182628,Staff,36,0,40,4
1681911142679,PHYS 1A,A00,183221,Staff,54,0,60,6
1681911143710,PHYS 1AL,001,183222,Staff,25,0,30,5
1681911143710,PHYS 1AL,002,183223,Staff,28,0,30,2
1681911144735,PHYS 1B,A00,183231,Staff,44,0,60,16
1681911145766,PHYS 1BL,001,183232,Staff,20,0,30,10
1681911145766,PHYS 1BL,002,183233,Staff,29,0,30,1
1681911146789,PHYS 1C,A00,183240,Staff,30,0,60,30
1681911147816,PHYS 1CL,001,183241,Staff,13,0,30,17
1681911147816,PHYS 1CL,002,183242,Staff,22,0,30,8
1681911148839,PHYS 2AR,A01,183250,Staff,44,0,50,6
1681911149862,PHYS 2B,A01,183252,Staff,106,0,115,9
1681911150894,PHYS 2BL,A01,183254,Staff,21,0,24,3
1681911150894,PHYS 2BL,A02,183255,Staff,22,0,24,2
1681911151924,PHYS 2C,A01,183522,Staff,105,0,115,10
1681911152953,PHYS 4A,A01,183524,Staff,49,0,50,1
1681911153976,POLI 5,A00,183525,Staff,44,0,50,6
1681911155003,POLI 12,A00,183540,Staff,48,0,50,2
1681911156029,POLI 13R,A00,183541,Forman; Fonna,42,0,50,8
1681911157052,POLI 30,A00,183542,Mignozzetti; Umberto,47,0,50,3
1681911158077,POLI 100A,A00,183543,Staff,45,0,50,5
1681911159106,POLI 100E,A00,223598,Staff,32,0,35,3
1681911160132,POLI 103A,A00,183564,Kousser; Thad,38,0,50,12
1681911161155,POLI 104B,A00,201329,Staff,29,0,35,6
1681911162181,POLI 113BR,A00,183576,Hoston; Germaine,28,0,50,22
1681911163205,POLI 114BR,A00,183588,Staff,27,0,30,3
1681911164229,POLI 117R,A00,183595,Forman; Fonna,9,0,20,11
1681911165262,POLI 120H,A00,183596,Fisk; David Lee,13,0,20,7
1681911166286,POLI 130AA,A00,183597,Staff,14,0,20,6
1681911167313,POLI 134AA,A00,183598,Staff,19,0,20,1
1681911168336,POLI 135,A00,183599,Fisk; David Lee,20,0,25,5
1681911169360,POLI 142P,A00,183623,Staff,37,0,40,3
1681911170385,POLI 144D,A00,183624,Staff,22,0,25,3
1681911171410,POLI 151,A00,183625,Staff,15,0,20,5
1681911172438,POLI 162,A00,183626,Mignozzetti; Umberto,18,0,20,2
1681911173463,PSYC 1,A00,253748,Staff,86,0,90,4
1681911174488,PSYC 2,A00,183627,Moranton; Nirelia Melbina-,25,0,35,10
1681911175516,PSYC 3,A00,183628,Staff,43,0,45,2
1681911177645,PSYC 60,A01,183631,Lowe; Angela Beth,35,0,40,5
1681911178671,PSYC 70,A01,253757,Staff,37,0,45,8
1681911179697,PSYC 101,A00,183632,Heyman; Gail D.,48,0,60,12
1681911180731,PSYC 105,A00,183848,Lowe; Angela Beth,50,0,60,10
1681911181757,PSYC 106,A00,183849,Dobkins; Karen R.,45,0,60,15
1681911182795,PSYC 108,A00,253750,Staff,24,0,60,36
1681911183822,PSYC 114,A01,184275,Winkielman; Piotr,0,6,30,30
1681911184848,PSYC 122,A00,183856,Moranton; Nirelia Melbina-,0,10,30,30
1681911185872,PSYC 124,A00,183865,Chapman; Eddie Nathaniel,52,0,80,28
1681911186898,PSYC 137,A00,183880,Staff,19,0,25,6
1681911188947,PSYC 154,A00,183910,Lacefield; Katharine I,0,2,90,90
1681911190995,PSYC 162,A00,183946,Wixted; John T,61,0,90,29
1681911192023,PSYC 172,A00,183947,Gorman; Michael R.,14,0,30,16
1681911193049,PSYC 178,A00,183963,Glaser; Dale,20,0,40,20
1681911194078,PSYC 181GS,A00,183964,Anagnostaras; Stephan,10,0,10,0
1681911195102,PSYC 186GS,A01,257660,Staff,10,0,10,0
1681911196126,PSYC 193,B00,253749,Staff,23,0,25,2
1681911198173,PSYC 193L,A01,184122,Staff,33,0,35,2
1681911198173,PSYC 193L,C01,184167,Winkielman; Piotr,16,0,30,14
1681911199197,RELI 188GS,A00,182629,Rahimi; Babak,20,0,20,0
1681911200220,SE 101A,A00,182646,Staff,26,0,30,4
1681911201244,SE 101C,A00,182650,Staff,18,0,20,2
1681911202271,SE 110A,A00,182651,Staff,28,0,28,0
1681911203297,SE 130A,A00,182652,Staff,39,0,40,1
1681911204321,SIO 46GS,A00,182636,Cook; Geoffrey W,28,0,28,0
1681911205343,SIO 109R,A00,194459,Staff,5,0,20,15
1681911206365,SIO 121GS,A00,182639,Cook; Geoffrey W,28,0,28,0
1681911207388,SIO 132,A01,182642,Staff,32,0,40,8
1681911208414,SIO 139,A00,182644,Kacev; David,36,0,40,4
1681911209436,SOCI 2,A01,258404,Staff,34,0,36,2
1681911209436,SOCI 2,A02,258405,Staff,35,0,36,1
1681911210460,SOCI 60,A01,258408,Staff,29,0,30,1
1681911210460,SOCI 60,A02,258413,Staff,30,0,30,0
1681911211483,SOCI 100,A01,258415,Staff,29,0,30,1
1681911211483,SOCI 100,A02,258416,Staff,28,0,30,2
1681911217635,SOCI 127,A00,258421,Staff,22,0,30,8
1681911218662,SOCI 132,A00,258422,Staff,45,0,50,5
1681911219690,SOCI 133,A00,258423,Staff,26,0,30,4
1681911220714,SOCI 138GS,A00,258424,Staff,15,0,15,0
1681911221744,SOCI 145,A00,258425,Staff,25,0,30,5
1681911222768,SOCI 148,A00,258426,Staff,26,0,30,4
1681911223796,SOCI 153,A00,199217,Staff,29,0,30,1
1681911224819,SOCI 160,A00,258427,Staff,28,0,30,2
1681911225845,SOCI 160E,A00,258435,Staff,56,0,60,4
1681911226866,SOCI 189GS,A00,258436,Staff,15,0,15,0
1681911227891,SOCI 190GS,A00,258437,Staff,15,0,15,0
1681911228916,SYN 2,001,182658,Staff,9,0,16,7
1681911228916,SYN 2,002,201439,Staff,15,0,16,1
1681911228916,SYN 2,003,201443,Staff,16,0,16,0
1681911229939,SYN 100,A01,182657,Staff,17,0,20,3
1681911230963,TDAC 1,A00,184381,Salovey; Todd,16,0,20,4
1681911230963,TDAC 1,B00,184385,Harting; Carla Kelso,19,0,20,1
1681911230963,TDAC 1,C00,184394,Staff,19,0,20,1
1681911231990,TDAC 101,A00,184483,Harting; Carla Kelso,19,0,20,1
1681911233018,TDDE 111,A00,184496,Staff,14,0,15,1
1681911234049,TDDE 131,A00,184504,Staff,20,0,20,0
1681911234049,TDDE 131,B00,184505,Staff,17,0,18,1
1681911234049,TDDE 131,C00,184534,Staff,49,0,50,1
1681911234049,TDDE 131,D00,184564,Staff,15,0,15,0
1681911234049,TDDE 131,E00,204725,Staff,19,0,20,1
1681911235071,TDGE 1,A01,184414,Salovey; Todd,37,0,50,13
1681911236099,TDGE 5,A01,184419,Staff,23,0,24,1
1681911237127,TDGE 10,A00,184428,Fulton; Julia,31,0,50,19
1681911238154,TDGE 124,A00,184565,Fulton; Julia,7,0,50,43
1681911239183,TDGE 125,B00,184567,Meyer; Ursula,9,0,25,16
1681911240211,TDHT 101,A00,184568,Staff,21,0,25,4
1681911240211,TDHT 101,B00,184569,Staff,20,0,20,0
1681911241240,TDHT 114,A00,184570,Staff,49,0,50,1
1681911242263,TDMV 1,A00,184437,Arcidiacono; Kristin,23,0,30,7
1681911242263,TDMV 1,B00,184448,Caligagan; Maria T.,22,0,30,8
1681911243290,TDMV 2,A00,184449,Weinberg; Sadie,27,0,30,3
1681911243290,TDMV 2,B00,184453,Arcidiacono; Kristin,29,0,30,1
1681911244317,TDMV 110,A00,184571,Weinberg; Sadie,30,0,30,0
1681911245341,TDMV 142,A00,184572,Caligagan; Tony,27,0,30,3
1681911245341,TDMV 142,B00,184573,Caligagan; Maria T.,27,0,30,3
1681911246366,TDTR 20,A00,184482,Jun; Grace Shin Hae,25,0,25,0
1681911247393,USP 2,A01,184290,Hinds; Juli Beth,24,0,25,1
1681911248420,USP 3,A01,184295,Staff,20,0,25,5
1681911249453,USP 4,A00,184304,McTague; Sarah,15,0,25,10
1681911250475,USP 100,A00,184315,Staff,17,0,25,8
1681911251511,USP 105,A00,184326,Staff,21,0,25,4
1681911252538,USP 151,A00,184327,Staff,20,0,25,5
1681911253561,USP 170,A00,184380,Hinds; Juli Beth,14,0,25,11
1681911254587,VIS 21B,A01,182660,Staff,28,0,31,3
1681911254587,VIS 21B,A02,182662,Staff,30,0,31,1
1681911255609,VIS 103D,A00,182663,Staff,74,0,75,1
1681911256636,VIS 105D,A00,182667,Li; Huai,15,0,22,7
1681911257660,VIS 122GS,A00,182668,Herbst; Matthew,20,0,20,0
1681911258684,VIS 128C,A00,182673,Staff,69,0,75,6
1681911259706,VIS 130,A00,182675,Staff,20,0,22,2
1681911260729,VIS 160A,A00,182678,Stalbaum; Brett,4,0,10,6
1681911262777,WCWP 10B,A00,201679,Staff,15,0,15,0
1681911262777,WCWP 10B,B00,201695,Staff,15,0,15,0
1681911263801,WCWP 100,A00,201716,Staff,15,0,15,0
1681911263801,WCWP 100,B00,201717,Staff,11,0,15,4
1681911265916,ANSC 105GS,A00,258289,Staff,0,0,0,0
1681911266941,ANSC 125GS,A00,258295,Staff,0,0,0,0
1681911267967,ANSC 150,A00,258267,Staff,30,0,40,10
1681911268994,ANSC 190GS,A00,258280,Staff,0,0,0,0
1681911270020,ANTH 1,A00,258264,Staff,38,0,40,2
1681911271049,ANTH 2,A01,258259,Staff,72,0,76,4
1681911272077,ANTH 23,A01,258228,Staff,36,0,40,4
1681911273110,ANTH 101,A01,258236,Staff,39,0,40,1
1681911274137,ANTH 102,A00,258272,Staff,59,0,60,1
1681911275161,ANTH 105,A00,258244,Staff,31,0,35,4
1681911276184,BENG 130,A00,253975,Staff,38,0,40,2
1681911277209,BIBC 102,A01,191866,Flagg; Matthew Paul,19,0,32,13
1681911277209,BIBC 102,A02,191867,Flagg; Matthew Paul,22,0,32,10
1681911277209,BIBC 102,A03,191868,Flagg; Matthew Paul,30,0,32,2
1681911277209,BIBC 102,A04,191936,Flagg; Matthew Paul,26,0,32,6
1681911277209,BIBC 102,A05,191937,Flagg; Matthew Paul,11,0,32,21
1681911278237,BICD 100,A01,191939,Cooper; Andrew Michael,28,0,32,4
1681911278237,BICD 100,A02,191940,Cooper; Andrew Michael,32,0,32,0
1681911278237,BICD 100,A03,191941,Cooper; Andrew Michael,32,0,32,0
1681911278237,BICD 100,A04,191942,Cooper; Andrew Michael,32,0,32,0
1681911278237,BICD 100,A05,191943,Cooper; Andrew Michael,32,0,32,0
1681911279263,BIEB 126,A01,191945,Cleland; Elsa Eleanor,1,0,32,31
1681911279263,BIEB 126,A02,191946,Cleland; Elsa Eleanor,28,0,32,4
1681911279263,BIEB 126,A03,191947,Cleland; Elsa Eleanor,29,0,32,3
1681911279263,BIEB 126,A04,191948,Cleland; Elsa Eleanor,23,0,32,9
1681911279263,BIEB 126,A05,191996,Cleland; Elsa Eleanor,28,0,32,4
1681911280290,BIEB 136GS,A00,191997,Shurin; Jonathan & Holway; David A.,0,0,0,0
1681911281387,BIEB 137GS,A01,191999,Shurin; Jonathan & Holway; David A.,0,0,0,0
1681911282411,BILD 1,A01,205385,Staff,31,0,32,1
1681911282411,BILD 1,A02,205386,Staff,30,0,32,2
1681911282411,BILD 1,A03,205387,Staff,32,0,32,0
1681911282411,BILD 1,A04,205388,Staff,28,0,32,4
1681911283444,BILD 2,A01,191774,Staff,28,0,32,4
1681911283444,BILD 2,A02,191775,Staff,30,0,32,2
1681911283444,BILD 2,A03,191777,Staff,30,0,32,2
1681911283444,BILD 2,A04,191856,Staff,31,0,32,1
1681911283444,BILD 2,A05,191857,Staff,32,0,32,0
1681911283444,BILD 2,A06,191858,Staff,32,0,32,0
1681911283444,BILD 2,A07,191859,Staff,31,0,32,1
1681911284469,BILD 3,A01,205391,Staff,29,0,32,3
1681911284469,BILD 3,A02,205393,Staff,32,0,32,0
1681911284469,BILD 3,A03,205394,Staff,28,0,32,4
1681911284469,BILD 3,A04,205395,Staff,32,0,32,0
1681911285492,BILD 20,A01,191861,Staff,32,0,32,0
1681911285492,BILD 20,A02,191862,Staff,32,0,32,0
1681911286515,BILD 30,A01,191864,Staff,31,0,32,1
1681911287538,BIMM 100,A01,192019,Staff,0,0,32,32
1681911287538,BIMM 100,A02,192020,Staff,23,0,32,9
1681911287538,BIMM 100,A03,192035,Staff,22,0,32,10
1681911288564,BIMM 110,A01,192037,Tat; John,0,0,32,32
1681911288564,BIMM 110,A02,192038,Tat; John,10,0,32,22
1681911289588,BIMM 120,A01,192040,Pickett; Brooke Elizabeth,2,0,32,30
1681911289588,BIMM 120,A02,192041,Pickett; Brooke Elizabeth,16,0,32,16
1681911289588,BIMM 120,A03,192042,Pickett; Brooke Elizabeth,16,0,32,16
1681911290612,BIPN 100,A01,192044,Armour; Jon Christopher,26,0,32,6
1681911290612,BIPN 100,A02,192059,Armour; Jon Christopher,30,0,32,2
1681911290612,BIPN 100,A03,192064,Armour; Jon Christopher,31,0,32,1
1681911290612,BIPN 100,A04,192073,Armour; Jon Christopher,28,0,32,4
1681911291636,BIPN 148,A01,205411,Leutgeb; Jill K.,16,0,32,16
1681911291636,BIPN 148,A02,205412,Leutgeb; Jill K.,31,0,32,1
1681911291636,BIPN 148,A03,205413,Leutgeb; Jill K.,30,0,32,2
1681911291636,BIPN 148,A04,205414,Leutgeb; Jill K.,30,0,32,2
1681911292662,BIPN 160,A01,192115,Marino; Marc J,19,0,32,13
1681911292662,BIPN 160,A02,192148,Marino; Marc J,27,0,32,5
1681911292662,BIPN 160,A03,192158,Marino; Marc J,31,0,32,1
1681911292662,BIPN 160,A04,192190,Marino; Marc J,32,0,32,0
1681911292662,BIPN 160,A05,192287,Marino; Marc J,32,0,32,0
1681911292662,BIPN 160,A06,192288,Marino; Marc J,32,0,32,0
1681911293689,BIPN 194,A00,206038,Staff,28,0,32,4
1681911294713,BISP 194,A00,192289,Leutgeb; Stefan,13,0,32,19
1681911294713,BISP 194,B00,245332,Nieh; James Charles,27,0,32,5
1681911295752,CAT 124,A01,202247,Staff,15,0,15,0
1681911296781,CAT 125,A00,202248,Staff,19,0,20,1
1681911296781,CAT 125,B00,202253,Staff,20,0,20,0
1681911296781,CAT 125,C00,202257,Staff,19,0,20,1
1681911297805,CAT 125GS,A01,202273,Bronstein; Phoebe Malan,20,0,20,0
1681911298834,CAT 125R,A00,202284,Staff,17,0,20,3
1681911298834,CAT 125R,C00,202286,Staff,10,0,20,10
1681911298834,CAT 125R,D00,202291,Staff,18,0,20,2
1681911298834,CAT 125R,E00,202295,Staff,13,0,20,7
1681911298834,CAT 125R,F00,202302,Staff,12,0,20,8
1681911299858,CENG 100,A00,204724,Opatkiewicz; Justin Paul,25,0,25,0
1681911300886,CGS 2A,A01,180420,Staff,31,0,36,5
1681911301928,CGS 101,A00,180421,Staff,16,0,20,4
1681911302952,CGS 112,A00,180422,Staff,10,0,16,6
1681911303975,CGS 113,A00,180423,Staff,18,0,20,2
1681911305004,CGS 137,A00,180424,Staff,12,0,12,0
1681911306026,CGS 147,A00,180425,Staff,10,0,10,0
1681911307055,CHEM 6A,A01,179556,Staff,97,0,100,3
1681911307055,CHEM 6A,A02,179558,Staff,0,0,0,0
1681911308079,CHEM 6B,A01,179560,Staff,100,0,100,0
1681911309110,CHEM 6C,A01,179565,Jazzar; Rodolphe,95,0,100,5
1681911310136,CHEM 7L,A01,179586,Schurmeier; Kimberly,13,0,24,11
1681911310136,CHEM 7L,A02,179587,Schurmeier; Kimberly,23,0,24,1
1681911310136,CHEM 7L,A03,179590,Schurmeier; Kimberly,22,0,24,2
1681911310136,CHEM 7L,A04,179591,Schurmeier; Kimberly,22,0,24,2
1681911310136,CHEM 7L,B01,179598,Schurmeier; Kimberly,17,0,24,7
1681911310136,CHEM 7L,B02,179599,Schurmeier; Kimberly,24,0,24,0
1681911310136,CHEM 7L,B03,179606,Schurmeier; Kimberly,23,0,24,1
1681911310136,CHEM 7L,B04,179607,Schurmeier; Kimberly,23,0,24,1
1681911311175,CHEM 11,A01,179609,Stallings; Dontarie M,88,0,100,12
1681911312203,CHEM 40A,A01,179621,Staff,41,0,50,9
1681911312203,CHEM 40A,A02,179622,Staff,47,0,50,3
1681911313234,CHEM 40B,A01,179630,Weizman; Haim,48,0,50,2
1681911313234,CHEM 40B,A02,179631,Weizman; Haim,45,0,50,5
1681911314261,CHEM 41A,A01,179660,Klosterman; Jeremy K,93,0,100,7
1681911315290,CHEM 43A,A01,179683,Klosterman; Jeremy K,0,0,24,24
1681911315290,CHEM 43A,A02,179688,Klosterman; Jeremy K,14,0,24,10
1681911315290,CHEM 43A,A03,179689,Klosterman; Jeremy K,20,0,24,4
1681911315290,CHEM 43A,A04,179691,Klosterman; Jeremy K,18,0,24,6
1681911316314,CHEM 114A,A01,179693,Stallings; Dontarie M,77,0,100,23
1681911317346,CHEM 143B,A01,179698,Weizman; Haim,17,0,24,7
1681911317346,CHEM 143B,A02,179700,Weizman; Haim,24,0,24,0
1681911318370,CHIN 169A,A00,179701,Wang; Xiao,20,0,20,0
1681911319397,COGS 2,A01,179750,Boyle; Mary E. T.,17,0,30,13
1681911320425,COGS 9,A01,179759,Jones; Cameron Robert,43,0,50,7
1681911321450,COGS 14A,A01,179854,Staff,18,0,50,32
1681911322479,COGS 14B,A01,179856,Staff,54,0,60,6
1681911323503,COGS 17,A01,179874,Staff,71,0,75,4
1681911324529,COGS 18,A01,179884,Staff,63,0,80,17
1681911325552,COGS 100,A01,179886,Staff,40,0,60,20
1681911326579,COGS 101B,A01,179892,Staff,1,0,30,29
1681911327607,COGS 101C,A01,179894,Staff,28,0,30,2
1681911328630,COGS 107A,A01,179896,Boyle; Mary E. T.,31,0,40,9
1681911329653,COGS 108,A01,179898,Simpkins; Charles Alexander,0,17,60,60
1681911330679,COGS 109,A01,179900,Staff,34,0,40,6
1681911331702,COGS 118A,A01,179946,Staff,9,0,40,31
1681911332724,COGS 153,A00,179978,Staff,1,0,30,29
1681911333749,COGS 156,A01,179981,Staff,27,0,30,3
1681911335799,COGS 172,A01,179987,Staff,13,0,30,17
1681911337850,COGS 186,A01,179991,Staff,13,0,30,17
1681911338883,COMM 10,A01,180001,Staff,15,0,25,10
1681911338883,COMM 10,A02,180004,Staff,20,0,25,5
1681911339911,COMM 100A,A01,180016,Staff,18,0,25,7
1681911339911,COMM 100A,A02,180020,Staff,24,0,25,1
1681911340937,COMM 101T,A00,180029,Halm; Gavin Patrick,23,0,35,12
1681911341963,COMM 106V,A00,180043,Staff,34,0,35,1
1681911342987,COMM 109P,A00,180044,Staff,31,0,35,4
1681911344013,COMM 113T,A00,180045,Havis; Allan,37,0,45,8
1681911345038,COMM 132,A00,180046,McKenna; Denise,23,0,30,7
1681911346069,COMM 143,A00,180047,Staff,19,0,30,11
1681911347101,COMM 190,A00,180048,Conner; Thomas Hartnell,20,0,23,3
1681911348132,CSE 8A,A50,180053,Cao; Yingjun,25,0,50,25
1681911348132,CSE 8A,B50,180180,Staff,50,0,50,0
1681911349155,CSE 11,A01,180190,Cao; Yingjun,31,0,50,19
1681911350182,CSE 20,A01,180192,Briones; Jor-el Thomas Caparas,23,0,30,7
1681911351205,CSE 21,A01,194538,Briones; Jor-el Thomas Caparas,50,0,60,10
1681911352233,CSE 30,A01,180324,Eldon; John,79,0,100,21
1681911353257,CSE 101,A01,201353,Staff,0,20,40,40
1681911354293,CSE 134B,A01,180326,Powell; Thomas Allan,74,0,100,26
1681911355319,CSE 140,A01,180328,Staff,46,0,75,29
1681911356347,CSE 140L,A01,180344,Eldon; John,69,0,100,31
1681911357378,CSE 150A,A01,180411,Staff,0,7,50,50
1681911358406,CSE 151A,A01,180414,Staff,0,6,50,50
1681911359431,CSE 175,A01,222521,Kumar; Rakesh,50,0,50,0
1681911360460,CSE 190,A00,201419,Staff,45,0,49,4
1681911361485,CSS 1,A01,194536,Staff,38,0,50,12
1681911362510,DSC 30,A01,202385,Staff,48,0,50,2
1681911363536,DSC 40A,A01,202387,Albuyeh; Rod,50,0,50,0
1681911364565,DSC 190,A01,202389,Silberman; Jack,21,0,21,0
1681911365589,DSGN 100,A01,179993,Staff,16,0,30,14
1681911366615,ECE 65,A50,180708,Staff,10,0,20,10
1681911366615,ECE 65,A51,180739,Staff,19,0,20,1
1681911367638,ECON 1,A01,180427,Famulari; Melissa,67,0,70,3
1681911368665,ECON 2,A01,180450,Levkoff; Steven B.,64,0,70,6
1681911369689,ECON 4,A01,203351,Anderson; John Charles,7,0,10,3
1681911370714,ECON 100A,A01,180472,Famulari; Melissa,65,0,70,5
1681911371742,ECON 120A,A01,180549,Staff,64,0,70,6
1681911372771,ECON 120B,A01,180655,Ma; Xinwei,46,0,70,24
1681911373798,ECON 129,A00,203333,Eckert; Fabian Paul,15,0,35,20
1681911374823,ECON 131,A00,180656,Staff,9,0,35,26
1681911375850,ECON 172B,A01,180672,Levkoff; Steven B.,32,0,35,3
1681911376874,ECON 178,A01,203342,Zhu; Ying,11,0,35,24
1681911377898,EDS 108GS,A00,202383,Wishard Guerra; Alison G.,20,0,20,0
1681911378920,EDS 111GS,A00,202347,Wishard Guerra; Alison G.,20,0,20,0
1681911379945,EDS 112,A01,202323,Staff,56,0,60,4
1681911380970,EDS 113,A00,202340,Staff,33,0,35,2
1681911381998,EDS 118,A00,201231,Staff,20,0,30,10
1681911383026,EDS 119,A00,204994,Staff,8,0,10,2
1681911384052,EDS 124BR,A00,202324,Eguchi; Emi,5,0,25,20
1681911385149,EDS 126,A01,203208,Jones; Makeba,26,0,30,4
1681911386176,EDS 135,A01,202333,Staff,18,0,20,2
1681911387210,EDS 180,A00,202311,Staff,47,0,50,3
1681911388234,ERC 190GS,A01,253747,Staff,28,0,28,0
1681911389263,ETHN 104,A00,180742,Staff,24,0,35,11
1681911390291,ETHN 118,A00,180745,Staff,28,0,35,7
1681911391318,ETHN 127,A00,180747,Staff,12,0,16,4
1681911392342,ETHN 137,A00,180880,Staff,12,0,12,0
1681911393366,ETHN 147,A00,180890,Staff,8,0,10,2
1681911394395,ETHN 154,A00,180891,Staff,7,0,8,1
1681911395418,ETHN 168,A00,180892,Staff,9,0,10,1
1681911396442,GLBH 20,A00,201051,Hannah; Seth Donal,0,1,0,1
1681911397468,GLBH 111,A01,209338,Burgos; Jose L.,0,0,0,0
1681911398496,GLBH 150,A00,258300,Staff,0,3,0,0
1681911399519,GLBH 181,A00,201207,Staff,15,0,40,25
1681911400549,HIEU 109,A00,180898,Staff,20,0,20,0
1681911401576,HIEU 111,A00,180899,Staff,1,0,20,19
1681911402603,HIEU 124,A00,180900,Staff,18,0,20,2
1681911403632,HILA 122,A00,180901,Staff,18,0,20,2
1681911404656,HILA 132,A00,180902,Vitz; Matthew,2,0,20,18
1681911405683,HILD 10,A01,180896,Staff,15,0,20,5
1681911406705,HILD 30GS,A00,180897,Edington; Claire Ellen,0,0,0,0
1681911407731,HISC 105,A00,180903,Staff,20,0,20,0
1681911408758,HISC 117,A00,180904,Staff,11,0,20,9
1681911409782,HIUS 108B,A00,181005,Staff,18,0,20,2
1681911410807,HIUS 113,A00,181093,Staff,4,0,20,16
1681911411837,HUM 3,A01,181190,Patterson; Patrick H.,40,0,50,10
1681911411837,HUM 3,B01,181195,Staff,47,0,50,3
1681911412861,HUM 3GS,A00,181196,Herbst; Matthew,0,0,0,0
1681911413886,HUM 4,A01,181227,West; Geoffrey Scott,34,0,50,16
1681911413886,HUM 4,B01,181282,Staff,43,0,50,7
1681911414911,HUM 4GS,A00,181377,Lyon; Antony J.,0,0,0,0
1681911415940,HUM 5,A01,181536,Zavodny; Tatiana Sophia,31,0,50,19
1681911415940,HUM 5,B01,181908,Staff,36,0,50,14
1681911416967,INTL 190,A00,181909,Segui; Alan S,0,0,0,6
1681911416967,INTL 190,B00,181961,Segui; Alan S,0,0,0,7
1681911417990,JAPN 20AR,A01,182113,Ross; Kayoko F,15,0,20,5
1681911419019,LATI 50,A01,202391,Martin-Cabrera; Luis,19,0,30,11
1681911419019,LATI 50,A02,202392,Martin-Cabrera; Luis,26,0,30,4
1681911420052,LATI 180,A00,202393,Kokinis; Troy Andreas,25,0,25,0
1681911421075,LIFR 1A,A00,182119,Staff,14,0,14,0
1681911422098,LIFR 1AX,A00,182324,Staff,14,0,14,0
1681911423129,LIFR 1B,A00,182259,Staff,14,0,14,0
1681911424151,LIFR 1BX,A00,182273,Staff,14,0,14,0
1681911425175,LIGN 8,A00,182330,Staff,137,0,150,13
1681911426198,LIGN 9GS,A00,182362,Staff,20,0,20,0
1681911427224,LIGN 119,A00,204992,Takahashi; Maho,12,0,15,3
1681911428253,LIGN 130,A01,182384,Staff,47,0,50,3
1681911429281,LIGN 149GS,A00,182390,Staff,20,0,20,0
1681911430306,LIGN 170,A00,182404,Staff,24,0,30,6
1681911431333,LISP 1D,A00,182281,Staff,7,0,14,7
1681911431333,LISP 1D,B00,182287,Staff,14,0,14,0
1681911431333,LISP 1D,C00,182295,Staff,11,0,14,3
1681911431333,LISP 1D,D00,182301,Staff,14,0,14,0
1681911432360,LISP 1DX,A00,182309,Staff,20,0,28,8
1681911432360,LISP 1DX,B00,182316,Staff,26,0,28,2
1681911433392,LTAF 120GS,A00,182412,Zhiri; Oumelbanine,20,0,20,0
1681911434414,LTCS 172GS,A00,182437,Bronstein; Phoebe Malan,20,0,20,0
1681911435437,LTEA 138,A00,182457,Staff,22,0,40,18
1681911436464,LTEN 114,A01,182490,Staff,23,0,25,2
1681911437486,LTEN 130GS,A00,182491,Lyon; Antony J.,20,0,20,0
1681911438509,LTEN 169,A00,182493,Cuong; Marisol,20,0,25,5
1681911439535,LTEN 178,A00,182501,Staff,14,0,15,1
1681911440561,LTEN 181,A00,182515,Staff,22,0,25,3
1681911441601,LTEN 185GS,A00,197655,Forbes; Camille,20,0,20,0
1681911442628,LTSP 100B,A00,202208,Bessett; Ryan Matthew,24,0,25,1
1681911443666,LTWL 100,A00,182516,Myerston Santana; Jacobo,23,0,30,7
1681911444692,LTWR 100GS,A00,182518,Forbes; Camille,20,0,20,0
1681911445718,LTWR 102,A00,182522,Staff,15,0,15,0
1681911445718,LTWR 102,B00,182525,Staff,14,0,15,1
1681911446741,LTWR 115,A00,182526,Staff,12,0,15,3
1681911447769,MAE 8,A01,182528,Pham; Hieu Tan,68,0,70,2
1681911448797,MAE 11,A00,182529,Bahadori; Mohammad Yousef,94,0,100,6
1681911449824,MAE 20,A00,182530,Evdokimenko; Ekaterina,68,0,70,2
1681911450852,MAE 30A,A00,182532,Staff,44,0,45,1
1681911451879,MAE 101A,A00,182533,Bahadori; Mohammad Yousef,97,0,100,3
1681911452904,MAE 101C,A00,182538,Staff,62,0,70,8
1681911453927,MAE 104,A00,182539,Staff,45,0,50,5
1681911454961,MAE 131A,A00,182540,Ghazinejad; Maziar,41,0,45,4
1681911455987,MAE 143A,A00,182548,Bewley; Thomas R,43,0,50,7
1681911457011,MAE 150,A00,182549,Staff,28,0,40,12
1681911458036,MAE 160,A00,182550,Evdokimenko; Ekaterina,43,0,60,17
1681911459060,MATH 3C,A01,182725,Staff,27,0,30,3
1681911460087,MATH 10A,A01,182729,Staff,25,0,30,5
1681911460087,MATH 10A,B01,182732,Staff,26,0,30,4
1681911461114,MATH 10B,A01,182737,Staff,21,0,30,9
1681911461114,MATH 10B,A02,182738,Staff,27,0,30,3
1681911461114,MATH 10B,B01,182744,Staff,27,0,30,3
1681911461114,MATH 10B,B02,182745,Staff,27,0,30,3
1681911462145,MATH 18,A01,182750,Anzaldo; Leesa B,28,0,30,2
1681911462145,MATH 18,A02,182751,Anzaldo; Leesa B,29,0,30,1
1681911462145,MATH 18,A03,182753,Anzaldo; Leesa B,28,0,30,2
1681911462145,MATH 18,A04,182757,Anzaldo; Leesa B,29,0,30,1
1681911462145,MATH 18,B01,182761,Anzaldo; Leesa B,27,0,30,3
1681911462145,MATH 18,B02,182764,Anzaldo; Leesa B,27,0,30,3
1681911462145,MATH 18,B03,182765,Anzaldo; Leesa B,30,0,30,0
1681911462145,MATH 18,B04,182766,Anzaldo; Leesa B,30,0,30,0
1681911463170,MATH 20A,A01,182771,Suk; Andrew Hoon,28,0,30,2
1681911464194,MATH 20B,A01,182775,Bach; Quang Tran,30,0,30,0
1681911464194,MATH 20B,A02,182777,Bach; Quang Tran,29,0,30,1
1681911464194,MATH 20B,B01,182780,Bach; Quang Tran,27,0,30,3
1681911464194,MATH 20B,B02,182782,Bach; Quang Tran,30,0,30,0
1681911465223,MATH 20C,A01,182787,Staff,25,0,30,5
1681911465223,MATH 20C,A02,182790,Staff,29,0,30,1
1681911465223,MATH 20C,B01,182792,Staff,25,0,30,5
1681911465223,MATH 20C,B02,182796,Staff,27,0,30,3
1681911466258,MATH 20D,A01,182799,Staff,29,0,30,1
1681911466258,MATH 20D,A02,182802,Staff,30,0,30,0
1681911466258,MATH 20D,A03,182803,Staff,30,0,30,0
1681911467280,MATH 20E,A01,182809,Verstraete; Jacques Allan,24,0,30,6
1681911467280,MATH 20E,A02,182811,Verstraete; Jacques Allan,28,0,30,2
1681911467280,MATH 20E,B01,182814,Verstraete; Jacques Allan,23,0,30,7
1681911467280,MATH 20E,B02,182815,Verstraete; Jacques Allan,30,0,30,0
1681911468314,MATH 103A,A01,182820,Staff,9,0,30,21
1681911468314,MATH 103A,A02,182821,Staff,27,0,30,3
1681911468314,MATH 103A,A03,182822,Staff,23,0,30,7
1681911468314,MATH 103A,B01,182825,Staff,23,0,30,7
1681911468314,MATH 103A,B02,182826,Staff,30,0,30,0
1681911468314,MATH 103A,B03,182830,Staff,30,0,30,0
1681911469344,MATH 109,A01,182836,Chow; Bennett,24,0,30,6
1681911469344,MATH 109,A02,182838,Chow; Bennett,29,0,30,1
1681911469344,MATH 109,A03,182894,Chow; Bennett,29,0,30,1
1681911469344,MATH 109,B01,182908,Chow; Bennett,28,0,30,2
1681911469344,MATH 109,B02,182909,Chow; Bennett,30,0,30,0
1681911469344,MATH 109,B03,182910,Chow; Bennett,27,0,30,3
1681911470368,MATH 142A,A01,182925,Staff,11,0,30,19
1681911470368,MATH 142A,A02,182935,Staff,25,0,30,5
1681911470368,MATH 142A,A03,182967,Staff,26,0,30,4
1681911470368,MATH 142A,B01,183125,Staff,24,0,30,6
1681911470368,MATH 142A,B02,183157,Staff,28,0,30,2
1681911470368,MATH 142A,B03,183158,Staff,29,0,30,1
1681911471397,MATH 183,A01,183160,Arias-Castro; Ery,23,0,30,7
1681911471397,MATH 183,A02,183161,Arias-Castro; Ery,29,0,30,1
1681911471397,MATH 183,B01,183163,Arias-Castro; Ery,28,0,30,2
1681911471397,MATH 183,B02,183164,Arias-Castro; Ery,28,0,30,2
1681911472425,MATH 193A,A01,183167,Staff,4,0,35,31
1681911472425,MATH 193A,A02,183168,Staff,28,0,35,7
1681911472425,MATH 193A,A03,183169,Staff,34,0,35,1
1681911472425,MATH 193A,A04,183170,Staff,28,0,35,7
1681911473448,MGT 4,A01,202395,Anderson; John Charles,75,0,80,5
1681911474471,MGT 5,A00,202396,Houskeeper; Robert,80,0,90,10
1681911475498,MGT 103,A00,202397,Eberhard; Craig A,55,0,90,35
1681911476522,MGT 131A,A00,202398,Houskeeper; Robert,85,0,90,5
1681911477545,MGT 135,A00,202399,Anderson; John Charles,82,0,90,8
1681911478571,MGT 162R,A00,202403,Gneezy; Uri,150,0,200,50
1681911479596,MGT 172,A00,202404,Hedges; Kathleen,50,0,90,40
1681911480623,MGT 181,A00,202405,Dunn; Louis Jean,84,0,90,6
1681911481651,MMW 14,A01,183200,Staff,16,0,28,12
1681911481651,MMW 14,A02,183201,Staff,26,0,28,2
1681911481651,MMW 14,A03,183202,Staff,24,0,28,4
1681911481651,MMW 14,A04,183203,Staff,25,0,28,3
1681911481651,MMW 14,A05,183204,Staff,26,0,28,2
1681911481651,MMW 14,A06,183205,Staff,27,0,28,1
1681911481651,MMW 14,B01,183207,Staff,26,0,28,2
1681911481651,MMW 14,B02,183208,Staff,28,0,28,0
1681911481651,MMW 14,B03,183209,Staff,28,0,28,0
1681911481651,MMW 14,B04,183210,Staff,28,0,28,0
1681911481651,MMW 14,B05,183211,Staff,28,0,28,0
1681911481651,MMW 14,B06,183212,Staff,28,0,28,0
1681911482675,MMW 14GS,A00,183213,Zhiri; Oumelbanine,28,0,28,0
1681911483698,MMW 15GS,B00,183215,Rahimi; Babak,28,0,28,0
1681911484726,MMW 121,A01,183217,Patterson; Patrick H.,14,0,28,14
1681911484726,MMW 121,A02,183218,Patterson; Patrick H.,25,0,28,3
1681911485752,MUS 1A,A01,182554,Staff,8,0,35,27
1681911486781,MUS 5,A01,182558,Staff,20,0,35,15
1681911487806,MUS 6,A01,182562,Staff,25,0,35,10
1681911488908,MUS 8GS,A00,182563,Borgo; David Garcia,25,0,25,0
1681911489933,MUS 13,A01,182567,Staff,24,0,25,1
1681911490962,MUS 15,A01,182570,Staff,32,0,35,3
1681911490962,MUS 15,B01,182575,Staff,10,0,35,25
1681911491990,MUS 80,A00,182578,Staff,23,0,25,2
1681911491990,MUS 80,B00,182581,Staff,20,0,25,5
1681911493013,MUS 113,A00,182582,Staff,25,0,25,0
1681911494038,MUS 114,A00,182583,Staff,4,0,25,21
1681911495061,MUS 150GS,A01,182588,Borgo; David Garcia,25,0,25,0
1681911496084,PHIL 1,A00,182590,Staff,35,0,40,5
1681911497109,PHIL 10,A01,182596,Grush; Rick Scott,31,0,35,4
1681911497109,PHIL 10,A02,182597,Grush; Rick Scott,34,0,35,1
1681911498136,PHIL 15,A01,182601,Staff,31,0,35,4
1681911498136,PHIL 15,A02,182602,Staff,33,0,35,2
1681911499161,PHIL 27,A01,182604,Staff,30,0,35,5
1681911499161,PHIL 27,A02,182607,Staff,35,0,35,0
1681911500183,PHIL 32,A01,182609,Staff,35,0,35,0
1681911500183,PHIL 32,A02,182612,Staff,35,0,35,0
1681911501207,PHIL 130,A00,182614,Staff,63,0,70,7
1681911502243,PHIL 136,A00,182616,Cohen; Jonathan David,66,0,70,4
1681911503266,PHIL 155,A00,182617,Vargas; Manuel Rogelio,60,0,70,10
1681911504289,PHIL 163,A01,182620,Staff,15,0,20,5
1681911504289,PHIL 163,A02,182624,Staff,10,0,20,10
1681911505316,PHIL 164,A00,182627,Staff,30,0,40,10
1681911506338,PHIL 173,A00,182628,Staff,36,0,40,4
1681911507366,PHYS 1A,A00,183221,Staff,54,0,60,6
1681911508393,PHYS 1AL,001,183222,Staff,25,0,30,5
1681911508393,PHYS 1AL,002,183223,Staff,28,0,30,2
1681911509427,PHYS 1B,A00,183231,Staff,44,0,60,16
1681911510451,PHYS 1BL,001,183232,Staff,20,0,30,10
1681911510451,PHYS 1BL,002,183233,Staff,29,0,30,1
1681911511474,PHYS 1C,A00,183240,Staff,30,0,60,30
1681911512501,PHYS 1CL,001,183241,Staff,13,0,30,17
1681911512501,PHYS 1CL,002,183242,Staff,22,0,30,8
1681911513525,PHYS 2AR,A01,183250,Staff,44,0,50,6
1681911514548,PHYS 2B,A01,183252,Staff,106,0,115,9
1681911515579,PHYS 2BL,A01,183254,Staff,21,0,24,3
1681911515579,PHYS 2BL,A02,183255,Staff,22,0,24,2
1681911516607,PHYS 2C,A01,183522,Staff,105,0,115,10
1681911517629,PHYS 4A,A01,183524,Staff,49,0,50,1
1681911518656,POLI 5,A00,183525,Staff,44,0,50,6
1681911519682,POLI 12,A00,183540,Staff,48,0,50,2
1681911520706,POLI 13R,A00,183541,Forman; Fonna,42,0,50,8
1681911521734,POLI 30,A00,183542,Mignozzetti; Umberto,47,0,50,3
1681911522762,POLI 100A,A00,183543,Staff,45,0,50,5
1681911523794,POLI 100E,A00,223598,Staff,32,0,35,3
1681911524820,POLI 103A,A00,183564,Kousser; Thad,38,0,50,12
1681911525848,POLI 104B,A00,201329,Staff,29,0,35,6
1681911526875,POLI 113BR,A00,183576,Hoston; Germaine,27,0,50,23
1681911527902,POLI 114BR,A00,183588,Staff,27,0,30,3
1681911528925,POLI 117R,A00,183595,Forman; Fonna,9,0,20,11
1681911529954,POLI 120H,A00,183596,Fisk; David Lee,13,0,20,7
1681911530977,POLI 130AA,A00,183597,Staff,14,0,20,6
1681911532004,POLI 134AA,A00,183598,Staff,19,0,20,1
1681911533027,POLI 135,A00,183599,Fisk; David Lee,20,0,25,5
1681911534051,POLI 142P,A00,183623,Staff,37,0,40,3
1681911535080,POLI 144D,A00,183624,Staff,22,0,25,3
1681911536107,POLI 151,A00,183625,Staff,15,0,20,5
1681911537130,POLI 162,A00,183626,Mignozzetti; Umberto,18,0,20,2
1681911538153,PSYC 1,A00,253748,Staff,86,0,90,4
1681911539182,PSYC 2,A00,183627,Moranton; Nirelia Melbina-,25,0,35,10
1681911540205,PSYC 3,A00,183628,Staff,43,0,45,2
1681911542256,PSYC 60,A01,183631,Lowe; Angela Beth,35,0,40,5
1681911543283,PSYC 70,A01,253757,Staff,37,0,45,8
1681911544308,PSYC 101,A00,183632,Heyman; Gail D.,48,0,60,12
1681911545339,PSYC 105,A00,183848,Lowe; Angela Beth,50,0,60,10
1681911546370,PSYC 106,A00,183849,Dobkins; Karen R.,45,0,60,15
1681911547393,PSYC 108,A00,253750,Staff,24,0,60,36
1681911548425,PSYC 114,A01,184275,Winkielman; Piotr,0,6,30,30
1681911549452,PSYC 122,A00,183856,Moranton; Nirelia Melbina-,0,10,30,30
1681911550476,PSYC 124,A00,183865,Chapman; Eddie Nathaniel,52,0,80,28
1681911551500,PSYC 137,A00,183880,Staff,19,0,25,6
1681911553545,PSYC 154,A00,183910,Lacefield; Katharine I,0,2,90,90
1681911555593,PSYC 162,A00,183946,Wixted; John T,61,0,90,29
1681911556617,PSYC 172,A00,183947,Gorman; Michael R.,14,0,30,16
1681911557641,PSYC 178,A00,183963,Glaser; Dale,20,0,40,20
1681911558664,PSYC 181GS,A00,183964,Anagnostaras; Stephan,10,0,10,0
1681911559688,PSYC 186GS,A01,257660,Staff,10,0,10,0
1681911560715,PSYC 193,B00,253749,Staff,23,0,25,2
1681911562771,PSYC 193L,A01,184122,Staff,33,0,35,2
1681911562771,PSYC 193L,C01,184167,Winkielman; Piotr,16,0,30,14
1681911563797,RELI 188GS,A00,182629,Rahimi; Babak,20,0,20,0
1681911564820,SE 101A,A00,182646,Staff,26,0,30,4
1681911565849,SE 101C,A00,182650,Staff,18,0,20,2
1681911566876,SE 110A,A00,182651,Staff,28,0,28,0
1681911567899,SE 130A,A00,182652,Staff,39,0,40,1
1681911568938,SIO 46GS,A00,182636,Cook; Geoffrey W,28,0,28,0
1681911569969,SIO 109R,A00,194459,Staff,5,0,20,15
1681911570999,SIO 121GS,A00,182639,Cook; Geoffrey W,28,0,28,0
1681911572023,SIO 132,A01,182642,Staff,32,0,40,8
1681911573048,SIO 139,A00,182644,Kacev; David,36,0,40,4
1681911574071,SOCI 2,A01,258404,Staff,34,0,36,2
1681911574071,SOCI 2,A02,258405,Staff,35,0,36,1
1681911575098,SOCI 60,A01,258408,Staff,29,0,30,1
1681911575098,SOCI 60,A02,258413,Staff,30,0,30,0
1681911576123,SOCI 100,A01,258415,Staff,29,0,30,1
1681911576123,SOCI 100,A02,258416,Staff,28,0,30,2
1681911582291,SOCI 127,A00,258421,Staff,22,0,30,8
1681911583316,SOCI 132,A00,258422,Staff,45,0,50,5
1681911584338,SOCI 133,A00,258423,Staff,26,0,30,4
1681911585363,SOCI 138GS,A00,258424,Staff,15,0,15,0
1681911586389,SOCI 145,A00,258425,Staff,25,0,30,5
1681911587416,SOCI 148,A00,258426,Staff,26,0,30,4
1681911588438,SOCI 153,A00,199217,Staff,29,0,30,1
1681911589461,SOCI 160,A00,258427,Staff,28,0,30,2
1681911590487,SOCI 160E,A00,258435,Staff,56,0,60,4
1681911591513,SOCI 189GS,A00,258436,Staff,15,0,15,0
1681911592607,SOCI 190GS,A00,258437,Staff,15,0,15,0
1681911593630,SYN 2,001,182658,Staff,9,0,16,7
1681911593630,SYN 2,002,201439,Staff,15,0,16,1
1681911593630,SYN 2,003,201443,Staff,16,0,16,0
1681911594658,SYN 100,A01,182657,Staff,17,0,20,3
1681911595686,TDAC 1,A00,184381,Salovey; Todd,16,0,20,4
1681911595686,TDAC 1,B00,184385,Harting; Carla Kelso,19,0,20,1
1681911595686,TDAC 1,C00,184394,Staff,19,0,20,1
1681911596711,TDAC 101,A00,184483,Harting; Carla Kelso,19,0,20,1
1681911597735,TDDE 111,A00,184496,Staff,14,0,15,1
1681911598759,TDDE 131,A00,184504,Staff,20,0,20,0
1681911598759,TDDE 131,B00,184505,Staff,17,0,18,1
1681911598759,TDDE 131,C00,184534,Staff,49,0,50,1
1681911598759,TDDE 131,D00,184564,Staff,15,0,15,0
1681911598759,TDDE 131,E00,204725,Staff,19,0,20,1
1681911599782,TDGE 1,A01,184414,Salovey; Todd,37,0,50,13
1681911600808,TDGE 5,A01,184419,Staff,23,0,24,1
1681911601836,TDGE 10,A00,184428,Fulton; Julia,31,0,50,19
1681911602858,TDGE 124,A00,184565,Fulton; Julia,7,0,50,43
1681911603881,TDGE 125,B00,184567,Meyer; Ursula,9,0,25,16
1681911604908,TDHT 101,A00,184568,Staff,21,0,25,4
1681911604908,TDHT 101,B00,184569,Staff,20,0,20,0
1681911605934,TDHT 114,A00,184570,Staff,49,0,50,1
1681911606961,TDMV 1,A00,184437,Arcidiacono; Kristin,23,0,30,7
1681911606961,TDMV 1,B00,184448,Caligagan; Maria T.,22,0,30,8
1681911607986,TDMV 2,A00,184449,Weinberg; Sadie,27,0,30,3
1681911607986,TDMV 2,B00,184453,Arcidiacono; Kristin,29,0,30,1
1681911609011,TDMV 110,A00,184571,Weinberg; Sadie,30,0,30,0
1681911610035,TDMV 142,A00,184572,Caligagan; Tony,27,0,30,3
1681911610035,TDMV 142,B00,184573,Caligagan; Maria T.,27,0,30,3
1681911611062,TDTR 20,A00,184482,Jun; Grace Shin Hae,25,0,25,0
1681911612085,USP 2,A01,184290,Hinds; Juli Beth,24,0,25,1
1681911613107,USP 3,A01,184295,Staff,20,0,25,5
1681911614131,USP 4,A00,184304,McTague; Sarah,15,0,25,10
1681911615159,USP 100,A00,184315,Staff,17,0,25,8
1681911616183,USP 105,A00,184326,Staff,21,0,25,4
1681911617208,USP 151,A00,184327,Staff,20,0,25,5
1681911618236,USP 170,A00,184380,Hinds; Juli Beth,14,0,25,11
1681911619260,VIS 21B,A01,182660,Staff,28,0,31,3
1681911619260,VIS 21B,A02,182662,Staff,30,0,31,1
1681911620285,VIS 103D,A00,182663,Staff,74,0,75,1
1681911621308,VIS 105D,A00,182667,Li; Huai,15,0,22,7
1681911622331,VIS 122GS,A00,182668,Herbst; Matthew,20,0,20,0
1681911623355,VIS 128C,A00,182673,Staff,69,0,75,6
1681911624380,VIS 130,A00,182675,Staff,20,0,22,2
1681911625405,VIS 160A,A00,182678,Stalbaum; Brett,4,0,10,6
1681911627461,WCWP 10B,A00,201679,Staff,15,0,15,0
1681911627461,WCWP 10B,B00,201695,Staff,15,0,15,0
1681911628495,WCWP 100,A00,201716,Staff,15,0,15,0
1681911628495,WCWP 100,B00,201717,Staff,11,0,15,4
1681911630568,ANSC 105GS,A00,258289,Staff,0,0,0,0
1681911631593,ANSC 125GS,A00,258295,Staff,0,0,0,0
1681911632625,ANSC 150,A00,258267,Staff,30,0,40,10
1681911633649,ANSC 190GS,A00,258280,Staff,0,0,0,0
1681911634671,ANTH 1,A00,258264,Staff,38,0,40,2
1681911635697,ANTH 2,A01,258259,Staff,72,0,76,4
1681911636722,ANTH 23,A01,258228,Staff,36,0,40,4
1681911637745,ANTH 101,A01,258236,Staff,39,0,40,1
1681911638768,ANTH 102,A00,258272,Staff,59,0,60,1
1681911639793,ANTH 105,A00,258244,Staff,31,0,35,4
1681911640816,BENG 130,A00,253975,Staff,38,0,40,2
1681911641840,BIBC 102,A01,191866,Flagg; Matthew Paul,19,0,32,13
1681911641840,BIBC 102,A02,191867,Flagg; Matthew Paul,22,0,32,10
1681911641840,BIBC 102,A03,191868,Flagg; Matthew Paul,30,0,32,2
1681911641840,BIBC 102,A04,191936,Flagg; Matthew Paul,26,0,32,6
1681911641840,BIBC 102,A05,191937,Flagg; Matthew Paul,11,0,32,21
1681911642872,BICD 100,A01,191939,Cooper; Andrew Michael,28,0,32,4
1681911642872,BICD 100,A02,191940,Cooper; Andrew Michael,32,0,32,0
1681911642872,BICD 100,A03,191941,Cooper; Andrew Michael,32,0,32,0
1681911642872,BICD 100,A04,191942,Cooper; Andrew Michael,32,0,32,0
1681911642872,BICD 100,A05,191943,Cooper; Andrew Michael,32,0,32,0
1681911643896,BIEB 126,A01,191945,Cleland; Elsa Eleanor,1,0,32,31
1681911643896,BIEB 126,A02,191946,Cleland; Elsa Eleanor,28,0,32,4
1681911643896,BIEB 126,A03,191947,Cleland; Elsa Eleanor,29,0,32,3
1681911643896,BIEB 126,A04,191948,Cleland; Elsa Eleanor,23,0,32,9
1681911643896,BIEB 126,A05,191996,Cleland; Elsa Eleanor,28,0,32,4
1681911644921,BIEB 136GS,A00,191997,Shurin; Jonathan & Holway; David A.,0,0,0,0
1681911645947,BIEB 137GS,A01,191999,Shurin; Jonathan & Holway; David A.,0,0,0,0
1681911646974,BILD 1,A01,205385,Staff,31,0,32,1
1681911646974,BILD 1,A02,205386,Staff,30,0,32,2
1681911646974,BILD 1,A03,205387,Staff,32,0,32,0
1681911646974,BILD 1,A04,205388,Staff,28,0,32,4
1681911648002,BILD 2,A01,191774,Staff,28,0,32,4
1681911648002,BILD 2,A02,191775,Staff,30,0,32,2
1681911648002,BILD 2,A03,191777,Staff,30,0,32,2
1681911648002,BILD 2,A04,191856,Staff,31,0,32,1
1681911648002,BILD 2,A05,191857,Staff,32,0,32,0
1681911648002,BILD 2,A06,191858,Staff,32,0,32,0
1681911648002,BILD 2,A07,191859,Staff,31,0,32,1
1681911649026,BILD 3,A01,205391,Staff,29,0,32,3
1681911649026,BILD 3,A02,205393,Staff,32,0,32,0
1681911649026,BILD 3,A03,205394,Staff,28,0,32,4
1681911649026,BILD 3,A04,205395,Staff,32,0,32,0
1681911650051,BILD 20,A01,191861,Staff,32,0,32,0
1681911650051,BILD 20,A02,191862,Staff,32,0,32,0
1681911651080,BILD 30,A01,191864,Staff,31,0,32,1
1681911652105,BIMM 100,A01,192019,Staff,0,0,32,32
1681911652105,BIMM 100,A02,192020,Staff,23,0,32,9
1681911652105,BIMM 100,A03,192035,Staff,22,0,32,10
1681911653135,BIMM 110,A01,192037,Tat; John,0,0,32,32
1681911653135,BIMM 110,A02,192038,Tat; John,10,0,32,22
1681911654159,BIMM 120,A01,192040,Pickett; Brooke Elizabeth,2,0,32,30
1681911654159,BIMM 120,A02,192041,Pickett; Brooke Elizabeth,16,0,32,16
1681911654159,BIMM 120,A03,192042,Pickett; Brooke Elizabeth,16,0,32,16
1681911655185,BIPN 100,A01,192044,Armour; Jon Christopher,26,0,32,6
1681911655185,BIPN 100,A02,192059,Armour; Jon Christopher,30,0,32,2
1681911655185,BIPN 100,A03,192064,Armour; Jon Christopher,31,0,32,1
1681911655185,BIPN 100,A04,192073,Armour; Jon Christopher,28,0,32,4
1681911656215,BIPN 148,A01,205411,Leutgeb; Jill K.,16,0,32,16
1681911656215,BIPN 148,A02,205412,Leutgeb; Jill K.,31,0,32,1
1681911656215,BIPN 148,A03,205413,Leutgeb; Jill K.,30,0,32,2
1681911656215,BIPN 148,A04,205414,Leutgeb; Jill K.,30,0,32,2
1681911657252,BIPN 160,A01,192115,Marino; Marc J,19,0,32,13
1681911657252,BIPN 160,A02,192148,Marino; Marc J,27,0,32,5
1681911657252,BIPN 160,A03,192158,Marino; Marc J,31,0,32,1
1681911657252,BIPN 160,A04,192190,Marino; Marc J,32,0,32,0
1681911657252,BIPN 160,A05,192287,Marino; Marc J,32,0,32,0
1681911657252,BIPN 160,A06,192288,Marino; Marc J,32,0,32,0
1681911658276,BIPN 194,A00,206038,Staff,28,0,32,4
1681911659304,BISP 194,A00,192289,Leutgeb; Stefan,13,0,32,19
1681911659304,BISP 194,B00,245332,Nieh; James Charles,27,0,32,5
1681911660328,CAT 124,A01,202247,Staff,15,0,15,0
1681911661353,CAT 125,A00,202248,Staff,19,0,20,1
1681911661353,CAT 125,B00,202253,Staff,20,0,20,0
1681911661353,CAT 125,C00,202257,Staff,19,0,20,1
1681911662377,CAT 125GS,A01,202273,Bronstein; Phoebe Malan,20,0,20,0
1681911663409,CAT 125R,A00,202284,Staff,17,0,20,3
1681911663409,CAT 125R,C00,202286,Staff,10,0,20,10
1681911663409,CAT 125R,D00,202291,Staff,18,0,20,2
1681911663409,CAT 125R,E00,202295,Staff,13,0,20,7
1681911663409,CAT 125R,F00,202302,Staff,12,0,20,8
1681911664438,CENG 100,A00,204724,Opatkiewicz; Justin Paul,25,0,25,0
1681911665461,CGS 2A,A01,180420,Staff,31,0,36,5
1681911666486,CGS 101,A00,180421,Staff,16,0,20,4
1681911667509,CGS 112,A00,180422,Staff,10,0,16,6
1681911668533,CGS 113,A00,180423,Staff,18,0,20,2
1681911669555,CGS 137,A00,180424,Staff,12,0,12,0
1681911670592,CGS 147,A00,180425,Staff,10,0,10,0
1681911671614,CHEM 6A,A01,179556,Staff,97,0,100,3
1681911671614,CHEM 6A,A02,179558,Staff,0,0,0,0
1681911672642,CHEM 6B,A01,179560,Staff,100,0,100,0
1681911673665,CHEM 6C,A01,179565,Jazzar; Rodolphe,95,0,100,5
1681911674703,CHEM 7L,A01,179586,Schurmeier; Kimberly,13,0,24,11
1681911674703,CHEM 7L,A02,179587,Schurmeier; Kimberly,23,0,24,1
1681911674703,CHEM 7L,A03,179590,Schurmeier; Kimberly,22,0,24,2
1681911674703,CHEM 7L,A04,179591,Schurmeier; Kimberly,22,0,24,2
1681911674703,CHEM 7L,B01,179598,Schurmeier; Kimberly,17,0,24,7
1681911674703,CHEM 7L,B02,179599,Schurmeier; Kimberly,24,0,24,0
1681911674703,CHEM 7L,B03,179606,Schurmeier; Kimberly,23,0,24,1
1681911674703,CHEM 7L,B04,179607,Schurmeier; Kimberly,23,0,24,1
1681911675731,CHEM 11,A01,179609,Stallings; Dontarie M,88,0,100,12
1681911676759,CHEM 40A,A01,179621,Staff,41,0,50,9
1681911676759,CHEM 40A,A02,179622,Staff,47,0,50,3
1681911677788,CHEM 40B,A01,179630,Weizman; Haim,48,0,50,2
1681911677788,CHEM 40B,A02,179631,Weizman; Haim,45,0,50,5
1681911678812,CHEM 41A,A01,179660,Klosterman; Jeremy K,93,0,100,7
1681911679837,CHEM 43A,A01,179683,Klosterman; Jeremy K,0,0,24,24
1681911679837,CHEM 43A,A02,179688,Klosterman; Jeremy K,14,0,24,10
1681911679837,CHEM 43A,A03,179689,Klosterman; Jeremy K,20,0,24,4
1681911679837,CHEM 43A,A04,179691,Klosterman; Jeremy K,18,0,24,6
1681911680861,CHEM 114A,A01,179693,Stallings; Dontarie M,77,0,100,23
1681911681885,CHEM 143B,A01,179698,Weizman; Haim,17,0,24,7
1681911681885,CHEM 143B,A02,179700,Weizman; Haim,24,0,24,0
1681911682909,CHIN 169A,A00,179701,Wang; Xiao,20,0,20,0
1681911683938,COGS 2,A01,179750,Boyle; Mary E. T.,17,0,30,13
1681911684961,COGS 9,A01,179759,Jones; Cameron Robert,43,0,50,7
1681911685984,COGS 14A,A01,179854,Staff,18,0,50,32
1681911687009,COGS 14B,A01,179856,Staff,54,0,60,6
1681911688036,COGS 17,A01,179874,Staff,71,0,75,4
1681911689061,COGS 18,A01,179884,Staff,63,0,80,17
1681911690087,COGS 100,A01,179886,Staff,40,0,60,20
1681911691113,COGS 101B,A01,179892,Staff,1,0,30,29
1681911692139,COGS 101C,A01,179894,Staff,28,0,30,2
1681911693163,COGS 107A,A01,179896,Boyle; Mary E. T.,31,0,40,9
1681911694192,COGS 108,A01,179898,Simpkins; Charles Alexander,0,17,60,60
1681911695216,COGS 109,A01,179900,Staff,34,0,40,6
1681911696331,COGS 118A,A01,179946,Staff,9,0,40,31
1681911697359,COGS 153,A00,179978,Staff,1,0,30,29
1681911698385,COGS 156,A01,179981,Staff,27,0,30,3
1681911700431,COGS 172,A01,179987,Staff,13,0,30,17
1681911702477,COGS 186,A01,179991,Staff,13,0,30,17
1681911703501,COMM 10,A01,180001,Staff,15,0,25,10
1681911703501,COMM 10,A02,180004,Staff,20,0,25,5
1681911704524,COMM 100A,A01,180016,Staff,18,0,25,7
1681911704524,COMM 100A,A02,180020,Staff,24,0,25,1
1681911705548,COMM 101T,A00,180029,Halm; Gavin Patrick,23,0,35,12
1681911706573,COMM 106V,A00,180043,Staff,34,0,35,1
1681911707595,COMM 109P,A00,180044,Staff,31,0,35,4
1681911708623,COMM 113T,A00,180045,Havis; Allan,37,0,45,8
1681911709646,COMM 132,A00,180046,McKenna; Denise,23,0,30,7
1681911710669,COMM 143,A00,180047,Staff,19,0,30,11
1681911711696,COMM 190,A00,180048,Conner; Thomas Hartnell,20,0,23,3
1681911712722,CSE 8A,A50,180053,Cao; Yingjun,25,0,50,25
1681911712722,CSE 8A,B50,180180,Staff,50,0,50,0
1681911713747,CSE 11,A01,180190,Cao; Yingjun,31,0,50,19
1681911714770,CSE 20,A01,180192,Briones; Jor-el Thomas Caparas,23,0,30,7
1681911715793,CSE 21,A01,194538,Briones; Jor-el Thomas Caparas,50,0,60,10
1681911716817,CSE 30,A01,180324,Eldon; John,79,0,100,21
1681911717844,CSE 101,A01,201353,Staff,0,20,40,40
1681911718870,CSE 134B,A01,180326,Powell; Thomas Allan,74,0,100,26
1681911719903,CSE 140,A01,180328,Staff,46,0,75,29
1681911720929,CSE 140L,A01,180344,Eldon; John,69,0,100,31
1681911721957,CSE 150A,A01,180411,Staff,0,7,50,50
1681911722982,CSE 151A,A01,180414,Staff,0,6,50,50
1681911724011,CSE 175,A01,222521,Kumar; Rakesh,50,0,50,0
1681911725037,CSE 190,A00,201419,Staff,45,0,49,4
1681911726060,CSS 1,A01,194536,Staff,38,0,50,12
1681911727086,DSC 30,A01,202385,Staff,48,0,50,2
1681911728112,DSC 40A,A01,202387,Albuyeh; Rod,50,0,50,0
1681911729141,DSC 190,A01,202389,Silberman; Jack,21,0,21,0
1681911730167,DSGN 100,A01,179993,Staff,16,0,30,14
1681911731193,ECE 65,A50,180708,Staff,10,0,20,10
1681911731193,ECE 65,A51,180739,Staff,19,0,20,1
1681911732217,ECON 1,A01,180427,Famulari; Melissa,67,0,70,3
1681911733243,ECON 2,A01,180450,Levkoff; Steven B.,64,0,70,6
1681911734268,ECON 4,A01,203351,Anderson; John Charles,7,0,10,3
1681911735294,ECON 100A,A01,180472,Famulari; Melissa,65,0,70,5
1681911736318,ECON 120A,A01,180549,Staff,64,0,70,6
1681911737345,ECON 120B,A01,180655,Ma; Xinwei,46,0,70,24
1681911738367,ECON 129,A00,203333,Eckert; Fabian Paul,15,0,35,20
1681911739393,ECON 131,A00,180656,Staff,9,0,35,26
1681911740418,ECON 172B,A01,180672,Levkoff; Steven B.,32,0,35,3
1681911741441,ECON 178,A01,203342,Zhu; Ying,11,0,35,24
1681911742465,EDS 108GS,A00,202383,Wishard Guerra; Alison G.,20,0,20,0
1681911743488,EDS 111GS,A00,202347,Wishard Guerra; Alison G.,20,0,20,0
1681911744520,EDS 112,A01,202323,Staff,56,0,60,4
1681911745553,EDS 113,A00,202340,Staff,33,0,35,2
1681911746578,EDS 118,A00,201231,Staff,20,0,30,10
1681911747603,EDS 119,A00,204994,Staff,8,0,10,2
1681911748626,EDS 124BR,A00,202324,Eguchi; Emi,5,0,25,20
1681911749648,EDS 126,A01,203208,Jones; Makeba,26,0,30,4
1681911750675,EDS 135,A01,202333,Staff,18,0,20,2
1681911751701,EDS 180,A00,202311,Staff,47,0,50,3
1681911752724,ERC 190GS,A01,253747,Staff,28,0,28,0
1681911753747,ETHN 104,A00,180742,Staff,24,0,35,11
1681911754771,ETHN 118,A00,180745,Staff,28,0,35,7
1681911755794,ETHN 127,A00,180747,Staff,12,0,16,4
1681911756817,ETHN 137,A00,180880,Staff,12,0,12,0
1681911757849,ETHN 147,A00,180890,Staff,8,0,10,2
1681911758878,ETHN 154,A00,180891,Staff,7,0,8,1
1681911759901,ETHN 168,A00,180892,Staff,9,0,10,1
1681911760930,GLBH 20,A00,201051,Hannah; Seth Donal,0,1,0,1
1681911761956,GLBH 111,A01,209338,Burgos; Jose L.,0,0,0,0
1681911762982,GLBH 150,A00,258300,Staff,0,3,0,0
1681911764008,GLBH 181,A00,201207,Staff,15,0,40,25
1681911765034,HIEU 109,A00,180898,Staff,20,0,20,0
1681911766060,HIEU 111,A00,180899,Staff,1,0,20,19
1681911767090,HIEU 124,A00,180900,Staff,18,0,20,2
1681911768114,HILA 122,A00,180901,Staff,18,0,20,2
1681911769138,HILA 132,A00,180902,Vitz; Matthew,2,0,20,18
1681911770167,HILD 10,A01,180896,Staff,15,0,20,5
1681911771190,HILD 30GS,A00,180897,Edington; Claire Ellen,0,0,0,0
1681911772213,HISC 105,A00,180903,Staff,20,0,20,0
1681911773237,HISC 117,A00,180904,Staff,11,0,20,9
1681911774260,HIUS 108B,A00,181005,Staff,18,0,20,2
1681911775288,HIUS 113,A00,181093,Staff,4,0,20,16
1681911776315,HUM 3,A01,181190,Patterson; Patrick H.,40,0,50,10
1681911776315,HUM 3,B01,181195,Staff,47,0,50,3
1681911777341,HUM 3GS,A00,181196,Herbst; Matthew,0,0,0,0
1681911778371,HUM 4,A01,181227,West; Geoffrey Scott,34,0,50,16
1681911778371,HUM 4,B01,181282,Staff,43,0,50,7
1681911779395,HUM 4GS,A00,181377,Lyon; Antony J.,0,0,0,0
1681911780419,HUM 5,A01,181536,Zavodny; Tatiana Sophia,31,0,50,19
1681911780419,HUM 5,B01,181908,Staff,36,0,50,14
1681911781446,INTL 190,A00,181909,Segui; Alan S,0,0,0,6
1681911781446,INTL 190,B00,181961,Segui; Alan S,0,0,0,7
1681911782473,JAPN 20AR,A01,182113,Ross; Kayoko F,15,0,20,5
1681911783500,LATI 50,A01,202391,Martin-Cabrera; Luis,19,0,30,11
1681911783500,LATI 50,A02,202392,Martin-Cabrera; Luis,26,0,30,4
1681911784528,LATI 180,A00,202393,Kokinis; Troy Andreas,25,0,25,0
1681911785555,LIFR 1A,A00,182119,Staff,14,0,14,0
1681911786580,LIFR 1AX,A00,182324,Staff,14,0,14,0
1681911787607,LIFR 1B,A00,182259,Staff,14,0,14,0
1681911788629,LIFR 1BX,A00,182273,Staff,14,0,14,0
1681911789653,LIGN 8,A00,182330,Staff,137,0,150,13
1681911790677,LIGN 9GS,A00,182362,Staff,20,0,20,0
1681911791704,LIGN 119,A00,204992,Takahashi; Maho,12,0,15,3
1681911792732,LIGN 130,A01,182384,Staff,47,0,50,3
1681911793759,LIGN 149GS,A00,182390,Staff,20,0,20,0
1681911794784,LIGN 170,A00,182404,Staff,24,0,30,6
1681911795807,LISP 1D,A00,182281,Staff,7,0,14,7
1681911795807,LISP 1D,B00,182287,Staff,14,0,14,0
1681911795807,LISP 1D,C00,182295,Staff,11,0,14,3
1681911795807,LISP 1D,D00,182301,Staff,14,0,14,0
1681911796829,LISP 1DX,A00,182309,Staff,20,0,28,8
1681911796829,LISP 1DX,B00,182316,Staff,26,0,28,2
1681911797851,LTAF 120GS,A00,182412,Zhiri; Oumelbanine,20,0,20,0
1681911798875,LTCS 172GS,A00,182437,Bronstein; Phoebe Malan,20,0,20,0
1681911800059,LTEA 138,A00,182457,Staff,22,0,40,18
1681911801111,LTEN 114,A01,182490,Staff,23,0,25,2
1681911802134,LTEN 130GS,A00,182491,Lyon; Antony J.,20,0,20,0
1681911803159,LTEN 169,A00,182493,Cuong; Marisol,20,0,25,5
1681911804184,LTEN 178,A00,182501,Staff,14,0,15,1
1681911805216,LTEN 181,A00,182515,Staff,22,0,25,3
1681911806242,LTEN 185GS,A00,197655,Forbes; Camille,20,0,20,0
1681911807266,LTSP 100B,A00,202208,Bessett; Ryan Matthew,24,0,25,1
1681911808292,LTWL 100,A00,182516,Myerston Santana; Jacobo,22,0,30,8
1681911809318,LTWR 100GS,A00,182518,Forbes; Camille,20,0,20,0
1681911810342,LTWR 102,A00,182522,Staff,15,0,15,0
1681911810342,LTWR 102,B00,182525,Staff,14,0,15,1
1681911811365,LTWR 115,A00,182526,Staff,12,0,15,3
1681911812392,MAE 8,A01,182528,Pham; Hieu Tan,68,0,70,2
1681911813416,MAE 11,A00,182529,Bahadori; Mohammad Yousef,94,0,100,6
1681911814439,MAE 20,A00,182530,Evdokimenko; Ekaterina,68,0,70,2
1681911815468,MAE 30A,A00,182532,Staff,44,0,45,1
1681911816495,MAE 101A,A00,182533,Bahadori; Mohammad Yousef,97,0,100,3
1681911817519,MAE 101C,A00,182538,Staff,62,0,70,8
1681911818544,MAE 104,A00,182539,Staff,45,0,50,5
1681911819570,MAE 131A,A00,182540,Ghazinejad; Maziar,41,0,45,4
1681911820593,MAE 143A,A00,182548,Bewley; Thomas R,43,0,50,7
1681911821616,MAE 150,A00,182549,Staff,28,0,40,12
1681911822644,MAE 160,A00,182550,Evdokimenko; Ekaterina,43,0,60,17
1681911823672,MATH 3C,A01,182725,Staff,27,0,30,3
1681911824699,MATH 10A,A01,182729,Staff,25,0,30,5
1681911824699,MATH 10A,B01,182732,Staff,26,0,30,4
1681911825729,MATH 10B,A01,182737,Staff,21,0,30,9
1681911825729,MATH 10B,A02,182738,Staff,27,0,30,3
1681911825729,MATH 10B,B01,182744,Staff,27,0,30,3
1681911825729,MATH 10B,B02,182745,Staff,27,0,30,3
1681911826752,MATH 18,A01,182750,Anzaldo; Leesa B,28,0,30,2
1681911826752,MATH 18,A02,182751,Anzaldo; Leesa B,29,0,30,1
1681911826752,MATH 18,A03,182753,Anzaldo; Leesa B,28,0,30,2
1681911826752,MATH 18,A04,182757,Anzaldo; Leesa B,29,0,30,1
1681911826752,MATH 18,B01,182761,Anzaldo; Leesa B,27,0,30,3
1681911826752,MATH 18,B02,182764,Anzaldo; Leesa B,27,0,30,3
1681911826752,MATH 18,B03,182765,Anzaldo; Leesa B,30,0,30,0
1681911826752,MATH 18,B04,182766,Anzaldo; Leesa B,30,0,30,0
1681911827777,MATH 20A,A01,182771,Suk; Andrew Hoon,28,0,30,2
1681911828806,MATH 20B,A01,182775,Bach; Quang Tran,30,0,30,0
1681911828806,MATH 20B,A02,182777,Bach; Quang Tran,29,0,30,1
1681911828806,MATH 20B,B01,182780,Bach; Quang Tran,27,0,30,3
1681911828806,MATH 20B,B02,182782,Bach; Quang Tran,30,0,30,0
1681911829831,MATH 20C,A01,182787,Staff,25,0,30,5
1681911829831,MATH 20C,A02,182790,Staff,29,0,30,1
1681911829831,MATH 20C,B01,182792,Staff,25,0,30,5
1681911829831,MATH 20C,B02,182796,Staff,27,0,30,3
1681911830858,MATH 20D,A01,182799,Staff,29,0,30,1
1681911830858,MATH 20D,A02,182802,Staff,30,0,30,0
1681911830858,MATH 20D,A03,182803,Staff,30,0,30,0
1681911831883,MATH 20E,A01,182809,Verstraete; Jacques Allan,24,0,30,6
1681911831883,MATH 20E,A02,182811,Verstraete; Jacques Allan,28,0,30,2
1681911831883,MATH 20E,B01,182814,Verstraete; Jacques Allan,23,0,30,7
1681911831883,MATH 20E,B02,182815,Verstraete; Jacques Allan,30,0,30,0
1681911832907,MATH 103A,A01,182820,Staff,9,0,30,21
1681911832907,MATH 103A,A02,182821,Staff,27,0,30,3
1681911832907,MATH 103A,A03,182822,Staff,23,0,30,7
1681911832907,MATH 103A,B01,182825,Staff,23,0,30,7
1681911832907,MATH 103A,B02,182826,Staff,30,0,30,0
1681911832907,MATH 103A,B03,182830,Staff,30,0,30,0
1681911833932,MATH 109,A01,182836,Chow; Bennett,24,0,30,6
1681911833932,MATH 109,A02,182838,Chow; Bennett,29,0,30,1
1681911833932,MATH 109,A03,182894,Chow; Bennett,29,0,30,1
1681911833932,MATH 109,B01,182908,Chow; Bennett,28,0,30,2
1681911833932,MATH 109,B02,182909,Chow; Bennett,30,0,30,0
1681911833932,MATH 109,B03,182910,Chow; Bennett,27,0,30,3
1681911834957,MATH 142A,A01,182925,Staff,11,0,30,19
1681911834957,MATH 142A,A02,182935,Staff,25,0,30,5
1681911834957,MATH 142A,A03,182967,Staff,26,0,30,4
1681911834957,MATH 142A,B01,183125,Staff,24,0,30,6
1681911834957,MATH 142A,B02,183157,Staff,28,0,30,2
1681911834957,MATH 142A,B03,183158,Staff,29,0,30,1
1681911835983,MATH 183,A01,183160,Arias-Castro; Ery,23,0,30,7
1681911835983,MATH 183,A02,183161,Arias-Castro; Ery,29,0,30,1
1681911835983,MATH 183,B01,183163,Arias-Castro; Ery,28,0,30,2
1681911835983,MATH 183,B02,183164,Arias-Castro; Ery,28,0,30,2
1681911837011,MATH 193A,A01,183167,Staff,4,0,35,31
1681911837011,MATH 193A,A02,183168,Staff,28,0,35,7
1681911837011,MATH 193A,A03,183169,Staff,34,0,35,1
1681911837011,MATH 193A,A04,183170,Staff,28,0,35,7
1681911838042,MGT 4,A01,202395,Anderson; John Charles,75,0,80,5
1681911839069,MGT 5,A00,202396,Houskeeper; Robert,80,0,90,10
1681911840093,MGT 103,A00,202397,Eberhard; Craig A,55,0,90,35
1681911841116,MGT 131A,A00,202398,Houskeeper; Robert,85,0,90,5
1681911842142,MGT 135,A00,202399,Anderson; John Charles,82,0,90,8
1681911843167,MGT 162R,A00,202403,Gneezy; Uri,150,0,200,50
1681911844201,MGT 172,A00,202404,Hedges; Kathleen,50,0,90,40
1681911845228,MGT 181,A00,202405,Dunn; Louis Jean,84,0,90,6
1681911846252,MMW 14,A01,183200,Staff,16,0,28,12
1681911846252,MMW 14,A02,183201,Staff,26,0,28,2
1681911846252,MMW 14,A03,183202,Staff,24,0,28,4
1681911846252,MMW 14,A04,183203,Staff,25,0,28,3
1681911846252,MMW 14,A05,183204,Staff,26,0,28,2
1681911846252,MMW 14,A06,183205,Staff,27,0,28,1
1681911846252,MMW 14,B01,183207,Staff,26,0,28,2
1681911846252,MMW 14,B02,183208,Staff,28,0,28,0
1681911846252,MMW 14,B03,183209,Staff,28,0,28,0
1681911846252,MMW 14,B04,183210,Staff,28,0,28,0
1681911846252,MMW 14,B05,183211,Staff,28,0,28,0
1681911846252,MMW 14,B06,183212,Staff,28,0,28,0
1681911847275,MMW 14GS,A00,183213,Zhiri; Oumelbanine,28,0,28,0
1681911848299,MMW 15GS,B00,183215,Rahimi; Babak,28,0,28,0
1681911849327,MMW 121,A01,183217,Patterson; Patrick H.,14,0,28,14
1681911849327,MMW 121,A02,183218,Patterson; Patrick H.,25,0,28,3
1681911850351,MUS 1A,A01,182554,Staff,8,0,35,27
1681911851378,MUS 5,A01,182558,Staff,20,0,35,15
1681911852401,MUS 6,A01,182562,Staff,25,0,35,10
1681911853424,MUS 8GS,A00,182563,Borgo; David Garcia,25,0,25,0
1681911854448,MUS 13,A01,182567,Staff,24,0,25,1
1681911855473,MUS 15,A01,182570,Staff,32,0,35,3
1681911855473,MUS 15,B01,182575,Staff,10,0,35,25
1681911856497,MUS 80,A00,182578,Staff,23,0,25,2
1681911856497,MUS 80,B00,182581,Staff,20,0,25,5
1681911857523,MUS 113,A00,182582,Staff,25,0,25,0
1681911858547,MUS 114,A00,182583,Staff,4,0,25,21
1681911859570,MUS 150GS,A01,182588,Borgo; David Garcia,25,0,25,0
1681911860597,PHIL 1,A00,182590,Staff,35,0,40,5
1681911861621,PHIL 10,A01,182596,Grush; Rick Scott,31,0,35,4
1681911861621,PHIL 10,A02,182597,Grush; Rick Scott,34,0,35,1
1681911862644,PHIL 15,A01,182601,Staff,31,0,35,4
1681911862644,PHIL 15,A02,182602,Staff,33,0,35,2
1681911863668,PHIL 27,A01,182604,Staff,30,0,35,5
1681911863668,PHIL 27,A02,182607,Staff,35,0,35,0
1681911864693,PHIL 32,A01,182609,Staff,35,0,35,0
1681911864693,PHIL 32,A02,182612,Staff,35,0,35,0
1681911865720,PHIL 130,A00,182614,Staff,63,0,70,7
1681911866743,PHIL 136,A00,182616,Cohen; Jonathan David,66,0,70,4
1681911867767,PHIL 155,A00,182617,Vargas; Manuel Rogelio,60,0,70,10
1681911868790,PHIL 163,A01,182620,Staff,15,0,20,5
1681911868790,PHIL 163,A02,182624,Staff,10,0,20,10
1681911869821,PHIL 164,A00,182627,Staff,30,0,40,10
1681911870847,PHIL 173,A00,182628,Staff,36,0,40,4
1681911871872,PHYS 1A,A00,183221,Staff,54,0,60,6
1681911872896,PHYS 1AL,001,183222,Staff,25,0,30,5
1681911872896,PHYS 1AL,002,183223,Staff,28,0,30,2
1681911873922,PHYS 1B,A00,183231,Staff,44,0,60,16
1681911874950,PHYS 1BL,001,183232,Staff,20,0,30,10
1681911874950,PHYS 1BL,002,183233,Staff,29,0,30,1
1681911875974,PHYS 1C,A00,183240,Staff,30,0,60,30
1681911876999,PHYS 1CL,001,183241,Staff,13,0,30,17
1681911876999,PHYS 1CL,002,183242,Staff,22,0,30,8
1681911878031,PHYS 2AR,A01,183250,Staff,44,0,50,6
1681911879065,PHYS 2B,A01,183252,Staff,106,0,115,9
1681911880089,PHYS 2BL,A01,183254,Staff,21,0,24,3
1681911880089,PHYS 2BL,A02,183255,Staff,22,0,24,2
1681911881113,PHYS 2C,A01,183522,Staff,105,0,115,10
1681911882140,PHYS 4A,A01,183524,Staff,49,0,50,1
1681911883163,POLI 5,A00,183525,Staff,44,0,50,6
1681911884188,POLI 12,A00,183540,Staff,48,0,50,2
1681911885219,POLI 13R,A00,183541,Forman; Fonna,42,0,50,8
1681911886243,POLI 30,A00,183542,Mignozzetti; Umberto,47,0,50,3
1681911887266,POLI 100A,A00,183543,Staff,45,0,50,5
1681911888298,POLI 100E,A00,223598,Staff,32,0,35,3
1681911889321,POLI 103A,A00,183564,Kousser; Thad,38,0,50,12
1681911890347,POLI 104B,A00,201329,Staff,29,0,35,6
1681911891382,POLI 113BR,A00,183576,Hoston; Germaine,27,0,50,23
1681911892411,POLI 114BR,A00,183588,Staff,27,0,30,3
1681911893434,POLI 117R,A00,183595,Forman; Fonna,9,0,20,11
1681911894457,POLI 120H,A00,183596,Fisk; David Lee,13,0,20,7
1681911895496,POLI 130AA,A00,183597,Staff,14,0,20,6
1681911896519,POLI 134AA,A00,183598,Staff,19,0,20,1
1681911897543,POLI 135,A00,183599,Fisk; David Lee,20,0,25,5
1681911898566,POLI 142P,A00,183623,Staff,37,0,40,3
1681911899590,POLI 144D,A00,183624,Staff,22,0,25,3
1681911900616,POLI 151,A00,183625,Staff,15,0,20,5
1681911901643,POLI 162,A00,183626,Mignozzetti; Umberto,18,0,20,2
1681911902670,PSYC 1,A00,253748,Staff,86,0,90,4
1681911903770,PSYC 2,A00,183627,Moranton; Nirelia Melbina-,25,0,35,10
1681911904794,PSYC 3,A00,183628,Staff,43,0,45,2
1681911906850,PSYC 60,A01,183631,Lowe; Angela Beth,35,0,40,5
1681911907873,PSYC 70,A01,253757,Staff,37,0,45,8
1681911908901,PSYC 101,A00,183632,Heyman; Gail D.,48,0,60,12
1681911909929,PSYC 105,A00,183848,Lowe; Angela Beth,50,0,60,10
1681911910952,PSYC 106,A00,183849,Dobkins; Karen R.,45,0,60,15
1681911911976,PSYC 108,A00,253750,Staff,24,0,60,36
1681911913000,PSYC 114,A01,184275,Winkielman; Piotr,0,6,30,30
1681911914024,PSYC 122,A00,183856,Moranton; Nirelia Melbina-,0,10,30,30
1681911915047,PSYC 124,A00,183865,Chapman; Eddie Nathaniel,52,0,80,28
1681911916074,PSYC 137,A00,183880,Staff,19,0,25,6
1681911918125,PSYC 154,A00,183910,Lacefield; Katharine I,0,2,90,90
1681911920175,PSYC 162,A00,183946,Wixted; John T,61,0,90,29
1681911921200,PSYC 172,A00,183947,Gorman; Michael R.,14,0,30,16
1681911922229,PSYC 178,A00,183963,Glaser; Dale,20,0,40,20
1681911923257,PSYC 181GS,A00,183964,Anagnostaras; Stephan,10,0,10,0
1681911924284,PSYC 186GS,A01,257660,Staff,10,0,10,0
1681911925315,PSYC 193,B00,253749,Staff,23,0,25,2
1681911927370,PSYC 193L,A01,184122,Staff,33,0,35,2
1681911927370,PSYC 193L,C01,184167,Winkielman; Piotr,16,0,30,14
1681911928399,RELI 188GS,A00,182629,Rahimi; Babak,20,0,20,0
1681911929427,SE 101A,A00,182646,Staff,26,0,30,4
1681911930454,SE 101C,A00,182650,Staff,18,0,20,2
1681911931480,SE 110A,A00,182651,Staff,28,0,28,0
1681911932504,SE 130A,A00,182652,Staff,39,0,40,1
1681911933532,SIO 46GS,A00,182636,Cook; Geoffrey W,28,0,28,0
1681911934555,SIO 109R,A00,194459,Staff,5,0,20,15
1681911935580,SIO 121GS,A00,182639,Cook; Geoffrey W,28,0,28,0
1681911936606,SIO 132,A01,182642,Staff,32,0,40,8
1681911937634,SIO 139,A00,182644,Kacev; David,36,0,40,4
1681911938670,SOCI 2,A01,258404,Staff,34,0,36,2
1681911938670,SOCI 2,A02,258405,Staff,35,0,36,1
1681911939695,SOCI 60,A01,258408,Staff,29,0,30,1
1681911939695,SOCI 60,A02,258413,Staff,30,0,30,0
1681911940720,SOCI 100,A01,258415,Staff,29,0,30,1
1681911940720,SOCI 100,A02,258416,Staff,28,0,30,2
1681911946883,SOCI 127,A00,258421,Staff,22,0,30,8
1681911947907,SOCI 132,A00,258422,Staff,45,0,50,5
1681911948934,SOCI 133,A00,258423,Staff,26,0,30,4
1681911949963,SOCI 138GS,A00,258424,Staff,15,0,15,0
1681911950988,SOCI 145,A00,258425,Staff,25,0,30,5
1681911952026,SOCI 148,A00,258426,Staff,26,0,30,4
1681911953051,SOCI 153,A00,199217,Staff,29,0,30,1
1681911954076,SOCI 160,A00,258427,Staff,28,0,30,2
1681911955103,SOCI 160E,A00,258435,Staff,56,0,60,4
1681911956127,SOCI 189GS,A00,258436,Staff,15,0,15,0
1681911957157,SOCI 190GS,A00,258437,Staff,15,0,15,0
1681911958181,SYN 2,001,182658,Staff,9,0,16,7
1681911958181,SYN 2,002,201439,Staff,15,0,16,1
1681911958181,SYN 2,003,201443,Staff,16,0,16,0
1681911959246,SYN 100,A01,182657,Staff,17,0,20,3
1681911960269,TDAC 1,A00,184381,Salovey; Todd,16,0,20,4
1681911960269,TDAC 1,B00,184385,Harting; Carla Kelso,19,0,20,1
1681911960269,TDAC 1,C00,184394,Staff,19,0,20,1
1681911961293,TDAC 101,A00,184483,Harting; Carla Kelso,19,0,20,1
1681911962317,TDDE 111,A00,184496,Staff,14,0,15,1
1681911963347,TDDE 131,A00,184504,Staff,20,0,20,0
1681911963347,TDDE 131,B00,184505,Staff,17,0,18,1
1681911963347,TDDE 131,C00,184534,Staff,49,0,50,1
1681911963347,TDDE 131,D00,184564,Staff,15,0,15,0
1681911963347,TDDE 131,E00,204725,Staff,19,0,20,1
1681911964375,TDGE 1,A01,184414,Salovey; Todd,37,0,50,13
1681911965399,TDGE 5,A01,184419,Staff,23,0,24,1
1681911966429,TDGE 10,A00,184428,Fulton; Julia,31,0,50,19
1681911967454,TDGE 124,A00,184565,Fulton; Julia,7,0,50,43
1681911968479,TDGE 125,B00,184567,Meyer; Ursula,9,0,25,16
1681911969503,TDHT 101,A00,184568,Staff,21,0,25,4
1681911969503,TDHT 101,B00,184569,Staff,20,0,20,0
1681911970535,TDHT 114,A00,184570,Staff,49,0,50,1
1681911971569,TDMV 1,A00,184437,Arcidiacono; Kristin,23,0,30,7
1681911971569,TDMV 1,B00,184448,Caligagan; Maria T.,22,0,30,8
1681911972598,TDMV 2,A00,184449,Weinberg; Sadie,27,0,30,3
1681911972598,TDMV 2,B00,184453,Arcidiacono; Kristin,29,0,30,1
1681911973625,TDMV 110,A00,184571,Weinberg; Sadie,30,0,30,0
1681911974653,TDMV 142,A00,184572,Caligagan; Tony,27,0,30,3
1681911974653,TDMV 142,B00,184573,Caligagan; Maria T.,27,0,30,3
1681911975677,TDTR 20,A00,184482,Jun; Grace Shin Hae,25,0,25,0
1681911976701,USP 2,A01,184290,Hinds; Juli Beth,24,0,25,1
1681911977726,USP 3,A01,184295,Staff,20,0,25,5
1681911978764,USP 4,A00,184304,McTague; Sarah,15,0,25,10
1681911979790,USP 100,A00,184315,Staff,17,0,25,8
1681911980815,USP 105,A00,184326,Staff,21,0,25,4
1681911981838,USP 151,A00,184327,Staff,20,0,25,5
1681911982863,USP 170,A00,184380,Hinds; Juli Beth,14,0,25,11
1681911983888,VIS 21B,A01,182660,Staff,28,0,31,3
1681911983888,VIS 21B,A02,182662,Staff,30,0,31,1
1681911984912,VIS 103D,A00,182663,Staff,74,0,75,1
1681911985939,VIS 105D,A00,182667,Li; Huai,15,0,22,7
1681911986964,VIS 122GS,A00,182668,Herbst; Matthew,20,0,20,0
1681911987990,VIS 128C,A00,182673,Staff,69,0,75,6
1681911989016,VIS 130,A00,182675,Staff,20,0,22,2
1681911990039,VIS 160A,A00,182678,Stalbaum; Brett,4,0,10,6
1681911992093,WCWP 10B,A00,201679,Staff,15,0,15,0
1681911992093,WCWP 10B,B00,201695,Staff,15,0,15,0
1681911993122,WCWP 100,A00,201716,Staff,15,0,15,0
1681911993122,WCWP 100,B00,201717,Staff,11,0,15,4
1681911995198,ANSC 105GS,A00,258289,Staff,0,0,0,0
1681911996221,ANSC 125GS,A00,258295,Staff,0,0,0,0
1681911997247,ANSC 150,A00,258267,Staff,30,0,40,10
1681911998275,ANSC 190GS,A00,258280,Staff,0,0,0,0
1681911999302,ANTH 1,A00,258264,Staff,38,0,40,2
1681912000326,ANTH 2,A01,258259,Staff,72,0,76,4
1681912001356,ANTH 23,A01,258228,Staff,36,0,40,4
1681912002383,ANTH 101,A01,258236,Staff,39,0,40,1
1681912003408,ANTH 102,A00,258272,Staff,59,0,60,1
1681912004432,ANTH 105,A00,258244,Staff,31,0,35,4
1681912005456,BENG 130,A00,253975,Staff,38,0,40,2
1681912006480,BIBC 102,A01,191866,Flagg; Matthew Paul,19,0,32,13
1681912006480,BIBC 102,A02,191867,Flagg; Matthew Paul,22,0,32,10
1681912006480,BIBC 102,A03,191868,Flagg; Matthew Paul,30,0,32,2
1681912006480,BIBC 102,A04,191936,Flagg; Matthew Paul,26,0,32,6
1681912006480,BIBC 102,A05,191937,Flagg; Matthew Paul,11,0,32,21
1681912007597,BICD 100,A01,191939,Cooper; Andrew Michael,28,0,32,4
1681912007597,BICD 100,A02,191940,Cooper; Andrew Michael,32,0,32,0
1681912007597,BICD 100,A03,191941,Cooper; Andrew Michael,32,0,32,0
1681912007597,BICD 100,A04,191942,Cooper; Andrew Michael,32,0,32,0
1681912007597,BICD 100,A05,191943,Cooper; Andrew Michael,32,0,32,0
1681912008627,BIEB 126,A01,191945,Cleland; Elsa Eleanor,1,0,32,31
1681912008627,BIEB 126,A02,191946,Cleland; Elsa Eleanor,28,0,32,4
1681912008627,BIEB 126,A03,191947,Cleland; Elsa Eleanor,29,0,32,3
1681912008627,BIEB 126,A04,191948,Cleland; Elsa Eleanor,23,0,32,9
1681912008627,BIEB 126,A05,191996,Cleland; Elsa Eleanor,28,0,32,4
1681912009651,BIEB 136GS,A00,191997,Shurin; Jonathan & Holway; David A.,0,0,0,0
1681912010675,BIEB 137GS,A01,191999,Shurin; Jonathan & Holway; David A.,0,0,0,0
1681912011700,BILD 1,A01,205385,Staff,31,0,32,1
1681912011700,BILD 1,A02,205386,Staff,30,0,32,2
1681912011700,BILD 1,A03,205387,Staff,32,0,32,0
1681912011700,BILD 1,A04,205388,Staff,28,0,32,4
1681912012730,BILD 2,A01,191774,Staff,28,0,32,4
1681912012730,BILD 2,A02,191775,Staff,30,0,32,2
1681912012730,BILD 2,A03,191777,Staff,30,0,32,2
1681912012730,BILD 2,A04,191856,Staff,31,0,32,1
1681912012730,BILD 2,A05,191857,Staff,32,0,32,0
1681912012730,BILD 2,A06,191858,Staff,32,0,32,0
1681912012730,BILD 2,A07,191859,Staff,31,0,32,1
1681912013756,BILD 3,A01,205391,Staff,29,0,32,3
1681912013756,BILD 3,A02,205393,Staff,32,0,32,0
1681912013756,BILD 3,A03,205394,Staff,28,0,32,4
1681912013756,BILD 3,A04,205395,Staff,32,0,32,0
1681912014782,BILD 20,A01,191861,Staff,32,0,32,0
1681912014782,BILD 20,A02,191862,Staff,32,0,32,0
1681912015805,BILD 30,A01,191864,Staff,31,0,32,1
1681912016833,BIMM 100,A01,192019,Staff,0,0,32,32
1681912016833,BIMM 100,A02,192020,Staff,23,0,32,9
1681912016833,BIMM 100,A03,192035,Staff,22,0,32,10
1681912017860,BIMM 110,A01,192037,Tat; John,0,0,32,32
1681912017860,BIMM 110,A02,192038,Tat; John,10,0,32,22
1681912018898,BIMM 120,A01,192040,Pickett; Brooke Elizabeth,2,0,32,30
1681912018898,BIMM 120,A02,192041,Pickett; Brooke Elizabeth,16,0,32,16
1681912018898,BIMM 120,A03,192042,Pickett; Brooke Elizabeth,16,0,32,16
1681912019923,BIPN 100,A01,192044,Armour; Jon Christopher,26,0,32,6
1681912019923,BIPN 100,A02,192059,Armour; Jon Christopher,30,0,32,2
1681912019923,BIPN 100,A03,192064,Armour; Jon Christopher,31,0,32,1
1681912019923,BIPN 100,A04,192073,Armour; Jon Christopher,28,0,32,4
1681912020951,BIPN 148,A01,205411,Leutgeb; Jill K.,16,0,32,16
1681912020951,BIPN 148,A02,205412,Leutgeb; Jill K.,31,0,32,1
1681912020951,BIPN 148,A03,205413,Leutgeb; Jill K.,30,0,32,2
1681912020951,BIPN 148,A04,205414,Leutgeb; Jill K.,30,0,32,2
1681912021982,BIPN 160,A01,192115,Marino; Marc J,19,0,32,13
1681912021982,BIPN 160,A02,192148,Marino; Marc J,27,0,32,5
1681912021982,BIPN 160,A03,192158,Marino; Marc J,31,0,32,1
1681912021982,BIPN 160,A04,192190,Marino; Marc J,32,0,32,0
1681912021982,BIPN 160,A05,192287,Marino; Marc J,32,0,32,0
1681912021982,BIPN 160,A06,192288,Marino; Marc J,32,0,32,0
1681912023005,BIPN 194,A00,206038,Staff,28,0,32,4
1681912024031,BISP 194,A00,192289,Leutgeb; Stefan,13,0,32,19
1681912024031,BISP 194,B00,245332,Nieh; James Charles,27,0,32,5
1681912025057,CAT 124,A01,202247,Staff,15,0,15,0
1681912026081,CAT 125,A00,202248,Staff,19,0,20,1
1681912026081,CAT 125,B00,202253,Staff,20,0,20,0
1681912026081,CAT 125,C00,202257,Staff,19,0,20,1
1681912027105,CAT 125GS,A01,202273,Bronstein; Phoebe Malan,20,0,20,0
1681912028130,CAT 125R,A00,202284,Staff,17,0,20,3
1681912028130,CAT 125R,C00,202286,Staff,10,0,20,10
1681912028130,CAT 125R,D00,202291,Staff,18,0,20,2
1681912028130,CAT 125R,E00,202295,Staff,13,0,20,7
1681912028130,CAT 125R,F00,202302,Staff,12,0,20,8
1681912029160,CENG 100,A00,204724,Opatkiewicz; Justin Paul,25,0,25,0
1681912030189,CGS 2A,A01,180420,Staff,31,0,36,5
1681912031213,CGS 101,A00,180421,Staff,16,0,20,4
1681912032235,CGS 112,A00,180422,Staff,10,0,16,6
1681912033259,CGS 113,A00,180423,Staff,18,0,20,2
1681912034283,CGS 137,A00,180424,Staff,12,0,12,0
1681912035310,CGS 147,A00,180425,Staff,10,0,10,0
1681912036339,CHEM 6A,A01,179556,Staff,97,0,100,3
1681912036339,CHEM 6A,A02,179558,Staff,0,0,0,0
1681912037370,CHEM 6B,A01,179560,Staff,100,0,100,0
1681912038395,CHEM 6C,A01,179565,Jazzar; Rodolphe,95,0,100,5
1681912039422,CHEM 7L,A01,179586,Schurmeier; Kimberly,13,0,24,11
1681912039422,CHEM 7L,A02,179587,Schurmeier; Kimberly,23,0,24,1
1681912039422,CHEM 7L,A03,179590,Schurmeier; Kimberly,22,0,24,2
1681912039422,CHEM 7L,A04,179591,Schurmeier; Kimberly,22,0,24,2
1681912039422,CHEM 7L,B01,179598,Schurmeier; Kimberly,17,0,24,7
1681912039422,CHEM 7L,B02,179599,Schurmeier; Kimberly,24,0,24,0
1681912039422,CHEM 7L,B03,179606,Schurmeier; Kimberly,23,0,24,1
1681912039422,CHEM 7L,B04,179607,Schurmeier; Kimberly,23,0,24,1
1681912040447,CHEM 11,A01,179609,Stallings; Dontarie M,88,0,100,12
1681912041472,CHEM 40A,A01,179621,Staff,41,0,50,9
1681912041472,CHEM 40A,A02,179622,Staff,47,0,50,3
1681912042496,CHEM 40B,A01,179630,Weizman; Haim,48,0,50,2
1681912042496,CHEM 40B,A02,179631,Weizman; Haim,45,0,50,5
1681912043525,CHEM 41A,A01,179660,Klosterman; Jeremy K,93,0,100,7
1681912044557,CHEM 43A,A01,179683,Klosterman; Jeremy K,0,0,24,24
1681912044557,CHEM 43A,A02,179688,Klosterman; Jeremy K,14,0,24,10
1681912044557,CHEM 43A,A03,179689,Klosterman; Jeremy K,20,0,24,4
1681912044557,CHEM 43A,A04,179691,Klosterman; Jeremy K,18,0,24,6
1681912045589,CHEM 114A,A01,179693,Stallings; Dontarie M,77,0,100,23
1681912046619,CHEM 143B,A01,179698,Weizman; Haim,17,0,24,7
1681912046619,CHEM 143B,A02,179700,Weizman; Haim,24,0,24,0
1681912047648,CHIN 169A,A00,179701,Wang; Xiao,20,0,20,0
1681912048672,COGS 2,A01,179750,Boyle; Mary E. T.,17,0,30,13
1681912049700,COGS 9,A01,179759,Jones; Cameron Robert,43,0,50,7
1681912050722,COGS 14A,A01,179854,Staff,18,0,50,32
1681912051748,COGS 14B,A01,179856,Staff,54,0,60,6
1681912052774,COGS 17,A01,179874,Staff,71,0,75,4
1681912053800,COGS 18,A01,179884,Staff,63,0,80,17
1681912054823,COGS 100,A01,179886,Staff,40,0,60,20
1681912055852,COGS 101B,A01,179892,Staff,1,0,30,29
1681912056885,COGS 101C,A01,179894,Staff,28,0,30,2
1681912057912,COGS 107A,A01,179896,Boyle; Mary E. T.,31,0,40,9
1681912058941,COGS 108,A01,179898,Simpkins; Charles Alexander,0,17,60,60
1681912059968,COGS 109,A01,179900,Staff,34,0,40,6
1681912060993,COGS 118A,A01,179946,Staff,9,0,40,31
1681912062017,COGS 153,A00,179978,Staff,1,0,30,29
1681912063043,COGS 156,A01,179981,Staff,27,0,30,3
1681912065097,COGS 172,A01,179987,Staff,13,0,30,17
1681912067146,COGS 186,A01,179991,Staff,13,0,30,17
1681912068168,COMM 10,A01,180001,Staff,15,0,25,10
1681912068168,COMM 10,A02,180004,Staff,20,0,25,5
1681912069192,COMM 100A,A01,180016,Staff,18,0,25,7
1681912069192,COMM 100A,A02,180020,Staff,24,0,25,1
1681912070219,COMM 101T,A00,180029,Halm; Gavin Patrick,23,0,35,12
1681912071245,COMM 106V,A00,180043,Staff,34,0,35,1
1681912072271,COMM 109P,A00,180044,Staff,31,0,35,4
1681912073303,COMM 113T,A00,180045,Havis; Allan,37,0,45,8
1681912074333,COMM 132,A00,180046,McKenna; Denise,23,0,30,7
1681912075359,COMM 143,A00,180047,Staff,19,0,30,11
1681912076392,COMM 190,A00,180048,Conner; Thomas Hartnell,20,0,23,3
1681912077417,CSE 8A,A50,180053,Cao; Yingjun,25,0,50,25
1681912077417,CSE 8A,B50,180180,Staff,50,0,50,0
1681912078444,CSE 11,A01,180190,Cao; Yingjun,31,0,50,19
1681912079470,CSE 20,A01,180192,Briones; Jor-el Thomas Caparas,23,0,30,7
1681912080494,CSE 21,A01,194538,Briones; Jor-el Thomas Caparas,50,0,60,10
1681912081517,CSE 30,A01,180324,Eldon; John,79,0,100,21
1681912082540,CSE 101,A01,201353,Staff,0,20,40,40
1681912083563,CSE 134B,A01,180326,Powell; Thomas Allan,74,0,100,26
1681912084587,CSE 140,A01,180328,Staff,46,0,75,29
1681912085614,CSE 140L,A01,180344,Eldon; John,69,0,100,31
1681912086642,CSE 150A,A01,180411,Staff,0,7,50,50
1681912087672,CSE 151A,A01,180414,Staff,0,6,50,50
1681912088698,CSE 175,A01,222521,Kumar; Rakesh,50,0,50,0
1681912089728,CSE 190,A00,201419,Staff,45,0,49,4
1681912090754,CSS 1,A01,194536,Staff,38,0,50,12
1681912091782,DSC 30,A01,202385,Staff,48,0,50,2
1681912092806,DSC 40A,A01,202387,Albuyeh; Rod,50,0,50,0
1681912093828,DSC 190,A01,202389,Silberman; Jack,21,0,21,0
1681912094852,DSGN 100,A01,179993,Staff,16,0,30,14
1681912095884,ECE 65,A50,180708,Staff,10,0,20,10
1681912095884,ECE 65,A51,180739,Staff,19,0,20,1
1681912096913,ECON 1,A01,180427,Famulari; Melissa,67,0,70,3
1681912097937,ECON 2,A01,180450,Levkoff; Steven B.,64,0,70,6
1681912098960,ECON 4,A01,203351,Anderson; John Charles,7,0,10,3
1681912099983,ECON 100A,A01,180472,Famulari; Melissa,65,0,70,5
1681912101017,ECON 120A,A01,180549,Staff,64,0,70,6
1681912102040,ECON 120B,A01,180655,Ma; Xinwei,46,0,70,24
1681912103063,ECON 129,A00,203333,Eckert; Fabian Paul,15,0,35,20
1681912104086,ECON 131,A00,180656,Staff,9,0,35,26
1681912105112,ECON 172B,A01,180672,Levkoff; Steven B.,32,0,35,3
1681912106143,ECON 178,A01,203342,Zhu; Ying,11,0,35,24
1681912107170,EDS 108GS,A00,202383,Wishard Guerra; Alison G.,20,0,20,0
1681912108193,EDS 111GS,A00,202347,Wishard Guerra; Alison G.,20,0,20,0
1681912109217,EDS 112,A01,202323,Staff,56,0,60,4
1681912110242,EDS 113,A00,202340,Staff,33,0,35,2
1681912111342,EDS 118,A00,201231,Staff,20,0,30,10
1681912112366,EDS 119,A00,204994,Staff,8,0,10,2
1681912113393,EDS 124BR,A00,202324,Eguchi; Emi,5,0,25,20
1681912114416,EDS 126,A01,203208,Jones; Makeba,26,0,30,4
1681912115445,EDS 135,A01,202333,Staff,18,0,20,2
1681912116468,EDS 180,A00,202311,Staff,47,0,50,3
1681912117495,ERC 190GS,A01,253747,Staff,28,0,28,0
1681912118519,ETHN 104,A00,180742,Staff,24,0,35,11
1681912119543,ETHN 118,A00,180745,Staff,28,0,35,7
1681912120567,ETHN 127,A00,180747,Staff,12,0,16,4
1681912121590,ETHN 137,A00,180880,Staff,12,0,12,0
1681912122634,ETHN 147,A00,180890,Staff,8,0,10,2
1681912123660,ETHN 154,A00,180891,Staff,7,0,8,1
1681912124686,ETHN 168,A00,180892,Staff,9,0,10,1
1681912125710,GLBH 20,A00,201051,Hannah; Seth Donal,0,1,0,1
1681912126737,GLBH 111,A01,209338,Burgos; Jose L.,0,0,0,0
1681912127771,GLBH 150,A00,258300,Staff,0,3,0,0
1681912128802,GLBH 181,A00,201207,Staff,15,0,40,25
1681912129825,HIEU 109,A00,180898,Staff,20,0,20,0
1681912130850,HIEU 111,A00,180899,Staff,1,0,20,19
1681912131874,HIEU 124,A00,180900,Staff,18,0,20,2
1681912132896,HILA 122,A00,180901,Staff,18,0,20,2
1681912133919,HILA 132,A00,180902,Vitz; Matthew,2,0,20,18
1681912134950,HILD 10,A01,180896,Staff,15,0,20,5
1681912135975,HILD 30GS,A00,180897,Edington; Claire Ellen,0,0,0,0
1681912137005,HISC 105,A00,180903,Staff,20,0,20,0
1681912138028,HISC 117,A00,180904,Staff,11,0,20,9
1681912139050,HIUS 108B,A00,181005,Staff,18,0,20,2
1681912140073,HIUS 113,A00,181093,Staff,4,0,20,16
1681912141097,HUM 3,A01,181190,Patterson; Patrick H.,40,0,50,10
1681912141097,HUM 3,B01,181195,Staff,47,0,50,3
1681912142124,HUM 3GS,A00,181196,Herbst; Matthew,0,0,0,0
1681912143152,HUM 4,A01,181227,West; Geoffrey Scott,34,0,50,16
1681912143152,HUM 4,B01,181282,Staff,43,0,50,7
1681912144181,HUM 4GS,A00,181377,Lyon; Antony J.,0,0,0,0
1681912145209,HUM 5,A01,181536,Zavodny; Tatiana Sophia,31,0,50,19
1681912145209,HUM 5,B01,181908,Staff,36,0,50,14
1681912146235,INTL 190,A00,181909,Segui; Alan S,0,0,0,6
1681912146235,INTL 190,B00,181961,Segui; Alan S,0,0,0,7
1681912147257,JAPN 20AR,A01,182113,Ross; Kayoko F,15,0,20,5
1681912148279,LATI 50,A01,202391,Martin-Cabrera; Luis,19,0,30,11
1681912148279,LATI 50,A02,202392,Martin-Cabrera; Luis,26,0,30,4
1681912149302,LATI 180,A00,202393,Kokinis; Troy Andreas,25,0,25,0
1681912150327,LIFR 1A,A00,182119,Staff,14,0,14,0
1681912151354,LIFR 1AX,A00,182324,Staff,14,0,14,0
1681912152383,LIFR 1B,A00,182259,Staff,14,0,14,0
1681912153406,LIFR 1BX,A00,182273,Staff,14,0,14,0
1681912154428,LIGN 8,A00,182330,Staff,137,0,150,13
1681912155459,LIGN 9GS,A00,182362,Staff,20,0,20,0
1681912156488,LIGN 119,A00,204992,Takahashi; Maho,12,0,15,3
1681912157520,LIGN 130,A01,182384,Staff,47,0,50,3
1681912158542,LIGN 149GS,A00,182390,Staff,20,0,20,0
1681912159566,LIGN 170,A00,182404,Staff,24,0,30,6
1681912160594,LISP 1D,A00,182281,Staff,7,0,14,7
1681912160594,LISP 1D,B00,182287,Staff,14,0,14,0
1681912160594,LISP 1D,C00,182295,Staff,11,0,14,3
1681912160594,LISP 1D,D00,182301,Staff,14,0,14,0
1681912161628,LISP 1DX,A00,182309,Staff,20,0,28,8
1681912161628,LISP 1DX,B00,182316,Staff,26,0,28,2
1681912162651,LTAF 120GS,A00,182412,Zhiri; Oumelbanine,20,0,20,0
1681912163678,LTCS 172GS,A00,182437,Bronstein; Phoebe Malan,20,0,20,0
1681912164712,LTEA 138,A00,182457,Staff,22,0,40,18
1681912165739,LTEN 114,A01,182490,Staff,23,0,25,2
1681912166765,LTEN 130GS,A00,182491,Lyon; Antony J.,20,0,20,0
1681912167789,LTEN 169,A00,182493,Cuong; Marisol,20,0,25,5
1681912168811,LTEN 178,A00,182501,Staff,14,0,15,1
1681912169837,LTEN 181,A00,182515,Staff,22,0,25,3
1681912170864,LTEN 185GS,A00,197655,Forbes; Camille,20,0,20,0
1681912171886,LTSP 100B,A00,202208,Bessett; Ryan Matthew,24,0,25,1
1681912172913,LTWL 100,A00,182516,Myerston Santana; Jacobo,22,0,30,8
1681912173935,LTWR 100GS,A00,182518,Forbes; Camille,20,0,20,0
1681912174962,LTWR 102,A00,182522,Staff,15,0,15,0
1681912174962,LTWR 102,B00,182525,Staff,14,0,15,1
1681912175985,LTWR 115,A00,182526,Staff,12,0,15,3
1681912177013,MAE 8,A01,182528,Pham; Hieu Tan,68,0,70,2
1681912178042,MAE 11,A00,182529,Bahadori; Mohammad Yousef,94,0,100,6
1681912179067,MAE 20,A00,182530,Evdokimenko; Ekaterina,68,0,70,2
1681912180097,MAE 30A,A00,182532,Staff,44,0,45,1
1681912181121,MAE 101A,A00,182533,Bahadori; Mohammad Yousef,97,0,100,3
1681912182149,MAE 101C,A00,182538,Staff,62,0,70,8
1681912183174,MAE 104,A00,182539,Staff,45,0,50,5
1681912184197,MAE 131A,A00,182540,Ghazinejad; Maziar,41,0,45,4
1681912185225,MAE 143A,A00,182548,Bewley; Thomas R,43,0,50,7
1681912186253,MAE 150,A00,182549,Staff,28,0,40,12
1681912187279,MAE 160,A00,182550,Evdokimenko; Ekaterina,43,0,60,17
1681912188307,MATH 3C,A01,182725,Staff,27,0,30,3
1681912189335,MATH 10A,A01,182729,Staff,25,0,30,5
1681912189335,MATH 10A,B01,182732,Staff,26,0,30,4
1681912190369,MATH 10B,A01,182737,Staff,21,0,30,9
1681912190369,MATH 10B,A02,182738,Staff,27,0,30,3
1681912190369,MATH 10B,B01,182744,Staff,27,0,30,3
1681912190369,MATH 10B,B02,182745,Staff,27,0,30,3
1681912191394,MATH 18,A01,182750,Anzaldo; Leesa B,28,0,30,2
1681912191394,MATH 18,A02,182751,Anzaldo; Leesa B,29,0,30,1
1681912191394,MATH 18,A03,182753,Anzaldo; Leesa B,28,0,30,2
1681912191394,MATH 18,A04,182757,Anzaldo; Leesa B,29,0,30,1
1681912191394,MATH 18,B01,182761,Anzaldo; Leesa B,27,0,30,3
1681912191394,MATH 18,B02,182764,Anzaldo; Leesa B,27,0,30,3
1681912191394,MATH 18,B03,182765,Anzaldo; Leesa B,30,0,30,0
1681912191394,MATH 18,B04,182766,Anzaldo; Leesa B,30,0,30,0
1681912192423,MATH 20A,A01,182771,Suk; Andrew Hoon,28,0,30,2
1681912193451,MATH 20B,A01,182775,Bach; Quang Tran,30,0,30,0
1681912193451,MATH 20B,A02,182777,Bach; Quang Tran,29,0,30,1
1681912193451,MATH 20B,B01,182780,Bach; Quang Tran,27,0,30,3
1681912193451,MATH 20B,B02,182782,Bach; Quang Tran,30,0,30,0
1681912194475,MATH 20C,A01,182787,Staff,25,0,30,5
1681912194475,MATH 20C,A02,182790,Staff,29,0,30,1
1681912194475,MATH 20C,B01,182792,Staff,25,0,30,5
1681912194475,MATH 20C,B02,182796,Staff,27,0,30,3
1681912195504,MATH 20D,A01,182799,Staff,29,0,30,1
1681912195504,MATH 20D,A02,182802,Staff,30,0,30,0
1681912195504,MATH 20D,A03,182803,Staff,30,0,30,0
1681912196527,MATH 20E,A01,182809,Verstraete; Jacques Allan,24,0,30,6
1681912196527,MATH 20E,A02,182811,Verstraete; Jacques Allan,28,0,30,2
1681912196527,MATH 20E,B01,182814,Verstraete; Jacques Allan,23,0,30,7
1681912196527,MATH 20E,B02,182815,Verstraete; Jacques Allan,30,0,30,0
1681912197552,MATH 103A,A01,182820,Staff,9,0,30,21
1681912197552,MATH 103A,A02,182821,Staff,27,0,30,3
1681912197552,MATH 103A,A03,182822,Staff,23,0,30,7
1681912197552,MATH 103A,B01,182825,Staff,23,0,30,7
1681912197552,MATH 103A,B02,182826,Staff,30,0,30,0
1681912197552,MATH 103A,B03,182830,Staff,30,0,30,0
1681912198584,MATH 109,A01,182836,Chow; Bennett,24,0,30,6
1681912198584,MATH 109,A02,182838,Chow; Bennett,29,0,30,1
1681912198584,MATH 109,A03,182894,Chow; Bennett,29,0,30,1
1681912198584,MATH 109,B01,182908,Chow; Bennett,28,0,30,2
1681912198584,MATH 109,B02,182909,Chow; Bennett,30,0,30,0
1681912198584,MATH 109,B03,182910,Chow; Bennett,27,0,30,3
1681912199614,MATH 142A,A01,182925,Staff,11,0,30,19
1681912199614,MATH 142A,A02,182935,Staff,25,0,30,5
1681912199614,MATH 142A,A03,182967,Staff,26,0,30,4
1681912199614,MATH 142A,B01,183125,Staff,24,0,30,6
1681912199614,MATH 142A,B02,183157,Staff,28,0,30,2
1681912199614,MATH 142A,B03,183158,Staff,29,0,30,1
1681912200651,MATH 183,A01,183160,Arias-Castro; Ery,23,0,30,7
1681912200651,MATH 183,A02,183161,Arias-Castro; Ery,29,0,30,1
1681912200651,MATH 183,B01,183163,Arias-Castro; Ery,28,0,30,2
1681912200651,MATH 183,B02,183164,Arias-Castro; Ery,28,0,30,2
1681912201685,MATH 193A,A01,183167,Staff,4,0,35,31
1681912201685,MATH 193A,A02,183168,Staff,28,0,35,7
1681912201685,MATH 193A,A03,183169,Staff,34,0,35,1
1681912201685,MATH 193A,A04,183170,Staff,28,0,35,7
1681912202708,MGT 4,A01,202395,Anderson; John Charles,75,0,80,5
1681912203731,MGT 5,A00,202396,Houskeeper; Robert,80,0,90,10
1681912204760,MGT 103,A00,202397,Eberhard; Craig A,55,0,90,35
1681912205784,MGT 131A,A00,202398,Houskeeper; Robert,85,0,90,5
1681912206807,MGT 135,A00,202399,Anderson; John Charles,82,0,90,8
1681912207829,MGT 162R,A00,202403,Gneezy; Uri,150,0,200,50
1681912208850,MGT 172,A00,202404,Hedges; Kathleen,50,0,90,40
1681912209873,MGT 181,A00,202405,Dunn; Louis Jean,84,0,90,6
1681912210898,MMW 14,A01,183200,Staff,16,0,28,12
1681912210898,MMW 14,A02,183201,Staff,26,0,28,2
1681912210898,MMW 14,A03,183202,Staff,24,0,28,4
1681912210898,MMW 14,A04,183203,Staff,25,0,28,3
1681912210898,MMW 14,A05,183204,Staff,26,0,28,2
1681912210898,MMW 14,A06,183205,Staff,27,0,28,1
1681912210898,MMW 14,B01,183207,Staff,26,0,28,2
1681912210898,MMW 14,B02,183208,Staff,28,0,28,0
1681912210898,MMW 14,B03,183209,Staff,28,0,28,0
1681912210898,MMW 14,B04,183210,Staff,28,0,28,0
1681912210898,MMW 14,B05,183211,Staff,28,0,28,0
1681912210898,MMW 14,B06,183212,Staff,28,0,28,0
1681912211921,MMW 14GS,A00,183213,Zhiri; Oumelbanine,28,0,28,0
1681912212946,MMW 15GS,B00,183215,Rahimi; Babak,28,0,28,0
1681912213972,MMW 121,A01,183217,Patterson; Patrick H.,14,0,28,14
1681912213972,MMW 121,A02,183218,Patterson; Patrick H.,25,0,28,3
1681912215071,MUS 1A,A01,182554,Staff,8,0,35,27
1681912216097,MUS 5,A01,182558,Staff,20,0,35,15
1681912217123,MUS 6,A01,182562,Staff,25,0,35,10
1681912218152,MUS 8GS,A00,182563,Borgo; David Garcia,25,0,25,0
1681912219178,MUS 13,A01,182567,Staff,24,0,25,1
1681912220201,MUS 15,A01,182570,Staff,32,0,35,3
1681912220201,MUS 15,B01,182575,Staff,10,0,35,25
1681912221224,MUS 80,A00,182578,Staff,23,0,25,2
1681912221224,MUS 80,B00,182581,Staff,20,0,25,5
1681912222250,MUS 113,A00,182582,Staff,25,0,25,0
1681912223284,MUS 114,A00,182583,Staff,4,0,25,21
1681912224309,MUS 150GS,A01,182588,Borgo; David Garcia,25,0,25,0
1681912225336,PHIL 1,A00,182590,Staff,35,0,40,5
1681912226364,PHIL 10,A01,182596,Grush; Rick Scott,31,0,35,4
1681912226364,PHIL 10,A02,182597,Grush; Rick Scott,34,0,35,1
1681912227386,PHIL 15,A01,182601,Staff,31,0,35,4
1681912227386,PHIL 15,A02,182602,Staff,33,0,35,2
1681912228410,PHIL 27,A01,182604,Staff,30,0,35,5
1681912228410,PHIL 27,A02,182607,Staff,35,0,35,0
1681912229436,PHIL 32,A01,182609,Staff,35,0,35,0
1681912229436,PHIL 32,A02,182612,Staff,35,0,35,0
1681912230458,PHIL 130,A00,182614,Staff,63,0,70,7
1681912231482,PHIL 136,A00,182616,Cohen; Jonathan David,66,0,70,4
1681912232508,PHIL 155,A00,182617,Vargas; Manuel Rogelio,60,0,70,10
1681912233531,PHIL 163,A01,182620,Staff,15,0,20,5
1681912233531,PHIL 163,A02,182624,Staff,10,0,20,10
1681912234554,PHIL 164,A00,182627,Staff,30,0,40,10
1681912235576,PHIL 173,A00,182628,Staff,36,0,40,4
1681912236602,PHYS 1A,A00,183221,Staff,54,0,60,6
1681912237629,PHYS 1AL,001,183222,Staff,25,0,30,5
1681912237629,PHYS 1AL,002,183223,Staff,28,0,30,2
1681912238652,PHYS 1B,A00,183231,Staff,44,0,60,16
1681912239685,PHYS 1BL,001,183232,Staff,20,0,30,10
1681912239685,PHYS 1BL,002,183233,Staff,29,0,30,1
1681912240709,PHYS 1C,A00,183240,Staff,30,0,60,30
1681912241744,PHYS 1CL,001,183241,Staff,13,0,30,17
1681912241744,PHYS 1CL,002,183242,Staff,22,0,30,8
1681912242775,PHYS 2AR,A01,183250,Staff,44,0,50,6
1681912243798,PHYS 2B,A01,183252,Staff,106,0,115,9
1681912244821,PHYS 2BL,A01,183254,Staff,21,0,24,3
1681912244821,PHYS 2BL,A02,183255,Staff,22,0,24,2
1681912245844,PHYS 2C,A01,183522,Staff,105,0,115,10
1681912246871,PHYS 4A,A01,183524,Staff,49,0,50,1
1681912247897,POLI 5,A00,183525,Staff,44,0,50,6
1681912248924,POLI 12,A00,183540,Staff,48,0,50,2
1681912249949,POLI 13R,A00,183541,Forman; Fonna,42,0,50,8
1681912250973,POLI 30,A00,183542,Mignozzetti; Umberto,47,0,50,3
1681912251997,POLI 100A,A00,183543,Staff,45,0,50,5
1681912253024,POLI 100E,A00,223598,Staff,32,0,35,3
1681912254049,POLI 103A,A00,183564,Kousser; Thad,38,0,50,12
1681912255075,POLI 104B,A00,201329,Staff,29,0,35,6
1681912256099,POLI 113BR,A00,183576,Hoston; Germaine,27,0,50,23
1681912257123,POLI 114BR,A00,183588,Staff,27,0,30,3
1681912258146,POLI 117R,A00,183595,Forman; Fonna,9,0,20,11
1681912259172,POLI 120H,A00,183596,Fisk; David Lee,13,0,20,7
1681912260199,POLI 130AA,A00,183597,Staff,14,0,20,6
1681912261225,POLI 134AA,A00,183598,Staff,19,0,20,1
1681912262252,POLI 135,A00,183599,Fisk; David Lee,20,0,25,5
1681912263276,POLI 142P,A00,183623,Staff,37,0,40,3
1681912264299,POLI 144D,A00,183624,Staff,22,0,25,3
1681912265320,POLI 151,A00,183625,Staff,15,0,20,5
1681912266349,POLI 162,A00,183626,Mignozzetti; Umberto,18,0,20,2
1681912267373,PSYC 1,A00,253748,Staff,86,0,90,4
1681912268397,PSYC 2,A00,183627,Moranton; Nirelia Melbina-,25,0,35,10
1681912269423,PSYC 3,A00,183628,Staff,43,0,45,2
1681912271485,PSYC 60,A01,183631,Lowe; Angela Beth,35,0,40,5
1681912272511,PSYC 70,A01,253757,Staff,37,0,45,8
1681912273537,PSYC 101,A00,183632,Heyman; Gail D.,48,0,60,12
1681912274563,PSYC 105,A00,183848,Lowe; Angela Beth,50,0,60,10
1681912275597,PSYC 106,A00,183849,Dobkins; Karen R.,45,0,60,15
1681912276621,PSYC 108,A00,253750,Staff,24,0,60,36
1681912277644,PSYC 114,A01,184275,Winkielman; Piotr,0,6,30,30
1681912278669,PSYC 122,A00,183856,Moranton; Nirelia Melbina-,0,10,30,30
1681912279693,PSYC 124,A00,183865,Chapman; Eddie Nathaniel,52,0,80,28
1681912280717,PSYC 137,A00,183880,Staff,19,0,25,6
1681912282767,PSYC 154,A00,183910,Lacefield; Katharine I,0,2,90,90
1681912284814,PSYC 162,A00,183946,Wixted; John T,61,0,90,29
1681912285837,PSYC 172,A00,183947,Gorman; Michael R.,14,0,30,16
1681912286861,PSYC 178,A00,183963,Glaser; Dale,20,0,40,20
1681912287886,PSYC 181GS,A00,183964,Anagnostaras; Stephan,10,0,10,0
1681912288909,PSYC 186GS,A01,257660,Staff,10,0,10,0
1681912289934,PSYC 193,B00,253749,Staff,23,0,25,2
1681912291983,PSYC 193L,A01,184122,Staff,33,0,35,2
1681912291983,PSYC 193L,C01,184167,Winkielman; Piotr,16,0,30,14
1681912293012,RELI 188GS,A00,182629,Rahimi; Babak,20,0,20,0
1681912294040,SE 101A,A00,182646,Staff,26,0,30,4
1681912295064,SE 101C,A00,182650,Staff,18,0,20,2
1681912296089,SE 110A,A00,182651,Staff,28,0,28,0
1681912297113,SE 130A,A00,182652,Staff,39,0,40,1
1681912298143,SIO 46GS,A00,182636,Cook; Geoffrey W,28,0,28,0
1681912299170,SIO 109R,A00,194459,Staff,5,0,20,15
1681912300193,SIO 121GS,A00,182639,Cook; Geoffrey W,28,0,28,0
1681912301217,SIO 132,A01,182642,Staff,32,0,40,8
1681912302243,SIO 139,A00,182644,Kacev; David,36,0,40,4
1681912303267,SOCI 2,A01,258404,Staff,34,0,36,2
1681912303267,SOCI 2,A02,258405,Staff,35,0,36,1
1681912304291,SOCI 60,A01,258408,Staff,29,0,30,1
1681912304291,SOCI 60,A02,258413,Staff,30,0,30,0
1681912305321,SOCI 100,A01,258415,Staff,29,0,30,1
1681912305321,SOCI 100,A02,258416,Staff,28,0,30,2
1681912311470,SOCI 127,A00,258421,Staff,22,0,30,8
1681912312493,SOCI 132,A00,258422,Staff,45,0,50,5
1681912313518,SOCI 133,A00,258423,Staff,26,0,30,4
1681912314545,SOCI 138GS,A00,258424,Staff,15,0,15,0
1681912315569,SOCI 145,A00,258425,Staff,25,0,30,5
1681912316595,SOCI 148,A00,258426,Staff,26,0,30,4
1681912317622,SOCI 153,A00,199217,Staff,29,0,30,1
1681912318722,SOCI 160,A00,258427,Staff,28,0,30,2
1681912319744,SOCI 160E,A00,258435,Staff,56,0,60,4
1681912320770,SOCI 189GS,A00,258436,Staff,15,0,15,0
1681912321796,SOCI 190GS,A00,258437,Staff,15,0,15,0
1681912322821,SYN 2,001,182658,Staff,9,0,16,7
1681912322821,SYN 2,002,201439,Staff,15,0,16,1
1681912322821,SYN 2,003,201443,Staff,16,0,16,0
1681912323847,SYN 100,A01,182657,Staff,17,0,20,3
1681912324872,TDAC 1,A00,184381,Salovey; Todd,16,0,20,4
1681912324872,TDAC 1,B00,184385,Harting; Carla Kelso,19,0,20,1
1681912324872,TDAC 1,C00,184394,Staff,19,0,20,1
1681912325900,TDAC 101,A00,184483,Harting; Carla Kelso,19,0,20,1
1681912326925,TDDE 111,A00,184496,Staff,14,0,15,1
1681912327959,TDDE 131,A00,184504,Staff,20,0,20,0
1681912327959,TDDE 131,B00,184505,Staff,17,0,18,1
1681912327959,TDDE 131,C00,184534,Staff,49,0,50,1
1681912327959,TDDE 131,D00,184564,Staff,15,0,15,0
1681912327959,TDDE 131,E00,204725,Staff,19,0,20,1
1681912328986,TDGE 1,A01,184414,Salovey; Todd,37,0,50,13
1681912330009,TDGE 5,A01,184419,Staff,23,0,24,1
1681912331035,TDGE 10,A00,184428,Fulton; Julia,31,0,50,19
1681912332061,TDGE 124,A00,184565,Fulton; Julia,7,0,50,43
1681912333084,TDGE 125,B00,184567,Meyer; Ursula,9,0,25,16
1681912334108,TDHT 101,A00,184568,Staff,21,0,25,4
1681912334108,TDHT 101,B00,184569,Staff,20,0,20,0
1681912335132,TDHT 114,A00,184570,Staff,49,0,50,1
1681912336156,TDMV 1,A00,184437,Arcidiacono; Kristin,23,0,30,7
1681912336156,TDMV 1,B00,184448,Caligagan; Maria T.,22,0,30,8
1681912337181,TDMV 2,A00,184449,Weinberg; Sadie,27,0,30,3
1681912337181,TDMV 2,B00,184453,Arcidiacono; Kristin,29,0,30,1
1681912338211,TDMV 110,A00,184571,Weinberg; Sadie,30,0,30,0
1681912339236,TDMV 142,A00,184572,Caligagan; Tony,27,0,30,3
1681912339236,TDMV 142,B00,184573,Caligagan; Maria T.,27,0,30,3
1681912340262,TDTR 20,A00,184482,Jun; Grace Shin Hae,25,0,25,0
1681912341287,USP 2,A01,184290,Hinds; Juli Beth,24,0,25,1
1681912342318,USP 3,A01,184295,Staff,20,0,25,5
1681912343343,USP 4,A00,184304,McTague; Sarah,15,0,25,10
1681912344373,USP 100,A00,184315,Staff,17,0,25,8
1681912345397,USP 105,A00,184326,Staff,21,0,25,4
1681912346424,USP 151,A00,184327,Staff,20,0,25,5
1681912347450,USP 170,A00,184380,Hinds; Juli Beth,14,0,25,11
1681912348474,VIS 21B,A01,182660,Staff,28,0,31,3
1681912348474,VIS 21B,A02,182662,Staff,30,0,31,1
1681912349500,VIS 103D,A00,182663,Staff,74,0,75,1
1681912350523,VIS 105D,A00,182667,Li; Huai,15,0,22,7
1681912351546,VIS 122GS,A00,182668,Herbst; Matthew,20,0,20,0
1681912352573,VIS 128C,A00,182673,Staff,69,0,75,6
1681912353597,VIS 130,A00,182675,Staff,20,0,22,2
1681912354620,VIS 160A,A00,182678,Stalbaum; Brett,4,0,10,6
1681912356668,WCWP 10B,A00,201679,Staff,15,0,15,0
1681912356668,WCWP 10B,B00,201695,Staff,15,0,15,0
1681912357693,WCWP 100,A00,201716,Staff,15,0,15,0
1681912357693,WCWP 100,B00,201717,Staff,11,0,15,4
1681912359767,ANSC 105GS,A00,258289,Staff,0,0,0,0
1681912360793,ANSC 125GS,A00,258295,Staff,0,0,0,0
1681912361817,ANSC 150,A00,258267,Staff,30,0,40,10
1681912362843,ANSC 190GS,A00,258280,Staff,0,0,0,0
1681912363869,ANTH 1,A00,258264,Staff,38,0,40,2
1681912364896,ANTH 2,A01,258259,Staff,72,0,76,4
1681912365921,ANTH 23,A01,258228,Staff,36,0,40,4
1681912366946,ANTH 101,A01,258236,Staff,39,0,40,1
1681912367972,ANTH 102,A00,258272,Staff,59,0,60,1
1681912368996,ANTH 105,A00,258244,Staff,31,0,35,4
1681912370023,BENG 130,A00,253975,Staff,38,0,40,2
1681912371049,BIBC 102,A01,191866,Flagg; Matthew Paul,19,0,32,13
1681912371049,BIBC 102,A02,191867,Flagg; Matthew Paul,22,0,32,10
1681912371049,BIBC 102,A03,191868,Flagg; Matthew Paul,30,0,32,2
1681912371049,BIBC 102,A04,191936,Flagg; Matthew Paul,26,0,32,6
1681912371049,BIBC 102,A05,191937,Flagg; Matthew Paul,11,0,32,21
1681912372078,BICD 100,A01,191939,Cooper; Andrew Michael,28,0,32,4
1681912372078,BICD 100,A02,191940,Cooper; Andrew Michael,32,0,32,0
1681912372078,BICD 100,A03,191941,Cooper; Andrew Michael,32,0,32,0
1681912372078,BICD 100,A04,191942,Cooper; Andrew Michael,32,0,32,0
1681912372078,BICD 100,A05,191943,Cooper; Andrew Michael,32,0,32,0
1681912373102,BIEB 126,A01,191945,Cleland; Elsa Eleanor,1,0,32,31
1681912373102,BIEB 126,A02,191946,Cleland; Elsa Eleanor,28,0,32,4
1681912373102,BIEB 126,A03,191947,Cleland; Elsa Eleanor,29,0,32,3
1681912373102,BIEB 126,A04,191948,Cleland; Elsa Eleanor,23,0,32,9
1681912373102,BIEB 126,A05,191996,Cleland; Elsa Eleanor,28,0,32,4
1681912374129,BIEB 136GS,A00,191997,Shurin; Jonathan & Holway; David A.,0,0,0,0
1681912375151,BIEB 137GS,A01,191999,Shurin; Jonathan & Holway; David A.,0,0,0,0
1681912376178,BILD 1,A01,205385,Staff,31,0,32,1
1681912376178,BILD 1,A02,205386,Staff,30,0,32,2
1681912376178,BILD 1,A03,205387,Staff,32,0,32,0
1681912376178,BILD 1,A04,205388,Staff,28,0,32,4
1681912377203,BILD 2,A01,191774,Staff,28,0,32,4
1681912377203,BILD 2,A02,191775,Staff,30,0,32,2
1681912377203,BILD 2,A03,191777,Staff,30,0,32,2
1681912377203,BILD 2,A04,191856,Staff,31,0,32,1
1681912377203,BILD 2,A05,191857,Staff,32,0,32,0
1681912377203,BILD 2,A06,191858,Staff,32,0,32,0
1681912377203,BILD 2,A07,191859,Staff,31,0,32,1
1681912378227,BILD 3,A01,205391,Staff,29,0,32,3
1681912378227,BILD 3,A02,205393,Staff,32,0,32,0
1681912378227,BILD 3,A03,205394,Staff,28,0,32,4
1681912378227,BILD 3,A04,205395,Staff,32,0,32,0
1681912379254,BILD 20,A01,191861,Staff,32,0,32,0
1681912379254,BILD 20,A02,191862,Staff,32,0,32,0
1681912380280,BILD 30,A01,191864,Staff,31,0,32,1
1681912381304,BIMM 100,A01,192019,Staff,0,0,32,32
1681912381304,BIMM 100,A02,192020,Staff,23,0,32,9
1681912381304,BIMM 100,A03,192035,Staff,22,0,32,10
1681912382329,BIMM 110,A01,192037,Tat; John,0,0,32,32
1681912382329,BIMM 110,A02,192038,Tat; John,10,0,32,22
1681912383353,BIMM 120,A01,192040,Pickett; Brooke Elizabeth,2,0,32,30
1681912383353,BIMM 120,A02,192041,Pickett; Brooke Elizabeth,16,0,32,16
1681912383353,BIMM 120,A03,192042,Pickett; Brooke Elizabeth,16,0,32,16
1681912384382,BIPN 100,A01,192044,Armour; Jon Christopher,26,0,32,6
1681912384382,BIPN 100,A02,192059,Armour; Jon Christopher,30,0,32,2
1681912384382,BIPN 100,A03,192064,Armour; Jon Christopher,31,0,32,1
1681912384382,BIPN 100,A04,192073,Armour; Jon Christopher,28,0,32,4
1681912385409,BIPN 148,A01,205411,Leutgeb; Jill K.,16,0,32,16
1681912385409,BIPN 148,A02,205412,Leutgeb; Jill K.,31,0,32,1
1681912385409,BIPN 148,A03,205413,Leutgeb; Jill K.,30,0,32,2
1681912385409,BIPN 148,A04,205414,Leutgeb; Jill K.,30,0,32,2
1681912386439,BIPN 160,A01,192115,Marino; Marc J,19,0,32,13
1681912386439,BIPN 160,A02,192148,Marino; Marc J,27,0,32,5
1681912386439,BIPN 160,A03,192158,Marino; Marc J,31,0,32,1
1681912386439,BIPN 160,A04,192190,Marino; Marc J,32,0,32,0
1681912386439,BIPN 160,A05,192287,Marino; Marc J,32,0,32,0
1681912386439,BIPN 160,A06,192288,Marino; Marc J,32,0,32,0
1681912387463,BIPN 194,A00,206038,Staff,28,0,32,4
1681912388490,BISP 194,A00,192289,Leutgeb; Stefan,13,0,32,19
1681912388490,BISP 194,B00,245332,Nieh; James Charles,27,0,32,5
1681912389514,CAT 124,A01,202247,Staff,15,0,15,0
1681912390538,CAT 125,A00,202248,Staff,19,0,20,1
1681912390538,CAT 125,B00,202253,Staff,20,0,20,0
1681912390538,CAT 125,C00,202257,Staff,19,0,20,1
1681912391565,CAT 125GS,A01,202273,Bronstein; Phoebe Malan,20,0,20,0
1681912392595,CAT 125R,A00,202284,Staff,17,0,20,3
1681912392595,CAT 125R,C00,202286,Staff,10,0,20,10
1681912392595,CAT 125R,D00,202291,Staff,18,0,20,2
1681912392595,CAT 125R,E00,202295,Staff,13,0,20,7
1681912392595,CAT 125R,F00,202302,Staff,12,0,20,8
1681912393618,CENG 100,A00,204724,Opatkiewicz; Justin Paul,25,0,25,0
1681912394644,CGS 2A,A01,180420,Staff,31,0,36,5
1681912395668,CGS 101,A00,180421,Staff,16,0,20,4
1681912396698,CGS 112,A00,180422,Staff,10,0,16,6
1681912397728,CGS 113,A00,180423,Staff,18,0,20,2
1681912398755,CGS 137,A00,180424,Staff,12,0,12,0
1681912399780,CGS 147,A00,180425,Staff,10,0,10,0
1681912400808,CHEM 6A,A01,179556,Staff,97,0,100,3
1681912400808,CHEM 6A,A02,179558,Staff,0,0,0,0
1681912401830,CHEM 6B,A01,179560,Staff,100,0,100,0
1681912402854,CHEM 6C,A01,179565,Jazzar; Rodolphe,95,0,100,5
1681912403880,CHEM 7L,A01,179586,Schurmeier; Kimberly,13,0,24,11
1681912403880,CHEM 7L,A02,179587,Schurmeier; Kimberly,23,0,24,1
1681912403880,CHEM 7L,A03,179590,Schurmeier; Kimberly,22,0,24,2
1681912403880,CHEM 7L,A04,179591,Schurmeier; Kimberly,22,0,24,2
1681912403880,CHEM 7L,B01,179598,Schurmeier; Kimberly,17,0,24,7
1681912403880,CHEM 7L,B02,179599,Schurmeier; Kimberly,24,0,24,0
1681912403880,CHEM 7L,B03,179606,Schurmeier; Kimberly,23,0,24,1
1681912403880,CHEM 7L,B04,179607,Schurmeier; Kimberly,23,0,24,1
1681912404912,CHEM 11,A01,179609,Stallings; Dontarie M,88,0,100,12
1681912405939,CHEM 40A,A01,179621,Staff,41,0,50,9
1681912405939,CHEM 40A,A02,179622,Staff,47,0,50,3
1681912406964,CHEM 40B,A01,179630,Weizman; Haim,48,0,50,2
1681912406964,CHEM 40B,A02,179631,Weizman; Haim,45,0,50,5
1681912407997,CHEM 41A,A01,179660,Klosterman; Jeremy K,93,0,100,7
1681912409025,CHEM 43A,A01,179683,Klosterman; Jeremy K,0,0,24,24
1681912409025,CHEM 43A,A02,179688,Klosterman; Jeremy K,14,0,24,10
1681912409025,CHEM 43A,A03,179689,Klosterman; Jeremy K,20,0,24,4
1681912409025,CHEM 43A,A04,179691,Klosterman; Jeremy K,18,0,24,6
1681912410056,CHEM 114A,A01,179693,Stallings; Dontarie M,77,0,100,23
1681912411080,CHEM 143B,A01,179698,Weizman; Haim,17,0,24,7
1681912411080,CHEM 143B,A02,179700,Weizman; Haim,24,0,24,0
1681912412112,CHIN 169A,A00,179701,Wang; Xiao,20,0,20,0
1681912413139,COGS 2,A01,179750,Boyle; Mary E. T.,17,0,30,13
1681912414164,COGS 9,A01,179759,Jones; Cameron Robert,43,0,50,7
1681912415190,COGS 14A,A01,179854,Staff,18,0,50,32
1681912416215,COGS 14B,A01,179856,Staff,54,0,60,6
1681912417243,COGS 17,A01,179874,Staff,71,0,75,4
1681912418267,COGS 18,A01,179884,Staff,63,0,80,17
1681912419293,COGS 100,A01,179886,Staff,40,0,60,20
1681912420318,COGS 101B,A01,179892,Staff,1,0,30,29
1681912421343,COGS 101C,A01,179894,Staff,28,0,30,2
1681912422441,COGS 107A,A01,179896,Boyle; Mary E. T.,31,0,40,9
1681912423465,COGS 108,A01,179898,Simpkins; Charles Alexander,0,17,60,60
1681912424488,COGS 109,A01,179900,Staff,34,0,40,6
1681912425515,COGS 118A,A01,179946,Staff,9,0,40,31
1681912426548,COGS 153,A00,179978,Staff,1,0,30,29
1681912427569,COGS 156,A01,179981,Staff,27,0,30,3
1681912429619,COGS 172,A01,179987,Staff,13,0,30,17
1681912431669,COGS 186,A01,179991,Staff,13,0,30,17
1681912432696,COMM 10,A01,180001,Staff,15,0,25,10
1681912432696,COMM 10,A02,180004,Staff,20,0,25,5
1681912433719,COMM 100A,A01,180016,Staff,18,0,25,7
1681912433719,COMM 100A,A02,180020,Staff,24,0,25,1
1681912434748,COMM 101T,A00,180029,Halm; Gavin Patrick,23,0,35,12
1681912435770,COMM 106V,A00,180043,Staff,34,0,35,1
1681912436795,COMM 109P,A00,180044,Staff,31,0,35,4
1681912437818,COMM 113T,A00,180045,Havis; Allan,37,0,45,8
1681912438842,COMM 132,A00,180046,McKenna; Denise,23,0,30,7
1681912439869,COMM 143,A00,180047,Staff,19,0,30,11
1681912440891,COMM 190,A00,180048,Conner; Thomas Hartnell,20,0,23,3
1681912441915,CSE 8A,A50,180053,Cao; Yingjun,25,0,50,25
1681912441915,CSE 8A,B50,180180,Staff,50,0,50,0
1681912442942,CSE 11,A01,180190,Cao; Yingjun,31,0,50,19
1681912443971,CSE 20,A01,180192,Briones; Jor-el Thomas Caparas,23,0,30,7
1681912444993,CSE 21,A01,194538,Briones; Jor-el Thomas Caparas,50,0,60,10
1681912446022,CSE 30,A01,180324,Eldon; John,79,0,100,21
1681912447044,CSE 101,A01,201353,Staff,0,20,40,40
1681912448071,CSE 134B,A01,180326,Powell; Thomas Allan,74,0,100,26
1681912449094,CSE 140,A01,180328,Staff,46,0,75,29
1681912450121,CSE 140L,A01,180344,Eldon; John,69,0,100,31
1681912451144,CSE 150A,A01,180411,Staff,0,7,50,50
1681912452167,CSE 151A,A01,180414,Staff,0,6,50,50
1681912453193,CSE 175,A01,222521,Kumar; Rakesh,50,0,50,0
1681912454215,CSE 190,A00,201419,Staff,45,0,49,4
1681912455237,CSS 1,A01,194536,Staff,38,0,50,12
1681912456259,DSC 30,A01,202385,Staff,48,0,50,2
1681912457290,DSC 40A,A01,202387,Albuyeh; Rod,50,0,50,0
1681912458316,DSC 190,A01,202389,Silberman; Jack,21,0,21,0
1681912459342,DSGN 100,A01,179993,Staff,16,0,30,14
1681912460365,ECE 65,A50,180708,Staff,10,0,20,10
1681912460365,ECE 65,A51,180739,Staff,19,0,20,1
1681912461391,ECON 1,A01,180427,Famulari; Melissa,67,0,70,3
1681912462413,ECON 2,A01,180450,Levkoff; Steven B.,64,0,70,6
1681912463436,ECON 4,A01,203351,Anderson; John Charles,7,0,10,3
1681912464462,ECON 100A,A01,180472,Famulari; Melissa,65,0,70,5
1681912465487,ECON 120A,A01,180549,Staff,64,0,70,6
1681912466512,ECON 120B,A01,180655,Ma; Xinwei,46,0,70,24
1681912467534,ECON 129,A00,203333,Eckert; Fabian Paul,15,0,35,20
1681912468562,ECON 131,A00,180656,Staff,9,0,35,26
1681912469587,ECON 172B,A01,180672,Levkoff; Steven B.,32,0,35,3
1681912470609,ECON 178,A01,203342,Zhu; Ying,11,0,35,24
1681912471630,EDS 108GS,A00,202383,Wishard Guerra; Alison G.,20,0,20,0
1681912472654,EDS 111GS,A00,202347,Wishard Guerra; Alison G.,20,0,20,0
1681912473679,EDS 112,A01,202323,Staff,56,0,60,4
1681912474705,EDS 113,A00,202340,Staff,33,0,35,2
1681912475727,EDS 118,A00,201231,Staff,20,0,30,10
1681912476755,EDS 119,A00,204994,Staff,8,0,10,2
1681912477779,EDS 124BR,A00,202324,Eguchi; Emi,5,0,25,20
1681912478802,EDS 126,A01,203208,Jones; Makeba,26,0,30,4
1681912479824,EDS 135,A01,202333,Staff,18,0,20,2
1681912480849,EDS 180,A00,202311,Staff,47,0,50,3
1681912481874,ERC 190GS,A01,253747,Staff,28,0,28,0
1681912482898,ETHN 104,A00,180742,Staff,24,0,35,11
1681912483923,ETHN 118,A00,180745,Staff,28,0,35,7
1681912484951,ETHN 127,A00,180747,Staff,12,0,16,4
1681912485978,ETHN 137,A00,180880,Staff,12,0,12,0
1681912487004,ETHN 147,A00,180890,Staff,8,0,10,2
1681912488027,ETHN 154,A00,180891,Staff,7,0,8,1
1681912489050,ETHN 168,A00,180892,Staff,9,0,10,1
1681912490073,GLBH 20,A00,201051,Hannah; Seth Donal,0,1,0,1
1681912491096,GLBH 111,A01,209338,Burgos; Jose L.,0,0,0,0
1681912492118,GLBH 150,A00,258300,Staff,0,3,0,0
1681912493145,GLBH 181,A00,201207,Staff,15,0,40,25
1681912494167,HIEU 109,A00,180898,Staff,20,0,20,0
1681912495192,HIEU 111,A00,180899,Staff,1,0,20,19
1681912496219,HIEU 124,A00,180900,Staff,18,0,20,2
1681912497249,HILA 122,A00,180901,Staff,18,0,20,2
1681912498275,HILA 132,A00,180902,Vitz; Matthew,2,0,20,18
1681912499301,HILD 10,A01,180896,Staff,15,0,20,5
1681912500324,HILD 30GS,A00,180897,Edington; Claire Ellen,0,0,0,0
1681912501351,HISC 105,A00,180903,Staff,20,0,20,0
1681912502376,HISC 117,A00,180904,Staff,11,0,20,9
1681912503401,HIUS 108B,A00,181005,Staff,18,0,20,2
1681912504430,HIUS 113,A00,181093,Staff,4,0,20,16
1681912505456,HUM 3,A01,181190,Patterson; Patrick H.,40,0,50,10
1681912505456,HUM 3,B01,181195,Staff,47,0,50,3
1681912506481,HUM 3GS,A00,181196,Herbst; Matthew,0,0,0,0
1681912507517,HUM 4,A01,181227,West; Geoffrey Scott,34,0,50,16
1681912507517,HUM 4,B01,181282,Staff,43,0,50,7
1681912508542,HUM 4GS,A00,181377,Lyon; Antony J.,0,0,0,0
1681912509569,HUM 5,A01,181536,Zavodny; Tatiana Sophia,31,0,50,19
1681912509569,HUM 5,B01,181908,Staff,36,0,50,14
1681912510595,INTL 190,A00,181909,Segui; Alan S,0,0,0,6
1681912510595,INTL 190,B00,181961,Segui; Alan S,0,0,0,7
1681912511620,JAPN 20AR,A01,182113,Ross; Kayoko F,15,0,20,5
1681912512642,LATI 50,A01,202391,Martin-Cabrera; Luis,19,0,30,11
1681912512642,LATI 50,A02,202392,Martin-Cabrera; Luis,26,0,30,4
1681912513664,LATI 180,A00,202393,Kokinis; Troy Andreas,25,0,25,0
1681912514689,LIFR 1A,A00,182119,Staff,14,0,14,0
1681912515717,LIFR 1AX,A00,182324,Staff,14,0,14,0
1681912516740,LIFR 1B,A00,182259,Staff,14,0,14,0
1681912517767,LIFR 1BX,A00,182273,Staff,14,0,14,0
1681912518789,LIGN 8,A00,182330,Staff,137,0,150,13
1681912519810,LIGN 9GS,A00,182362,Staff,20,0,20,0
1681912520838,LIGN 119,A00,204992,Takahashi; Maho,12,0,15,3
1681912521863,LIGN 130,A01,182384,Staff,47,0,50,3
1681912522889,LIGN 149GS,A00,182390,Staff,20,0,20,0
1681912523913,LIGN 170,A00,182404,Staff,24,0,30,6
1681912524941,LISP 1D,A00,182281,Staff,7,0,14,7
1681912524941,LISP 1D,B00,182287,Staff,14,0,14,0
1681912524941,LISP 1D,C00,182295,Staff,11,0,14,3
1681912524941,LISP 1D,D00,182301,Staff,14,0,14,0
1681912526045,LISP 1DX,A00,182309,Staff,20,0,28,8
1681912526045,LISP 1DX,B00,182316,Staff,26,0,28,2
1681912527075,LTAF 120GS,A00,182412,Zhiri; Oumelbanine,20,0,20,0
1681912528101,LTCS 172GS,A00,182437,Bronstein; Phoebe Malan,20,0,20,0
1681912529125,LTEA 138,A00,182457,Staff,22,0,40,18
1681912530147,LTEN 114,A01,182490,Staff,23,0,25,2
1681912531173,LTEN 130GS,A00,182491,Lyon; Antony J.,20,0,20,0
1681912532199,LTEN 169,A00,182493,Cuong; Marisol,20,0,25,5
1681912533226,LTEN 178,A00,182501,Staff,14,0,15,1
1681912534252,LTEN 181,A00,182515,Staff,22,0,25,3
1681912535278,LTEN 185GS,A00,197655,Forbes; Camille,20,0,20,0
1681912536302,LTSP 100B,A00,202208,Bessett; Ryan Matthew,24,0,25,1
1681912537325,LTWL 100,A00,182516,Myerston Santana; Jacobo,22,0,30,8
1681912538348,LTWR 100GS,A00,182518,Forbes; Camille,20,0,20,0
1681912539375,LTWR 102,A00,182522,Staff,15,0,15,0
1681912539375,LTWR 102,B00,182525,Staff,14,0,15,1
1681912540400,LTWR 115,A00,182526,Staff,12,0,15,3
1681912541426,MAE 8,A01,182528,Pham; Hieu Tan,68,0,70,2
1681912542452,MAE 11,A00,182529,Bahadori; Mohammad Yousef,94,0,100,6
1681912543479,MAE 20,A00,182530,Evdokimenko; Ekaterina,68,0,70,2
1681912544506,MAE 30A,A00,182532,Staff,44,0,45,1
1681912545528,MAE 101A,A00,182533,Bahadori; Mohammad Yousef,97,0,100,3
1681912546552,MAE 101C,A00,182538,Staff,62,0,70,8
1681912547575,MAE 104,A00,182539,Staff,45,0,50,5
1681912548599,MAE 131A,A00,182540,Ghazinejad; Maziar,41,0,45,4
1681912549621,MAE 143A,A00,182548,Bewley; Thomas R,43,0,50,7
1681912550646,MAE 150,A00,182549,Staff,28,0,40,12
1681912551674,MAE 160,A00,182550,Evdokimenko; Ekaterina,43,0,60,17
1681912552700,MATH 3C,A01,182725,Staff,27,0,30,3
1681912553725,MATH 10A,A01,182729,Staff,25,0,30,5
1681912553725,MATH 10A,B01,182732,Staff,26,0,30,4
1681912554749,MATH 10B,A01,182737,Staff,21,0,30,9
1681912554749,MATH 10B,A02,182738,Staff,27,0,30,3
1681912554749,MATH 10B,B01,182744,Staff,27,0,30,3
1681912554749,MATH 10B,B02,182745,Staff,27,0,30,3
1681912555773,MATH 18,A01,182750,Anzaldo; Leesa B,28,0,30,2
1681912555773,MATH 18,A02,182751,Anzaldo; Leesa B,29,0,30,1
1681912555773,MATH 18,A03,182753,Anzaldo; Leesa B,28,0,30,2
1681912555773,MATH 18,A04,182757,Anzaldo; Leesa B,29,0,30,1
1681912555773,MATH 18,B01,182761,Anzaldo; Leesa B,27,0,30,3
1681912555773,MATH 18,B02,182764,Anzaldo; Leesa B,27,0,30,3
1681912555773,MATH 18,B03,182765,Anzaldo; Leesa B,30,0,30,0
1681912555773,MATH 18,B04,182766,Anzaldo; Leesa B,30,0,30,0
1681912556796,MATH 20A,A01,182771,Suk; Andrew Hoon,28,0,30,2
1681912557824,MATH 20B,A01,182775,Bach; Quang Tran,30,0,30,0
1681912557824,MATH 20B,A02,182777,Bach; Quang Tran,29,0,30,1
1681912557824,MATH 20B,B01,182780,Bach; Quang Tran,27,0,30,3
1681912557824,MATH 20B,B02,182782,Bach; Quang Tran,30,0,30,0
1681912558847,MATH 20C,A01,182787,Staff,25,0,30,5
1681912558847,MATH 20C,A02,182790,Staff,29,0,30,1
1681912558847,MATH 20C,B01,182792,Staff,25,0,30,5
1681912558847,MATH 20C,B02,182796,Staff,27,0,30,3
1681912559872,MATH 20D,A01,182799,Staff,29,0,30,1
1681912559872,MATH 20D,A02,182802,Staff,30,0,30,0
1681912559872,MATH 20D,A03,182803,Staff,30,0,30,0
1681912560901,MATH 20E,A01,182809,Verstraete; Jacques Allan,24,0,30,6
1681912560901,MATH 20E,A02,182811,Verstraete; Jacques Allan,28,0,30,2
1681912560901,MATH 20E,B01,182814,Verstraete; Jacques Allan,23,0,30,7
1681912560901,MATH 20E,B02,182815,Verstraete; Jacques Allan,30,0,30,0
1681912561927,MATH 103A,A01,182820,Staff,9,0,30,21
1681912561927,MATH 103A,A02,182821,Staff,27,0,30,3
1681912561927,MATH 103A,A03,182822,Staff,23,0,30,7
1681912561927,MATH 103A,B01,182825,Staff,23,0,30,7
1681912561927,MATH 103A,B02,182826,Staff,30,0,30,0
1681912561927,MATH 103A,B03,182830,Staff,30,0,30,0
1681912562951,MATH 109,A01,182836,Chow; Bennett,24,0,30,6
1681912562951,MATH 109,A02,182838,Chow; Bennett,29,0,30,1
1681912562951,MATH 109,A03,182894,Chow; Bennett,29,0,30,1
1681912562951,MATH 109,B01,182908,Chow; Bennett,28,0,30,2
1681912562951,MATH 109,B02,182909,Chow; Bennett,30,0,30,0
1681912562951,MATH 109,B03,182910,Chow; Bennett,27,0,30,3
1681912563979,MATH 142A,A01,182925,Staff,11,0,30,19
1681912563979,MATH 142A,A02,182935,Staff,25,0,30,5
1681912563979,MATH 142A,A03,182967,Staff,26,0,30,4
1681912563979,MATH 142A,B01,183125,Staff,24,0,30,6
1681912563979,MATH 142A,B02,183157,Staff,28,0,30,2
1681912563979,MATH 142A,B03,183158,Staff,29,0,30,1
1681912565003,MATH 183,A01,183160,Arias-Castro; Ery,23,0,30,7
1681912565003,MATH 183,A02,183161,Arias-Castro; Ery,29,0,30,1
1681912565003,MATH 183,B01,183163,Arias-Castro; Ery,28,0,30,2
1681912565003,MATH 183,B02,183164,Arias-Castro; Ery,28,0,30,2
1681912566027,MATH 193A,A01,183167,Staff,4,0,35,31
1681912566027,MATH 193A,A02,183168,Staff,28,0,35,7
1681912566027,MATH 193A,A03,183169,Staff,34,0,35,1
1681912566027,MATH 193A,A04,183170,Staff,28,0,35,7
1681912567058,MGT 4,A01,202395,Anderson; John Charles,75,0,80,5
1681912568082,MGT 5,A00,202396,Houskeeper; Robert,80,0,90,10
1681912569110,MGT 103,A00,202397,Eberhard; Craig A,55,0,90,35
1681912570133,MGT 131A,A00,202398,Houskeeper; Robert,85,0,90,5
1681912571158,MGT 135,A00,202399,Anderson; John Charles,82,0,90,8
1681912572185,MGT 162R,A00,202403,Gneezy; Uri,150,0,200,50
1681912573209,MGT 172,A00,202404,Hedges; Kathleen,50,0,90,40
1681912574234,MGT 181,A00,202405,Dunn; Louis Jean,84,0,90,6
1681912575262,MMW 14,A01,183200,Staff,16,0,28,12
1681912575262,MMW 14,A02,183201,Staff,26,0,28,2
1681912575262,MMW 14,A03,183202,Staff,24,0,28,4
1681912575262,MMW 14,A04,183203,Staff,25,0,28,3
1681912575262,MMW 14,A05,183204,Staff,26,0,28,2
1681912575262,MMW 14,A06,183205,Staff,27,0,28,1
1681912575262,MMW 14,B01,183207,Staff,26,0,28,2
1681912575262,MMW 14,B02,183208,Staff,28,0,28,0
1681912575262,MMW 14,B03,183209,Staff,28,0,28,0
1681912575262,MMW 14,B04,183210,Staff,28,0,28,0
1681912575262,MMW 14,B05,183211,Staff,28,0,28,0
1681912575262,MMW 14,B06,183212,Staff,28,0,28,0
1681912576289,MMW 14GS,A00,183213,Zhiri; Oumelbanine,28,0,28,0
1681912577311,MMW 15GS,B00,183215,Rahimi; Babak,28,0,28,0
1681912578334,MMW 121,A01,183217,Patterson; Patrick H.,14,0,28,14
1681912578334,MMW 121,A02,183218,Patterson; Patrick H.,25,0,28,3
1681912579357,MUS 1A,A01,182554,Staff,8,0,35,27
1681912580384,MUS 5,A01,182558,Staff,20,0,35,15
1681912581406,MUS 6,A01,182562,Staff,25,0,35,10
1681912582432,MUS 8GS,A00,182563,Borgo; David Garcia,25,0,25,0
1681912583457,MUS 13,A01,182567,Staff,24,0,25,1
1681912584483,MUS 15,A01,182570,Staff,32,0,35,3
1681912584483,MUS 15,B01,182575,Staff,10,0,35,25
1681912585506,MUS 80,A00,182578,Staff,23,0,25,2
1681912585506,MUS 80,B00,182581,Staff,20,0,25,5
1681912586530,MUS 113,A00,182582,Staff,25,0,25,0
1681912587562,MUS 114,A00,182583,Staff,4,0,25,21
1681912588583,MUS 150GS,A01,182588,Borgo; David Garcia,25,0,25,0
1681912589606,PHIL 1,A00,182590,Staff,35,0,40,5
1681912590629,PHIL 10,A01,182596,Grush; Rick Scott,31,0,35,4
1681912590629,PHIL 10,A02,182597,Grush; Rick Scott,34,0,35,1
1681912591657,PHIL 15,A01,182601,Staff,31,0,35,4
1681912591657,PHIL 15,A02,182602,Staff,33,0,35,2
1681912592685,PHIL 27,A01,182604,Staff,30,0,35,5
1681912592685,PHIL 27,A02,182607,Staff,35,0,35,0
1681912593715,PHIL 32,A01,182609,Staff,35,0,35,0
1681912593715,PHIL 32,A02,182612,Staff,35,0,35,0
1681912594738,PHIL 130,A00,182614,Staff,63,0,70,7
1681912595761,PHIL 136,A00,182616,Cohen; Jonathan David,66,0,70,4
1681912596786,PHIL 155,A00,182617,Vargas; Manuel Rogelio,60,0,70,10
1681912597810,PHIL 163,A01,182620,Staff,15,0,20,5
1681912597810,PHIL 163,A02,182624,Staff,10,0,20,10
1681912598837,PHIL 164,A00,182627,Staff,30,0,40,10
1681912599860,PHIL 173,A00,182628,Staff,36,0,40,4
1681912600886,PHYS 1A,A00,183221,Staff,54,0,60,6
1681912601914,PHYS 1AL,001,183222,Staff,25,0,30,5
1681912601914,PHYS 1AL,002,183223,Staff,28,0,30,2
1681912602939,PHYS 1B,A00,183231,Staff,44,0,60,16
1681912603962,PHYS 1BL,001,183232,Staff,20,0,30,10
1681912603962,PHYS 1BL,002,183233,Staff,29,0,30,1
1681912604988,PHYS 1C,A00,183240,Staff,30,0,60,30
1681912606012,PHYS 1CL,001,183241,Staff,13,0,30,17
1681912606012,PHYS 1CL,002,183242,Staff,22,0,30,8
1681912607036,PHYS 2AR,A01,183250,Staff,44,0,50,6
1681912608058,PHYS 2B,A01,183252,Staff,106,0,115,9
1681912609081,PHYS 2BL,A01,183254,Staff,21,0,24,3
1681912609081,PHYS 2BL,A02,183255,Staff,22,0,24,2
1681912610108,PHYS 2C,A01,183522,Staff,105,0,115,10
1681912611130,PHYS 4A,A01,183524,Staff,49,0,50,1
1681912612155,POLI 5,A00,183525,Staff,44,0,50,6
1681912613179,POLI 12,A00,183540,Staff,48,0,50,2
1681912614207,POLI 13R,A00,183541,Forman; Fonna,42,0,50,8
1681912615233,POLI 30,A00,183542,Mignozzetti; Umberto,47,0,50,3
1681912616259,POLI 100A,A00,183543,Staff,45,0,50,5
1681912617319,POLI 100E,A00,223598,Staff,32,0,35,3
1681912618343,POLI 103A,A00,183564,Kousser; Thad,38,0,50,12
1681912619369,POLI 104B,A00,201329,Staff,29,0,35,6
1681912620396,POLI 113BR,A00,183576,Hoston; Germaine,27,0,50,23
1681912621419,POLI 114BR,A00,183588,Staff,27,0,30,3
1681912622457,POLI 117R,A00,183595,Forman; Fonna,9,0,20,11
1681912623484,POLI 120H,A00,183596,Fisk; David Lee,13,0,20,7
1681912624508,POLI 130AA,A00,183597,Staff,14,0,20,6
1681912625533,POLI 134AA,A00,183598,Staff,19,0,20,1
1681912626560,POLI 135,A00,183599,Fisk; David Lee,20,0,25,5
1681912627584,POLI 142P,A00,183623,Staff,37,0,40,3
1681912628609,POLI 144D,A00,183624,Staff,22,0,25,3
1681912629709,POLI 151,A00,183625,Staff,15,0,20,5
1681912630731,POLI 162,A00,183626,Mignozzetti; Umberto,18,0,20,2
1681912631755,PSYC 1,A00,253748,Staff,86,0,90,4
1681912632779,PSYC 2,A00,183627,Moranton; Nirelia Melbina-,25,0,35,10
1681912633802,PSYC 3,A00,183628,Staff,43,0,45,2
1681912635848,PSYC 60,A01,183631,Lowe; Angela Beth,35,0,40,5
1681912636874,PSYC 70,A01,253757,Staff,37,0,45,8
1681912637897,PSYC 101,A00,183632,Heyman; Gail D.,48,0,60,12
1681912638920,PSYC 105,A00,183848,Lowe; Angela Beth,50,0,60,10
1681912639945,PSYC 106,A00,183849,Dobkins; Karen R.,45,0,60,15
1681912640969,PSYC 108,A00,253750,Staff,24,0,60,36
1681912641994,PSYC 114,A01,184275,Winkielman; Piotr,0,6,30,30
1681912643016,PSYC 122,A00,183856,Moranton; Nirelia Melbina-,0,10,30,30
1681912644043,PSYC 124,A00,183865,Chapman; Eddie Nathaniel,52,0,80,28
1681912645077,PSYC 137,A00,183880,Staff,19,0,25,6
1681912647126,PSYC 154,A00,183910,Lacefield; Katharine I,0,2,90,90
1681912649173,PSYC 162,A00,183946,Wixted; John T,61,0,90,29
1681912650200,PSYC 172,A00,183947,Gorman; Michael R.,14,0,30,16
1681912651224,PSYC 178,A00,183963,Glaser; Dale,20,0,40,20
1681912652257,PSYC 181GS,A00,183964,Anagnostaras; Stephan,10,0,10,0
1681912653288,PSYC 186GS,A01,257660,Staff,10,0,10,0
1681912654310,PSYC 193,B00,253749,Staff,23,0,25,2
1681912656362,PSYC 193L,A01,184122,Staff,33,0,35,2
1681912656362,PSYC 193L,C01,184167,Winkielman; Piotr,16,0,30,14
1681912657385,RELI 188GS,A00,182629,Rahimi; Babak,20,0,20,0
1681912658410,SE 101A,A00,182646,Staff,26,0,30,4
1681912659435,SE 101C,A00,182650,Staff,18,0,20,2
1681912660463,SE 110A,A00,182651,Staff,28,0,28,0
1681912661486,SE 130A,A00,182652,Staff,39,0,40,1
1681912662510,SIO 46GS,A00,182636,Cook; Geoffrey W,28,0,28,0
1681912663532,SIO 109R,A00,194459,Staff,5,0,20,15
1681912664556,SIO 121GS,A00,182639,Cook; Geoffrey W,28,0,28,0
1681912665579,SIO 132,A01,182642,Staff,32,0,40,8
1681912666601,SIO 139,A00,182644,Kacev; David,36,0,40,4
1681912667623,SOCI 2,A01,258404,Staff,34,0,36,2
1681912667623,SOCI 2,A02,258405,Staff,35,0,36,1
1681912668656,SOCI 60,A01,258408,Staff,29,0,30,1
1681912668656,SOCI 60,A02,258413,Staff,30,0,30,0
1681912669680,SOCI 100,A01,258415,Staff,29,0,30,1
1681912669680,SOCI 100,A02,258416,Staff,28,0,30,2
1681912675848,SOCI 127,A00,258421,Staff,22,0,30,8
1681912676872,SOCI 132,A00,258422,Staff,45,0,50,5
1681912677894,SOCI 133,A00,258423,Staff,26,0,30,4
1681912678918,SOCI 138GS,A00,258424,Staff,15,0,15,0
1681912679945,SOCI 145,A00,258425,Staff,25,0,30,5
1681912680970,SOCI 148,A00,258426,Staff,26,0,30,4
1681912681999,SOCI 153,A00,199217,Staff,29,0,30,1
1681912683026,SOCI 160,A00,258427,Staff,28,0,30,2
1681912684050,SOCI 160E,A00,258435,Staff,56,0,60,4
1681912685076,SOCI 189GS,A00,258436,Staff,15,0,15,0
1681912686101,SOCI 190GS,A00,258437,Staff,15,0,15,0
1681912687126,SYN 2,001,182658,Staff,9,0,16,7
1681912687126,SYN 2,002,201439,Staff,15,0,16,1
1681912687126,SYN 2,003,201443,Staff,16,0,16,0
1681912688149,SYN 100,A01,182657,Staff,17,0,20,3
1681912689178,TDAC 1,A00,184381,Salovey; Todd,16,0,20,4
1681912689178,TDAC 1,B00,184385,Harting; Carla Kelso,19,0,20,1
1681912689178,TDAC 1,C00,184394,Staff,19,0,20,1
1681912690203,TDAC 101,A00,184483,Harting; Carla Kelso,19,0,20,1
1681912691227,TDDE 111,A00,184496,Staff,14,0,15,1
1681912692251,TDDE 131,A00,184504,Staff,20,0,20,0
1681912692251,TDDE 131,B00,184505,Staff,17,0,18,1
1681912692251,TDDE 131,C00,184534,Staff,49,0,50,1
1681912692251,TDDE 131,D00,184564,Staff,15,0,15,0
1681912692251,TDDE 131,E00,204725,Staff,19,0,20,1
1681912693274,TDGE 1,A01,184414,Salovey; Todd,37,0,50,13
1681912694297,TDGE 5,A01,184419,Staff,23,0,24,1
1681912695322,TDGE 10,A00,184428,Fulton; Julia,31,0,50,19
1681912696349,TDGE 124,A00,184565,Fulton; Julia,7,0,50,43
1681912697376,TDGE 125,B00,184567,Meyer; Ursula,9,0,25,16
1681912698400,TDHT 101,A00,184568,Staff,21,0,25,4
1681912698400,TDHT 101,B00,184569,Staff,20,0,20,0
1681912699425,TDHT 114,A00,184570,Staff,49,0,50,1
1681912700453,TDMV 1,A00,184437,Arcidiacono; Kristin,23,0,30,7
1681912700453,TDMV 1,B00,184448,Caligagan; Maria T.,22,0,30,8
1681912701477,TDMV 2,A00,184449,Weinberg; Sadie,27,0,30,3
1681912701477,TDMV 2,B00,184453,Arcidiacono; Kristin,29,0,30,1
1681912702505,TDMV 110,A00,184571,Weinberg; Sadie,30,0,30,0
1681912703530,TDMV 142,A00,184572,Caligagan; Tony,27,0,30,3
1681912703530,TDMV 142,B00,184573,Caligagan; Maria T.,27,0,30,3
1681912704557,TDTR 20,A00,184482,Jun; Grace Shin Hae,25,0,25,0
1681912705586,USP 2,A01,184290,Hinds; Juli Beth,24,0,25,1
1681912706612,USP 3,A01,184295,Staff,20,0,25,5
1681912707643,USP 4,A00,184304,McTague; Sarah,15,0,25,10
1681912708666,USP 100,A00,184315,Staff,17,0,25,8
1681912709689,USP 105,A00,184326,Staff,21,0,25,4
1681912710713,USP 151,A00,184327,Staff,20,0,25,5
1681912711737,USP 170,A00,184380,Hinds; Juli Beth,14,0,25,11
1681912712772,VIS 21B,A01,182660,Staff,28,0,31,3
1681912712772,VIS 21B,A02,182662,Staff,30,0,31,1
1681912713797,VIS 103D,A00,182663,Staff,74,0,75,1
1681912714826,VIS 105D,A00,182667,Li; Huai,15,0,22,7
1681912715849,VIS 122GS,A00,182668,Herbst; Matthew,20,0,20,0
1681912716873,VIS 128C,A00,182673,Staff,69,0,75,6
1681912717900,VIS 130,A00,182675,Staff,20,0,22,2
1681912718922,VIS 160A,A00,182678,Stalbaum; Brett,4,0,10,6
1681912720985,WCWP 10B,A00,201679,Staff,15,0,15,0
1681912720985,WCWP 10B,B00,201695,Staff,15,0,15,0
1681912722008,WCWP 100,A00,201716,Staff,15,0,15,0
1681912722008,WCWP 100,B00,201717,Staff,11,0,15,4
1681912724129,ANSC 105GS,A00,258289,Staff,0,0,0,0
1681912725158,ANSC 125GS,A00,258295,Staff,0,0,0,0
1681912726184,ANSC 150,A00,258267,Staff,30,0,40,10
1681912727208,ANSC 190GS,A00,258280,Staff,0,0,0,0
1681912728230,ANTH 1,A00,258264,Staff,38,0,40,2
1681912729257,ANTH 2,A01,258259,Staff,72,0,76,4
1681912730279,ANTH 23,A01,258228,Staff,36,0,40,4
1681912731303,ANTH 101,A01,258236,Staff,39,0,40,1
1681912732328,ANTH 102,A00,258272,Staff,59,0,60,1
1681912733429,ANTH 105,A00,258244,Staff,31,0,35,4
1681912734453,BENG 130,A00,253975,Staff,38,0,40,2
1681912735485,BIBC 102,A01,191866,Flagg; Matthew Paul,19,0,32,13
1681912735485,BIBC 102,A02,191867,Flagg; Matthew Paul,22,0,32,10
1681912735485,BIBC 102,A03,191868,Flagg; Matthew Paul,30,0,32,2
1681912735485,BIBC 102,A04,191936,Flagg; Matthew Paul,26,0,32,6
1681912735485,BIBC 102,A05,191937,Flagg; Matthew Paul,11,0,32,21
1681912736520,BICD 100,A01,191939,Cooper; Andrew Michael,28,0,32,4
1681912736520,BICD 100,A02,191940,Cooper; Andrew Michael,32,0,32,0
1681912736520,BICD 100,A03,191941,Cooper; Andrew Michael,32,0,32,0
1681912736520,BICD 100,A04,191942,Cooper; Andrew Michael,32,0,32,0
1681912736520,BICD 100,A05,191943,Cooper; Andrew Michael,32,0,32,0
1681912737547,BIEB 126,A01,191945,Cleland; Elsa Eleanor,1,0,32,31
1681912737547,BIEB 126,A02,191946,Cleland; Elsa Eleanor,28,0,32,4
1681912737547,BIEB 126,A03,191947,Cleland; Elsa Eleanor,29,0,32,3
1681912737547,BIEB 126,A04,191948,Cleland; Elsa Eleanor,23,0,32,9
1681912737547,BIEB 126,A05,191996,Cleland; Elsa Eleanor,28,0,32,4
1681912738574,BIEB 136GS,A00,191997,Shurin; Jonathan & Holway; David A.,0,0,0,0
1681912739600,BIEB 137GS,A01,191999,Shurin; Jonathan & Holway; David A.,0,0,0,0
1681912740629,BILD 1,A01,205385,Staff,31,0,32,1
1681912740629,BILD 1,A02,205386,Staff,30,0,32,2
1681912740629,BILD 1,A03,205387,Staff,32,0,32,0
1681912740629,BILD 1,A04,205388,Staff,28,0,32,4
1681912741654,BILD 2,A01,191774,Staff,28,0,32,4
1681912741654,BILD 2,A02,191775,Staff,30,0,32,2
1681912741654,BILD 2,A03,191777,Staff,30,0,32,2
1681912741654,BILD 2,A04,191856,Staff,31,0,32,1
1681912741654,BILD 2,A05,191857,Staff,32,0,32,0
1681912741654,BILD 2,A06,191858,Staff,32,0,32,0
1681912741654,BILD 2,A07,191859,Staff,31,0,32,1
1681912742685,BILD 3,A01,205391,Staff,29,0,32,3
1681912742685,BILD 3,A02,205393,Staff,32,0,32,0
1681912742685,BILD 3,A03,205394,Staff,28,0,32,4
1681912742685,BILD 3,A04,205395,Staff,32,0,32,0
1681912743711,BILD 20,A01,191861,Staff,32,0,32,0
1681912743711,BILD 20,A02,191862,Staff,32,0,32,0
1681912744734,BILD 30,A01,191864,Staff,31,0,32,1
1681912745759,BIMM 100,A01,192019,Staff,0,0,32,32
1681912745759,BIMM 100,A02,192020,Staff,23,0,32,9
1681912745759,BIMM 100,A03,192035,Staff,22,0,32,10
1681912746784,BIMM 110,A01,192037,Tat; John,0,0,32,32
1681912746784,BIMM 110,A02,192038,Tat; John,10,0,32,22
1681912747816,BIMM 120,A01,192040,Pickett; Brooke Elizabeth,2,0,32,30
1681912747816,BIMM 120,A02,192041,Pickett; Brooke Elizabeth,16,0,32,16
1681912747816,BIMM 120,A03,192042,Pickett; Brooke Elizabeth,16,0,32,16
1681912748845,BIPN 100,A01,192044,Armour; Jon Christopher,26,0,32,6
1681912748845,BIPN 100,A02,192059,Armour; Jon Christopher,30,0,32,2
1681912748845,BIPN 100,A03,192064,Armour; Jon Christopher,31,0,32,1
1681912748845,BIPN 100,A04,192073,Armour; Jon Christopher,28,0,32,4
1681912749869,BIPN 148,A01,205411,Leutgeb; Jill K.,16,0,32,16
1681912749869,BIPN 148,A02,205412,Leutgeb; Jill K.,31,0,32,1
1681912749869,BIPN 148,A03,205413,Leutgeb; Jill K.,30,0,32,2
1681912749869,BIPN 148,A04,205414,Leutgeb; Jill K.,30,0,32,2
1681912750898,BIPN 160,A01,192115,Marino; Marc J,19,0,32,13
1681912750898,BIPN 160,A02,192148,Marino; Marc J,27,0,32,5
1681912750898,BIPN 160,A03,192158,Marino; Marc J,31,0,32,1
1681912750898,BIPN 160,A04,192190,Marino; Marc J,32,0,32,0
1681912750898,BIPN 160,A05,192287,Marino; Marc J,32,0,32,0
1681912750898,BIPN 160,A06,192288,Marino; Marc J,32,0,32,0
1681912751925,BIPN 194,A00,206038,Staff,28,0,32,4
1681912752949,BISP 194,A00,192289,Leutgeb; Stefan,13,0,32,19
1681912752949,BISP 194,B00,245332,Nieh; James Charles,27,0,32,5
1681912753970,CAT 124,A01,202247,Staff,15,0,15,0
1681912754993,CAT 125,A00,202248,Staff,19,0,20,1
1681912754993,CAT 125,B00,202253,Staff,20,0,20,0
1681912754993,CAT 125,C00,202257,Staff,19,0,20,1
1681912756018,CAT 125GS,A01,202273,Bronstein; Phoebe Malan,20,0,20,0
1681912757043,CAT 125R,A00,202284,Staff,17,0,20,3
1681912757043,CAT 125R,C00,202286,Staff,10,0,20,10
1681912757043,CAT 125R,D00,202291,Staff,18,0,20,2
1681912757043,CAT 125R,E00,202295,Staff,13,0,20,7
1681912757043,CAT 125R,F00,202302,Staff,12,0,20,8
1681912758073,CENG 100,A00,204724,Opatkiewicz; Justin Paul,25,0,25,0
1681912759097,CGS 2A,A01,180420,Staff,31,0,36,5
1681912760122,CGS 101,A00,180421,Staff,16,0,20,4
1681912761146,CGS 112,A00,180422,Staff,10,0,16,6
1681912762172,CGS 113,A00,180423,Staff,18,0,20,2
1681912763197,CGS 137,A00,180424,Staff,12,0,12,0
1681912764237,CGS 147,A00,180425,Staff,10,0,10,0
1681912765260,CHEM 6A,A01,179556,Staff,97,0,100,3
1681912765260,CHEM 6A,A02,179558,Staff,0,0,0,0
1681912766285,CHEM 6B,A01,179560,Staff,100,0,100,0
1681912767308,CHEM 6C,A01,179565,Jazzar; Rodolphe,95,0,100,5
1681912768333,CHEM 7L,A01,179586,Schurmeier; Kimberly,13,0,24,11
1681912768333,CHEM 7L,A02,179587,Schurmeier; Kimberly,23,0,24,1
1681912768333,CHEM 7L,A03,179590,Schurmeier; Kimberly,22,0,24,2
1681912768333,CHEM 7L,A04,179591,Schurmeier; Kimberly,22,0,24,2
1681912768333,CHEM 7L,B01,179598,Schurmeier; Kimberly,17,0,24,7
1681912768333,CHEM 7L,B02,179599,Schurmeier; Kimberly,24,0,24,0
1681912768333,CHEM 7L,B03,179606,Schurmeier; Kimberly,23,0,24,1
1681912768333,CHEM 7L,B04,179607,Schurmeier; Kimberly,23,0,24,1
1681912769365,CHEM 11,A01,179609,Stallings; Dontarie M,88,0,100,12
1681912770391,CHEM 40A,A01,179621,Staff,41,0,50,9
1681912770391,CHEM 40A,A02,179622,Staff,47,0,50,3
1681912771418,CHEM 40B,A01,179630,Weizman; Haim,48,0,50,2
1681912771418,CHEM 40B,A02,179631,Weizman; Haim,45,0,50,5
1681912772442,CHEM 41A,A01,179660,Klosterman; Jeremy K,93,0,100,7
1681912773465,CHEM 43A,A01,179683,Klosterman; Jeremy K,0,0,24,24
1681912773465,CHEM 43A,A02,179688,Klosterman; Jeremy K,14,0,24,10
1681912773465,CHEM 43A,A03,179689,Klosterman; Jeremy K,20,0,24,4
1681912773465,CHEM 43A,A04,179691,Klosterman; Jeremy K,18,0,24,6
1681912774492,CHEM 114A,A01,179693,Stallings; Dontarie M,77,0,100,23
1681912775521,CHEM 143B,A01,179698,Weizman; Haim,17,0,24,7
1681912775521,CHEM 143B,A02,179700,Weizman; Haim,24,0,24,0
1681912776551,CHIN 169A,A00,179701,Wang; Xiao,20,0,20,0
1681912777574,COGS 2,A01,179750,Boyle; Mary E. T.,17,0,30,13
1681912778597,COGS 9,A01,179759,Jones; Cameron Robert,43,0,50,7
1681912779620,COGS 14A,A01,179854,Staff,18,0,50,32
1681912780643,COGS 14B,A01,179856,Staff,54,0,60,6
1681912781669,COGS 17,A01,179874,Staff,71,0,75,4
1681912782703,COGS 18,A01,179884,Staff,63,0,80,17
1681912783728,COGS 100,A01,179886,Staff,40,0,60,20
1681912784751,COGS 101B,A01,179892,Staff,1,0,30,29
1681912785778,COGS 101C,A01,179894,Staff,28,0,30,2
1681912786800,COGS 107A,A01,179896,Boyle; Mary E. T.,31,0,40,9
1681912787823,COGS 108,A01,179898,Simpkins; Charles Alexander,0,17,60,60
1681912788850,COGS 109,A01,179900,Staff,34,0,40,6
1681912789873,COGS 118A,A01,179946,Staff,9,0,40,31
1681912790897,COGS 153,A00,179978,Staff,1,0,30,29
1681912791925,COGS 156,A01,179981,Staff,27,0,30,3
1681912793978,COGS 172,A01,179987,Staff,13,0,30,17
1681912796026,COGS 186,A01,179991,Staff,13,0,30,17
1681912797060,COMM 10,A01,180001,Staff,15,0,25,10
1681912797060,COMM 10,A02,180004,Staff,20,0,25,5
1681912798087,COMM 100A,A01,180016,Staff,18,0,25,7
1681912798087,COMM 100A,A02,180020,Staff,24,0,25,1
1681912799111,COMM 101T,A00,180029,Halm; Gavin Patrick,23,0,35,12
1681912800134,COMM 106V,A00,180043,Staff,34,0,35,1
1681912801162,COMM 109P,A00,180044,Staff,31,0,35,4
1681912802185,COMM 113T,A00,180045,Havis; Allan,37,0,45,8
1681912803209,COMM 132,A00,180046,McKenna; Denise,23,0,30,7
1681912804231,COMM 143,A00,180047,Staff,19,0,30,11
1681912805256,COMM 190,A00,180048,Conner; Thomas Hartnell,20,0,23,3
1681912806283,CSE 8A,A50,180053,Cao; Yingjun,25,0,50,25
1681912806283,CSE 8A,B50,180180,Staff,50,0,50,0
1681912807313,CSE 11,A01,180190,Cao; Yingjun,31,0,50,19
1681912808339,CSE 20,A01,180192,Briones; Jor-el Thomas Caparas,23,0,30,7
1681912809366,CSE 21,A01,194538,Briones; Jor-el Thomas Caparas,50,0,60,10
1681912810389,CSE 30,A01,180324,Eldon; John,79,0,100,21
1681912811415,CSE 101,A01,201353,Staff,0,20,40,40
1681912812443,CSE 134B,A01,180326,Powell; Thomas Allan,74,0,100,26
1681912813471,CSE 140,A01,180328,Staff,46,0,75,29
1681912814494,CSE 140L,A01,180344,Eldon; John,69,0,100,31
1681912815516,CSE 150A,A01,180411,Staff,0,7,50,50
1681912816543,CSE 151A,A01,180414,Staff,0,6,50,50
1681912817572,CSE 175,A01,222521,Kumar; Rakesh,50,0,50,0
1681912818601,CSE 190,A00,201419,Staff,45,0,49,4
1681912819624,CSS 1,A01,194536,Staff,38,0,50,12
1681912820647,DSC 30,A01,202385,Staff,48,0,50,2
1681912821674,DSC 40A,A01,202387,Albuyeh; Rod,50,0,50,0
1681912822701,DSC 190,A01,202389,Silberman; Jack,21,0,21,0
1681912823724,DSGN 100,A01,179993,Staff,16,0,30,14
1681912824755,ECE 65,A50,180708,Staff,10,0,20,10
1681912824755,ECE 65,A51,180739,Staff,19,0,20,1
1681912825781,ECON 1,A01,180427,Famulari; Melissa,67,0,70,3
1681912826807,ECON 2,A01,180450,Levkoff; Steven B.,64,0,70,6
1681912827830,ECON 4,A01,203351,Anderson; John Charles,7,0,10,3
1681912828858,ECON 100A,A01,180472,Famulari; Melissa,65,0,70,5
1681912829886,ECON 120A,A01,180549,Staff,64,0,70,6
1681912830910,ECON 120B,A01,180655,Ma; Xinwei,46,0,70,24
1681912831937,ECON 129,A00,203333,Eckert; Fabian Paul,15,0,35,20
1681912832959,ECON 131,A00,180656,Staff,9,0,35,26
1681912833983,ECON 172B,A01,180672,Levkoff; Steven B.,32,0,35,3
1681912835007,ECON 178,A01,203342,Zhu; Ying,11,0,35,24
1681912836034,EDS 108GS,A00,202383,Wishard Guerra; Alison G.,20,0,20,0
1681912837142,EDS 111GS,A00,202347,Wishard Guerra; Alison G.,20,0,20,0
1681912838170,EDS 112,A01,202323,Staff,56,0,60,4
1681912839197,EDS 113,A00,202340,Staff,33,0,35,2
1681912840223,EDS 118,A00,201231,Staff,20,0,30,10
1681912841246,EDS 119,A00,204994,Staff,8,0,10,2
1681912842271,EDS 124BR,A00,202324,Eguchi; Emi,5,0,25,20
1681912843297,EDS 126,A01,203208,Jones; Makeba,26,0,30,4
1681912844322,EDS 135,A01,202333,Staff,18,0,20,2
1681912845345,EDS 180,A00,202311,Staff,47,0,50,3
1681912846368,ERC 190GS,A01,253747,Staff,28,0,28,0
1681912847394,ETHN 104,A00,180742,Staff,24,0,35,11
1681912848417,ETHN 118,A00,180745,Staff,28,0,35,7
1681912849443,ETHN 127,A00,180747,Staff,12,0,16,4
1681912850466,ETHN 137,A00,180880,Staff,12,0,12,0
1681912851489,ETHN 147,A00,180890,Staff,8,0,10,2
1681912852511,ETHN 154,A00,180891,Staff,7,0,8,1
1681912853538,ETHN 168,A00,180892,Staff,9,0,10,1
1681912854562,GLBH 20,A00,201051,Hannah; Seth Donal,0,1,0,1
1681912855589,GLBH 111,A01,209338,Burgos; Jose L.,0,0,0,0
1681912856614,GLBH 150,A00,258300,Staff,0,3,0,0
1681912857636,GLBH 181,A00,201207,Staff,15,0,40,25
1681912858662,HIEU 109,A00,180898,Staff,20,0,20,0
1681912859685,HIEU 111,A00,180899,Staff,1,0,20,19
1681912860710,HIEU 124,A00,180900,Staff,18,0,20,2
1681912861733,HILA 122,A00,180901,Staff,18,0,20,2
1681912862761,HILA 132,A00,180902,Vitz; Matthew,2,0,20,18
1681912863789,HILD 10,A01,180896,Staff,15,0,20,5
1681912864811,HILD 30GS,A00,180897,Edington; Claire Ellen,0,0,0,0
1681912865835,HISC 105,A00,180903,Staff,20,0,20,0
1681912866858,HISC 117,A00,180904,Staff,11,0,20,9
1681912867881,HIUS 108B,A00,181005,Staff,18,0,20,2
1681912868908,HIUS 113,A00,181093,Staff,4,0,20,16
1681912869931,HUM 3,A01,181190,Patterson; Patrick H.,40,0,50,10
1681912869931,HUM 3,B01,181195,Staff,47,0,50,3
1681912870960,HUM 3GS,A00,181196,Herbst; Matthew,0,0,0,0
1681912871984,HUM 4,A01,181227,West; Geoffrey Scott,34,0,50,16
1681912871984,HUM 4,B01,181282,Staff,43,0,50,7
1681912873007,HUM 4GS,A00,181377,Lyon; Antony J.,0,0,0,0
1681912874030,HUM 5,A01,181536,Zavodny; Tatiana Sophia,31,0,50,19
1681912874030,HUM 5,B01,181908,Staff,36,0,50,14
1681912875052,INTL 190,A00,181909,Segui; Alan S,0,0,0,6
1681912875052,INTL 190,B00,181961,Segui; Alan S,0,0,0,7
1681912876075,JAPN 20AR,A01,182113,Ross; Kayoko F,15,0,20,5
1681912877099,LATI 50,A01,202391,Martin-Cabrera; Luis,19,0,30,11
1681912877099,LATI 50,A02,202392,Martin-Cabrera; Luis,26,0,30,4
1681912878128,LATI 180,A00,202393,Kokinis; Troy Andreas,25,0,25,0
1681912879151,LIFR 1A,A00,182119,Staff,14,0,14,0
1681912880174,LIFR 1AX,A00,182324,Staff,14,0,14,0
1681912881197,LIFR 1B,A00,182259,Staff,14,0,14,0
1681912882226,LIFR 1BX,A00,182273,Staff,14,0,14,0
1681912883262,LIGN 8,A00,182330,Staff,137,0,150,13
1681912884285,LIGN 9GS,A00,182362,Staff,20,0,20,0
1681912885315,LIGN 119,A00,204992,Takahashi; Maho,12,0,15,3
1681912886337,LIGN 130,A01,182384,Staff,47,0,50,3
1681912887364,LIGN 149GS,A00,182390,Staff,20,0,20,0
1681912888457,LIGN 170,A00,182404,Staff,24,0,30,6
1681912889480,LISP 1D,A00,182281,Staff,7,0,14,7
1681912889480,LISP 1D,B00,182287,Staff,14,0,14,0
1681912889480,LISP 1D,C00,182295,Staff,11,0,14,3
1681912889480,LISP 1D,D00,182301,Staff,14,0,14,0
1681912890506,LISP 1DX,A00,182309,Staff,20,0,28,8
1681912890506,LISP 1DX,B00,182316,Staff,26,0,28,2
1681912891534,LTAF 120GS,A00,182412,Zhiri; Oumelbanine,20,0,20,0
1681912892558,LTCS 172GS,A00,182437,Bronstein; Phoebe Malan,20,0,20,0
1681912893581,LTEA 138,A00,182457,Staff,22,0,40,18
1681912894604,LTEN 114,A01,182490,Staff,23,0,25,2
1681912895630,LTEN 130GS,A00,182491,Lyon; Antony J.,20,0,20,0
1681912896657,LTEN 169,A00,182493,Cuong; Marisol,20,0,25,5
1681912897683,LTEN 178,A00,182501,Staff,14,0,15,1
1681912898706,LTEN 181,A00,182515,Staff,22,0,25,3
1681912899732,LTEN 185GS,A00,197655,Forbes; Camille,20,0,20,0
1681912900754,LTSP 100B,A00,202208,Bessett; Ryan Matthew,24,0,25,1
1681912901778,LTWL 100,A00,182516,Myerston Santana; Jacobo,22,0,30,8
1681912902801,LTWR 100GS,A00,182518,Forbes; Camille,20,0,20,0
1681912903831,LTWR 102,A00,182522,Staff,15,0,15,0
1681912903831,LTWR 102,B00,182525,Staff,14,0,15,1
1681912904858,LTWR 115,A00,182526,Staff,12,0,15,3
1681912905882,MAE 8,A01,182528,Pham; Hieu Tan,68,0,70,2
1681912906909,MAE 11,A00,182529,Bahadori; Mohammad Yousef,94,0,100,6
1681912907931,MAE 20,A00,182530,Evdokimenko; Ekaterina,68,0,70,2
1681912908954,MAE 30A,A00,182532,Staff,44,0,45,1
1681912909987,MAE 101A,A00,182533,Bahadori; Mohammad Yousef,97,0,100,3
1681912911011,MAE 101C,A00,182538,Staff,62,0,70,8
1681912912037,MAE 104,A00,182539,Staff,45,0,50,5
1681912913067,MAE 131A,A00,182540,Ghazinejad; Maziar,41,0,45,4
1681912914097,MAE 143A,A00,182548,Bewley; Thomas R,43,0,50,7
1681912915124,MAE 150,A00,182549,Staff,28,0,40,12
1681912916147,MAE 160,A00,182550,Evdokimenko; Ekaterina,43,0,60,17
1681912917189,MATH 3C,A01,182725,Staff,27,0,30,3
1681912918218,MATH 10A,A01,182729,Staff,25,0,30,5
1681912918218,MATH 10A,B01,182732,Staff,26,0,30,4
1681912919242,MATH 10B,A01,182737,Staff,21,0,30,9
1681912919242,MATH 10B,A02,182738,Staff,27,0,30,3
1681912919242,MATH 10B,B01,182744,Staff,27,0,30,3
1681912919242,MATH 10B,B02,182745,Staff,27,0,30,3
1681912920274,MATH 18,A01,182750,Anzaldo; Leesa B,28,0,30,2
1681912920274,MATH 18,A02,182751,Anzaldo; Leesa B,29,0,30,1
1681912920274,MATH 18,A03,182753,Anzaldo; Leesa B,28,0,30,2
1681912920274,MATH 18,A04,182757,Anzaldo; Leesa B,29,0,30,1
1681912920274,MATH 18,B01,182761,Anzaldo; Leesa B,27,0,30,3
1681912920274,MATH 18,B02,182764,Anzaldo; Leesa B,27,0,30,3
1681912920274,MATH 18,B03,182765,Anzaldo; Leesa B,30,0,30,0
1681912920274,MATH 18,B04,182766,Anzaldo; Leesa B,30,0,30,0
1681912921307,MATH 20A,A01,182771,Suk; Andrew Hoon,28,0,30,2
1681912922338,MATH 20B,A01,182775,Bach; Quang Tran,30,0,30,0
1681912922338,MATH 20B,A02,182777,Bach; Quang Tran,29,0,30,1
1681912922338,MATH 20B,B01,182780,Bach; Quang Tran,27,0,30,3
1681912922338,MATH 20B,B02,182782,Bach; Quang Tran,30,0,30,0
1681912923369,MATH 20C,A01,182787,Staff,25,0,30,5
1681912923369,MATH 20C,A02,182790,Staff,29,0,30,1
1681912923369,MATH 20C,B01,182792,Staff,25,0,30,5
1681912923369,MATH 20C,B02,182796,Staff,27,0,30,3
1681912924393,MATH 20D,A01,182799,Staff,29,0,30,1
1681912924393,MATH 20D,A02,182802,Staff,30,0,30,0
1681912924393,MATH 20D,A03,182803,Staff,30,0,30,0
1681912925418,MATH 20E,A01,182809,Verstraete; Jacques Allan,24,0,30,6
1681912925418,MATH 20E,A02,182811,Verstraete; Jacques Allan,28,0,30,2
1681912925418,MATH 20E,B01,182814,Verstraete; Jacques Allan,23,0,30,7
1681912925418,MATH 20E,B02,182815,Verstraete; Jacques Allan,30,0,30,0
1681912926449,MATH 103A,A01,182820,Staff,9,0,30,21
1681912926449,MATH 103A,A02,182821,Staff,27,0,30,3
1681912926449,MATH 103A,A03,182822,Staff,23,0,30,7
1681912926449,MATH 103A,B01,182825,Staff,23,0,30,7
1681912926449,MATH 103A,B02,182826,Staff,30,0,30,0
1681912926449,MATH 103A,B03,182830,Staff,30,0,30,0
1681912927483,MATH 109,A01,182836,Chow; Bennett,24,0,30,6
1681912927483,MATH 109,A02,182838,Chow; Bennett,29,0,30,1
1681912927483,MATH 109,A03,182894,Chow; Bennett,29,0,30,1
1681912927483,MATH 109,B01,182908,Chow; Bennett,28,0,30,2
1681912927483,MATH 109,B02,182909,Chow; Bennett,30,0,30,0
1681912927483,MATH 109,B03,182910,Chow; Bennett,27,0,30,3
1681912928527,MATH 142A,A01,182925,Staff,11,0,30,19
1681912928527,MATH 142A,A02,182935,Staff,25,0,30,5
1681912928527,MATH 142A,A03,182967,Staff,26,0,30,4
1681912928527,MATH 142A,B01,183125,Staff,24,0,30,6
1681912928527,MATH 142A,B02,183157,Staff,28,0,30,2
1681912928527,MATH 142A,B03,183158,Staff,29,0,30,1
1681912929557,MATH 183,A01,183160,Arias-Castro; Ery,23,0,30,7
1681912929557,MATH 183,A02,183161,Arias-Castro; Ery,29,0,30,1
1681912929557,MATH 183,B01,183163,Arias-Castro; Ery,28,0,30,2
1681912929557,MATH 183,B02,183164,Arias-Castro; Ery,28,0,30,2
1681912930590,MATH 193A,A01,183167,Staff,4,0,35,31
1681912930590,MATH 193A,A02,183168,Staff,28,0,35,7
1681912930590,MATH 193A,A03,183169,Staff,34,0,35,1
1681912930590,MATH 193A,A04,183170,Staff,28,0,35,7
1681912931627,MGT 4,A01,202395,Anderson; John Charles,75,0,80,5
1681912932650,MGT 5,A00,202396,Houskeeper; Robert,80,0,90,10
1681912933677,MGT 103,A00,202397,Eberhard; Craig A,55,0,90,35
1681912934704,MGT 131A,A00,202398,Houskeeper; Robert,85,0,90,5
1681912935736,MGT 135,A00,202399,Anderson; John Charles,82,0,90,8
1681912936762,MGT 162R,A00,202403,Gneezy; Uri,150,0,200,50
1681912937785,MGT 172,A00,202404,Hedges; Kathleen,50,0,90,40
1681912938811,MGT 181,A00,202405,Dunn; Louis Jean,84,0,90,6
1681912939835,MMW 14,A01,183200,Staff,16,0,28,12
1681912939835,MMW 14,A02,183201,Staff,26,0,28,2
1681912939835,MMW 14,A03,183202,Staff,24,0,28,4
1681912939835,MMW 14,A04,183203,Staff,25,0,28,3
1681912939835,MMW 14,A05,183204,Staff,26,0,28,2
1681912939835,MMW 14,A06,183205,Staff,27,0,28,1
1681912939835,MMW 14,B01,183207,Staff,26,0,28,2
1681912939835,MMW 14,B02,183208,Staff,28,0,28,0
1681912939835,MMW 14,B03,183209,Staff,28,0,28,0
1681912939835,MMW 14,B04,183210,Staff,28,0,28,0
1681912939835,MMW 14,B05,183211,Staff,28,0,28,0
1681912939835,MMW 14,B06,183212,Staff,28,0,28,0
1681912940932,MMW 14GS,A00,183213,Zhiri; Oumelbanine,28,0,28,0
1681912941954,MMW 15GS,B00,183215,Rahimi; Babak,28,0,28,0
1681912942978,MMW 121,A01,183217,Patterson; Patrick H.,14,0,28,14
1681912942978,MMW 121,A02,183218,Patterson; Patrick H.,25,0,28,3
1681912944002,MUS 1A,A01,182554,Staff,8,0,35,27
1681912945028,MUS 5,A01,182558,Staff,20,0,35,15
1681912946059,MUS 6,A01,182562,Staff,25,0,35,10
1681912947084,MUS 8GS,A00,182563,Borgo; David Garcia,25,0,25,0
1681912948107,MUS 13,A01,182567,Staff,24,0,25,1
1681912949136,MUS 15,A01,182570,Staff,32,0,35,3
1681912949136,MUS 15,B01,182575,Staff,10,0,35,25
1681912950161,MUS 80,A00,182578,Staff,23,0,25,2
1681912950161,MUS 80,B00,182581,Staff,20,0,25,5
1681912951189,MUS 113,A00,182582,Staff,25,0,25,0
1681912952811,MUS 114,A00,182583,Staff,4,0,25,21
1681912953835,MUS 150GS,A01,182588,Borgo; David Garcia,25,0,25,0
1681912954863,PHIL 1,A00,182590,Staff,35,0,40,5
1681912955886,PHIL 10,A01,182596,Grush; Rick Scott,31,0,35,4
1681912955886,PHIL 10,A02,182597,Grush; Rick Scott,34,0,35,1
1681912956922,PHIL 15,A01,182601,Staff,31,0,35,4
1681912956922,PHIL 15,A02,182602,Staff,33,0,35,2
1681912957973,PHIL 27,A01,182604,Staff,30,0,35,5
1681912957973,PHIL 27,A02,182607,Staff,35,0,35,0
1681912959002,PHIL 32,A01,182609,Staff,35,0,35,0
1681912959002,PHIL 32,A02,182612,Staff,35,0,35,0
1681912960031,PHIL 130,A00,182614,Staff,63,0,70,7
1681912961062,PHIL 136,A00,182616,Cohen; Jonathan David,66,0,70,4
1681912962090,PHIL 155,A00,182617,Vargas; Manuel Rogelio,60,0,70,10
1681912963118,PHIL 163,A01,182620,Staff,15,0,20,5
1681912963118,PHIL 163,A02,182624,Staff,10,0,20,10
1681912964140,PHIL 164,A00,182627,Staff,30,0,40,10
1681912965162,PHIL 173,A00,182628,Staff,36,0,40,4
1681912966190,PHYS 1A,A00,183221,Staff,54,0,60,6
1681912967221,PHYS 1AL,001,183222,Staff,25,0,30,5
1681912967221,PHYS 1AL,002,183223,Staff,28,0,30,2
1681912968245,PHYS 1B,A00,183231,Staff,44,0,60,16
1681912969271,PHYS 1BL,001,183232,Staff,20,0,30,10
1681912969271,PHYS 1BL,002,183233,Staff,29,0,30,1
1681912970306,PHYS 1C,A00,183240,Staff,30,0,60,30
1681912971337,PHYS 1CL,001,183241,Staff,13,0,30,17
1681912971337,PHYS 1CL,002,183242,Staff,22,0,30,8
1681912972361,PHYS 2AR,A01,183250,Staff,44,0,50,6
1681912973385,PHYS 2B,A01,183252,Staff,106,0,115,9
1681912974413,PHYS 2BL,A01,183254,Staff,21,0,24,3
1681912974413,PHYS 2BL,A02,183255,Staff,22,0,24,2
1681912975437,PHYS 2C,A01,183522,Staff,105,0,115,10
1681912976462,PHYS 4A,A01,183524,Staff,49,0,50,1
1681912977486,POLI 5,A00,183525,Staff,44,0,50,6
1681912978510,POLI 12,A00,183540,Staff,48,0,50,2
1681912979532,POLI 13R,A00,183541,Forman; Fonna,42,0,50,8
1681912980557,POLI 30,A00,183542,Mignozzetti; Umberto,47,0,50,3
1681912981590,POLI 100A,A00,183543,Staff,45,0,50,5
1681912982620,POLI 100E,A00,223598,Staff,32,0,35,3
1681912983647,POLI 103A,A00,183564,Kousser; Thad,38,0,50,12
1681912984671,POLI 104B,A00,201329,Staff,29,0,35,6
1681912985697,POLI 113BR,A00,183576,Hoston; Germaine,27,0,50,23
1681912986727,POLI 114BR,A00,183588,Staff,27,0,30,3
1681912987754,POLI 117R,A00,183595,Forman; Fonna,9,0,20,11
1681912988780,POLI 120H,A00,183596,Fisk; David Lee,13,0,20,7
1681912989804,POLI 130AA,A00,183597,Staff,14,0,20,6
1681912990830,POLI 134AA,A00,183598,Staff,19,0,20,1
1681912991856,POLI 135,A00,183599,Fisk; David Lee,20,0,25,5
1681912992884,POLI 142P,A00,183623,Staff,37,0,40,3
1681912993908,POLI 144D,A00,183624,Staff,22,0,25,3
1681912994930,POLI 151,A00,183625,Staff,15,0,20,5
1681912995959,POLI 162,A00,183626,Mignozzetti; Umberto,18,0,20,2
1681912996990,PSYC 1,A00,253748,Staff,86,0,90,4
1681912998014,PSYC 2,A00,183627,Moranton; Nirelia Melbina-,25,0,35,10
1681912999038,PSYC 3,A00,183628,Staff,43,0,45,2
1681913001095,PSYC 60,A01,183631,Lowe; Angela Beth,35,0,40,5
1681913002120,PSYC 70,A01,253757,Staff,37,0,45,8
1681913003154,PSYC 101,A00,183632,Heyman; Gail D.,48,0,60,12
1681913004178,PSYC 105,A00,183848,Lowe; Angela Beth,50,0,60,10
1681913005202,PSYC 106,A00,183849,Dobkins; Karen R.,45,0,60,15
1681913006225,PSYC 108,A00,253750,Staff,24,0,60,36
1681913007258,PSYC 114,A01,184275,Winkielman; Piotr,0,6,30,30
1681913008282,PSYC 122,A00,183856,Moranton; Nirelia Melbina-,0,10,30,30
1681913009316,PSYC 124,A00,183865,Chapman; Eddie Nathaniel,52,0,80,28
1681913010341,PSYC 137,A00,183880,Staff,19,0,25,6
1681913012392,PSYC 154,A00,183910,Lacefield; Katharine I,0,2,90,90
1681913014445,PSYC 162,A00,183946,Wixted; John T,61,0,90,29
1681913015472,PSYC 172,A00,183947,Gorman; Michael R.,14,0,30,16
1681913016501,PSYC 178,A00,183963,Glaser; Dale,20,0,40,20
1681913017525,PSYC 181GS,A00,183964,Anagnostaras; Stephan,10,0,10,0
1681913018554,PSYC 186GS,A01,257660,Staff,10,0,10,0
1681913019587,PSYC 193,B00,253749,Staff,23,0,25,2
1681913021637,PSYC 193L,A01,184122,Staff,33,0,35,2
1681913021637,PSYC 193L,C01,184167,Winkielman; Piotr,16,0,30,14
1681913022659,RELI 188GS,A00,182629,Rahimi; Babak,20,0,20,0
1681913023681,SE 101A,A00,182646,Staff,26,0,30,4
1681913024715,SE 101C,A00,182650,Staff,18,0,20,2
1681913025738,SE 110A,A00,182651,Staff,28,0,28,0
1681913026767,SE 130A,A00,182652,Staff,39,0,40,1
1681913027791,SIO 46GS,A00,182636,Cook; Geoffrey W,28,0,28,0
1681913028813,SIO 109R,A00,194459,Staff,5,0,20,15
1681913029838,SIO 121GS,A00,182639,Cook; Geoffrey W,28,0,28,0
1681913030868,SIO 132,A01,182642,Staff,32,0,40,8
1681913031892,SIO 139,A00,182644,Kacev; David,36,0,40,4
1681913032916,SOCI 2,A01,258404,Staff,34,0,36,2
1681913032916,SOCI 2,A02,258405,Staff,35,0,36,1
1681913033941,SOCI 60,A01,258408,Staff,29,0,30,1
1681913033941,SOCI 60,A02,258413,Staff,30,0,30,0
1681913034964,SOCI 100,A01,258415,Staff,29,0,30,1
1681913034964,SOCI 100,A02,258416,Staff,28,0,30,2
1681913041143,SOCI 127,A00,258421,Staff,22,0,30,8
1681913042167,SOCI 132,A00,258422,Staff,45,0,50,5
1681913043192,SOCI 133,A00,258423,Staff,26,0,30,4
1681913044226,SOCI 138GS,A00,258424,Staff,15,0,15,0
1681913045350,SOCI 145,A00,258425,Staff,25,0,30,5
1681913046375,SOCI 148,A00,258426,Staff,26,0,30,4
1681913047406,SOCI 153,A00,199217,Staff,29,0,30,1
1681913048434,SOCI 160,A00,258427,Staff,28,0,30,2
1681913049460,SOCI 160E,A00,258435,Staff,56,0,60,4
1681913050483,SOCI 189GS,A00,258436,Staff,15,0,15,0
1681913051506,SOCI 190GS,A00,258437,Staff,15,0,15,0
1681913052530,SYN 2,001,182658,Staff,9,0,16,7
1681913052530,SYN 2,002,201439,Staff,15,0,16,1
1681913052530,SYN 2,003,201443,Staff,16,0,16,0
1681913053557,SYN 100,A01,182657,Staff,17,0,20,3
1681913054580,TDAC 1,A00,184381,Salovey; Todd,16,0,20,4
1681913054580,TDAC 1,B00,184385,Harting; Carla Kelso,19,0,20,1
1681913054580,TDAC 1,C00,184394,Staff,19,0,20,1
1681913055607,TDAC 101,A00,184483,Harting; Carla Kelso,19,0,20,1
1681913056631,TDDE 111,A00,184496,Staff,14,0,15,1
1681913057663,TDDE 131,A00,184504,Staff,20,0,20,0
1681913057663,TDDE 131,B00,184505,Staff,17,0,18,1
1681913057663,TDDE 131,C00,184534,Staff,49,0,50,1
1681913057663,TDDE 131,D00,184564,Staff,15,0,15,0
1681913057663,TDDE 131,E00,204725,Staff,19,0,20,1
1681913058687,TDGE 1,A01,184414,Salovey; Todd,37,0,50,13
1681913059719,TDGE 5,A01,184419,Staff,23,0,24,1
1681913060746,TDGE 10,A00,184428,Fulton; Julia,31,0,50,19
1681913061769,TDGE 124,A00,184565,Fulton; Julia,7,0,50,43
1681913062801,TDGE 125,B00,184567,Meyer; Ursula,9,0,25,16
1681913063832,TDHT 101,A00,184568,Staff,21,0,25,4
1681913063832,TDHT 101,B00,184569,Staff,20,0,20,0
1681913064855,TDHT 114,A00,184570,Staff,49,0,50,1
1681913065881,TDMV 1,A00,184437,Arcidiacono; Kristin,23,0,30,7
1681913065881,TDMV 1,B00,184448,Caligagan; Maria T.,22,0,30,8
1681913066914,TDMV 2,A00,184449,Weinberg; Sadie,27,0,30,3
1681913066914,TDMV 2,B00,184453,Arcidiacono; Kristin,29,0,30,1
1681913067940,TDMV 110,A00,184571,Weinberg; Sadie,30,0,30,0
1681913068968,TDMV 142,A00,184572,Caligagan; Tony,27,0,30,3
1681913068968,TDMV 142,B00,184573,Caligagan; Maria T.,27,0,30,3
1681913069998,TDTR 20,A00,184482,Jun; Grace Shin Hae,25,0,25,0
1681913071023,USP 2,A01,184290,Hinds; Juli Beth,24,0,25,1
1681913072048,USP 3,A01,184295,Staff,20,0,25,5
1681913073084,USP 4,A00,184304,McTague; Sarah,15,0,25,10
1681913074113,USP 100,A00,184315,Staff,17,0,25,8
1681913075136,USP 105,A00,184326,Staff,21,0,25,4
1681913076162,USP 151,A00,184327,Staff,20,0,25,5
1681913077189,USP 170,A00,184380,Hinds; Juli Beth,14,0,25,11
1681913078218,VIS 21B,A01,182660,Staff,28,0,31,3
1681913078218,VIS 21B,A02,182662,Staff,30,0,31,1
1681913079244,VIS 103D,A00,182663,Staff,74,0,75,1
1681913080275,VIS 105D,A00,182667,Li; Huai,15,0,22,7
1681913081298,VIS 122GS,A00,182668,Herbst; Matthew,20,0,20,0
1681913082322,VIS 128C,A00,182673,Staff,69,0,75,6
1681913083399,VIS 130,A00,182675,Staff,20,0,22,2
1681913084423,VIS 160A,A00,182678,Stalbaum; Brett,4,0,10,6
1681913086474,WCWP 10B,A00,201679,Staff,15,0,15,0
1681913086474,WCWP 10B,B00,201695,Staff,15,0,15,0
1681913087497,WCWP 100,A00,201716,Staff,15,0,15,0
1681913087497,WCWP 100,B00,201717,Staff,11,0,15,4
1681913089602,ANSC 105GS,A00,258289,Staff,0,0,0,0
1681913090626,ANSC 125GS,A00,258295,Staff,0,0,0,0
1681913091651,ANSC 150,A00,258267,Staff,30,0,40,10
1681913092674,ANSC 190GS,A00,258280,Staff,0,0,0,0
1681913093700,ANTH 1,A00,258264,Staff,38,0,40,2
1681913094723,ANTH 2,A01,258259,Staff,72,0,76,4
1681913095751,ANTH 23,A01,258228,Staff,36,0,40,4
1681913096780,ANTH 101,A01,258236,Staff,39,0,40,1
1681913097803,ANTH 102,A00,258272,Staff,59,0,60,1
1681913098829,ANTH 105,A00,258244,Staff,31,0,35,4
1681913099853,BENG 130,A00,253975,Staff,38,0,40,2
1681913100881,BIBC 102,A01,191866,Flagg; Matthew Paul,19,0,32,13
1681913100881,BIBC 102,A02,191867,Flagg; Matthew Paul,22,0,32,10
1681913100881,BIBC 102,A03,191868,Flagg; Matthew Paul,30,0,32,2
1681913100881,BIBC 102,A04,191936,Flagg; Matthew Paul,26,0,32,6
1681913100881,BIBC 102,A05,191937,Flagg; Matthew Paul,11,0,32,21
1681913101910,BICD 100,A01,191939,Cooper; Andrew Michael,28,0,32,4
1681913101910,BICD 100,A02,191940,Cooper; Andrew Michael,32,0,32,0
1681913101910,BICD 100,A03,191941,Cooper; Andrew Michael,32,0,32,0
1681913101910,BICD 100,A04,191942,Cooper; Andrew Michael,32,0,32,0
1681913101910,BICD 100,A05,191943,Cooper; Andrew Michael,32,0,32,0
1681913102935,BIEB 126,A01,191945,Cleland; Elsa Eleanor,1,0,32,31
1681913102935,BIEB 126,A02,191946,Cleland; Elsa Eleanor,28,0,32,4
1681913102935,BIEB 126,A03,191947,Cleland; Elsa Eleanor,29,0,32,3
1681913102935,BIEB 126,A04,191948,Cleland; Elsa Eleanor,23,0,32,9
1681913102935,BIEB 126,A05,191996,Cleland; Elsa Eleanor,28,0,32,4
1681913103962,BIEB 136GS,A00,191997,Shurin; Jonathan & Holway; David A.,0,0,0,0
1681913104989,BIEB 137GS,A01,191999,Shurin; Jonathan & Holway; David A.,0,0,0,0
1681913106014,BILD 1,A01,205385,Staff,31,0,32,1
1681913106014,BILD 1,A02,205386,Staff,30,0,32,2
1681913106014,BILD 1,A03,205387,Staff,32,0,32,0
1681913106014,BILD 1,A04,205388,Staff,28,0,32,4
1681913107037,BILD 2,A01,191774,Staff,28,0,32,4
1681913107037,BILD 2,A02,191775,Staff,30,0,32,2
1681913107037,BILD 2,A03,191777,Staff,30,0,32,2
1681913107037,BILD 2,A04,191856,Staff,31,0,32,1
1681913107037,BILD 2,A05,191857,Staff,32,0,32,0
1681913107037,BILD 2,A06,191858,Staff,32,0,32,0
1681913107037,BILD 2,A07,191859,Staff,31,0,32,1
1681913108062,BILD 3,A01,205391,Staff,29,0,32,3
1681913108062,BILD 3,A02,205393,Staff,32,0,32,0
1681913108062,BILD 3,A03,205394,Staff,28,0,32,4
1681913108062,BILD 3,A04,205395,Staff,32,0,32,0
1681913109085,BILD 20,A01,191861,Staff,32,0,32,0
1681913109085,BILD 20,A02,191862,Staff,32,0,32,0
1681913110111,BILD 30,A01,191864,Staff,31,0,32,1
1681913111134,BIMM 100,A01,192019,Staff,0,0,32,32
1681913111134,BIMM 100,A02,192020,Staff,23,0,32,9
1681913111134,BIMM 100,A03,192035,Staff,22,0,32,10
1681913112158,BIMM 110,A01,192037,Tat; John,0,0,32,32
1681913112158,BIMM 110,A02,192038,Tat; John,10,0,32,22
1681913113181,BIMM 120,A01,192040,Pickett; Brooke Elizabeth,2,0,32,30
1681913113181,BIMM 120,A02,192041,Pickett; Brooke Elizabeth,16,0,32,16
1681913113181,BIMM 120,A03,192042,Pickett; Brooke Elizabeth,16,0,32,16
1681913114210,BIPN 100,A01,192044,Armour; Jon Christopher,26,0,32,6
1681913114210,BIPN 100,A02,192059,Armour; Jon Christopher,30,0,32,2
1681913114210,BIPN 100,A03,192064,Armour; Jon Christopher,31,0,32,1
1681913114210,BIPN 100,A04,192073,Armour; Jon Christopher,28,0,32,4
1681913115238,BIPN 148,A01,205411,Leutgeb; Jill K.,16,0,32,16
1681913115238,BIPN 148,A02,205412,Leutgeb; Jill K.,31,0,32,1
1681913115238,BIPN 148,A03,205413,Leutgeb; Jill K.,30,0,32,2
1681913115238,BIPN 148,A04,205414,Leutgeb; Jill K.,30,0,32,2
1681913116263,BIPN 160,A01,192115,Marino; Marc J,19,0,32,13
1681913116263,BIPN 160,A02,192148,Marino; Marc J,27,0,32,5
1681913116263,BIPN 160,A03,192158,Marino; Marc J,31,0,32,1
1681913116263,BIPN 160,A04,192190,Marino; Marc J,32,0,32,0
1681913116263,BIPN 160,A05,192287,Marino; Marc J,32,0,32,0
1681913116263,BIPN 160,A06,192288,Marino; Marc J,32,0,32,0
1681913117285,BIPN 194,A00,206038,Staff,28,0,32,4
1681913118316,BISP 194,A00,192289,Leutgeb; Stefan,13,0,32,19
1681913118316,BISP 194,B00,245332,Nieh; James Charles,27,0,32,5
1681913119339,CAT 124,A01,202247,Staff,15,0,15,0
1681913120362,CAT 125,A00,202248,Staff,19,0,20,1
1681913120362,CAT 125,B00,202253,Staff,20,0,20,0
1681913120362,CAT 125,C00,202257,Staff,19,0,20,1
1681913121385,CAT 125GS,A01,202273,Bronstein; Phoebe Malan,20,0,20,0
1681913122421,CAT 125R,A00,202284,Staff,17,0,20,3
1681913122421,CAT 125R,C00,202286,Staff,10,0,20,10
1681913122421,CAT 125R,D00,202291,Staff,18,0,20,2
1681913122421,CAT 125R,E00,202295,Staff,13,0,20,7
1681913122421,CAT 125R,F00,202302,Staff,12,0,20,8
1681913123445,CENG 100,A00,204724,Opatkiewicz; Justin Paul,25,0,25,0
1681913124473,CGS 2A,A01,180420,Staff,31,0,36,5
1681913125496,CGS 101,A00,180421,Staff,16,0,20,4
1681913126531,CGS 112,A00,180422,Staff,10,0,16,6
1681913127559,CGS 113,A00,180423,Staff,18,0,20,2
1681913128582,CGS 137,A00,180424,Staff,12,0,12,0
1681913129608,CGS 147,A00,180425,Staff,10,0,10,0
1681913130632,CHEM 6A,A01,179556,Staff,97,0,100,3
1681913130632,CHEM 6A,A02,179558,Staff,0,0,0,0
1681913131658,CHEM 6B,A01,179560,Staff,100,0,100,0
1681913132681,CHEM 6C,A01,179565,Jazzar; Rodolphe,95,0,100,5
1681913133712,CHEM 7L,A01,179586,Schurmeier; Kimberly,13,0,24,11
1681913133712,CHEM 7L,A02,179587,Schurmeier; Kimberly,23,0,24,1
1681913133712,CHEM 7L,A03,179590,Schurmeier; Kimberly,22,0,24,2
1681913133712,CHEM 7L,A04,179591,Schurmeier; Kimberly,22,0,24,2
1681913133712,CHEM 7L,B01,179598,Schurmeier; Kimberly,17,0,24,7
1681913133712,CHEM 7L,B02,179599,Schurmeier; Kimberly,24,0,24,0
1681913133712,CHEM 7L,B03,179606,Schurmeier; Kimberly,23,0,24,1
1681913133712,CHEM 7L,B04,179607,Schurmeier; Kimberly,23,0,24,1
1681913134741,CHEM 11,A01,179609,Stallings; Dontarie M,88,0,100,12
1681913135767,CHEM 40A,A01,179621,Staff,41,0,50,9
1681913135767,CHEM 40A,A02,179622,Staff,47,0,50,3
1681913136795,CHEM 40B,A01,179630,Weizman; Haim,48,0,50,2
1681913136795,CHEM 40B,A02,179631,Weizman; Haim,45,0,50,5
1681913137824,CHEM 41A,A01,179660,Klosterman; Jeremy K,93,0,100,7
1681913138849,CHEM 43A,A01,179683,Klosterman; Jeremy K,0,0,24,24
1681913138849,CHEM 43A,A02,179688,Klosterman; Jeremy K,14,0,24,10
1681913138849,CHEM 43A,A03,179689,Klosterman; Jeremy K,20,0,24,4
1681913138849,CHEM 43A,A04,179691,Klosterman; Jeremy K,18,0,24,6
1681913139876,CHEM 114A,A01,179693,Stallings; Dontarie M,77,0,100,23
1681913140914,CHEM 143B,A01,179698,Weizman; Haim,17,0,24,7
1681913140914,CHEM 143B,A02,179700,Weizman; Haim,24,0,24,0
1681913141937,CHIN 169A,A00,179701,Wang; Xiao,20,0,20,0
1681913142965,COGS 2,A01,179750,Boyle; Mary E. T.,17,0,30,13
1681913143989,COGS 9,A01,179759,Jones; Cameron Robert,43,0,50,7
1681913145012,COGS 14A,A01,179854,Staff,18,0,50,32
1681913146043,COGS 14B,A01,179856,Staff,54,0,60,6
1681913147066,COGS 17,A01,179874,Staff,71,0,75,4
1681913148090,COGS 18,A01,179884,Staff,63,0,80,17
1681913149204,COGS 100,A01,179886,Staff,40,0,60,20
1681913150227,COGS 101B,A01,179892,Staff,1,0,30,29
1681913151250,COGS 101C,A01,179894,Staff,28,0,30,2
1681913152273,COGS 107A,A01,179896,Boyle; Mary E. T.,31,0,40,9
1681913153295,COGS 108,A01,179898,Simpkins; Charles Alexander,0,17,60,60
1681913154318,COGS 109,A01,179900,Staff,34,0,40,6
1681913155348,COGS 118A,A01,179946,Staff,9,0,40,31
1681913156377,COGS 153,A00,179978,Staff,1,0,30,29
1681913157403,COGS 156,A01,179981,Staff,27,0,30,3
1681913159450,COGS 172,A01,179987,Staff,13,0,30,17
1681913161502,COGS 186,A01,179991,Staff,13,0,30,17
1681913162530,COMM 10,A01,180001,Staff,15,0,25,10
1681913162530,COMM 10,A02,180004,Staff,20,0,25,5
1681913163557,COMM 100A,A01,180016,Staff,18,0,25,7
1681913163557,COMM 100A,A02,180020,Staff,24,0,25,1
1681913164585,COMM 101T,A00,180029,Halm; Gavin Patrick,23,0,35,12
1681913165608,COMM 106V,A00,180043,Staff,34,0,35,1
1681913166630,COMM 109P,A00,180044,Staff,31,0,35,4
1681913167654,COMM 113T,A00,180045,Havis; Allan,37,0,45,8
1681913168678,COMM 132,A00,180046,McKenna; Denise,23,0,30,7
1681913169704,COMM 143,A00,180047,Staff,19,0,30,11
1681913170731,COMM 190,A00,180048,Conner; Thomas Hartnell,20,0,23,3
1681913171754,CSE 8A,A50,180053,Cao; Yingjun,25,0,50,25
1681913171754,CSE 8A,B50,180180,Staff,50,0,50,0
1681913172777,CSE 11,A01,180190,Cao; Yingjun,31,0,50,19
1681913173805,CSE 20,A01,180192,Briones; Jor-el Thomas Caparas,23,0,30,7
1681913174827,CSE 21,A01,194538,Briones; Jor-el Thomas Caparas,50,0,60,10
1681913175859,CSE 30,A01,180324,Eldon; John,78,0,100,22
1681913176882,CSE 101,A01,201353,Staff,0,20,40,40
1681913177907,CSE 134B,A01,180326,Powell; Thomas Allan,74,0,100,26
1681913178930,CSE 140,A01,180328,Staff,46,0,75,29
1681913179952,CSE 140L,A01,180344,Eldon; John,69,0,100,31
1681913180981,CSE 150A,A01,180411,Staff,0,7,50,50
1681913182004,CSE 151A,A01,180414,Staff,0,6,50,50
1681913183029,CSE 175,A01,222521,Kumar; Rakesh,50,0,50,0
1681913184054,CSE 190,A00,201419,Staff,45,0,49,4
1681913185081,CSS 1,A01,194536,Staff,38,0,50,12
1681913186105,DSC 30,A01,202385,Staff,48,0,50,2
1681913187133,DSC 40A,A01,202387,Albuyeh; Rod,50,0,50,0
1681913188154,DSC 190,A01,202389,Silberman; Jack,21,0,21,0
1681913189177,DSGN 100,A01,179993,Staff,16,0,30,14
1681913190206,ECE 65,A50,180708,Staff,10,0,20,10
1681913190206,ECE 65,A51,180739,Staff,19,0,20,1
1681913191229,ECON 1,A01,180427,Famulari; Melissa,67,0,70,3
1681913192253,ECON 2,A01,180450,Levkoff; Steven B.,64,0,70,6
1681913193279,ECON 4,A01,203351,Anderson; John Charles,7,0,10,3
1681913194304,ECON 100A,A01,180472,Famulari; Melissa,65,0,70,5
1681913195331,ECON 120A,A01,180549,Staff,64,0,70,6
1681913196357,ECON 120B,A01,180655,Ma; Xinwei,46,0,70,24
1681913197385,ECON 129,A00,203333,Eckert; Fabian Paul,15,0,35,20
1681913198407,ECON 131,A00,180656,Staff,9,0,35,26
1681913199432,ECON 172B,A01,180672,Levkoff; Steven B.,32,0,35,3
1681913200454,ECON 178,A01,203342,Zhu; Ying,11,0,35,24
1681913201495,EDS 108GS,A00,202383,Wishard Guerra; Alison G.,20,0,20,0
1681913202525,EDS 111GS,A00,202347,Wishard Guerra; Alison G.,20,0,20,0
1681913203548,EDS 112,A01,202323,Staff,56,0,60,4
1681913204573,EDS 113,A00,202340,Staff,33,0,35,2
1681913205599,EDS 118,A00,201231,Staff,20,0,30,10
1681913206625,EDS 119,A00,204994,Staff,8,0,10,2
1681913207647,EDS 124BR,A00,202324,Eguchi; Emi,5,0,25,20
1681913208673,EDS 126,A01,203208,Jones; Makeba,26,0,30,4
1681913209695,EDS 135,A01,202333,Staff,18,0,20,2
1681913210718,EDS 180,A00,202311,Staff,47,0,50,3
1681913211747,ERC 190GS,A01,253747,Staff,28,0,28,0
1681913212775,ETHN 104,A00,180742,Staff,24,0,35,11
1681913213800,ETHN 118,A00,180745,Staff,28,0,35,7
1681913214825,ETHN 127,A00,180747,Staff,12,0,16,4
1681913215847,ETHN 137,A00,180880,Staff,12,0,12,0
1681913216874,ETHN 147,A00,180890,Staff,8,0,10,2
1681913217898,ETHN 154,A00,180891,Staff,7,0,8,1
1681913218923,ETHN 168,A00,180892,Staff,9,0,10,1
1681913219948,GLBH 20,A00,201051,Hannah; Seth Donal,0,1,0,1
1681913220973,GLBH 111,A01,209338,Burgos; Jose L.,0,0,0,0
1681913221998,GLBH 150,A00,258300,Staff,0,3,0,0
1681913223024,GLBH 181,A00,201207,Staff,15,0,40,25
1681913224050,HIEU 109,A00,180898,Staff,20,0,20,0
1681913225073,HIEU 111,A00,180899,Staff,1,0,20,19
1681913226098,HIEU 124,A00,180900,Staff,18,0,20,2
1681913227126,HILA 122,A00,180901,Staff,18,0,20,2
1681913228155,HILA 132,A00,180902,Vitz; Matthew,2,0,20,18
1681913229178,HILD 10,A01,180896,Staff,15,0,20,5
1681913230201,HILD 30GS,A00,180897,Edington; Claire Ellen,0,0,0,0
1681913231226,HISC 105,A00,180903,Staff,20,0,20,0
1681913232255,HISC 117,A00,180904,Staff,11,0,20,9
1681913233278,HIUS 108B,A00,181005,Staff,18,0,20,2
1681913234301,HIUS 113,A00,181093,Staff,4,0,20,16
1681913235331,HUM 3,A01,181190,Patterson; Patrick H.,40,0,50,10
1681913235331,HUM 3,B01,181195,Staff,47,0,50,3
1681913236362,HUM 3GS,A00,181196,Herbst; Matthew,0,0,0,0
1681913237387,HUM 4,A01,181227,West; Geoffrey Scott,34,0,50,16
1681913237387,HUM 4,B01,181282,Staff,43,0,50,7
1681913238413,HUM 4GS,A00,181377,Lyon; Antony J.,0,0,0,0
1681913239443,HUM 5,A01,181536,Zavodny; Tatiana Sophia,31,0,50,19
1681913239443,HUM 5,B01,181908,Staff,36,0,50,14
1681913240475,INTL 190,A00,181909,Segui; Alan S,0,0,0,6
1681913240475,INTL 190,B00,181961,Segui; Alan S,0,0,0,7
1681913241497,JAPN 20AR,A01,182113,Ross; Kayoko F,15,0,20,5
1681913242523,LATI 50,A01,202391,Martin-Cabrera; Luis,19,0,30,11
1681913242523,LATI 50,A02,202392,Martin-Cabrera; Luis,26,0,30,4
1681913243553,LATI 180,A00,202393,Kokinis; Troy Andreas,25,0,25,0
1681913244580,LIFR 1A,A00,182119,Staff,14,0,14,0
1681913245604,LIFR 1AX,A00,182324,Staff,14,0,14,0
1681913246626,LIFR 1B,A00,182259,Staff,14,0,14,0
1681913247651,LIFR 1BX,A00,182273,Staff,14,0,14,0
1681913248674,LIGN 8,A00,182330,Staff,137,0,150,13
1681913249699,LIGN 9GS,A00,182362,Staff,20,0,20,0
1681913250726,LIGN 119,A00,204992,Takahashi; Maho,12,0,15,3
1681913251750,LIGN 130,A01,182384,Staff,47,0,50,3
1681913252853,LIGN 149GS,A00,182390,Staff,20,0,20,0
1681913253881,LIGN 170,A00,182404,Staff,24,0,30,6
1681913254905,LISP 1D,A00,182281,Staff,7,0,14,7
1681913254905,LISP 1D,B00,182287,Staff,14,0,14,0
1681913254905,LISP 1D,C00,182295,Staff,11,0,14,3
1681913254905,LISP 1D,D00,182301,Staff,14,0,14,0
1681913255932,LISP 1DX,A00,182309,Staff,20,0,28,8
1681913255932,LISP 1DX,B00,182316,Staff,26,0,28,2
1681913256955,LTAF 120GS,A00,182412,Zhiri; Oumelbanine,20,0,20,0
1681913257978,LTCS 172GS,A00,182437,Bronstein; Phoebe Malan,20,0,20,0
1681913259001,LTEA 138,A00,182457,Staff,22,0,40,18
1681913260027,LTEN 114,A01,182490,Staff,23,0,25,2
1681913261059,LTEN 130GS,A00,182491,Lyon; Antony J.,20,0,20,0
1681913262083,LTEN 169,A00,182493,Cuong; Marisol,20,0,25,5
1681913263111,LTEN 178,A00,182501,Staff,14,0,15,1
1681913264134,LTEN 181,A00,182515,Staff,22,0,25,3
1681913265160,LTEN 185GS,A00,197655,Forbes; Camille,20,0,20,0
1681913266186,LTSP 100B,A00,202208,Bessett; Ryan Matthew,24,0,25,1
1681913267208,LTWL 100,A00,182516,Myerston Santana; Jacobo,22,0,30,8
1681913268231,LTWR 100GS,A00,182518,Forbes; Camille,20,0,20,0
1681913269256,LTWR 102,A00,182522,Staff,15,0,15,0
1681913269256,LTWR 102,B00,182525,Staff,14,0,15,1
1681913270279,LTWR 115,A00,182526,Staff,12,0,15,3
1681913271301,MAE 8,A01,182528,Pham; Hieu Tan,68,0,70,2
1681913272329,MAE 11,A00,182529,Bahadori; Mohammad Yousef,94,0,100,6
1681913273351,MAE 20,A00,182530,Evdokimenko; Ekaterina,68,0,70,2
1681913274375,MAE 30A,A00,182532,Staff,44,0,45,1
1681913275403,MAE 101A,A00,182533,Bahadori; Mohammad Yousef,97,0,100,3
1681913276429,MAE 101C,A00,182538,Staff,62,0,70,8
1681913277453,MAE 104,A00,182539,Staff,45,0,50,5
1681913278482,MAE 131A,A00,182540,Ghazinejad; Maziar,41,0,45,4
1681913279504,MAE 143A,A00,182548,Bewley; Thomas R,43,0,50,7
1681913280529,MAE 150,A00,182549,Staff,28,0,40,12
1681913281557,MAE 160,A00,182550,Evdokimenko; Ekaterina,43,0,60,17
1681913282585,MATH 3C,A01,182725,Staff,27,0,30,3
1681913283611,MATH 10A,A01,182729,Staff,25,0,30,5
1681913283611,MATH 10A,B01,182732,Staff,26,0,30,4
1681913284644,MATH 10B,A01,182737,Staff,21,0,30,9
1681913284644,MATH 10B,A02,182738,Staff,27,0,30,3
1681913284644,MATH 10B,B01,182744,Staff,27,0,30,3
1681913284644,MATH 10B,B02,182745,Staff,27,0,30,3
1681913285667,MATH 18,A01,182750,Anzaldo; Leesa B,28,0,30,2
1681913285667,MATH 18,A02,182751,Anzaldo; Leesa B,29,0,30,1
1681913285667,MATH 18,A03,182753,Anzaldo; Leesa B,28,0,30,2
1681913285667,MATH 18,A04,182757,Anzaldo; Leesa B,29,0,30,1
1681913285667,MATH 18,B01,182761,Anzaldo; Leesa B,27,0,30,3
1681913285667,MATH 18,B02,182764,Anzaldo; Leesa B,27,0,30,3
1681913285667,MATH 18,B03,182765,Anzaldo; Leesa B,30,0,30,0
1681913285667,MATH 18,B04,182766,Anzaldo; Leesa B,30,0,30,0
1681913286690,MATH 20A,A01,182771,Suk; Andrew Hoon,28,0,30,2
1681913287712,MATH 20B,A01,182775,Bach; Quang Tran,30,0,30,0
1681913287712,MATH 20B,A02,182777,Bach; Quang Tran,29,0,30,1
1681913287712,MATH 20B,B01,182780,Bach; Quang Tran,27,0,30,3
1681913287712,MATH 20B,B02,182782,Bach; Quang Tran,30,0,30,0
1681913288740,MATH 20C,A01,182787,Staff,25,0,30,5
1681913288740,MATH 20C,A02,182790,Staff,29,0,30,1
1681913288740,MATH 20C,B01,182792,Staff,25,0,30,5
1681913288740,MATH 20C,B02,182796,Staff,27,0,30,3
1681913289767,MATH 20D,A01,182799,Staff,29,0,30,1
1681913289767,MATH 20D,A02,182802,Staff,30,0,30,0
1681913289767,MATH 20D,A03,182803,Staff,30,0,30,0
1681913290797,MATH 20E,A01,182809,Verstraete; Jacques Allan,24,0,30,6
1681913290797,MATH 20E,A02,182811,Verstraete; Jacques Allan,28,0,30,2
1681913290797,MATH 20E,B01,182814,Verstraete; Jacques Allan,23,0,30,7
1681913290797,MATH 20E,B02,182815,Verstraete; Jacques Allan,30,0,30,0
1681913291826,MATH 103A,A01,182820,Staff,9,0,30,21
1681913291826,MATH 103A,A02,182821,Staff,27,0,30,3
1681913291826,MATH 103A,A03,182822,Staff,23,0,30,7
1681913291826,MATH 103A,B01,182825,Staff,23,0,30,7
1681913291826,MATH 103A,B02,182826,Staff,30,0,30,0
1681913291826,MATH 103A,B03,182830,Staff,30,0,30,0
1681913292856,MATH 109,A01,182836,Chow; Bennett,24,0,30,6
1681913292856,MATH 109,A02,182838,Chow; Bennett,29,0,30,1
1681913292856,MATH 109,A03,182894,Chow; Bennett,29,0,30,1
1681913292856,MATH 109,B01,182908,Chow; Bennett,28,0,30,2
1681913292856,MATH 109,B02,182909,Chow; Bennett,30,0,30,0
1681913292856,MATH 109,B03,182910,Chow; Bennett,27,0,30,3
1681913293881,MATH 142A,A01,182925,Staff,11,0,30,19
1681913293881,MATH 142A,A02,182935,Staff,25,0,30,5
1681913293881,MATH 142A,A03,182967,Staff,26,0,30,4
1681913293881,MATH 142A,B01,183125,Staff,24,0,30,6
1681913293881,MATH 142A,B02,183157,Staff,28,0,30,2
1681913293881,MATH 142A,B03,183158,Staff,29,0,30,1
1681913294913,MATH 183,A01,183160,Arias-Castro; Ery,23,0,30,7
1681913294913,MATH 183,A02,183161,Arias-Castro; Ery,29,0,30,1
1681913294913,MATH 183,B01,183163,Arias-Castro; Ery,28,0,30,2
1681913294913,MATH 183,B02,183164,Arias-Castro; Ery,28,0,30,2
1681913295940,MATH 193A,A01,183167,Staff,4,0,35,31
1681913295940,MATH 193A,A02,183168,Staff,28,0,35,7
1681913295940,MATH 193A,A03,183169,Staff,34,0,35,1
1681913295940,MATH 193A,A04,183170,Staff,28,0,35,7
1681913296974,MGT 4,A01,202395,Anderson; John Charles,75,0,80,5
1681913298000,MGT 5,A00,202396,Houskeeper; Robert,80,0,90,10
1681913299027,MGT 103,A00,202397,Eberhard; Craig A,55,0,90,35
1681913300051,MGT 131A,A00,202398,Houskeeper; Robert,85,0,90,5
1681913301074,MGT 135,A00,202399,Anderson; John Charles,82,0,90,8
1681913302099,MGT 162R,A00,202403,Gneezy; Uri,150,0,200,50
1681913303122,MGT 172,A00,202404,Hedges; Kathleen,50,0,90,40
1681913304149,MGT 181,A00,202405,Dunn; Louis Jean,84,0,90,6
1681913305177,MMW 14,A01,183200,Staff,16,0,28,12
1681913305177,MMW 14,A02,183201,Staff,26,0,28,2
1681913305177,MMW 14,A03,183202,Staff,24,0,28,4
1681913305177,MMW 14,A04,183203,Staff,25,0,28,3
1681913305177,MMW 14,A05,183204,Staff,26,0,28,2
1681913305177,MMW 14,A06,183205,Staff,27,0,28,1
1681913305177,MMW 14,B01,183207,Staff,26,0,28,2
1681913305177,MMW 14,B02,183208,Staff,28,0,28,0
1681913305177,MMW 14,B03,183209,Staff,28,0,28,0
1681913305177,MMW 14,B04,183210,Staff,28,0,28,0
1681913305177,MMW 14,B05,183211,Staff,28,0,28,0
1681913305177,MMW 14,B06,183212,Staff,28,0,28,0
1681913306203,MMW 14GS,A00,183213,Zhiri; Oumelbanine,28,0,28,0
1681913307228,MMW 15GS,B00,183215,Rahimi; Babak,28,0,28,0
1681913308256,MMW 121,A01,183217,Patterson; Patrick H.,14,0,28,14
1681913308256,MMW 121,A02,183218,Patterson; Patrick H.,25,0,28,3
1681913309282,MUS 1A,A01,182554,Staff,8,0,35,27
1681913310306,MUS 5,A01,182558,Staff,20,0,35,15
1681913311329,MUS 6,A01,182562,Staff,25,0,35,10
1681913312356,MUS 8GS,A00,182563,Borgo; David Garcia,25,0,25,0
1681913313389,MUS 13,A01,182567,Staff,24,0,25,1
1681913314415,MUS 15,A01,182570,Staff,32,0,35,3
1681913314415,MUS 15,B01,182575,Staff,10,0,35,25
1681913315442,MUS 80,A00,182578,Staff,23,0,25,2
1681913315442,MUS 80,B00,182581,Staff,20,0,25,5
1681913316467,MUS 113,A00,182582,Staff,25,0,25,0
1681913317489,MUS 114,A00,182583,Staff,4,0,25,21
1681913318511,MUS 150GS,A01,182588,Borgo; David Garcia,25,0,25,0
1681913319537,PHIL 1,A00,182590,Staff,35,0,40,5
1681913320564,PHIL 10,A01,182596,Grush; Rick Scott,31,0,35,4
1681913320564,PHIL 10,A02,182597,Grush; Rick Scott,34,0,35,1
1681913321590,PHIL 15,A01,182601,Staff,31,0,35,4
1681913321590,PHIL 15,A02,182602,Staff,33,0,35,2
1681913322616,PHIL 27,A01,182604,Staff,30,0,35,5
1681913322616,PHIL 27,A02,182607,Staff,35,0,35,0
1681913323639,PHIL 32,A01,182609,Staff,35,0,35,0
1681913323639,PHIL 32,A02,182612,Staff,35,0,35,0
1681913324665,PHIL 130,A00,182614,Staff,63,0,70,7
1681913325690,PHIL 136,A00,182616,Cohen; Jonathan David,66,0,70,4
1681913326716,PHIL 155,A00,182617,Vargas; Manuel Rogelio,60,0,70,10
1681913327739,PHIL 163,A01,182620,Staff,15,0,20,5
1681913327739,PHIL 163,A02,182624,Staff,10,0,20,10
1681913328765,PHIL 164,A00,182627,Staff,30,0,40,10
1681913329791,PHIL 173,A00,182628,Staff,36,0,40,4
1681913330815,PHYS 1A,A00,183221,Staff,54,0,60,6
1681913331843,PHYS 1AL,001,183222,Staff,25,0,30,5
1681913331843,PHYS 1AL,002,183223,Staff,28,0,30,2
1681913332867,PHYS 1B,A00,183231,Staff,44,0,60,16
1681913333895,PHYS 1BL,001,183232,Staff,20,0,30,10
1681913333895,PHYS 1BL,002,183233,Staff,29,0,30,1
1681913334924,PHYS 1C,A00,183240,Staff,30,0,60,30
1681913335947,PHYS 1CL,001,183241,Staff,13,0,30,17
1681913335947,PHYS 1CL,002,183242,Staff,22,0,30,8
1681913336974,PHYS 2AR,A01,183250,Staff,44,0,50,6
1681913337996,PHYS 2B,A01,183252,Staff,106,0,115,9
1681913339022,PHYS 2BL,A01,183254,Staff,21,0,24,3
1681913339022,PHYS 2BL,A02,183255,Staff,22,0,24,2
1681913340053,PHYS 2C,A01,183522,Staff,105,0,115,10
1681913341079,PHYS 4A,A01,183524,Staff,49,0,50,1
1681913342110,POLI 5,A00,183525,Staff,44,0,50,6
1681913343135,POLI 12,A00,183540,Staff,48,0,50,2
1681913344161,POLI 13R,A00,183541,Forman; Fonna,42,0,50,8
1681913345183,POLI 30,A00,183542,Mignozzetti; Umberto,47,0,50,3
1681913346205,POLI 100A,A00,183543,Staff,45,0,50,5
1681913347229,POLI 100E,A00,223598,Staff,32,0,35,3
1681913348257,POLI 103A,A00,183564,Kousser; Thad,38,0,50,12
1681913349283,POLI 104B,A00,201329,Staff,29,0,35,6
1681913350306,POLI 113BR,A00,183576,Hoston; Germaine,27,0,50,23
1681913351329,POLI 114BR,A00,183588,Staff,27,0,30,3
1681913352355,POLI 117R,A00,183595,Forman; Fonna,9,0,20,11
1681913353378,POLI 120H,A00,183596,Fisk; David Lee,13,0,20,7
1681913354403,POLI 130AA,A00,183597,Staff,14,0,20,6
1681913355432,POLI 134AA,A00,183598,Staff,19,0,20,1
1681913356528,POLI 135,A00,183599,Fisk; David Lee,20,0,25,5
1681913357565,POLI 142P,A00,183623,Staff,37,0,40,3
1681913358590,POLI 144D,A00,183624,Staff,22,0,25,3
1681913359616,POLI 151,A00,183625,Staff,15,0,20,5
1681913360650,POLI 162,A00,183626,Mignozzetti; Umberto,18,0,20,2
1681913361676,PSYC 1,A00,253748,Staff,86,0,90,4
1681913362699,PSYC 2,A00,183627,Moranton; Nirelia Melbina-,25,0,35,10
1681913363733,PSYC 3,A00,183628,Staff,43,0,45,2
1681913365779,PSYC 60,A01,183631,Lowe; Angela Beth,35,0,40,5
1681913366802,PSYC 70,A01,253757,Staff,37,0,45,8
1681913367827,PSYC 101,A00,183632,Heyman; Gail D.,48,0,60,12
1681913368851,PSYC 105,A00,183848,Lowe; Angela Beth,50,0,60,10
1681913369877,PSYC 106,A00,183849,Dobkins; Karen R.,45,0,60,15
1681913370900,PSYC 108,A00,253750,Staff,24,0,60,36
1681913371927,PSYC 114,A01,184275,Winkielman; Piotr,0,6,30,30
1681913372952,PSYC 122,A00,183856,Moranton; Nirelia Melbina-,0,10,30,30
1681913373975,PSYC 124,A00,183865,Chapman; Eddie Nathaniel,52,0,80,28
1681913375009,PSYC 137,A00,183880,Staff,19,0,25,6
1681913377059,PSYC 154,A00,183910,Lacefield; Katharine I,0,2,90,90
1681913379108,PSYC 162,A00,183946,Wixted; John T,61,0,90,29
1681913380132,PSYC 172,A00,183947,Gorman; Michael R.,14,0,30,16
1681913381155,PSYC 178,A00,183963,Glaser; Dale,20,0,40,20
1681913382181,PSYC 181GS,A00,183964,Anagnostaras; Stephan,10,0,10,0
1681913383203,PSYC 186GS,A01,257660,Staff,10,0,10,0
1681913384231,PSYC 193,B00,253749,Staff,23,0,25,2
1681913386281,PSYC 193L,A01,184122,Staff,33,0,35,2
1681913386281,PSYC 193L,C01,184167,Winkielman; Piotr,16,0,30,14
1681913387308,RELI 188GS,A00,182629,Rahimi; Babak,20,0,20,0
1681913388334,SE 101A,A00,182646,Staff,26,0,30,4
1681913389360,SE 101C,A00,182650,Staff,18,0,20,2
1681913390383,SE 110A,A00,182651,Staff,28,0,28,0
1681913391406,SE 130A,A00,182652,Staff,39,0,40,1
1681913392429,SIO 46GS,A00,182636,Cook; Geoffrey W,28,0,28,0
1681913393456,SIO 109R,A00,194459,Staff,5,0,20,15
1681913394483,SIO 121GS,A00,182639,Cook; Geoffrey W,28,0,28,0
1681913395511,SIO 132,A01,182642,Staff,32,0,40,8
1681913396535,SIO 139,A00,182644,Kacev; David,36,0,40,4
1681913397559,SOCI 2,A01,258404,Staff,34,0,36,2
1681913397559,SOCI 2,A02,258405,Staff,35,0,36,1
1681913398584,SOCI 60,A01,258408,Staff,29,0,30,1
1681913398584,SOCI 60,A02,258413,Staff,30,0,30,0
1681913399606,SOCI 100,A01,258415,Staff,29,0,30,1
1681913399606,SOCI 100,A02,258416,Staff,28,0,30,2
1681913405758,SOCI 127,A00,258421,Staff,22,0,30,8
1681913406782,SOCI 132,A00,258422,Staff,45,0,50,5
1681913407805,SOCI 133,A00,258423,Staff,26,0,30,4
1681913408832,SOCI 138GS,A00,258424,Staff,15,0,15,0
1681913409854,SOCI 145,A00,258425,Staff,25,0,30,5
1681913410880,SOCI 148,A00,258426,Staff,26,0,30,4
1681913411904,SOCI 153,A00,199217,Staff,29,0,30,1
1681913412927,SOCI 160,A00,258427,Staff,28,0,30,2
1681913413953,SOCI 160E,A00,258435,Staff,56,0,60,4
1681913414978,SOCI 189GS,A00,258436,Staff,15,0,15,0
1681913416004,SOCI 190GS,A00,258437,Staff,15,0,15,0
1681913417026,SYN 2,001,182658,Staff,9,0,16,7
1681913417026,SYN 2,002,201439,Staff,15,0,16,1
1681913417026,SYN 2,003,201443,Staff,16,0,16,0
1681913418048,SYN 100,A01,182657,Staff,17,0,20,3
1681913419072,TDAC 1,A00,184381,Salovey; Todd,16,0,20,4
1681913419072,TDAC 1,B00,184385,Harting; Carla Kelso,19,0,20,1
1681913419072,TDAC 1,C00,184394,Staff,19,0,20,1
1681913420099,TDAC 101,A00,184483,Harting; Carla Kelso,19,0,20,1
1681913421131,TDDE 111,A00,184496,Staff,14,0,15,1
1681913422165,TDDE 131,A00,184504,Staff,20,0,20,0
1681913422165,TDDE 131,B00,184505,Staff,17,0,18,1
1681913422165,TDDE 131,C00,184534,Staff,49,0,50,1
1681913422165,TDDE 131,D00,184564,Staff,15,0,15,0
1681913422165,TDDE 131,E00,204725,Staff,19,0,20,1
1681913423193,TDGE 1,A01,184414,Salovey; Todd,37,0,50,13
1681913424221,TDGE 5,A01,184419,Staff,23,0,24,1
1681913425246,TDGE 10,A00,184428,Fulton; Julia,31,0,50,19
1681913426268,TDGE 124,A00,184565,Fulton; Julia,7,0,50,43
1681913427302,TDGE 125,B00,184567,Meyer; Ursula,9,0,25,16
1681913428332,TDHT 101,A00,184568,Staff,21,0,25,4
1681913428332,TDHT 101,B00,184569,Staff,20,0,20,0
1681913429361,TDHT 114,A00,184570,Staff,49,0,50,1
1681913430386,TDMV 1,A00,184437,Arcidiacono; Kristin,23,0,30,7
1681913430386,TDMV 1,B00,184448,Caligagan; Maria T.,22,0,30,8
1681913431410,TDMV 2,A00,184449,Weinberg; Sadie,27,0,30,3
1681913431410,TDMV 2,B00,184453,Arcidiacono; Kristin,29,0,30,1
1681913432436,TDMV 110,A00,184571,Weinberg; Sadie,30,0,30,0
1681913433460,TDMV 142,A00,184572,Caligagan; Tony,27,0,30,3
1681913433460,TDMV 142,B00,184573,Caligagan; Maria T.,27,0,30,3
1681913434486,TDTR 20,A00,184482,Jun; Grace Shin Hae,25,0,25,0
1681913435512,USP 2,A01,184290,Hinds; Juli Beth,24,0,25,1
1681913436538,USP 3,A01,184295,Staff,20,0,25,5
1681913437563,USP 4,A00,184304,McTague; Sarah,15,0,25,10
1681913438590,USP 100,A00,184315,Staff,17,0,25,8
1681913439615,USP 105,A00,184326,Staff,21,0,25,4
1681913440643,USP 151,A00,184327,Staff,20,0,25,5
1681913441666,USP 170,A00,184380,Hinds; Juli Beth,14,0,25,11
1681913442694,VIS 21B,A01,182660,Staff,28,0,31,3
1681913442694,VIS 21B,A02,182662,Staff,30,0,31,1
1681913443720,VIS 103D,A00,182663,Staff,74,0,75,1
1681913444745,VIS 105D,A00,182667,Li; Huai,15,0,22,7
1681913445771,VIS 122GS,A00,182668,Herbst; Matthew,20,0,20,0
1681913446795,VIS 128C,A00,182673,Staff,69,0,75,6
1681913447822,VIS 130,A00,182675,Staff,20,0,22,2
1681913448846,VIS 160A,A00,182678,Stalbaum; Brett,4,0,10,6
1681913450903,WCWP 10B,A00,201679,Staff,15,0,15,0
1681913450903,WCWP 10B,B00,201695,Staff,15,0,15,0
1681913451935,WCWP 100,A00,201716,Staff,15,0,15,0
1681913451935,WCWP 100,B00,201717,Staff,11,0,15,4
1681913454033,ANSC 105GS,A00,258289,Staff,0,0,0,0
1681913455059,ANSC 125GS,A00,258295,Staff,0,0,0,0
1681913456084,ANSC 150,A00,258267,Staff,30,0,40,10
1681913457109,ANSC 190GS,A00,258280,Staff,0,0,0,0
1681913458134,ANTH 1,A00,258264,Staff,38,0,40,2
1681913459157,ANTH 2,A01,258259,Staff,72,0,76,4
1681913460252,ANTH 23,A01,258228,Staff,36,0,40,4
1681913461278,ANTH 101,A01,258236,Staff,39,0,40,1
1681913462302,ANTH 102,A00,258272,Staff,59,0,60,1
1681913463326,ANTH 105,A00,258244,Staff,31,0,35,4
1681913464351,BENG 130,A00,253975,Staff,38,0,40,2
1681913465374,BIBC 102,A01,191866,Flagg; Matthew Paul,19,0,32,13
1681913465374,BIBC 102,A02,191867,Flagg; Matthew Paul,22,0,32,10
1681913465374,BIBC 102,A03,191868,Flagg; Matthew Paul,30,0,32,2
1681913465374,BIBC 102,A04,191936,Flagg; Matthew Paul,26,0,32,6
1681913465374,BIBC 102,A05,191937,Flagg; Matthew Paul,11,0,32,21
1681913466398,BICD 100,A01,191939,Cooper; Andrew Michael,28,0,32,4
1681913466398,BICD 100,A02,191940,Cooper; Andrew Michael,32,0,32,0
1681913466398,BICD 100,A03,191941,Cooper; Andrew Michael,32,0,32,0
1681913466398,BICD 100,A04,191942,Cooper; Andrew Michael,32,0,32,0
1681913466398,BICD 100,A05,191943,Cooper; Andrew Michael,32,0,32,0
1681913467426,BIEB 126,A01,191945,Cleland; Elsa Eleanor,1,0,32,31
1681913467426,BIEB 126,A02,191946,Cleland; Elsa Eleanor,28,0,32,4
1681913467426,BIEB 126,A03,191947,Cleland; Elsa Eleanor,29,0,32,3
1681913467426,BIEB 126,A04,191948,Cleland; Elsa Eleanor,23,0,32,9
1681913467426,BIEB 126,A05,191996,Cleland; Elsa Eleanor,28,0,32,4
1681913468447,BIEB 136GS,A00,191997,Shurin; Jonathan & Holway; David A.,0,0,0,0
1681913469474,BIEB 137GS,A01,191999,Shurin; Jonathan & Holway; David A.,0,0,0,0
1681913470498,BILD 1,A01,205385,Staff,31,0,32,1
1681913470498,BILD 1,A02,205386,Staff,30,0,32,2
1681913470498,BILD 1,A03,205387,Staff,32,0,32,0
1681913470498,BILD 1,A04,205388,Staff,28,0,32,4
1681913471534,BILD 2,A01,191774,Staff,28,0,32,4
1681913471534,BILD 2,A02,191775,Staff,30,0,32,2
1681913471534,BILD 2,A03,191777,Staff,30,0,32,2
1681913471534,BILD 2,A04,191856,Staff,31,0,32,1
1681913471534,BILD 2,A05,191857,Staff,32,0,32,0
1681913471534,BILD 2,A06,191858,Staff,32,0,32,0
1681913471534,BILD 2,A07,191859,Staff,31,0,32,1
1681913472560,BILD 3,A01,205391,Staff,29,0,32,3
1681913472560,BILD 3,A02,205393,Staff,32,0,32,0
1681913472560,BILD 3,A03,205394,Staff,28,0,32,4
1681913472560,BILD 3,A04,205395,Staff,32,0,32,0
1681913473586,BILD 20,A01,191861,Staff,32,0,32,0
1681913473586,BILD 20,A02,191862,Staff,32,0,32,0
1681913474610,BILD 30,A01,191864,Staff,31,0,32,1
1681913475634,BIMM 100,A01,192019,Staff,0,0,32,32
1681913475634,BIMM 100,A02,192020,Staff,23,0,32,9
1681913475634,BIMM 100,A03,192035,Staff,22,0,32,10
1681913476659,BIMM 110,A01,192037,Tat; John,0,0,32,32
1681913476659,BIMM 110,A02,192038,Tat; John,10,0,32,22
1681913477685,BIMM 120,A01,192040,Pickett; Brooke Elizabeth,2,0,32,30
1681913477685,BIMM 120,A02,192041,Pickett; Brooke Elizabeth,16,0,32,16
1681913477685,BIMM 120,A03,192042,Pickett; Brooke Elizabeth,16,0,32,16
1681913478710,BIPN 100,A01,192044,Armour; Jon Christopher,26,0,32,6
1681913478710,BIPN 100,A02,192059,Armour; Jon Christopher,30,0,32,2
1681913478710,BIPN 100,A03,192064,Armour; Jon Christopher,31,0,32,1
1681913478710,BIPN 100,A04,192073,Armour; Jon Christopher,28,0,32,4
1681913479737,BIPN 148,A01,205411,Leutgeb; Jill K.,16,0,32,16
1681913479737,BIPN 148,A02,205412,Leutgeb; Jill K.,31,0,32,1
1681913479737,BIPN 148,A03,205413,Leutgeb; Jill K.,30,0,32,2
1681913479737,BIPN 148,A04,205414,Leutgeb; Jill K.,30,0,32,2
1681913480759,BIPN 160,A01,192115,Marino; Marc J,19,0,32,13
1681913480759,BIPN 160,A02,192148,Marino; Marc J,27,0,32,5
1681913480759,BIPN 160,A03,192158,Marino; Marc J,31,0,32,1
1681913480759,BIPN 160,A04,192190,Marino; Marc J,32,0,32,0
1681913480759,BIPN 160,A05,192287,Marino; Marc J,32,0,32,0
1681913480759,BIPN 160,A06,192288,Marino; Marc J,32,0,32,0
1681913481783,BIPN 194,A00,206038,Staff,28,0,32,4
1681913482810,BISP 194,A00,192289,Leutgeb; Stefan,13,0,32,19
1681913482810,BISP 194,B00,245332,Nieh; James Charles,27,0,32,5
1681913483835,CAT 124,A01,202247,Staff,15,0,15,0
1681913484858,CAT 125,A00,202248,Staff,19,0,20,1
1681913484858,CAT 125,B00,202253,Staff,20,0,20,0
1681913484858,CAT 125,C00,202257,Staff,19,0,20,1
1681913485880,CAT 125GS,A01,202273,Bronstein; Phoebe Malan,20,0,20,0
1681913486910,CAT 125R,A00,202284,Staff,17,0,20,3
1681913486910,CAT 125R,C00,202286,Staff,10,0,20,10
1681913486910,CAT 125R,D00,202291,Staff,18,0,20,2
1681913486910,CAT 125R,E00,202295,Staff,13,0,20,7
1681913486910,CAT 125R,F00,202302,Staff,12,0,20,8
1681913487933,CENG 100,A00,204724,Opatkiewicz; Justin Paul,25,0,25,0
1681913488956,CGS 2A,A01,180420,Staff,31,0,36,5
1681913489980,CGS 101,A00,180421,Staff,16,0,20,4
1681913491007,CGS 112,A00,180422,Staff,10,0,16,6
1681913492032,CGS 113,A00,180423,Staff,18,0,20,2
1681913493055,CGS 137,A00,180424,Staff,12,0,12,0
1681913494078,CGS 147,A00,180425,Staff,10,0,10,0
1681913495109,CHEM 6A,A01,179556,Staff,97,0,100,3
1681913495109,CHEM 6A,A02,179558,Staff,0,0,0,0
1681913496133,CHEM 6B,A01,179560,Staff,100,0,100,0
1681913497156,CHEM 6C,A01,179565,Jazzar; Rodolphe,95,0,100,5
1681913498188,CHEM 7L,A01,179586,Schurmeier; Kimberly,13,0,24,11
1681913498188,CHEM 7L,A02,179587,Schurmeier; Kimberly,23,0,24,1
1681913498188,CHEM 7L,A03,179590,Schurmeier; Kimberly,22,0,24,2
1681913498188,CHEM 7L,A04,179591,Schurmeier; Kimberly,22,0,24,2
1681913498188,CHEM 7L,B01,179598,Schurmeier; Kimberly,17,0,24,7
1681913498188,CHEM 7L,B02,179599,Schurmeier; Kimberly,24,0,24,0
1681913498188,CHEM 7L,B03,179606,Schurmeier; Kimberly,23,0,24,1
1681913498188,CHEM 7L,B04,179607,Schurmeier; Kimberly,23,0,24,1
1681913499211,CHEM 11,A01,179609,Stallings; Dontarie M,88,0,100,12
1681913500234,CHEM 40A,A01,179621,Staff,41,0,50,9
1681913500234,CHEM 40A,A02,179622,Staff,47,0,50,3
1681913501259,CHEM 40B,A01,179630,Weizman; Haim,48,0,50,2
1681913501259,CHEM 40B,A02,179631,Weizman; Haim,45,0,50,5
1681913502284,CHEM 41A,A01,179660,Klosterman; Jeremy K,93,0,100,7
1681913503312,CHEM 43A,A01,179683,Klosterman; Jeremy K,0,0,24,24
1681913503312,CHEM 43A,A02,179688,Klosterman; Jeremy K,14,0,24,10
1681913503312,CHEM 43A,A03,179689,Klosterman; Jeremy K,20,0,24,4
1681913503312,CHEM 43A,A04,179691,Klosterman; Jeremy K,18,0,24,6
1681913504337,CHEM 114A,A01,179693,Stallings; Dontarie M,77,0,100,23
1681913505360,CHEM 143B,A01,179698,Weizman; Haim,17,0,24,7
1681913505360,CHEM 143B,A02,179700,Weizman; Haim,24,0,24,0
1681913506390,CHIN 169A,A00,179701,Wang; Xiao,20,0,20,0
1681913507413,COGS 2,A01,179750,Boyle; Mary E. T.,17,0,30,13
1681913508437,COGS 9,A01,179759,Jones; Cameron Robert,43,0,50,7
1681913509462,COGS 14A,A01,179854,Staff,18,0,50,32
1681913510484,COGS 14B,A01,179856,Staff,54,0,60,6
1681913511507,COGS 17,A01,179874,Staff,71,0,75,4
1681913512531,COGS 18,A01,179884,Staff,63,0,80,17
1681913513556,COGS 100,A01,179886,Staff,40,0,60,20
1681913514579,COGS 101B,A01,179892,Staff,1,0,30,29
1681913515602,COGS 101C,A01,179894,Staff,28,0,30,2
1681913516631,COGS 107A,A01,179896,Boyle; Mary E. T.,31,0,40,9
1681913517653,COGS 108,A01,179898,Simpkins; Charles Alexander,0,17,60,60
1681913518675,COGS 109,A01,179900,Staff,34,0,40,6
1681913519697,COGS 118A,A01,179946,Staff,9,0,40,31
1681913520723,COGS 153,A00,179978,Staff,1,0,30,29
1681913521747,COGS 156,A01,179981,Staff,27,0,30,3
1681913523795,COGS 172,A01,179987,Staff,13,0,30,17
1681913525844,COGS 186,A01,179991,Staff,13,0,30,17
1681913526873,COMM 10,A01,180001,Staff,15,0,25,10
1681913526873,COMM 10,A02,180004,Staff,20,0,25,5
1681913527897,COMM 100A,A01,180016,Staff,18,0,25,7
1681913527897,COMM 100A,A02,180020,Staff,24,0,25,1
1681913528926,COMM 101T,A00,180029,Halm; Gavin Patrick,23,0,35,12
1681913529953,COMM 106V,A00,180043,Staff,34,0,35,1
1681913530979,COMM 109P,A00,180044,Staff,31,0,35,4
1681913532004,COMM 113T,A00,180045,Havis; Allan,37,0,45,8
1681913533032,COMM 132,A00,180046,McKenna; Denise,23,0,30,7
1681913534059,COMM 143,A00,180047,Staff,19,0,30,11
1681913535093,COMM 190,A00,180048,Conner; Thomas Hartnell,20,0,23,3
1681913536124,CSE 8A,A50,180053,Cao; Yingjun,25,0,50,25
1681913536124,CSE 8A,B50,180180,Staff,50,0,50,0
1681913537147,CSE 11,A01,180190,Cao; Yingjun,31,0,50,19
1681913538171,CSE 20,A01,180192,Briones; Jor-el Thomas Caparas,23,0,30,7
1681913539198,CSE 21,A01,194538,Briones; Jor-el Thomas Caparas,50,0,60,10
1681913540229,CSE 30,A01,180324,Eldon; John,78,0,100,22
1681913541256,CSE 101,A01,201353,Staff,0,20,40,40
1681913542280,CSE 134B,A01,180326,Powell; Thomas Allan,74,0,100,26
1681913543303,CSE 140,A01,180328,Staff,46,0,75,29
1681913544327,CSE 140L,A01,180344,Eldon; John,69,0,100,31
1681913545361,CSE 150A,A01,180411,Staff,0,7,50,50
1681913546385,CSE 151A,A01,180414,Staff,0,6,50,50
1681913547409,CSE 175,A01,222521,Kumar; Rakesh,50,0,50,0
1681913548434,CSE 190,A00,201419,Staff,45,0,49,4
1681913549458,CSS 1,A01,194536,Staff,38,0,50,12
1681913550483,DSC 30,A01,202385,Staff,48,0,50,2
1681913551510,DSC 40A,A01,202387,Albuyeh; Rod,50,0,50,0
1681913552536,DSC 190,A01,202389,Silberman; Jack,21,0,21,0
1681913553560,DSGN 100,A01,179993,Staff,16,0,30,14
1681913554586,ECE 65,A50,180708,Staff,10,0,20,10
1681913554586,ECE 65,A51,180739,Staff,19,0,20,1
1681913555613,ECON 1,A01,180427,Famulari; Melissa,67,0,70,3
1681913556639,ECON 2,A01,180450,Levkoff; Steven B.,64,0,70,6
1681913557662,ECON 4,A01,203351,Anderson; John Charles,7,0,10,3
1681913558686,ECON 100A,A01,180472,Famulari; Melissa,65,0,70,5
1681913559712,ECON 120A,A01,180549,Staff,64,0,70,6
1681913560737,ECON 120B,A01,180655,Ma; Xinwei,46,0,70,24
1681913561764,ECON 129,A00,203333,Eckert; Fabian Paul,15,0,35,20
1681913562787,ECON 131,A00,180656,Staff,9,0,35,26
1681913563907,ECON 172B,A01,180672,Levkoff; Steven B.,32,0,35,3
1681913564933,ECON 178,A01,203342,Zhu; Ying,11,0,35,24
1681913565963,EDS 108GS,A00,202383,Wishard Guerra; Alison G.,20,0,20,0
1681913566985,EDS 111GS,A00,202347,Wishard Guerra; Alison G.,20,0,20,0
1681913568009,EDS 112,A01,202323,Staff,56,0,60,4
1681913569032,EDS 113,A00,202340,Staff,33,0,35,2
1681913570054,EDS 118,A00,201231,Staff,20,0,30,10
1681913571077,EDS 119,A00,204994,Staff,8,0,10,2
1681913572101,EDS 124BR,A00,202324,Eguchi; Emi,5,0,25,20
1681913573127,EDS 126,A01,203208,Jones; Makeba,26,0,30,4
1681913574153,EDS 135,A01,202333,Staff,18,0,20,2
1681913575179,EDS 180,A00,202311,Staff,47,0,50,3
1681913576204,ERC 190GS,A01,253747,Staff,28,0,28,0
1681913577233,ETHN 104,A00,180742,Staff,24,0,35,11
1681913578259,ETHN 118,A00,180745,Staff,28,0,35,7
1681913579284,ETHN 127,A00,180747,Staff,12,0,16,4
1681913580311,ETHN 137,A00,180880,Staff,12,0,12,0
1681913581346,ETHN 147,A00,180890,Staff,8,0,10,2
1681913582369,ETHN 154,A00,180891,Staff,7,0,8,1
1681913583395,ETHN 168,A00,180892,Staff,9,0,10,1
1681913584419,GLBH 20,A00,201051,Hannah; Seth Donal,0,1,0,1
1681913585442,GLBH 111,A01,209338,Burgos; Jose L.,0,0,0,0
1681913586468,GLBH 150,A00,258300,Staff,0,3,0,0
1681913587502,GLBH 181,A00,201207,Staff,15,0,40,25
1681913588531,HIEU 109,A00,180898,Staff,20,0,20,0
1681913589558,HIEU 111,A00,180899,Staff,1,0,20,19
1681913590585,HIEU 124,A00,180900,Staff,18,0,20,2
1681913591608,HILA 122,A00,180901,Staff,18,0,20,2
1681913592632,HILA 132,A00,180902,Vitz; Matthew,2,0,20,18
1681913593656,HILD 10,A01,180896,Staff,15,0,20,5
1681913594682,HILD 30GS,A00,180897,Edington; Claire Ellen,0,0,0,0
1681913595704,HISC 105,A00,180903,Staff,20,0,20,0
1681913596734,HISC 117,A00,180904,Staff,11,0,20,9
1681913597759,HIUS 108B,A00,181005,Staff,18,0,20,2
1681913598782,HIUS 113,A00,181093,Staff,4,0,20,16
1681913599807,HUM 3,A01,181190,Patterson; Patrick H.,40,0,50,10
1681913599807,HUM 3,B01,181195,Staff,47,0,50,3
1681913600834,HUM 3GS,A00,181196,Herbst; Matthew,0,0,0,0
1681913601861,HUM 4,A01,181227,West; Geoffrey Scott,34,0,50,16
1681913601861,HUM 4,B01,181282,Staff,43,0,50,7
1681913602885,HUM 4GS,A00,181377,Lyon; Antony J.,0,0,0,0
1681913603912,HUM 5,A01,181536,Zavodny; Tatiana Sophia,31,0,50,19
1681913603912,HUM 5,B01,181908,Staff,36,0,50,14
1681913604935,INTL 190,A00,181909,Segui; Alan S,0,0,0,6
1681913604935,INTL 190,B00,181961,Segui; Alan S,0,0,0,7
1681913605958,JAPN 20AR,A01,182113,Ross; Kayoko F,15,0,20,5
1681913606986,LATI 50,A01,202391,Martin-Cabrera; Luis,19,0,30,11
1681913606986,LATI 50,A02,202392,Martin-Cabrera; Luis,26,0,30,4
1681913608011,LATI 180,A00,202393,Kokinis; Troy Andreas,25,0,25,0
1681913609038,LIFR 1A,A00,182119,Staff,14,0,14,0
1681913610063,LIFR 1AX,A00,182324,Staff,14,0,14,0
1681913611088,LIFR 1B,A00,182259,Staff,14,0,14,0
1681913612112,LIFR 1BX,A00,182273,Staff,14,0,14,0
1681913613135,LIGN 8,A00,182330,Staff,137,0,150,13
1681913614160,LIGN 9GS,A00,182362,Staff,20,0,20,0
1681913615183,LIGN 119,A00,204992,Takahashi; Maho,12,0,15,3
1681913616206,LIGN 130,A01,182384,Staff,47,0,50,3
1681913617232,LIGN 149GS,A00,182390,Staff,20,0,20,0
1681913618264,LIGN 170,A00,182404,Staff,24,0,30,6
1681913619292,LISP 1D,A00,182281,Staff,7,0,14,7
1681913619292,LISP 1D,B00,182287,Staff,14,0,14,0
1681913619292,LISP 1D,C00,182295,Staff,11,0,14,3
1681913619292,LISP 1D,D00,182301,Staff,14,0,14,0
1681913620315,LISP 1DX,A00,182309,Staff,20,0,28,8
1681913620315,LISP 1DX,B00,182316,Staff,26,0,28,2
1681913621338,LTAF 120GS,A00,182412,Zhiri; Oumelbanine,20,0,20,0
1681913622365,LTCS 172GS,A00,182437,Bronstein; Phoebe Malan,20,0,20,0
1681913623388,LTEA 138,A00,182457,Staff,22,0,40,18
1681913624415,LTEN 114,A01,182490,Staff,23,0,25,2
1681913625440,LTEN 130GS,A00,182491,Lyon; Antony J.,20,0,20,0
1681913626473,LTEN 169,A00,182493,Cuong; Marisol,20,0,25,5
1681913627498,LTEN 178,A00,182501,Staff,14,0,15,1
1681913628520,LTEN 181,A00,182515,Staff,22,0,25,3
1681913629542,LTEN 185GS,A00,197655,Forbes; Camille,20,0,20,0
1681913630564,LTSP 100B,A00,202208,Bessett; Ryan Matthew,24,0,25,1
1681913631590,LTWL 100,A00,182516,Myerston Santana; Jacobo,22,0,30,8
1681913632619,LTWR 100GS,A00,182518,Forbes; Camille,20,0,20,0
1681913633642,LTWR 102,A00,182522,Staff,15,0,15,0
1681913633642,LTWR 102,B00,182525,Staff,14,0,15,1
1681913634678,LTWR 115,A00,182526,Staff,12,0,15,3
1681913635705,MAE 8,A01,182528,Pham; Hieu Tan,68,0,70,2
1681913636728,MAE 11,A00,182529,Bahadori; Mohammad Yousef,94,0,100,6
1681913637752,MAE 20,A00,182530,Evdokimenko; Ekaterina,68,0,70,2
1681913638775,MAE 30A,A00,182532,Staff,44,0,45,1
1681913639796,MAE 101A,A00,182533,Bahadori; Mohammad Yousef,97,0,100,3
1681913640820,MAE 101C,A00,182538,Staff,62,0,70,8
1681913641846,MAE 104,A00,182539,Staff,45,0,50,5
1681913642874,MAE 131A,A00,182540,Ghazinejad; Maziar,41,0,45,4
1681913643902,MAE 143A,A00,182548,Bewley; Thomas R,43,0,50,7
1681913644928,MAE 150,A00,182549,Staff,28,0,40,12
1681913645952,MAE 160,A00,182550,Evdokimenko; Ekaterina,43,0,60,17
1681913646981,MATH 3C,A01,182725,Staff,27,0,30,3
1681913648015,MATH 10A,A01,182729,Staff,25,0,30,5
1681913648015,MATH 10A,B01,182732,Staff,26,0,30,4
1681913649042,MATH 10B,A01,182737,Staff,21,0,30,9
1681913649042,MATH 10B,A02,182738,Staff,27,0,30,3
1681913649042,MATH 10B,B01,182744,Staff,27,0,30,3
1681913649042,MATH 10B,B02,182745,Staff,27,0,30,3
1681913650068,MATH 18,A01,182750,Anzaldo; Leesa B,28,0,30,2
1681913650068,MATH 18,A02,182751,Anzaldo; Leesa B,29,0,30,1
1681913650068,MATH 18,A03,182753,Anzaldo; Leesa B,28,0,30,2
1681913650068,MATH 18,A04,182757,Anzaldo; Leesa B,29,0,30,1
1681913650068,MATH 18,B01,182761,Anzaldo; Leesa B,27,0,30,3
1681913650068,MATH 18,B02,182764,Anzaldo; Leesa B,27,0,30,3
1681913650068,MATH 18,B03,182765,Anzaldo; Leesa B,30,0,30,0
1681913650068,MATH 18,B04,182766,Anzaldo; Leesa B,30,0,30,0
1681913651100,MATH 20A,A01,182771,Suk; Andrew Hoon,28,0,30,2
1681913652125,MATH 20B,A01,182775,Bach; Quang Tran,30,0,30,0
1681913652125,MATH 20B,A02,182777,Bach; Quang Tran,29,0,30,1
1681913652125,MATH 20B,B01,182780,Bach; Quang Tran,27,0,30,3
1681913652125,MATH 20B,B02,182782,Bach; Quang Tran,30,0,30,0
1681913653149,MATH 20C,A01,182787,Staff,25,0,30,5
1681913653149,MATH 20C,A02,182790,Staff,29,0,30,1
1681913653149,MATH 20C,B01,182792,Staff,25,0,30,5
1681913653149,MATH 20C,B02,182796,Staff,27,0,30,3
1681913654172,MATH 20D,A01,182799,Staff,29,0,30,1
1681913654172,MATH 20D,A02,182802,Staff,30,0,30,0
1681913654172,MATH 20D,A03,182803,Staff,30,0,30,0
1681913655195,MATH 20E,A01,182809,Verstraete; Jacques Allan,24,0,30,6
1681913655195,MATH 20E,A02,182811,Verstraete; Jacques Allan,28,0,30,2
1681913655195,MATH 20E,B01,182814,Verstraete; Jacques Allan,23,0,30,7
1681913655195,MATH 20E,B02,182815,Verstraete; Jacques Allan,30,0,30,0
1681913656219,MATH 103A,A01,182820,Staff,9,0,30,21
1681913656219,MATH 103A,A02,182821,Staff,27,0,30,3
1681913656219,MATH 103A,A03,182822,Staff,23,0,30,7
1681913656219,MATH 103A,B01,182825,Staff,23,0,30,7
1681913656219,MATH 103A,B02,182826,Staff,30,0,30,0
1681913656219,MATH 103A,B03,182830,Staff,30,0,30,0
1681913657244,MATH 109,A01,182836,Chow; Bennett,24,0,30,6
1681913657244,MATH 109,A02,182838,Chow; Bennett,29,0,30,1
1681913657244,MATH 109,A03,182894,Chow; Bennett,29,0,30,1
1681913657244,MATH 109,B01,182908,Chow; Bennett,28,0,30,2
1681913657244,MATH 109,B02,182909,Chow; Bennett,30,0,30,0
1681913657244,MATH 109,B03,182910,Chow; Bennett,27,0,30,3
1681913658267,MATH 142A,A01,182925,Staff,11,0,30,19
1681913658267,MATH 142A,A02,182935,Staff,25,0,30,5
1681913658267,MATH 142A,A03,182967,Staff,26,0,30,4
1681913658267,MATH 142A,B01,183125,Staff,24,0,30,6
1681913658267,MATH 142A,B02,183157,Staff,28,0,30,2
1681913658267,MATH 142A,B03,183158,Staff,29,0,30,1
1681913659294,MATH 183,A01,183160,Arias-Castro; Ery,23,0,30,7
1681913659294,MATH 183,A02,183161,Arias-Castro; Ery,29,0,30,1
1681913659294,MATH 183,B01,183163,Arias-Castro; Ery,28,0,30,2
1681913659294,MATH 183,B02,183164,Arias-Castro; Ery,28,0,30,2
1681913660319,MATH 193A,A01,183167,Staff,4,0,35,31
1681913660319,MATH 193A,A02,183168,Staff,28,0,35,7
1681913660319,MATH 193A,A03,183169,Staff,34,0,35,1
1681913660319,MATH 193A,A04,183170,Staff,28,0,35,7
1681913661343,MGT 4,A01,202395,Anderson; John Charles,75,0,80,5
1681913662374,MGT 5,A00,202396,Houskeeper; Robert,80,0,90,10
1681913663401,MGT 103,A00,202397,Eberhard; Craig A,55,0,90,35
1681913664423,MGT 131A,A00,202398,Houskeeper; Robert,85,0,90,5
1681913665447,MGT 135,A00,202399,Anderson; John Charles,82,0,90,8
1681913666471,MGT 162R,A00,202403,Gneezy; Uri,150,0,200,50
1681913667571,MGT 172,A00,202404,Hedges; Kathleen,50,0,90,40
1681913668594,MGT 181,A00,202405,Dunn; Louis Jean,84,0,90,6
1681913669617,MMW 14,A01,183200,Staff,16,0,28,12
1681913669617,MMW 14,A02,183201,Staff,26,0,28,2
1681913669617,MMW 14,A03,183202,Staff,24,0,28,4
1681913669617,MMW 14,A04,183203,Staff,25,0,28,3
1681913669617,MMW 14,A05,183204,Staff,26,0,28,2
1681913669617,MMW 14,A06,183205,Staff,27,0,28,1
1681913669617,MMW 14,B01,183207,Staff,26,0,28,2
1681913669617,MMW 14,B02,183208,Staff,28,0,28,0
1681913669617,MMW 14,B03,183209,Staff,28,0,28,0
1681913669617,MMW 14,B04,183210,Staff,28,0,28,0
1681913669617,MMW 14,B05,183211,Staff,28,0,28,0
1681913669617,MMW 14,B06,183212,Staff,28,0,28,0
1681913670643,MMW 14GS,A00,183213,Zhiri; Oumelbanine,28,0,28,0
1681913671667,MMW 15GS,B00,183215,Rahimi; Babak,28,0,28,0
1681913672691,MMW 121,A01,183217,Patterson; Patrick H.,14,0,28,14
1681913672691,MMW 121,A02,183218,Patterson; Patrick H.,25,0,28,3
1681913673715,MUS 1A,A01,182554,Staff,8,0,35,27
1681913674744,MUS 5,A01,182558,Staff,20,0,35,15
1681913675768,MUS 6,A01,182562,Staff,25,0,35,10
1681913676792,MUS 8GS,A00,182563,Borgo; David Garcia,25,0,25,0
1681913677815,MUS 13,A01,182567,Staff,24,0,25,1
1681913678839,MUS 15,A01,182570,Staff,32,0,35,3
1681913678839,MUS 15,B01,182575,Staff,10,0,35,25
1681913679864,MUS 80,A00,182578,Staff,23,0,25,2
1681913679864,MUS 80,B00,182581,Staff,20,0,25,5
1681913680889,MUS 113,A00,182582,Staff,25,0,25,0
1681913681912,MUS 114,A00,182583,Staff,4,0,25,21
1681913682934,MUS 150GS,A01,182588,Borgo; David Garcia,25,0,25,0
1681913683956,PHIL 1,A00,182590,Staff,35,0,40,5
1681913684981,PHIL 10,A01,182596,Grush; Rick Scott,31,0,35,4
1681913684981,PHIL 10,A02,182597,Grush; Rick Scott,34,0,35,1
1681913686003,PHIL 15,A01,182601,Staff,31,0,35,4
1681913686003,PHIL 15,A02,182602,Staff,33,0,35,2
1681913687029,PHIL 27,A01,182604,Staff,30,0,35,5
1681913687029,PHIL 27,A02,182607,Staff,35,0,35,0
1681913688054,PHIL 32,A01,182609,Staff,35,0,35,0
1681913688054,PHIL 32,A02,182612,Staff,35,0,35,0
1681913689077,PHIL 130,A00,182614,Staff,63,0,70,7
1681913690100,PHIL 136,A00,182616,Cohen; Jonathan David,66,0,70,4
1681913691128,PHIL 155,A00,182617,Vargas; Manuel Rogelio,60,0,70,10
1681913692150,PHIL 163,A01,182620,Staff,15,0,20,5
1681913692150,PHIL 163,A02,182624,Staff,10,0,20,10
1681913693178,PHIL 164,A00,182627,Staff,30,0,40,10
1681913694204,PHIL 173,A00,182628,Staff,36,0,40,4
1681913695229,PHYS 1A,A00,183221,Staff,54,0,60,6
1681913696255,PHYS 1AL,001,183222,Staff,25,0,30,5
1681913696255,PHYS 1AL,002,183223,Staff,28,0,30,2
1681913697277,PHYS 1B,A00,183231,Staff,44,0,60,16
1681913698307,PHYS 1BL,001,183232,Staff,20,0,30,10
1681913698307,PHYS 1BL,002,183233,Staff,29,0,30,1
1681913699331,PHYS 1C,A00,183240,Staff,30,0,60,30
1681913700366,PHYS 1CL,001,183241,Staff,13,0,30,17
1681913700366,PHYS 1CL,002,183242,Staff,22,0,30,8
1681913701411,PHYS 2AR,A01,183250,Staff,44,0,50,6
1681913702433,PHYS 2B,A01,183252,Staff,106,0,115,9
1681913703455,PHYS 2BL,A01,183254,Staff,21,0,24,3
1681913703455,PHYS 2BL,A02,183255,Staff,22,0,24,2
1681913704480,PHYS 2C,A01,183522,Staff,105,0,115,10
1681913705524,PHYS 4A,A01,183524,Staff,49,0,50,1
1681913706547,POLI 5,A00,183525,Staff,44,0,50,6
1681913707581,POLI 12,A00,183540,Staff,48,0,50,2
1681913708607,POLI 13R,A00,183541,Forman; Fonna,42,0,50,8
1681913709631,POLI 30,A00,183542,Mignozzetti; Umberto,47,0,50,3
1681913710655,POLI 100A,A00,183543,Staff,45,0,50,5
1681913711683,POLI 100E,A00,223598,Staff,32,0,35,3
1681913712715,POLI 103A,A00,183564,Kousser; Thad,38,0,50,12
1681913713737,POLI 104B,A00,201329,Staff,29,0,35,6
1681913714759,POLI 113BR,A00,183576,Hoston; Germaine,27,0,50,23
1681913715782,POLI 114BR,A00,183588,Staff,27,0,30,3
1681913716808,POLI 117R,A00,183595,Forman; Fonna,9,0,20,11
1681913717836,POLI 120H,A00,183596,Fisk; David Lee,13,0,20,7
1681913718862,POLI 130AA,A00,183597,Staff,14,0,20,6
1681913719888,POLI 134AA,A00,183598,Staff,19,0,20,1
1681913720914,POLI 135,A00,183599,Fisk; David Lee,20,0,25,5
1681913721938,POLI 142P,A00,183623,Staff,37,0,40,3
1681913722960,POLI 144D,A00,183624,Staff,22,0,25,3
1681913723983,POLI 151,A00,183625,Staff,15,0,20,5
1681913725006,POLI 162,A00,183626,Mignozzetti; Umberto,18,0,20,2
1681913726030,PSYC 1,A00,253748,Staff,86,0,90,4
1681913727061,PSYC 2,A00,183627,Moranton; Nirelia Melbina-,25,0,35,10
1681913728086,PSYC 3,A00,183628,Staff,43,0,45,2
1681913730136,PSYC 60,A01,183631,Lowe; Angela Beth,35,0,40,5
1681913731161,PSYC 70,A01,253757,Staff,37,0,45,8
1681913732185,PSYC 101,A00,183632,Heyman; Gail D.,48,0,60,12
1681913733208,PSYC 105,A00,183848,Lowe; Angela Beth,50,0,60,10
1681913734233,PSYC 106,A00,183849,Dobkins; Karen R.,45,0,60,15
1681913735259,PSYC 108,A00,253750,Staff,24,0,60,36
1681913736293,PSYC 114,A01,184275,Winkielman; Piotr,0,6,30,30
1681913737320,PSYC 122,A00,183856,Moranton; Nirelia Melbina-,0,10,30,30
1681913738344,PSYC 124,A00,183865,Chapman; Eddie Nathaniel,52,0,80,28
1681913739367,PSYC 137,A00,183880,Staff,19,0,25,6
1681913741416,PSYC 154,A00,183910,Lacefield; Katharine I,0,2,90,90
1681913743469,PSYC 162,A00,183946,Wixted; John T,61,0,90,29
1681913744494,PSYC 172,A00,183947,Gorman; Michael R.,14,0,30,16
1681913745517,PSYC 178,A00,183963,Glaser; Dale,20,0,40,20
1681913746542,PSYC 181GS,A00,183964,Anagnostaras; Stephan,10,0,10,0
1681913747566,PSYC 186GS,A01,257660,Staff,10,0,10,0
1681913748589,PSYC 193,B00,253749,Staff,23,0,25,2
1681913750644,PSYC 193L,A01,184122,Staff,33,0,35,2
1681913750644,PSYC 193L,C01,184167,Winkielman; Piotr,16,0,30,14
1681913751670,RELI 188GS,A00,182629,Rahimi; Babak,20,0,20,0
1681913752694,SE 101A,A00,182646,Staff,26,0,30,4
1681913753721,SE 101C,A00,182650,Staff,18,0,20,2
1681913754746,SE 110A,A00,182651,Staff,28,0,28,0
1681913755770,SE 130A,A00,182652,Staff,39,0,40,1
1681913756793,SIO 46GS,A00,182636,Cook; Geoffrey W,28,0,28,0
1681913757819,SIO 109R,A00,194459,Staff,5,0,20,15
1681913758849,SIO 121GS,A00,182639,Cook; Geoffrey W,28,0,28,0
1681913759871,SIO 132,A01,182642,Staff,32,0,40,8
1681913760897,SIO 139,A00,182644,Kacev; David,36,0,40,4
1681913761922,SOCI 2,A01,258404,Staff,34,0,36,2
1681913761922,SOCI 2,A02,258405,Staff,35,0,36,1
1681913762946,SOCI 60,A01,258408,Staff,29,0,30,1
1681913762946,SOCI 60,A02,258413,Staff,30,0,30,0
1681913763969,SOCI 100,A01,258415,Staff,29,0,30,1
1681913763969,SOCI 100,A02,258416,Staff,28,0,30,2
1681913770118,SOCI 127,A00,258421,Staff,22,0,30,8
1681913771211,SOCI 132,A00,258422,Staff,45,0,50,5
1681913772234,SOCI 133,A00,258423,Staff,26,0,30,4
1681913773257,SOCI 138GS,A00,258424,Staff,15,0,15,0
1681913774281,SOCI 145,A00,258425,Staff,25,0,30,5
1681913775305,SOCI 148,A00,258426,Staff,26,0,30,4
1681913776328,SOCI 153,A00,199217,Staff,29,0,30,1
1681913777351,SOCI 160,A00,258427,Staff,28,0,30,2
1681913778378,SOCI 160E,A00,258435,Staff,56,0,60,4
1681913779402,SOCI 189GS,A00,258436,Staff,15,0,15,0
1681913780428,SOCI 190GS,A00,258437,Staff,15,0,15,0
1681913781456,SYN 2,001,182658,Staff,9,0,16,7
1681913781456,SYN 2,002,201439,Staff,15,0,16,1
1681913781456,SYN 2,003,201443,Staff,16,0,16,0
1681913782480,SYN 100,A01,182657,Staff,17,0,20,3
1681913783509,TDAC 1,A00,184381,Salovey; Todd,16,0,20,4
1681913783509,TDAC 1,B00,184385,Harting; Carla Kelso,19,0,20,1
1681913783509,TDAC 1,C00,184394,Staff,19,0,20,1
1681913784532,TDAC 101,A00,184483,Harting; Carla Kelso,19,0,20,1
1681913785559,TDDE 111,A00,184496,Staff,14,0,15,1
1681913786581,TDDE 131,A00,184504,Staff,20,0,20,0
1681913786581,TDDE 131,B00,184505,Staff,17,0,18,1
1681913786581,TDDE 131,C00,184534,Staff,49,0,50,1
1681913786581,TDDE 131,D00,184564,Staff,15,0,15,0
1681913786581,TDDE 131,E00,204725,Staff,19,0,20,1
1681913787603,TDGE 1,A01,184414,Salovey; Todd,37,0,50,13
1681913788630,TDGE 5,A01,184419,Staff,23,0,24,1
1681913789652,TDGE 10,A00,184428,Fulton; Julia,31,0,50,19
1681913790678,TDGE 124,A00,184565,Fulton; Julia,7,0,50,43
1681913791701,TDGE 125,B00,184567,Meyer; Ursula,9,0,25,16
1681913792723,TDHT 101,A00,184568,Staff,21,0,25,4
1681913792723,TDHT 101,B00,184569,Staff,20,0,20,0
1681913793749,TDHT 114,A00,184570,Staff,49,0,50,1
1681913794776,TDMV 1,A00,184437,Arcidiacono; Kristin,23,0,30,7
1681913794776,TDMV 1,B00,184448,Caligagan; Maria T.,22,0,30,8
1681913795803,TDMV 2,A00,184449,Weinberg; Sadie,27,0,30,3
1681913795803,TDMV 2,B00,184453,Arcidiacono; Kristin,29,0,30,1
1681913796829,TDMV 110,A00,184571,Weinberg; Sadie,30,0,30,0
1681913797854,TDMV 142,A00,184572,Caligagan; Tony,27,0,30,3
1681913797854,TDMV 142,B00,184573,Caligagan; Maria T.,27,0,30,3
1681913798881,TDTR 20,A00,184482,Jun; Grace Shin Hae,25,0,25,0
1681913799905,USP 2,A01,184290,Hinds; Juli Beth,24,0,25,1
1681913800935,USP 3,A01,184295,Staff,20,0,25,5
1681913801959,USP 4,A00,184304,McTague; Sarah,15,0,25,10
1681913802986,USP 100,A00,184315,Staff,17,0,25,8
1681913804011,USP 105,A00,184326,Staff,21,0,25,4
1681913805033,USP 151,A00,184327,Staff,20,0,25,5
1681913806058,USP 170,A00,184380,Hinds; Juli Beth,14,0,25,11
1681913807092,VIS 21B,A01,182660,Staff,28,0,31,3
1681913807092,VIS 21B,A02,182662,Staff,30,0,31,1
1681913808115,VIS 103D,A00,182663,Staff,74,0,75,1
1681913809138,VIS 105D,A00,182667,Li; Huai,15,0,22,7
1681913810169,VIS 122GS,A00,182668,Herbst; Matthew,20,0,20,0
1681913811195,VIS 128C,A00,182673,Staff,69,0,75,6
1681913812221,VIS 130,A00,182675,Staff,20,0,22,2
1681913813252,VIS 160A,A00,182678,Stalbaum; Brett,4,0,10,6
1681913815301,WCWP 10B,A00,201679,Staff,15,0,15,0
1681913815301,WCWP 10B,B00,201695,Staff,15,0,15,0
1681913816324,WCWP 100,A00,201716,Staff,15,0,15,0
1681913816324,WCWP 100,B00,201717,Staff,11,0,15,4
1681913818399,ANSC 105GS,A00,258289,Staff,0,0,0,0
1681913819424,ANSC 125GS,A00,258295,Staff,0,0,0,0
1681913820456,ANSC 150,A00,258267,Staff,30,0,40,10
1681913821479,ANSC 190GS,A00,258280,Staff,0,0,0,0
1681913822503,ANTH 1,A00,258264,Staff,38,0,40,2
1681913823527,ANTH 2,A01,258259,Staff,72,0,76,4
1681913824551,ANTH 23,A01,258228,Staff,36,0,40,4
1681913825573,ANTH 101,A01,258236,Staff,39,0,40,1
1681913826595,ANTH 102,A00,258272,Staff,59,0,60,1
1681913827621,ANTH 105,A00,258244,Staff,31,0,35,4
1681913828646,BENG 130,A00,253975,Staff,38,0,40,2
1681913829673,BIBC 102,A01,191866,Flagg; Matthew Paul,19,0,32,13
1681913829673,BIBC 102,A02,191867,Flagg; Matthew Paul,22,0,32,10
1681913829673,BIBC 102,A03,191868,Flagg; Matthew Paul,30,0,32,2
1681913829673,BIBC 102,A04,191936,Flagg; Matthew Paul,26,0,32,6
1681913829673,BIBC 102,A05,191937,Flagg; Matthew Paul,11,0,32,21
1681913830700,BICD 100,A01,191939,Cooper; Andrew Michael,28,0,32,4
1681913830700,BICD 100,A02,191940,Cooper; Andrew Michael,32,0,32,0
1681913830700,BICD 100,A03,191941,Cooper; Andrew Michael,32,0,32,0
1681913830700,BICD 100,A04,191942,Cooper; Andrew Michael,32,0,32,0
1681913830700,BICD 100,A05,191943,Cooper; Andrew Michael,32,0,32,0
1681913831729,BIEB 126,A01,191945,Cleland; Elsa Eleanor,1,0,32,31
1681913831729,BIEB 126,A02,191946,Cleland; Elsa Eleanor,28,0,32,4
1681913831729,BIEB 126,A03,191947,Cleland; Elsa Eleanor,29,0,32,3
1681913831729,BIEB 126,A04,191948,Cleland; Elsa Eleanor,23,0,32,9
1681913831729,BIEB 126,A05,191996,Cleland; Elsa Eleanor,28,0,32,4
1681913832765,BIEB 136GS,A00,191997,Shurin; Jonathan & Holway; David A.,0,0,0,0
1681913833792,BIEB 137GS,A01,191999,Shurin; Jonathan & Holway; David A.,0,0,0,0
1681913834814,BILD 1,A01,205385,Staff,31,0,32,1
1681913834814,BILD 1,A02,205386,Staff,30,0,32,2
1681913834814,BILD 1,A03,205387,Staff,32,0,32,0
1681913834814,BILD 1,A04,205388,Staff,28,0,32,4
1681913835837,BILD 2,A01,191774,Staff,28,0,32,4
1681913835837,BILD 2,A02,191775,Staff,30,0,32,2
1681913835837,BILD 2,A03,191777,Staff,30,0,32,2
1681913835837,BILD 2,A04,191856,Staff,31,0,32,1
1681913835837,BILD 2,A05,191857,Staff,32,0,32,0
1681913835837,BILD 2,A06,191858,Staff,32,0,32,0
1681913835837,BILD 2,A07,191859,Staff,31,0,32,1
1681913836861,BILD 3,A01,205391,Staff,29,0,32,3
1681913836861,BILD 3,A02,205393,Staff,32,0,32,0
1681913836861,BILD 3,A03,205394,Staff,28,0,32,4
1681913836861,BILD 3,A04,205395,Staff,32,0,32,0
1681913837883,BILD 20,A01,191861,Staff,32,0,32,0
1681913837883,BILD 20,A02,191862,Staff,32,0,32,0
1681913838910,BILD 30,A01,191864,Staff,31,0,32,1
1681913839935,BIMM 100,A01,192019,Staff,0,0,32,32
1681913839935,BIMM 100,A02,192020,Staff,23,0,32,9
1681913839935,BIMM 100,A03,192035,Staff,22,0,32,10
1681913840959,BIMM 110,A01,192037,Tat; John,0,0,32,32
1681913840959,BIMM 110,A02,192038,Tat; John,10,0,32,22
1681913841983,BIMM 120,A01,192040,Pickett; Brooke Elizabeth,2,0,32,30
1681913841983,BIMM 120,A02,192041,Pickett; Brooke Elizabeth,16,0,32,16
1681913841983,BIMM 120,A03,192042,Pickett; Brooke Elizabeth,16,0,32,16
1681913843007,BIPN 100,A01,192044,Armour; Jon Christopher,26,0,32,6
1681913843007,BIPN 100,A02,192059,Armour; Jon Christopher,30,0,32,2
1681913843007,BIPN 100,A03,192064,Armour; Jon Christopher,31,0,32,1
1681913843007,BIPN 100,A04,192073,Armour; Jon Christopher,28,0,32,4
1681913844034,BIPN 148,A01,205411,Leutgeb; Jill K.,16,0,32,16
1681913844034,BIPN 148,A02,205412,Leutgeb; Jill K.,31,0,32,1
1681913844034,BIPN 148,A03,205413,Leutgeb; Jill K.,30,0,32,2
1681913844034,BIPN 148,A04,205414,Leutgeb; Jill K.,30,0,32,2
1681913845058,BIPN 160,A01,192115,Marino; Marc J,19,0,32,13
1681913845058,BIPN 160,A02,192148,Marino; Marc J,27,0,32,5
1681913845058,BIPN 160,A03,192158,Marino; Marc J,31,0,32,1
1681913845058,BIPN 160,A04,192190,Marino; Marc J,32,0,32,0
1681913845058,BIPN 160,A05,192287,Marino; Marc J,32,0,32,0
1681913845058,BIPN 160,A06,192288,Marino; Marc J,32,0,32,0
1681913846085,BIPN 194,A00,206038,Staff,28,0,32,4
1681913847112,BISP 194,A00,192289,Leutgeb; Stefan,13,0,32,19
1681913847112,BISP 194,B00,245332,Nieh; James Charles,27,0,32,5
1681913848135,CAT 124,A01,202247,Staff,15,0,15,0
1681913849158,CAT 125,A00,202248,Staff,19,0,20,1
1681913849158,CAT 125,B00,202253,Staff,20,0,20,0
1681913849158,CAT 125,C00,202257,Staff,19,0,20,1
1681913850182,CAT 125GS,A01,202273,Bronstein; Phoebe Malan,20,0,20,0
1681913851210,CAT 125R,A00,202284,Staff,17,0,20,3
1681913851210,CAT 125R,C00,202286,Staff,10,0,20,10
1681913851210,CAT 125R,D00,202291,Staff,18,0,20,2
1681913851210,CAT 125R,E00,202295,Staff,13,0,20,7
1681913851210,CAT 125R,F00,202302,Staff,12,0,20,8
1681913852237,CENG 100,A00,204724,Opatkiewicz; Justin Paul,25,0,25,0
1681913853266,CGS 2A,A01,180420,Staff,31,0,36,5
1681913854290,CGS 101,A00,180421,Staff,16,0,20,4
1681913855313,CGS 112,A00,180422,Staff,10,0,16,6
1681913856336,CGS 113,A00,180423,Staff,18,0,20,2
1681913857360,CGS 137,A00,180424,Staff,12,0,12,0
1681913858383,CGS 147,A00,180425,Staff,10,0,10,0
1681913859412,CHEM 6A,A01,179556,Staff,97,0,100,3
1681913859412,CHEM 6A,A02,179558,Staff,0,0,0,0
1681913860439,CHEM 6B,A01,179560,Staff,100,0,100,0
1681913861466,CHEM 6C,A01,179565,Jazzar; Rodolphe,95,0,100,5
1681913862493,CHEM 7L,A01,179586,Schurmeier; Kimberly,13,0,24,11
1681913862493,CHEM 7L,A02,179587,Schurmeier; Kimberly,23,0,24,1
1681913862493,CHEM 7L,A03,179590,Schurmeier; Kimberly,22,0,24,2
1681913862493,CHEM 7L,A04,179591,Schurmeier; Kimberly,22,0,24,2
1681913862493,CHEM 7L,B01,179598,Schurmeier; Kimberly,17,0,24,7
1681913862493,CHEM 7L,B02,179599,Schurmeier; Kimberly,24,0,24,0
1681913862493,CHEM 7L,B03,179606,Schurmeier; Kimberly,23,0,24,1
1681913862493,CHEM 7L,B04,179607,Schurmeier; Kimberly,23,0,24,1
1681913863518,CHEM 11,A01,179609,Stallings; Dontarie M,88,0,100,12
1681913864540,CHEM 40A,A01,179621,Staff,41,0,50,9
1681913864540,CHEM 40A,A02,179622,Staff,47,0,50,3
1681913865566,CHEM 40B,A01,179630,Weizman; Haim,48,0,50,2
1681913865566,CHEM 40B,A02,179631,Weizman; Haim,45,0,50,5
1681913866590,CHEM 41A,A01,179660,Klosterman; Jeremy K,93,0,100,7
1681913867614,CHEM 43A,A01,179683,Klosterman; Jeremy K,0,0,24,24
1681913867614,CHEM 43A,A02,179688,Klosterman; Jeremy K,14,0,24,10
1681913867614,CHEM 43A,A03,179689,Klosterman; Jeremy K,20,0,24,4
1681913867614,CHEM 43A,A04,179691,Klosterman; Jeremy K,18,0,24,6
1681913868638,CHEM 114A,A01,179693,Stallings; Dontarie M,77,0,100,23
1681913869662,CHEM 143B,A01,179698,Weizman; Haim,17,0,24,7
1681913869662,CHEM 143B,A02,179700,Weizman; Haim,24,0,24,0
1681913870687,CHIN 169A,A00,179701,Wang; Xiao,20,0,20,0
1681913871711,COGS 2,A01,179750,Boyle; Mary E. T.,17,0,30,13
1681913872737,COGS 9,A01,179759,Jones; Cameron Robert,43,0,50,7
1681913873764,COGS 14A,A01,179854,Staff,18,0,50,32
1681913874876,COGS 14B,A01,179856,Staff,54,0,60,6
1681913875904,COGS 17,A01,179874,Staff,71,0,75,4
1681913876928,COGS 18,A01,179884,Staff,63,0,80,17
1681913877951,COGS 100,A01,179886,Staff,40,0,60,20
1681913878974,COGS 101B,A01,179892,Staff,1,0,30,29
1681913879997,COGS 101C,A01,179894,Staff,28,0,30,2
1681913881020,COGS 107A,A01,179896,Boyle; Mary E. T.,31,0,40,9
1681913882052,COGS 108,A01,179898,Simpkins; Charles Alexander,0,17,60,60
1681913883076,COGS 109,A01,179900,Staff,34,0,40,6
1681913884104,COGS 118A,A01,179946,Staff,9,0,40,31
1681913885128,COGS 153,A00,179978,Staff,1,0,30,29
1681913886151,COGS 156,A01,179981,Staff,27,0,30,3
1681913888202,COGS 172,A01,179987,Staff,13,0,30,17
1681913890252,COGS 186,A01,179991,Staff,13,0,30,17
1681913891278,COMM 10,A01,180001,Staff,15,0,25,10
1681913891278,COMM 10,A02,180004,Staff,20,0,25,5
1681913892300,COMM 100A,A01,180016,Staff,18,0,25,7
1681913892300,COMM 100A,A02,180020,Staff,24,0,25,1
1681913893322,COMM 101T,A00,180029,Halm; Gavin Patrick,23,0,35,12
1681913894350,COMM 106V,A00,180043,Staff,34,0,35,1
1681913895373,COMM 109P,A00,180044,Staff,31,0,35,4
1681913896400,COMM 113T,A00,180045,Havis; Allan,37,0,45,8
1681913897426,COMM 132,A00,180046,McKenna; Denise,23,0,30,7
1681913898451,COMM 143,A00,180047,Staff,19,0,30,11
1681913899474,COMM 190,A00,180048,Conner; Thomas Hartnell,20,0,23,3
1681913900497,CSE 8A,A50,180053,Cao; Yingjun,25,0,50,25
1681913900497,CSE 8A,B50,180180,Staff,50,0,50,0
1681913901521,CSE 11,A01,180190,Cao; Yingjun,31,0,50,19
1681913902547,CSE 20,A01,180192,Briones; Jor-el Thomas Caparas,23,0,30,7
1681913903574,CSE 21,A01,194538,Briones; Jor-el Thomas Caparas,50,0,60,10
1681913904598,CSE 30,A01,180324,Eldon; John,78,0,100,22
1681913905623,CSE 101,A01,201353,Staff,0,20,40,40
1681913906647,CSE 134B,A01,180326,Powell; Thomas Allan,74,0,100,26
1681913907674,CSE 140,A01,180328,Staff,46,0,75,29
1681913908697,CSE 140L,A01,180344,Eldon; John,69,0,100,31
1681913909721,CSE 150A,A01,180411,Staff,0,7,50,50
1681913910747,CSE 151A,A01,180414,Staff,0,6,50,50
1681913911772,CSE 175,A01,222521,Kumar; Rakesh,50,0,50,0
1681913912797,CSE 190,A00,201419,Staff,45,0,49,4
1681913913820,CSS 1,A01,194536,Staff,38,0,50,12
1681913914844,DSC 30,A01,202385,Staff,48,0,50,2
1681913915872,DSC 40A,A01,202387,Albuyeh; Rod,50,0,50,0
1681913916902,DSC 190,A01,202389,Silberman; Jack,21,0,21,0
1681913917928,DSGN 100,A01,179993,Staff,16,0,30,14
1681913918959,ECE 65,A50,180708,Staff,10,0,20,10
1681913918959,ECE 65,A51,180739,Staff,19,0,20,1
1681913919987,ECON 1,A01,180427,Famulari; Melissa,67,0,70,3
1681913921011,ECON 2,A01,180450,Levkoff; Steven B.,64,0,70,6
1681913922037,ECON 4,A01,203351,Anderson; John Charles,7,0,10,3
1681913923065,ECON 100A,A01,180472,Famulari; Melissa,65,0,70,5
1681913924090,ECON 120A,A01,180549,Staff,64,0,70,6
1681913925117,ECON 120B,A01,180655,Ma; Xinwei,46,0,70,24
1681913926142,ECON 129,A00,203333,Eckert; Fabian Paul,15,0,35,20
1681913927165,ECON 131,A00,180656,Staff,9,0,35,26
1681913928189,ECON 172B,A01,180672,Levkoff; Steven B.,32,0,35,3
1681913929212,ECON 178,A01,203342,Zhu; Ying,11,0,35,24
1681913930237,EDS 108GS,A00,202383,Wishard Guerra; Alison G.,20,0,20,0
1681913931261,EDS 111GS,A00,202347,Wishard Guerra; Alison G.,20,0,20,0
1681913932285,EDS 112,A01,202323,Staff,56,0,60,4
1681913933309,EDS 113,A00,202340,Staff,33,0,35,2
1681913934336,EDS 118,A00,201231,Staff,20,0,30,10
1681913935363,EDS 119,A00,204994,Staff,8,0,10,2
1681913936385,EDS 124BR,A00,202324,Eguchi; Emi,5,0,25,20
1681913937411,EDS 126,A01,203208,Jones; Makeba,26,0,30,4
1681913938437,EDS 135,A01,202333,Staff,18,0,20,2
1681913939461,EDS 180,A00,202311,Staff,47,0,50,3
1681913940487,ERC 190GS,A01,253747,Staff,28,0,28,0
1681913941522,ETHN 104,A00,180742,Staff,24,0,35,11
1681913942546,ETHN 118,A00,180745,Staff,28,0,35,7
1681913943579,ETHN 127,A00,180747,Staff,12,0,16,4
1681913944610,ETHN 137,A00,180880,Staff,12,0,12,0
1681913945633,ETHN 147,A00,180890,Staff,8,0,10,2
1681913946656,ETHN 154,A00,180891,Staff,7,0,8,1
1681913947682,ETHN 168,A00,180892,Staff,9,0,10,1
1681913948707,GLBH 20,A00,201051,Hannah; Seth Donal,0,1,0,1
1681913949736,GLBH 111,A01,209338,Burgos; Jose L.,0,0,0,0
1681913950762,GLBH 150,A00,258300,Staff,0,3,0,0
1681913951790,GLBH 181,A00,201207,Staff,15,0,40,25
1681913952819,HIEU 109,A00,180898,Staff,20,0,20,0
1681913953842,HIEU 111,A00,180899,Staff,1,0,20,19
1681913954865,HIEU 124,A00,180900,Staff,18,0,20,2
1681913955891,HILA 122,A00,180901,Staff,18,0,20,2
1681913956917,HILA 132,A00,180902,Vitz; Matthew,2,0,20,18
1681913957944,HILD 10,A01,180896,Staff,15,0,20,5
1681913958971,HILD 30GS,A00,180897,Edington; Claire Ellen,0,0,0,0
1681913959997,HISC 105,A00,180903,Staff,20,0,20,0
1681913961022,HISC 117,A00,180904,Staff,11,0,20,9
1681913962047,HIUS 108B,A00,181005,Staff,18,0,20,2
1681913963074,HIUS 113,A00,181093,Staff,4,0,20,16
1681913964100,HUM 3,A01,181190,Patterson; Patrick H.,40,0,50,10
1681913964100,HUM 3,B01,181195,Staff,47,0,50,3
1681913965124,HUM 3GS,A00,181196,Herbst; Matthew,0,0,0,0
1681913966149,HUM 4,A01,181227,West; Geoffrey Scott,34,0,50,16
1681913966149,HUM 4,B01,181282,Staff,43,0,50,7
1681913967172,HUM 4GS,A00,181377,Lyon; Antony J.,0,0,0,0
1681913968202,HUM 5,A01,181536,Zavodny; Tatiana Sophia,31,0,50,19
1681913968202,HUM 5,B01,181908,Staff,36,0,50,14
1681913969229,INTL 190,A00,181909,Segui; Alan S,0,0,0,6
1681913969229,INTL 190,B00,181961,Segui; Alan S,0,0,0,7
1681913970261,JAPN 20AR,A01,182113,Ross; Kayoko F,15,0,20,5
1681913971285,LATI 50,A01,202391,Martin-Cabrera; Luis,19,0,30,11
1681913971285,LATI 50,A02,202392,Martin-Cabrera; Luis,26,0,30,4
1681913972309,LATI 180,A00,202393,Kokinis; Troy Andreas,25,0,25,0
1681913973336,LIFR 1A,A00,182119,Staff,14,0,14,0
1681913974362,LIFR 1AX,A00,182324,Staff,14,0,14,0
1681913975385,LIFR 1B,A00,182259,Staff,14,0,14,0
1681913976410,LIFR 1BX,A00,182273,Staff,14,0,14,0
1681913977434,LIGN 8,A00,182330,Staff,137,0,150,13
1681913978528,LIGN 9GS,A00,182362,Staff,20,0,20,0
1681913979552,LIGN 119,A00,204992,Takahashi; Maho,12,0,15,3
1681913980576,LIGN 130,A01,182384,Staff,47,0,50,3
1681913981599,LIGN 149GS,A00,182390,Staff,20,0,20,0
1681913982632,LIGN 170,A00,182404,Staff,24,0,30,6
1681913983660,LISP 1D,A00,182281,Staff,7,0,14,7
1681913983660,LISP 1D,B00,182287,Staff,14,0,14,0
1681913983660,LISP 1D,C00,182295,Staff,11,0,14,3
1681913983660,LISP 1D,D00,182301,Staff,14,0,14,0
1681913984684,LISP 1DX,A00,182309,Staff,20,0,28,8
1681913984684,LISP 1DX,B00,182316,Staff,26,0,28,2
1681913985711,LTAF 120GS,A00,182412,Zhiri; Oumelbanine,20,0,20,0
1681913986736,LTCS 172GS,A00,182437,Bronstein; Phoebe Malan,20,0,20,0
1681913987759,LTEA 138,A00,182457,Staff,22,0,40,18
1681913988786,LTEN 114,A01,182490,Staff,23,0,25,2
1681913989813,LTEN 130GS,A00,182491,Lyon; Antony J.,20,0,20,0
1681913990837,LTEN 169,A00,182493,Cuong; Marisol,20,0,25,5
1681913991867,LTEN 178,A00,182501,Staff,14,0,15,1
1681913992891,LTEN 181,A00,182515,Staff,22,0,25,3
1681913993918,LTEN 185GS,A00,197655,Forbes; Camille,20,0,20,0
1681913994941,LTSP 100B,A00,202208,Bessett; Ryan Matthew,24,0,25,1
1681913995967,LTWL 100,A00,182516,Myerston Santana; Jacobo,22,0,30,8
1681913996995,LTWR 100GS,A00,182518,Forbes; Camille,20,0,20,0
1681913998017,LTWR 102,A00,182522,Staff,15,0,15,0
1681913998017,LTWR 102,B00,182525,Staff,14,0,15,1
1681913999039,LTWR 115,A00,182526,Staff,12,0,15,3
1681914000066,MAE 8,A01,182528,Pham; Hieu Tan,68,0,70,2
1681914001091,MAE 11,A00,182529,Bahadori; Mohammad Yousef,94,0,100,6
1681914002115,MAE 20,A00,182530,Evdokimenko; Ekaterina,68,0,70,2
1681914003137,MAE 30A,A00,182532,Staff,44,0,45,1
1681914004162,MAE 101A,A00,182533,Bahadori; Mohammad Yousef,97,0,100,3
1681914005189,MAE 101C,A00,182538,Staff,62,0,70,8
1681914006213,MAE 104,A00,182539,Staff,45,0,50,5
1681914007251,MAE 131A,A00,182540,Ghazinejad; Maziar,41,0,45,4
1681914008276,MAE 143A,A00,182548,Bewley; Thomas R,43,0,50,7
1681914009302,MAE 150,A00,182549,Staff,28,0,40,12
1681914010335,MAE 160,A00,182550,Evdokimenko; Ekaterina,43,0,60,17
1681914011358,MATH 3C,A01,182725,Staff,27,0,30,3
1681914012381,MATH 10A,A01,182729,Staff,25,0,30,5
1681914012381,MATH 10A,B01,182732,Staff,26,0,30,4
1681914013411,MATH 10B,A01,182737,Staff,21,0,30,9
1681914013411,MATH 10B,A02,182738,Staff,27,0,30,3
1681914013411,MATH 10B,B01,182744,Staff,27,0,30,3
1681914013411,MATH 10B,B02,182745,Staff,27,0,30,3
1681914014440,MATH 18,A01,182750,Anzaldo; Leesa B,28,0,30,2
1681914014440,MATH 18,A02,182751,Anzaldo; Leesa B,29,0,30,1
1681914014440,MATH 18,A03,182753,Anzaldo; Leesa B,28,0,30,2
1681914014440,MATH 18,A04,182757,Anzaldo; Leesa B,29,0,30,1
1681914014440,MATH 18,B01,182761,Anzaldo; Leesa B,27,0,30,3
1681914014440,MATH 18,B02,182764,Anzaldo; Leesa B,27,0,30,3
1681914014440,MATH 18,B03,182765,Anzaldo; Leesa B,30,0,30,0
1681914014440,MATH 18,B04,182766,Anzaldo; Leesa B,30,0,30,0
1681914015467,MATH 20A,A01,182771,Suk; Andrew Hoon,28,0,30,2
1681914016491,MATH 20B,A01,182775,Bach; Quang Tran,30,0,30,0
1681914016491,MATH 20B,A02,182777,Bach; Quang Tran,29,0,30,1
1681914016491,MATH 20B,B01,182780,Bach; Quang Tran,27,0,30,3
1681914016491,MATH 20B,B02,182782,Bach; Quang Tran,30,0,30,0
1681914017515,MATH 20C,A01,182787,Staff,25,0,30,5
1681914017515,MATH 20C,A02,182790,Staff,29,0,30,1
1681914017515,MATH 20C,B01,182792,Staff,25,0,30,5
1681914017515,MATH 20C,B02,182796,Staff,27,0,30,3
1681914018543,MATH 20D,A01,182799,Staff,29,0,30,1
1681914018543,MATH 20D,A02,182802,Staff,30,0,30,0
1681914018543,MATH 20D,A03,182803,Staff,30,0,30,0
1681914019572,MATH 20E,A01,182809,Verstraete; Jacques Allan,24,0,30,6
1681914019572,MATH 20E,A02,182811,Verstraete; Jacques Allan,28,0,30,2
1681914019572,MATH 20E,B01,182814,Verstraete; Jacques Allan,23,0,30,7
1681914019572,MATH 20E,B02,182815,Verstraete; Jacques Allan,30,0,30,0
1681914020600,MATH 103A,A01,182820,Staff,9,0,30,21
1681914020600,MATH 103A,A02,182821,Staff,27,0,30,3
1681914020600,MATH 103A,A03,182822,Staff,23,0,30,7
1681914020600,MATH 103A,B01,182825,Staff,23,0,30,7
1681914020600,MATH 103A,B02,182826,Staff,30,0,30,0
1681914020600,MATH 103A,B03,182830,Staff,30,0,30,0
1681914021628,MATH 109,A01,182836,Chow; Bennett,24,0,30,6
1681914021628,MATH 109,A02,182838,Chow; Bennett,29,0,30,1
1681914021628,MATH 109,A03,182894,Chow; Bennett,29,0,30,1
1681914021628,MATH 109,B01,182908,Chow; Bennett,28,0,30,2
1681914021628,MATH 109,B02,182909,Chow; Bennett,30,0,30,0
1681914021628,MATH 109,B03,182910,Chow; Bennett,27,0,30,3
1681914022655,MATH 142A,A01,182925,Staff,11,0,30,19
1681914022655,MATH 142A,A02,182935,Staff,25,0,30,5
1681914022655,MATH 142A,A03,182967,Staff,26,0,30,4
1681914022655,MATH 142A,B01,183125,Staff,24,0,30,6
1681914022655,MATH 142A,B02,183157,Staff,28,0,30,2
1681914022655,MATH 142A,B03,183158,Staff,29,0,30,1
1681914023679,MATH 183,A01,183160,Arias-Castro; Ery,23,0,30,7
1681914023679,MATH 183,A02,183161,Arias-Castro; Ery,29,0,30,1
1681914023679,MATH 183,B01,183163,Arias-Castro; Ery,28,0,30,2
1681914023679,MATH 183,B02,183164,Arias-Castro; Ery,28,0,30,2
1681914024703,MATH 193A,A01,183167,Staff,4,0,35,31
1681914024703,MATH 193A,A02,183168,Staff,28,0,35,7
1681914024703,MATH 193A,A03,183169,Staff,34,0,35,1
1681914024703,MATH 193A,A04,183170,Staff,28,0,35,7
1681914025751,MGT 4,A01,202395,Anderson; John Charles,75,0,80,5
1681914026778,MGT 5,A00,202396,Houskeeper; Robert,80,0,90,10
1681914027801,MGT 103,A00,202397,Eberhard; Craig A,55,0,90,35
1681914028823,MGT 131A,A00,202398,Houskeeper; Robert,85,0,90,5
1681914029846,MGT 135,A00,202399,Anderson; John Charles,82,0,90,8
1681914030877,MGT 162R,A00,202403,Gneezy; Uri,150,0,200,50
1681914031902,MGT 172,A00,202404,Hedges; Kathleen,50,0,90,40
1681914032930,MGT 181,A00,202405,Dunn; Louis Jean,84,0,90,6
1681914033953,MMW 14,A01,183200,Staff,16,0,28,12
1681914033953,MMW 14,A02,183201,Staff,26,0,28,2
1681914033953,MMW 14,A03,183202,Staff,24,0,28,4
1681914033953,MMW 14,A04,183203,Staff,25,0,28,3
1681914033953,MMW 14,A05,183204,Staff,26,0,28,2
1681914033953,MMW 14,A06,183205,Staff,27,0,28,1
1681914033953,MMW 14,B01,183207,Staff,26,0,28,2
1681914033953,MMW 14,B02,183208,Staff,28,0,28,0
1681914033953,MMW 14,B03,183209,Staff,28,0,28,0
1681914033953,MMW 14,B04,183210,Staff,28,0,28,0
1681914033953,MMW 14,B05,183211,Staff,28,0,28,0
1681914033953,MMW 14,B06,183212,Staff,28,0,28,0
1681914034980,MMW 14GS,A00,183213,Zhiri; Oumelbanine,28,0,28,0
1681914036003,MMW 15GS,B00,183215,Rahimi; Babak,28,0,28,0
1681914037036,MMW 121,A01,183217,Patterson; Patrick H.,14,0,28,14
1681914037036,MMW 121,A02,183218,Patterson; Patrick H.,25,0,28,3
1681914038059,MUS 1A,A01,182554,Staff,8,0,35,27
1681914039086,MUS 5,A01,182558,Staff,20,0,35,15
1681914040110,MUS 6,A01,182562,Staff,25,0,35,10
1681914041136,MUS 8GS,A00,182563,Borgo; David Garcia,25,0,25,0
1681914042163,MUS 13,A01,182567,Staff,24,0,25,1
1681914043186,MUS 15,A01,182570,Staff,32,0,35,3
1681914043186,MUS 15,B01,182575,Staff,10,0,35,25
1681914044217,MUS 80,A00,182578,Staff,23,0,25,2
1681914044217,MUS 80,B00,182581,Staff,20,0,25,5
1681914045243,MUS 113,A00,182582,Staff,25,0,25,0
1681914046266,MUS 114,A00,182583,Staff,4,0,25,21
1681914047289,MUS 150GS,A01,182588,Borgo; David Garcia,25,0,25,0
1681914048311,PHIL 1,A00,182590,Staff,35,0,40,5
1681914049352,PHIL 10,A01,182596,Grush; Rick Scott,31,0,35,4
1681914049352,PHIL 10,A02,182597,Grush; Rick Scott,34,0,35,1
1681914050374,PHIL 15,A01,182601,Staff,31,0,35,4
1681914050374,PHIL 15,A02,182602,Staff,33,0,35,2
1681914051399,PHIL 27,A01,182604,Staff,30,0,35,5
1681914051399,PHIL 27,A02,182607,Staff,35,0,35,0
1681914052434,PHIL 32,A01,182609,Staff,35,0,35,0
1681914052434,PHIL 32,A02,182612,Staff,35,0,35,0
1681914053457,PHIL 130,A00,182614,Staff,63,0,70,7
1681914054489,PHIL 136,A00,182616,Cohen; Jonathan David,66,0,70,4
1681914055517,PHIL 155,A00,182617,Vargas; Manuel Rogelio,60,0,70,10
1681914056541,PHIL 163,A01,182620,Staff,15,0,20,5
1681914056541,PHIL 163,A02,182624,Staff,10,0,20,10
1681914057572,PHIL 164,A00,182627,Staff,30,0,40,10
1681914058597,PHIL 173,A00,182628,Staff,36,0,40,4
1681914059626,PHYS 1A,A00,183221,Staff,54,0,60,6
1681914060657,PHYS 1AL,001,183222,Staff,25,0,30,5
1681914060657,PHYS 1AL,002,183223,Staff,28,0,30,2
1681914061681,PHYS 1B,A00,183231,Staff,44,0,60,16
1681914062709,PHYS 1BL,001,183232,Staff,20,0,30,10
1681914062709,PHYS 1BL,002,183233,Staff,29,0,30,1
1681914063736,PHYS 1C,A00,183240,Staff,30,0,60,30
1681914064761,PHYS 1CL,001,183241,Staff,13,0,30,17
1681914064761,PHYS 1CL,002,183242,Staff,22,0,30,8
1681914065787,PHYS 2AR,A01,183250,Staff,44,0,50,6
1681914066810,PHYS 2B,A01,183252,Staff,106,0,115,9
1681914067843,PHYS 2BL,A01,183254,Staff,21,0,24,3
1681914067843,PHYS 2BL,A02,183255,Staff,22,0,24,2
1681914068869,PHYS 2C,A01,183522,Staff,105,0,115,10
1681914069897,PHYS 4A,A01,183524,Staff,49,0,50,1
1681914070924,POLI 5,A00,183525,Staff,44,0,50,6
1681914071950,POLI 12,A00,183540,Staff,48,0,50,2
1681914072973,POLI 13R,A00,183541,Forman; Fonna,42,0,50,8
1681914073997,POLI 30,A00,183542,Mignozzetti; Umberto,47,0,50,3
1681914075029,POLI 100A,A00,183543,Staff,45,0,50,5
1681914076058,POLI 100E,A00,223598,Staff,32,0,35,3
1681914077086,POLI 103A,A00,183564,Kousser; Thad,38,0,50,12
1681914078109,POLI 104B,A00,201329,Staff,29,0,35,6
1681914079138,POLI 113BR,A00,183576,Hoston; Germaine,27,0,50,23
1681914080165,POLI 114BR,A00,183588,Staff,27,0,30,3
1681914081196,POLI 117R,A00,183595,Forman; Fonna,9,0,20,11
1681914082297,POLI 120H,A00,183596,Fisk; David Lee,13,0,20,7
1681914083321,POLI 130AA,A00,183597,Staff,14,0,20,6
1681914084345,POLI 134AA,A00,183598,Staff,19,0,20,1
1681914085374,POLI 135,A00,183599,Fisk; David Lee,20,0,25,5
1681914086400,POLI 142P,A00,183623,Staff,37,0,40,3
1681914087426,POLI 144D,A00,183624,Staff,22,0,25,3
1681914088449,POLI 151,A00,183625,Staff,15,0,20,5
1681914089472,POLI 162,A00,183626,Mignozzetti; Umberto,18,0,20,2
1681914090499,PSYC 1,A00,253748,Staff,86,0,90,4
1681914091523,PSYC 2,A00,183627,Moranton; Nirelia Melbina-,25,0,35,10
1681914092546,PSYC 3,A00,183628,Staff,43,0,45,2
1681914094594,PSYC 60,A01,183631,Lowe; Angela Beth,35,0,40,5
1681914095617,PSYC 70,A01,253757,Staff,37,0,45,8
1681914096647,PSYC 101,A00,183632,Heyman; Gail D.,48,0,60,12
1681914097673,PSYC 105,A00,183848,Lowe; Angela Beth,50,0,60,10
1681914098695,PSYC 106,A00,183849,Dobkins; Karen R.,45,0,60,15
1681914099720,PSYC 108,A00,253750,Staff,24,0,60,36
1681914100746,PSYC 114,A01,184275,Winkielman; Piotr,0,6,30,30
1681914101769,PSYC 122,A00,183856,Moranton; Nirelia Melbina-,0,10,30,30
1681914102793,PSYC 124,A00,183865,Chapman; Eddie Nathaniel,52,0,80,28
1681914103820,PSYC 137,A00,183880,Staff,19,0,25,6
1681914105868,PSYC 154,A00,183910,Lacefield; Katharine I,0,2,90,90
1681914107922,PSYC 162,A00,183946,Wixted; John T,61,0,90,29
1681914108954,PSYC 172,A00,183947,Gorman; Michael R.,14,0,30,16
1681914109978,PSYC 178,A00,183963,Glaser; Dale,20,0,40,20
1681914111003,PSYC 181GS,A00,183964,Anagnostaras; Stephan,10,0,10,0
1681914112027,PSYC 186GS,A01,257660,Staff,10,0,10,0
1681914113054,PSYC 193,B00,253749,Staff,23,0,25,2
1681914115107,PSYC 193L,A01,184122,Staff,33,0,35,2
1681914115107,PSYC 193L,C01,184167,Winkielman; Piotr,16,0,30,14
1681914116139,RELI 188GS,A00,182629,Rahimi; Babak,20,0,20,0
1681914117164,SE 101A,A00,182646,Staff,26,0,30,4
1681914118189,SE 101C,A00,182650,Staff,18,0,20,2
1681914119213,SE 110A,A00,182651,Staff,28,0,28,0
1681914120238,SE 130A,A00,182652,Staff,39,0,40,1
1681914121263,SIO 46GS,A00,182636,Cook; Geoffrey W,28,0,28,0
1681914122289,SIO 109R,A00,194459,Staff,5,0,20,15
1681914123318,SIO 121GS,A00,182639,Cook; Geoffrey W,28,0,28,0
1681914124344,SIO 132,A01,182642,Staff,32,0,40,8
1681914125371,SIO 139,A00,182644,Kacev; David,36,0,40,4
1681914126400,SOCI 2,A01,258404,Staff,34,0,36,2
1681914126400,SOCI 2,A02,258405,Staff,35,0,36,1
1681914127437,SOCI 60,A01,258408,Staff,29,0,30,1
1681914127437,SOCI 60,A02,258413,Staff,30,0,30,0
1681914128463,SOCI 100,A01,258415,Staff,29,0,30,1
1681914128463,SOCI 100,A02,258416,Staff,28,0,30,2
1681914134623,SOCI 127,A00,258421,Staff,22,0,30,8
1681914135653,SOCI 132,A00,258422,Staff,45,0,50,5
1681914136683,SOCI 133,A00,258423,Staff,26,0,30,4
1681914137706,SOCI 138GS,A00,258424,Staff,15,0,15,0
1681914138732,SOCI 145,A00,258425,Staff,25,0,30,5
1681914139761,SOCI 148,A00,258426,Staff,26,0,30,4
1681914140787,SOCI 153,A00,199217,Staff,29,0,30,1
1681914141811,SOCI 160,A00,258427,Staff,28,0,30,2
1681914142846,SOCI 160E,A00,258435,Staff,56,0,60,4
1681914143877,SOCI 189GS,A00,258436,Staff,15,0,15,0
1681914144903,SOCI 190GS,A00,258437,Staff,15,0,15,0
1681914145927,SYN 2,001,182658,Staff,9,0,16,7
1681914145927,SYN 2,002,201439,Staff,15,0,16,1
1681914145927,SYN 2,003,201443,Staff,16,0,16,0
1681914146950,SYN 100,A01,182657,Staff,17,0,20,3
1681914147975,TDAC 1,A00,184381,Salovey; Todd,16,0,20,4
1681914147975,TDAC 1,B00,184385,Harting; Carla Kelso,19,0,20,1
1681914147975,TDAC 1,C00,184394,Staff,19,0,20,1
1681914149002,TDAC 101,A00,184483,Harting; Carla Kelso,19,0,20,1
1681914150027,TDDE 111,A00,184496,Staff,14,0,15,1
1681914151062,TDDE 131,A00,184504,Staff,20,0,20,0
1681914151062,TDDE 131,B00,184505,Staff,17,0,18,1
1681914151062,TDDE 131,C00,184534,Staff,49,0,50,1
1681914151062,TDDE 131,D00,184564,Staff,15,0,15,0
1681914151062,TDDE 131,E00,204725,Staff,19,0,20,1
1681914152091,TDGE 1,A01,184414,Salovey; Todd,37,0,50,13
1681914153116,TDGE 5,A01,184419,Staff,23,0,24,1
1681914154140,TDGE 10,A00,184428,Fulton; Julia,31,0,50,19
1681914155166,TDGE 124,A00,184565,Fulton; Julia,7,0,50,43
1681914156194,TDGE 125,B00,184567,Meyer; Ursula,9,0,25,16
1681914157220,TDHT 101,A00,184568,Staff,21,0,25,4
1681914157220,TDHT 101,B00,184569,Staff,20,0,20,0
1681914158242,TDHT 114,A00,184570,Staff,49,0,50,1
1681914159265,TDMV 1,A00,184437,Arcidiacono; Kristin,23,0,30,7
1681914159265,TDMV 1,B00,184448,Caligagan; Maria T.,22,0,30,8
1681914160287,TDMV 2,A00,184449,Weinberg; Sadie,27,0,30,3
1681914160287,TDMV 2,B00,184453,Arcidiacono; Kristin,29,0,30,1
1681914161310,TDMV 110,A00,184571,Weinberg; Sadie,30,0,30,0
1681914162340,TDMV 142,A00,184572,Caligagan; Tony,27,0,30,3
1681914162340,TDMV 142,B00,184573,Caligagan; Maria T.,27,0,30,3
1681914163365,TDTR 20,A00,184482,Jun; Grace Shin Hae,25,0,25,0
1681914164392,USP 2,A01,184290,Hinds; Juli Beth,24,0,25,1
1681914165425,USP 3,A01,184295,Staff,20,0,25,5
1681914166452,USP 4,A00,184304,McTague; Sarah,15,0,25,10
1681914167477,USP 100,A00,184315,Staff,17,0,25,8
1681914168501,USP 105,A00,184326,Staff,21,0,25,4
1681914169524,USP 151,A00,184327,Staff,20,0,25,5
1681914170548,USP 170,A00,184380,Hinds; Juli Beth,14,0,25,11
1681914171573,VIS 21B,A01,182660,Staff,28,0,31,3
1681914171573,VIS 21B,A02,182662,Staff,30,0,31,1
1681914172596,VIS 103D,A00,182663,Staff,74,0,75,1
1681914173619,VIS 105D,A00,182667,Li; Huai,15,0,22,7
1681914174646,VIS 122GS,A00,182668,Herbst; Matthew,20,0,20,0
1681914175675,VIS 128C,A00,182673,Staff,69,0,75,6
1681914176700,VIS 130,A00,182675,Staff,20,0,22,2
1681914177729,VIS 160A,A00,182678,Stalbaum; Brett,4,0,10,6
1681914179775,WCWP 10B,A00,201679,Staff,15,0,15,0
1681914179775,WCWP 10B,B00,201695,Staff,15,0,15,0
1681914180799,WCWP 100,A00,201716,Staff,15,0,15,0
1681914180799,WCWP 100,B00,201717,Staff,11,0,15,4
1681914182888,ANSC 105GS,A00,258289,Staff,0,0,0,0
1681914183913,ANSC 125GS,A00,258295,Staff,0,0,0,0
1681914184938,ANSC 150,A00,258267,Staff,30,0,40,10
1681914186038,ANSC 190GS,A00,258280,Staff,0,0,0,0
1681914187060,ANTH 1,A00,258264,Staff,38,0,40,2
1681914188083,ANTH 2,A01,258259,Staff,72,0,76,4
1681914189109,ANTH 23,A01,258228,Staff,36,0,40,4
1681914190137,ANTH 101,A01,258236,Staff,39,0,40,1
1681914191163,ANTH 102,A00,258272,Staff,59,0,60,1
1681914192193,ANTH 105,A00,258244,Staff,31,0,35,4
1681914193218,BENG 130,A00,253975,Staff,38,0,40,2
1681914194243,BIBC 102,A01,191866,Flagg; Matthew Paul,19,0,32,13
1681914194243,BIBC 102,A02,191867,Flagg; Matthew Paul,22,0,32,10
1681914194243,BIBC 102,A03,191868,Flagg; Matthew Paul,30,0,32,2
1681914194243,BIBC 102,A04,191936,Flagg; Matthew Paul,26,0,32,6
1681914194243,BIBC 102,A05,191937,Flagg; Matthew Paul,11,0,32,21
1681914195279,BICD 100,A01,191939,Cooper; Andrew Michael,28,0,32,4
1681914195279,BICD 100,A02,191940,Cooper; Andrew Michael,32,0,32,0
1681914195279,BICD 100,A03,191941,Cooper; Andrew Michael,32,0,32,0
1681914195279,BICD 100,A04,191942,Cooper; Andrew Michael,32,0,32,0
1681914195279,BICD 100,A05,191943,Cooper; Andrew Michael,32,0,32,0
1681914196303,BIEB 126,A01,191945,Cleland; Elsa Eleanor,1,0,32,31
1681914196303,BIEB 126,A02,191946,Cleland; Elsa Eleanor,28,0,32,4
1681914196303,BIEB 126,A03,191947,Cleland; Elsa Eleanor,29,0,32,3
1681914196303,BIEB 126,A04,191948,Cleland; Elsa Eleanor,23,0,32,9
1681914196303,BIEB 126,A05,191996,Cleland; Elsa Eleanor,28,0,32,4
1681914197327,BIEB 136GS,A00,191997,Shurin; Jonathan & Holway; David A.,0,0,0,0
1681914198357,BIEB 137GS,A01,191999,Shurin; Jonathan & Holway; David A.,0,0,0,0
1681914199393,BILD 1,A01,205385,Staff,31,0,32,1
1681914199393,BILD 1,A02,205386,Staff,30,0,32,2
1681914199393,BILD 1,A03,205387,Staff,32,0,32,0
1681914199393,BILD 1,A04,205388,Staff,28,0,32,4
1681914200417,BILD 2,A01,191774,Staff,28,0,32,4
1681914200417,BILD 2,A02,191775,Staff,30,0,32,2
1681914200417,BILD 2,A03,191777,Staff,30,0,32,2
1681914200417,BILD 2,A04,191856,Staff,31,0,32,1
1681914200417,BILD 2,A05,191857,Staff,32,0,32,0
1681914200417,BILD 2,A06,191858,Staff,32,0,32,0
1681914200417,BILD 2,A07,191859,Staff,31,0,32,1
1681914201441,BILD 3,A01,205391,Staff,29,0,32,3
1681914201441,BILD 3,A02,205393,Staff,32,0,32,0
1681914201441,BILD 3,A03,205394,Staff,28,0,32,4
1681914201441,BILD 3,A04,205395,Staff,32,0,32,0
1681914202467,BILD 20,A01,191861,Staff,32,0,32,0
1681914202467,BILD 20,A02,191862,Staff,32,0,32,0
1681914203491,BILD 30,A01,191864,Staff,31,0,32,1
1681914204517,BIMM 100,A01,192019,Staff,0,0,32,32
1681914204517,BIMM 100,A02,192020,Staff,23,0,32,9
1681914204517,BIMM 100,A03,192035,Staff,22,0,32,10
1681914205543,BIMM 110,A01,192037,Tat; John,0,0,32,32
1681914205543,BIMM 110,A02,192038,Tat; John,10,0,32,22
1681914206568,BIMM 120,A01,192040,Pickett; Brooke Elizabeth,2,0,32,30
1681914206568,BIMM 120,A02,192041,Pickett; Brooke Elizabeth,16,0,32,16
1681914206568,BIMM 120,A03,192042,Pickett; Brooke Elizabeth,16,0,32,16
1681914207592,BIPN 100,A01,192044,Armour; Jon Christopher,26,0,32,6
1681914207592,BIPN 100,A02,192059,Armour; Jon Christopher,30,0,32,2
1681914207592,BIPN 100,A03,192064,Armour; Jon Christopher,31,0,32,1
1681914207592,BIPN 100,A04,192073,Armour; Jon Christopher,28,0,32,4
1681914208620,BIPN 148,A01,205411,Leutgeb; Jill K.,16,0,32,16
1681914208620,BIPN 148,A02,205412,Leutgeb; Jill K.,31,0,32,1
1681914208620,BIPN 148,A03,205413,Leutgeb; Jill K.,30,0,32,2
1681914208620,BIPN 148,A04,205414,Leutgeb; Jill K.,30,0,32,2
1681914209643,BIPN 160,A01,192115,Marino; Marc J,19,0,32,13
1681914209643,BIPN 160,A02,192148,Marino; Marc J,27,0,32,5
1681914209643,BIPN 160,A03,192158,Marino; Marc J,31,0,32,1
1681914209643,BIPN 160,A04,192190,Marino; Marc J,32,0,32,0
1681914209643,BIPN 160,A05,192287,Marino; Marc J,32,0,32,0
1681914209643,BIPN 160,A06,192288,Marino; Marc J,32,0,32,0
1681914210666,BIPN 194,A00,206038,Staff,28,0,32,4
1681914211692,BISP 194,A00,192289,Leutgeb; Stefan,13,0,32,19
1681914211692,BISP 194,B00,245332,Nieh; James Charles,27,0,32,5
1681914212717,CAT 124,A01,202247,Staff,15,0,15,0
1681914213745,CAT 125,A00,202248,Staff,19,0,20,1
1681914213745,CAT 125,B00,202253,Staff,20,0,20,0
1681914213745,CAT 125,C00,202257,Staff,19,0,20,1
1681914214769,CAT 125GS,A01,202273,Bronstein; Phoebe Malan,20,0,20,0
1681914215798,CAT 125R,A00,202284,Staff,17,0,20,3
1681914215798,CAT 125R,C00,202286,Staff,10,0,20,10
1681914215798,CAT 125R,D00,202291,Staff,18,0,20,2
1681914215798,CAT 125R,E00,202295,Staff,13,0,20,7
1681914215798,CAT 125R,F00,202302,Staff,12,0,20,8
1681914216821,CENG 100,A00,204724,Opatkiewicz; Justin Paul,25,0,25,0
1681914217846,CGS 2A,A01,180420,Staff,31,0,36,5
1681914218870,CGS 101,A00,180421,Staff,16,0,20,4
1681914219898,CGS 112,A00,180422,Staff,10,0,16,6
1681914220924,CGS 113,A00,180423,Staff,18,0,20,2
1681914221975,CGS 137,A00,180424,Staff,12,0,12,0
1681914222999,CGS 147,A00,180425,Staff,10,0,10,0
1681914224026,CHEM 6A,A01,179556,Staff,97,0,100,3
1681914224026,CHEM 6A,A02,179558,Staff,0,0,0,0
1681914225053,CHEM 6B,A01,179560,Staff,100,0,100,0
1681914226080,CHEM 6C,A01,179565,Jazzar; Rodolphe,95,0,100,5
1681914227237,CHEM 7L,A01,179586,Schurmeier; Kimberly,13,0,24,11
1681914227237,CHEM 7L,A02,179587,Schurmeier; Kimberly,23,0,24,1
1681914227237,CHEM 7L,A03,179590,Schurmeier; Kimberly,22,0,24,2
1681914227237,CHEM 7L,A04,179591,Schurmeier; Kimberly,22,0,24,2
1681914227237,CHEM 7L,B01,179598,Schurmeier; Kimberly,17,0,24,7
1681914227237,CHEM 7L,B02,179599,Schurmeier; Kimberly,24,0,24,0
1681914227237,CHEM 7L,B03,179606,Schurmeier; Kimberly,23,0,24,1
1681914227237,CHEM 7L,B04,179607,Schurmeier; Kimberly,23,0,24,1
1681914228261,CHEM 11,A01,179609,Stallings; Dontarie M,88,0,100,12
1681914229308,CHEM 40A,A01,179621,Staff,41,0,50,9
1681914229308,CHEM 40A,A02,179622,Staff,47,0,50,3
1681914230330,CHEM 40B,A01,179630,Weizman; Haim,48,0,50,2
1681914230330,CHEM 40B,A02,179631,Weizman; Haim,45,0,50,5
1681914231362,CHEM 41A,A01,179660,Klosterman; Jeremy K,93,0,100,7
1681914232386,CHEM 43A,A01,179683,Klosterman; Jeremy K,0,0,24,24
1681914232386,CHEM 43A,A02,179688,Klosterman; Jeremy K,14,0,24,10
1681914232386,CHEM 43A,A03,179689,Klosterman; Jeremy K,20,0,24,4
1681914232386,CHEM 43A,A04,179691,Klosterman; Jeremy K,18,0,24,6
1681914233412,CHEM 114A,A01,179693,Stallings; Dontarie M,77,0,100,23
1681914234452,CHEM 143B,A01,179698,Weizman; Haim,17,0,24,7
1681914234452,CHEM 143B,A02,179700,Weizman; Haim,24,0,24,0
1681914235473,CHIN 169A,A00,179701,Wang; Xiao,20,0,20,0
1681914236509,COGS 2,A01,179750,Boyle; Mary E. T.,17,0,30,13
1681914237536,COGS 9,A01,179759,Jones; Cameron Robert,43,0,50,7
1681914238559,COGS 14A,A01,179854,Staff,18,0,50,32
1681914239597,COGS 14B,A01,179856,Staff,54,0,60,6
1681914240624,COGS 17,A01,179874,Staff,71,0,75,4
1681914241652,COGS 18,A01,179884,Staff,63,0,80,17
1681914242678,COGS 100,A01,179886,Staff,40,0,60,20
1681914243716,COGS 101B,A01,179892,Staff,1,0,30,29
1681914244746,COGS 101C,A01,179894,Staff,28,0,30,2
1681914245781,COGS 107A,A01,179896,Boyle; Mary E. T.,31,0,40,9
1681914246803,COGS 108,A01,179898,Simpkins; Charles Alexander,0,17,60,60
1681914247828,COGS 109,A01,179900,Staff,34,0,40,6
1681914248852,COGS 118A,A01,179946,Staff,9,0,40,31
1681914249882,COGS 153,A00,179978,Staff,1,0,30,29
1681914250907,COGS 156,A01,179981,Staff,27,0,30,3
1681914252955,COGS 172,A01,179987,Staff,13,0,30,17
1681914255009,COGS 186,A01,179991,Staff,13,0,30,17
1681914256041,COMM 10,A01,180001,Staff,15,0,25,10
1681914256041,COMM 10,A02,180004,Staff,20,0,25,5
1681914257064,COMM 100A,A01,180016,Staff,18,0,25,7
1681914257064,COMM 100A,A02,180020,Staff,24,0,25,1
1681914258091,COMM 101T,A00,180029,Halm; Gavin Patrick,23,0,35,12
1681914259118,COMM 106V,A00,180043,Staff,34,0,35,1
1681914260145,COMM 109P,A00,180044,Staff,31,0,35,4
1681914261176,COMM 113T,A00,180045,Havis; Allan,37,0,45,8
1681914262203,COMM 132,A00,180046,McKenna; Denise,23,0,30,7
1681914263225,COMM 143,A00,180047,Staff,19,0,30,11
1681914264253,COMM 190,A00,180048,Conner; Thomas Hartnell,20,0,23,3
1681914265276,CSE 8A,A50,180053,Cao; Yingjun,25,0,50,25
1681914265276,CSE 8A,B50,180180,Staff,50,0,50,0
1681914266301,CSE 11,A01,180190,Cao; Yingjun,31,0,50,19
1681914267328,CSE 20,A01,180192,Briones; Jor-el Thomas Caparas,23,0,30,7
1681914268352,CSE 21,A01,194538,Briones; Jor-el Thomas Caparas,50,0,60,10
1681914269375,CSE 30,A01,180324,Eldon; John,78,0,100,22
1681914270401,CSE 101,A01,201353,Staff,0,20,40,40
1681914271428,CSE 134B,A01,180326,Powell; Thomas Allan,74,0,100,26
1681914272454,CSE 140,A01,180328,Staff,46,0,75,29
1681914273477,CSE 140L,A01,180344,Eldon; John,69,0,100,31
1681914274507,CSE 150A,A01,180411,Staff,0,7,50,50
1681914275530,CSE 151A,A01,180414,Staff,0,6,50,50
1681914276553,CSE 175,A01,222521,Kumar; Rakesh,50,0,50,0
1681914277580,CSE 190,A00,201419,Staff,45,0,49,4
1681914278605,CSS 1,A01,194536,Staff,38,0,50,12
1681914279634,DSC 30,A01,202385,Staff,48,0,50,2
1681914280657,DSC 40A,A01,202387,Albuyeh; Rod,50,0,50,0
1681914281681,DSC 190,A01,202389,Silberman; Jack,21,0,21,0
1681914282705,DSGN 100,A01,179993,Staff,16,0,30,14
1681914283729,ECE 65,A50,180708,Staff,10,0,20,10
1681914283729,ECE 65,A51,180739,Staff,19,0,20,1
1681914284752,ECON 1,A01,180427,Famulari; Melissa,67,0,70,3
1681914285777,ECON 2,A01,180450,Levkoff; Steven B.,64,0,70,6
1681914286800,ECON 4,A01,203351,Anderson; John Charles,7,0,10,3
1681914287822,ECON 100A,A01,180472,Famulari; Melissa,65,0,70,5
1681914288845,ECON 120A,A01,180549,Staff,64,0,70,6
1681914289939,ECON 120B,A01,180655,Ma; Xinwei,46,0,70,24
1681914290964,ECON 129,A00,203333,Eckert; Fabian Paul,15,0,35,20
1681914291986,ECON 131,A00,180656,Staff,9,0,35,26
1681914293013,ECON 172B,A01,180672,Levkoff; Steven B.,32,0,35,3
1681914294040,ECON 178,A01,203342,Zhu; Ying,11,0,35,24
1681914295067,EDS 108GS,A00,202383,Wishard Guerra; Alison G.,20,0,20,0
1681914296092,EDS 111GS,A00,202347,Wishard Guerra; Alison G.,20,0,20,0
1681914297118,EDS 112,A01,202323,Staff,56,0,60,4
1681914298142,EDS 113,A00,202340,Staff,33,0,35,2
1681914299165,EDS 118,A00,201231,Staff,20,0,30,10
1681914300191,EDS 119,A00,204994,Staff,8,0,10,2
1681914301225,EDS 124BR,A00,202324,Eguchi; Emi,5,0,25,20
1681914302255,EDS 126,A01,203208,Jones; Makeba,26,0,30,4
1681914303281,EDS 135,A01,202333,Staff,18,0,20,2
1681914304305,EDS 180,A00,202311,Staff,47,0,50,3
1681914305332,ERC 190GS,A01,253747,Staff,28,0,28,0
1681914306357,ETHN 104,A00,180742,Staff,24,0,35,11
1681914307382,ETHN 118,A00,180745,Staff,28,0,35,7
1681914308407,ETHN 127,A00,180747,Staff,12,0,16,4
1681914309433,ETHN 137,A00,180880,Staff,12,0,12,0
1681914310460,ETHN 147,A00,180890,Staff,8,0,10,2
1681914311489,ETHN 154,A00,180891,Staff,7,0,8,1
1681914312512,ETHN 168,A00,180892,Staff,9,0,10,1
1681914313536,GLBH 20,A00,201051,Hannah; Seth Donal,0,1,0,1
1681914314562,GLBH 111,A01,209338,Burgos; Jose L.,0,0,0,0
1681914315586,GLBH 150,A00,258300,Staff,0,3,0,0
1681914316608,GLBH 181,A00,201207,Staff,15,0,40,25
1681914317638,HIEU 109,A00,180898,Staff,20,0,20,0
1681914318665,HIEU 111,A00,180899,Staff,1,0,20,19
1681914319693,HIEU 124,A00,180900,Staff,18,0,20,2
1681914320715,HILA 122,A00,180901,Staff,18,0,20,2
1681914321742,HILA 132,A00,180902,Vitz; Matthew,2,0,20,18
1681914322765,HILD 10,A01,180896,Staff,15,0,20,5
1681914323788,HILD 30GS,A00,180897,Edington; Claire Ellen,0,0,0,0
1681914324815,HISC 105,A00,180903,Staff,20,0,20,0
1681914325837,HISC 117,A00,180904,Staff,11,0,20,9
1681914326861,HIUS 108B,A00,181005,Staff,18,0,20,2
1681914327884,HIUS 113,A00,181093,Staff,4,0,20,16
1681914328907,HUM 3,A01,181190,Patterson; Patrick H.,40,0,50,10
1681914328907,HUM 3,B01,181195,Staff,47,0,50,3
1681914329929,HUM 3GS,A00,181196,Herbst; Matthew,0,0,0,0
1681914330960,HUM 4,A01,181227,West; Geoffrey Scott,34,0,50,16
1681914330960,HUM 4,B01,181282,Staff,43,0,50,7
1681914331986,HUM 4GS,A00,181377,Lyon; Antony J.,0,0,0,0
1681914333014,HUM 5,A01,181536,Zavodny; Tatiana Sophia,31,0,50,19
1681914333014,HUM 5,B01,181908,Staff,36,0,50,14
1681914334040,INTL 190,A00,181909,Segui; Alan S,0,0,0,6
1681914334040,INTL 190,B00,181961,Segui; Alan S,0,0,0,7
1681914335064,JAPN 20AR,A01,182113,Ross; Kayoko F,15,0,20,5
1681914336087,LATI 50,A01,202391,Martin-Cabrera; Luis,19,0,30,11
1681914336087,LATI 50,A02,202392,Martin-Cabrera; Luis,26,0,30,4
1681914337114,LATI 180,A00,202393,Kokinis; Troy Andreas,25,0,25,0
1681914338137,LIFR 1A,A00,182119,Staff,14,0,14,0
1681914339163,LIFR 1AX,A00,182324,Staff,14,0,14,0
1681914340192,LIFR 1B,A00,182259,Staff,14,0,14,0
1681914341218,LIFR 1BX,A00,182273,Staff,14,0,14,0
1681914342242,LIGN 8,A00,182330,Staff,137,0,150,13
1681914343266,LIGN 9GS,A00,182362,Staff,20,0,20,0
1681914344287,LIGN 119,A00,204992,Takahashi; Maho,12,0,15,3
1681914345313,LIGN 130,A01,182384,Staff,47,0,50,3
1681914346341,LIGN 149GS,A00,182390,Staff,20,0,20,0
1681914347363,LIGN 170,A00,182404,Staff,24,0,30,6
1681914348392,LISP 1D,A00,182281,Staff,7,0,14,7
1681914348392,LISP 1D,B00,182287,Staff,14,0,14,0
1681914348392,LISP 1D,C00,182295,Staff,11,0,14,3
1681914348392,LISP 1D,D00,182301,Staff,14,0,14,0
1681914349420,LISP 1DX,A00,182309,Staff,20,0,28,8
1681914349420,LISP 1DX,B00,182316,Staff,26,0,28,2
1681914350442,LTAF 120GS,A00,182412,Zhiri; Oumelbanine,20,0,20,0
1681914351467,LTCS 172GS,A00,182437,Bronstein; Phoebe Malan,20,0,20,0
1681914352491,LTEA 138,A00,182457,Staff,22,0,40,18
1681914353513,LTEN 114,A01,182490,Staff,23,0,25,2
1681914354537,LTEN 130GS,A00,182491,Lyon; Antony J.,20,0,20,0
1681914355568,LTEN 169,A00,182493,Cuong; Marisol,20,0,25,5
1681914356592,LTEN 178,A00,182501,Staff,14,0,15,1
1681914357618,LTEN 181,A00,182515,Staff,22,0,25,3
1681914358644,LTEN 185GS,A00,197655,Forbes; Camille,20,0,20,0
1681914359673,LTSP 100B,A00,202208,Bessett; Ryan Matthew,24,0,25,1
1681914360695,LTWL 100,A00,182516,Myerston Santana; Jacobo,22,0,30,8
1681914361725,LTWR 100GS,A00,182518,Forbes; Camille,20,0,20,0
1681914362751,LTWR 102,A00,182522,Staff,15,0,15,0
1681914362751,LTWR 102,B00,182525,Staff,14,0,15,1
1681914363773,LTWR 115,A00,182526,Staff,12,0,15,3
1681914364796,MAE 8,A01,182528,Pham; Hieu Tan,68,0,70,2
1681914365822,MAE 11,A00,182529,Bahadori; Mohammad Yousef,94,0,100,6
1681914366847,MAE 20,A00,182530,Evdokimenko; Ekaterina,68,0,70,2
1681914367881,MAE 30A,A00,182532,Staff,44,0,45,1
1681914368907,MAE 101A,A00,182533,Bahadori; Mohammad Yousef,97,0,100,3
1681914369931,MAE 101C,A00,182538,Staff,62,0,70,8
1681914370958,MAE 104,A00,182539,Staff,45,0,50,5
1681914371981,MAE 131A,A00,182540,Ghazinejad; Maziar,41,0,45,4
1681914373005,MAE 143A,A00,182548,Bewley; Thomas R,43,0,50,7
1681914374029,MAE 150,A00,182549,Staff,28,0,40,12
1681914375056,MAE 160,A00,182550,Evdokimenko; Ekaterina,43,0,60,17
1681914376079,MATH 3C,A01,182725,Staff,27,0,30,3
1681914377103,MATH 10A,A01,182729,Staff,25,0,30,5
1681914377103,MATH 10A,B01,182732,Staff,26,0,30,4
1681914378126,MATH 10B,A01,182737,Staff,21,0,30,9
1681914378126,MATH 10B,A02,182738,Staff,27,0,30,3
1681914378126,MATH 10B,B01,182744,Staff,27,0,30,3
1681914378126,MATH 10B,B02,182745,Staff,27,0,30,3
1681914379154,MATH 18,A01,182750,Anzaldo; Leesa B,28,0,30,2
1681914379154,MATH 18,A02,182751,Anzaldo; Leesa B,29,0,30,1
1681914379154,MATH 18,A03,182753,Anzaldo; Leesa B,28,0,30,2
1681914379154,MATH 18,A04,182757,Anzaldo; Leesa B,29,0,30,1
1681914379154,MATH 18,B01,182761,Anzaldo; Leesa B,27,0,30,3
1681914379154,MATH 18,B02,182764,Anzaldo; Leesa B,27,0,30,3
1681914379154,MATH 18,B03,182765,Anzaldo; Leesa B,30,0,30,0
1681914379154,MATH 18,B04,182766,Anzaldo; Leesa B,30,0,30,0
1681914380177,MATH 20A,A01,182771,Suk; Andrew Hoon,28,0,30,2
1681914381201,MATH 20B,A01,182775,Bach; Quang Tran,30,0,30,0
1681914381201,MATH 20B,A02,182777,Bach; Quang Tran,29,0,30,1
1681914381201,MATH 20B,B01,182780,Bach; Quang Tran,27,0,30,3
1681914381201,MATH 20B,B02,182782,Bach; Quang Tran,30,0,30,0
1681914382233,MATH 20C,A01,182787,Staff,25,0,30,5
1681914382233,MATH 20C,A02,182790,Staff,29,0,30,1
1681914382233,MATH 20C,B01,182792,Staff,25,0,30,5
1681914382233,MATH 20C,B02,182796,Staff,27,0,30,3
1681914383257,MATH 20D,A01,182799,Staff,29,0,30,1
1681914383257,MATH 20D,A02,182802,Staff,30,0,30,0
1681914383257,MATH 20D,A03,182803,Staff,30,0,30,0
1681914384282,MATH 20E,A01,182809,Verstraete; Jacques Allan,24,0,30,6
1681914384282,MATH 20E,A02,182811,Verstraete; Jacques Allan,28,0,30,2
1681914384282,MATH 20E,B01,182814,Verstraete; Jacques Allan,23,0,30,7
1681914384282,MATH 20E,B02,182815,Verstraete; Jacques Allan,30,0,30,0
1681914385308,MATH 103A,A01,182820,Staff,9,0,30,21
1681914385308,MATH 103A,A02,182821,Staff,27,0,30,3
1681914385308,MATH 103A,A03,182822,Staff,23,0,30,7
1681914385308,MATH 103A,B01,182825,Staff,23,0,30,7
1681914385308,MATH 103A,B02,182826,Staff,30,0,30,0
1681914385308,MATH 103A,B03,182830,Staff,30,0,30,0
1681914386338,MATH 109,A01,182836,Chow; Bennett,24,0,30,6
1681914386338,MATH 109,A02,182838,Chow; Bennett,29,0,30,1
1681914386338,MATH 109,A03,182894,Chow; Bennett,29,0,30,1
1681914386338,MATH 109,B01,182908,Chow; Bennett,28,0,30,2
1681914386338,MATH 109,B02,182909,Chow; Bennett,30,0,30,0
1681914386338,MATH 109,B03,182910,Chow; Bennett,27,0,30,3
1681914387363,MATH 142A,A01,182925,Staff,11,0,30,19
1681914387363,MATH 142A,A02,182935,Staff,25,0,30,5
1681914387363,MATH 142A,A03,182967,Staff,26,0,30,4
1681914387363,MATH 142A,B01,183125,Staff,24,0,30,6
1681914387363,MATH 142A,B02,183157,Staff,28,0,30,2
1681914387363,MATH 142A,B03,183158,Staff,29,0,30,1
1681914388386,MATH 183,A01,183160,Arias-Castro; Ery,23,0,30,7
1681914388386,MATH 183,A02,183161,Arias-Castro; Ery,29,0,30,1
1681914388386,MATH 183,B01,183163,Arias-Castro; Ery,28,0,30,2
1681914388386,MATH 183,B02,183164,Arias-Castro; Ery,28,0,30,2
1681914389414,MATH 193A,A01,183167,Staff,4,0,35,31
1681914389414,MATH 193A,A02,183168,Staff,28,0,35,7
1681914389414,MATH 193A,A03,183169,Staff,34,0,35,1
1681914389414,MATH 193A,A04,183170,Staff,28,0,35,7
1681914390441,MGT 4,A01,202395,Anderson; John Charles,75,0,80,5
1681914391471,MGT 5,A00,202396,Houskeeper; Robert,80,0,90,10
1681914392494,MGT 103,A00,202397,Eberhard; Craig A,55,0,90,35
1681914393597,MGT 131A,A00,202398,Houskeeper; Robert,85,0,90,5
1681914394623,MGT 135,A00,202399,Anderson; John Charles,82,0,90,8
1681914395645,MGT 162R,A00,202403,Gneezy; Uri,150,0,200,50
1681914396668,MGT 172,A00,202404,Hedges; Kathleen,50,0,90,40
1681914397691,MGT 181,A00,202405,Dunn; Louis Jean,84,0,90,6
1681914398715,MMW 14,A01,183200,Staff,16,0,28,12
1681914398715,MMW 14,A02,183201,Staff,26,0,28,2
1681914398715,MMW 14,A03,183202,Staff,24,0,28,4
1681914398715,MMW 14,A04,183203,Staff,25,0,28,3
1681914398715,MMW 14,A05,183204,Staff,26,0,28,2
1681914398715,MMW 14,A06,183205,Staff,27,0,28,1
1681914398715,MMW 14,B01,183207,Staff,26,0,28,2
1681914398715,MMW 14,B02,183208,Staff,28,0,28,0
1681914398715,MMW 14,B03,183209,Staff,28,0,28,0
1681914398715,MMW 14,B04,183210,Staff,28,0,28,0
1681914398715,MMW 14,B05,183211,Staff,28,0,28,0
1681914398715,MMW 14,B06,183212,Staff,28,0,28,0
1681914399743,MMW 14GS,A00,183213,Zhiri; Oumelbanine,28,0,28,0
1681914400766,MMW 15GS,B00,183215,Rahimi; Babak,28,0,28,0
1681914401793,MMW 121,A01,183217,Patterson; Patrick H.,14,0,28,14
1681914401793,MMW 121,A02,183218,Patterson; Patrick H.,25,0,28,3
1681914402821,MUS 1A,A01,182554,Staff,8,0,35,27
1681914403847,MUS 5,A01,182558,Staff,20,0,35,15
1681914404869,MUS 6,A01,182562,Staff,25,0,35,10
1681914405896,MUS 8GS,A00,182563,Borgo; David Garcia,25,0,25,0
1681914406923,MUS 13,A01,182567,Staff,24,0,25,1
1681914407945,MUS 15,A01,182570,Staff,32,0,35,3
1681914407945,MUS 15,B01,182575,Staff,10,0,35,25
1681914408968,MUS 80,A00,182578,Staff,23,0,25,2
1681914408968,MUS 80,B00,182581,Staff,20,0,25,5
1681914409991,MUS 113,A00,182582,Staff,25,0,25,0
1681914411017,MUS 114,A00,182583,Staff,4,0,25,21
1681914412042,MUS 150GS,A01,182588,Borgo; David Garcia,25,0,25,0
1681914413065,PHIL 1,A00,182590,Staff,35,0,40,5
1681914414087,PHIL 10,A01,182596,Grush; Rick Scott,31,0,35,4
1681914414087,PHIL 10,A02,182597,Grush; Rick Scott,34,0,35,1
1681914415110,PHIL 15,A01,182601,Staff,31,0,35,4
1681914415110,PHIL 15,A02,182602,Staff,33,0,35,2
1681914416133,PHIL 27,A01,182604,Staff,30,0,35,5
1681914416133,PHIL 27,A02,182607,Staff,35,0,35,0
1681914417159,PHIL 32,A01,182609,Staff,35,0,35,0
1681914417159,PHIL 32,A02,182612,Staff,35,0,35,0
1681914418182,PHIL 130,A00,182614,Staff,63,0,70,7
1681914419206,PHIL 136,A00,182616,Cohen; Jonathan David,66,0,70,4
1681914420233,PHIL 155,A00,182617,Vargas; Manuel Rogelio,60,0,70,10
1681914421256,PHIL 163,A01,182620,Staff,15,0,20,5
1681914421256,PHIL 163,A02,182624,Staff,10,0,20,10
1681914422279,PHIL 164,A00,182627,Staff,30,0,40,10
1681914423303,PHIL 173,A00,182628,Staff,36,0,40,4
1681914424328,PHYS 1A,A00,183221,Staff,54,0,60,6
1681914425367,PHYS 1AL,001,183222,Staff,25,0,30,5
1681914425367,PHYS 1AL,002,183223,Staff,28,0,30,2
1681914426390,PHYS 1B,A00,183231,Staff,44,0,60,16
1681914427415,PHYS 1BL,001,183232,Staff,20,0,30,10
1681914427415,PHYS 1BL,002,183233,Staff,29,0,30,1
1681914428438,PHYS 1C,A00,183240,Staff,30,0,60,30
1681914429466,PHYS 1CL,001,183241,Staff,13,0,30,17
1681914429466,PHYS 1CL,002,183242,Staff,22,0,30,8
1681914430489,PHYS 2AR,A01,183250,Staff,44,0,50,6
1681914431511,PHYS 2B,A01,183252,Staff,106,0,115,9
1681914432534,PHYS 2BL,A01,183254,Staff,21,0,24,3
1681914432534,PHYS 2BL,A02,183255,Staff,22,0,24,2
1681914433561,PHYS 2C,A01,183522,Staff,105,0,115,10
1681914434583,PHYS 4A,A01,183524,Staff,49,0,50,1
1681914435615,POLI 5,A00,183525,Staff,44,0,50,6
1681914436641,POLI 12,A00,183540,Staff,48,0,50,2
1681914437667,POLI 13R,A00,183541,Forman; Fonna,42,0,50,8
1681914438692,POLI 30,A00,183542,Mignozzetti; Umberto,47,0,50,3
1681914439714,POLI 100A,A00,183543,Staff,45,0,50,5
1681914440739,POLI 100E,A00,223598,Staff,32,0,35,3
1681914441762,POLI 103A,A00,183564,Kousser; Thad,38,0,50,12
1681914442785,POLI 104B,A00,201329,Staff,29,0,35,6
1681914443809,POLI 113BR,A00,183576,Hoston; Germaine,27,0,50,23
1681914444832,POLI 114BR,A00,183588,Staff,27,0,30,3
1681914445865,POLI 117R,A00,183595,Forman; Fonna,9,0,20,11
1681914446895,POLI 120H,A00,183596,Fisk; David Lee,13,0,20,7
1681914447918,POLI 130AA,A00,183597,Staff,14,0,20,6
1681914448941,POLI 134AA,A00,183598,Staff,19,0,20,1
1681914449964,POLI 135,A00,183599,Fisk; David Lee,20,0,25,5
1681914450989,POLI 142P,A00,183623,Staff,37,0,40,3
1681914452014,POLI 144D,A00,183624,Staff,22,0,25,3
1681914453047,POLI 151,A00,183625,Staff,15,0,20,5
1681914454074,POLI 162,A00,183626,Mignozzetti; Umberto,18,0,20,2
1681914455107,PSYC 1,A00,253748,Staff,86,0,90,4
1681914456131,PSYC 2,A00,183627,Moranton; Nirelia Melbina-,25,0,35,10
1681914457154,PSYC 3,A00,183628,Staff,43,0,45,2
1681914459212,PSYC 60,A01,183631,Lowe; Angela Beth,35,0,40,5
1681914460238,PSYC 70,A01,253757,Staff,37,0,45,8
1681914461264,PSYC 101,A00,183632,Heyman; Gail D.,48,0,60,12
1681914462287,PSYC 105,A00,183848,Lowe; Angela Beth,50,0,60,10
1681914463315,PSYC 106,A00,183849,Dobkins; Karen R.,45,0,60,15
1681914464340,PSYC 108,A00,253750,Staff,24,0,60,36
1681914465364,PSYC 114,A01,184275,Winkielman; Piotr,0,6,30,30
1681914466391,PSYC 122,A00,183856,Moranton; Nirelia Melbina-,0,10,30,30
1681914467413,PSYC 124,A00,183865,Chapman; Eddie Nathaniel,52,0,80,28
1681914468436,PSYC 137,A00,183880,Staff,19,0,25,6
1681914470489,PSYC 154,A00,183910,Lacefield; Katharine I,0,2,90,90
1681914472571,PSYC 162,A00,183946,Wixted; John T,61,0,90,29
1681914473595,PSYC 172,A00,183947,Gorman; Michael R.,14,0,30,16
1681914474626,PSYC 178,A00,183963,Glaser; Dale,20,0,40,20
1681914475649,PSYC 181GS,A00,183964,Anagnostaras; Stephan,10,0,10,0
1681914476677,PSYC 186GS,A01,257660,Staff,10,0,10,0
1681914477702,PSYC 193,B00,253749,Staff,23,0,25,2
1681914479754,PSYC 193L,A01,184122,Staff,33,0,35,2
1681914479754,PSYC 193L,C01,184167,Winkielman; Piotr,16,0,30,14
1681914480780,RELI 188GS,A00,182629,Rahimi; Babak,20,0,20,0
1681914481807,SE 101A,A00,182646,Staff,26,0,30,4
1681914482830,SE 101C,A00,182650,Staff,18,0,20,2
1681914483853,SE 110A,A00,182651,Staff,28,0,28,0
1681914484880,SE 130A,A00,182652,Staff,39,0,40,1
1681914485904,SIO 46GS,A00,182636,Cook; Geoffrey W,28,0,28,0
1681914486927,SIO 109R,A00,194459,Staff,5,0,20,15
1681914487950,SIO 121GS,A00,182639,Cook; Geoffrey W,28,0,28,0
1681914488974,SIO 132,A01,182642,Staff,32,0,40,8
1681914490001,SIO 139,A00,182644,Kacev; David,36,0,40,4
1681914491029,SOCI 2,A01,258404,Staff,34,0,36,2
1681914491029,SOCI 2,A02,258405,Staff,35,0,36,1
1681914492053,SOCI 60,A01,258408,Staff,29,0,30,1
1681914492053,SOCI 60,A02,258413,Staff,30,0,30,0
1681914493079,SOCI 100,A01,258415,Staff,29,0,30,1
1681914493079,SOCI 100,A02,258416,Staff,28,0,30,2
1681914499307,SOCI 127,A00,258421,Staff,22,0,30,8
1681914500330,SOCI 132,A00,258422,Staff,45,0,50,5
1681914501356,SOCI 133,A00,258423,Staff,26,0,30,4
1681914502380,SOCI 138GS,A00,258424,Staff,15,0,15,0
1681914503409,SOCI 145,A00,258425,Staff,25,0,30,5
1681914504435,SOCI 148,A00,258426,Staff,26,0,30,4
1681914505461,SOCI 153,A00,199217,Staff,29,0,30,1
1681914506487,SOCI 160,A00,258427,Staff,28,0,30,2
1681914507510,SOCI 160E,A00,258435,Staff,56,0,60,4
1681914508532,SOCI 189GS,A00,258436,Staff,15,0,15,0
1681914509555,SOCI 190GS,A00,258437,Staff,15,0,15,0
1681914510579,SYN 2,001,182658,Staff,9,0,16,7
1681914510579,SYN 2,002,201439,Staff,15,0,16,1
1681914510579,SYN 2,003,201443,Staff,16,0,16,0
1681914511602,SYN 100,A01,182657,Staff,17,0,20,3
1681914512630,TDAC 1,A00,184381,Salovey; Todd,16,0,20,4
1681914512630,TDAC 1,B00,184385,Harting; Carla Kelso,19,0,20,1
1681914512630,TDAC 1,C00,184394,Staff,19,0,20,1
1681914513653,TDAC 101,A00,184483,Harting; Carla Kelso,19,0,20,1
1681914514677,TDDE 111,A00,184496,Staff,14,0,15,1
1681914515707,TDDE 131,A00,184504,Staff,20,0,20,0
1681914515707,TDDE 131,B00,184505,Staff,17,0,18,1
1681914515707,TDDE 131,C00,184534,Staff,49,0,50,1
1681914515707,TDDE 131,D00,184564,Staff,15,0,15,0
1681914515707,TDDE 131,E00,204725,Staff,19,0,20,1
1681914516732,TDGE 1,A01,184414,Salovey; Todd,37,0,50,13
1681914517758,TDGE 5,A01,184419,Staff,23,0,24,1
1681914518784,TDGE 10,A00,184428,Fulton; Julia,31,0,50,19
1681914519808,TDGE 124,A00,184565,Fulton; Julia,7,0,50,43
1681914520836,TDGE 125,B00,184567,Meyer; Ursula,9,0,25,16
1681914521860,TDHT 101,A00,184568,Staff,21,0,25,4
1681914521860,TDHT 101,B00,184569,Staff,20,0,20,0
1681914522891,TDHT 114,A00,184570,Staff,49,0,50,1
1681914523914,TDMV 1,A00,184437,Arcidiacono; Kristin,23,0,30,7
1681914523914,TDMV 1,B00,184448,Caligagan; Maria T.,22,0,30,8
1681914524938,TDMV 2,A00,184449,Weinberg; Sadie,27,0,30,3
1681914524938,TDMV 2,B00,184453,Arcidiacono; Kristin,29,0,30,1
1681914525961,TDMV 110,A00,184571,Weinberg; Sadie,30,0,30,0
1681914526984,TDMV 142,A00,184572,Caligagan; Tony,27,0,30,3
1681914526984,TDMV 142,B00,184573,Caligagan; Maria T.,27,0,30,3
1681914528006,TDTR 20,A00,184482,Jun; Grace Shin Hae,25,0,25,0
1681914529033,USP 2,A01,184290,Hinds; Juli Beth,24,0,25,1
1681914530059,USP 3,A01,184295,Staff,20,0,25,5
1681914531081,USP 4,A00,184304,McTague; Sarah,15,0,25,10
1681914532108,USP 100,A00,184315,Staff,17,0,25,8
1681914533133,USP 105,A00,184326,Staff,21,0,25,4
1681914534155,USP 151,A00,184327,Staff,20,0,25,5
1681914535179,USP 170,A00,184380,Hinds; Juli Beth,14,0,25,11
1681914536205,VIS 21B,A01,182660,Staff,28,0,31,3
1681914536205,VIS 21B,A02,182662,Staff,30,0,31,1
1681914537228,VIS 103D,A00,182663,Staff,74,0,75,1
1681914538254,VIS 105D,A00,182667,Li; Huai,15,0,22,7
1681914539280,VIS 122GS,A00,182668,Herbst; Matthew,20,0,20,0
1681914540303,VIS 128C,A00,182673,Staff,69,0,75,6
1681914541337,VIS 130,A00,182675,Staff,20,0,22,2
1681914542366,VIS 160A,A00,182678,Stalbaum; Brett,4,0,10,6
1681914544421,WCWP 10B,A00,201679,Staff,15,0,15,0
1681914544421,WCWP 10B,B00,201695,Staff,15,0,15,0
1681914545443,WCWP 100,A00,201716,Staff,15,0,15,0
1681914545443,WCWP 100,B00,201717,Staff,11,0,15,4
1681914547541,ANSC 105GS,A00,258289,Staff,0,0,0,0
1681914548574,ANSC 125GS,A00,258295,Staff,0,0,0,0
1681914549598,ANSC 150,A00,258267,Staff,30,0,40,10
1681914550626,ANSC 190GS,A00,258280,Staff,0,0,0,0
1681914551652,ANTH 1,A00,258264,Staff,38,0,40,2
1681914552678,ANTH 2,A01,258259,Staff,72,0,76,4
1681914553703,ANTH 23,A01,258228,Staff,36,0,40,4
1681914554726,ANTH 101,A01,258236,Staff,39,0,40,1
1681914555752,ANTH 102,A00,258272,Staff,59,0,60,1
1681914556776,ANTH 105,A00,258244,Staff,31,0,35,4
1681914557803,BENG 130,A00,253975,Staff,38,0,40,2
1681914558832,BIBC 102,A01,191866,Flagg; Matthew Paul,19,0,32,13
1681914558832,BIBC 102,A02,191867,Flagg; Matthew Paul,22,0,32,10
1681914558832,BIBC 102,A03,191868,Flagg; Matthew Paul,30,0,32,2
1681914558832,BIBC 102,A04,191936,Flagg; Matthew Paul,26,0,32,6
1681914558832,BIBC 102,A05,191937,Flagg; Matthew Paul,11,0,32,21
1681914559855,BICD 100,A01,191939,Cooper; Andrew Michael,28,0,32,4
1681914559855,BICD 100,A02,191940,Cooper; Andrew Michael,32,0,32,0
1681914559855,BICD 100,A03,191941,Cooper; Andrew Michael,32,0,32,0
1681914559855,BICD 100,A04,191942,Cooper; Andrew Michael,32,0,32,0
1681914559855,BICD 100,A05,191943,Cooper; Andrew Michael,32,0,32,0
1681914560882,BIEB 126,A01,191945,Cleland; Elsa Eleanor,1,0,32,31
1681914560882,BIEB 126,A02,191946,Cleland; Elsa Eleanor,28,0,32,4
1681914560882,BIEB 126,A03,191947,Cleland; Elsa Eleanor,29,0,32,3
1681914560882,BIEB 126,A04,191948,Cleland; Elsa Eleanor,23,0,32,9
1681914560882,BIEB 126,A05,191996,Cleland; Elsa Eleanor,28,0,32,4
1681914561906,BIEB 136GS,A00,191997,Shurin; Jonathan & Holway; David A.,0,0,0,0
1681914562930,BIEB 137GS,A01,191999,Shurin; Jonathan & Holway; David A.,0,0,0,0
1681914563954,BILD 1,A01,205385,Staff,31,0,32,1
1681914563954,BILD 1,A02,205386,Staff,30,0,32,2
1681914563954,BILD 1,A03,205387,Staff,32,0,32,0
1681914563954,BILD 1,A04,205388,Staff,28,0,32,4
1681914564978,BILD 2,A01,191774,Staff,28,0,32,4
1681914564978,BILD 2,A02,191775,Staff,30,0,32,2
1681914564978,BILD 2,A03,191777,Staff,30,0,32,2
1681914564978,BILD 2,A04,191856,Staff,31,0,32,1
1681914564978,BILD 2,A05,191857,Staff,32,0,32,0
1681914564978,BILD 2,A06,191858,Staff,32,0,32,0
1681914564978,BILD 2,A07,191859,Staff,31,0,32,1
1681914566003,BILD 3,A01,205391,Staff,29,0,32,3
1681914566003,BILD 3,A02,205393,Staff,32,0,32,0
1681914566003,BILD 3,A03,205394,Staff,28,0,32,4
1681914566003,BILD 3,A04,205395,Staff,32,0,32,0
1681914567026,BILD 20,A01,191861,Staff,32,0,32,0
1681914567026,BILD 20,A02,191862,Staff,32,0,32,0
1681914568050,BILD 30,A01,191864,Staff,31,0,32,1
1681914569077,BIMM 100,A01,192019,Staff,0,0,32,32
1681914569077,BIMM 100,A02,192020,Staff,23,0,32,9
1681914569077,BIMM 100,A03,192035,Staff,22,0,32,10
1681914570104,BIMM 110,A01,192037,Tat; John,0,0,32,32
1681914570104,BIMM 110,A02,192038,Tat; John,10,0,32,22
1681914571127,BIMM 120,A01,192040,Pickett; Brooke Elizabeth,2,0,32,30
1681914571127,BIMM 120,A02,192041,Pickett; Brooke Elizabeth,16,0,32,16
1681914571127,BIMM 120,A03,192042,Pickett; Brooke Elizabeth,16,0,32,16
1681914572151,BIPN 100,A01,192044,Armour; Jon Christopher,26,0,32,6
1681914572151,BIPN 100,A02,192059,Armour; Jon Christopher,30,0,32,2
1681914572151,BIPN 100,A03,192064,Armour; Jon Christopher,31,0,32,1
1681914572151,BIPN 100,A04,192073,Armour; Jon Christopher,28,0,32,4
1681914573175,BIPN 148,A01,205411,Leutgeb; Jill K.,16,0,32,16
1681914573175,BIPN 148,A02,205412,Leutgeb; Jill K.,31,0,32,1
1681914573175,BIPN 148,A03,205413,Leutgeb; Jill K.,30,0,32,2
1681914573175,BIPN 148,A04,205414,Leutgeb; Jill K.,30,0,32,2
1681914574204,BIPN 160,A01,192115,Marino; Marc J,19,0,32,13
1681914574204,BIPN 160,A02,192148,Marino; Marc J,27,0,32,5
1681914574204,BIPN 160,A03,192158,Marino; Marc J,31,0,32,1
1681914574204,BIPN 160,A04,192190,Marino; Marc J,32,0,32,0
1681914574204,BIPN 160,A05,192287,Marino; Marc J,32,0,32,0
1681914574204,BIPN 160,A06,192288,Marino; Marc J,32,0,32,0
1681914575227,BIPN 194,A00,206038,Staff,28,0,32,4
1681914576251,BISP 194,A00,192289,Leutgeb; Stefan,13,0,32,19
1681914576251,BISP 194,B00,245332,Nieh; James Charles,27,0,32,5
1681914577275,CAT 124,A01,202247,Staff,15,0,15,0
1681914578303,CAT 125,A00,202248,Staff,19,0,20,1
1681914578303,CAT 125,B00,202253,Staff,20,0,20,0
1681914578303,CAT 125,C00,202257,Staff,19,0,20,1
1681914579328,CAT 125GS,A01,202273,Bronstein; Phoebe Malan,20,0,20,0
1681914580352,CAT 125R,A00,202284,Staff,17,0,20,3
1681914580352,CAT 125R,C00,202286,Staff,10,0,20,10
1681914580352,CAT 125R,D00,202291,Staff,18,0,20,2
1681914580352,CAT 125R,E00,202295,Staff,13,0,20,7
1681914580352,CAT 125R,F00,202302,Staff,12,0,20,8
1681914581379,CENG 100,A00,204724,Opatkiewicz; Justin Paul,25,0,25,0
1681914582405,CGS 2A,A01,180420,Staff,31,0,36,5
1681914583428,CGS 101,A00,180421,Staff,16,0,20,4
1681914584453,CGS 112,A00,180422,Staff,10,0,16,6
1681914585479,CGS 113,A00,180423,Staff,18,0,20,2
1681914586505,CGS 137,A00,180424,Staff,12,0,12,0
1681914587531,CGS 147,A00,180425,Staff,10,0,10,0
1681914588561,CHEM 6A,A01,179556,Staff,97,0,100,3
1681914588561,CHEM 6A,A02,179558,Staff,0,0,0,0
1681914589588,CHEM 6B,A01,179560,Staff,100,0,100,0
1681914590615,CHEM 6C,A01,179565,Jazzar; Rodolphe,95,0,100,5
1681914591639,CHEM 7L,A01,179586,Schurmeier; Kimberly,13,0,24,11
1681914591639,CHEM 7L,A02,179587,Schurmeier; Kimberly,23,0,24,1
1681914591639,CHEM 7L,A03,179590,Schurmeier; Kimberly,22,0,24,2
1681914591639,CHEM 7L,A04,179591,Schurmeier; Kimberly,22,0,24,2
1681914591639,CHEM 7L,B01,179598,Schurmeier; Kimberly,17,0,24,7
1681914591639,CHEM 7L,B02,179599,Schurmeier; Kimberly,24,0,24,0
1681914591639,CHEM 7L,B03,179606,Schurmeier; Kimberly,23,0,24,1
1681914591639,CHEM 7L,B04,179607,Schurmeier; Kimberly,23,0,24,1
1681914592663,CHEM 11,A01,179609,Stallings; Dontarie M,88,0,100,12
1681914593691,CHEM 40A,A01,179621,Staff,41,0,50,9
1681914593691,CHEM 40A,A02,179622,Staff,47,0,50,3
1681914594721,CHEM 40B,A01,179630,Weizman; Haim,48,0,50,2
1681914594721,CHEM 40B,A02,179631,Weizman; Haim,45,0,50,5
1681914595751,CHEM 41A,A01,179660,Klosterman; Jeremy K,93,0,100,7
1681914596776,CHEM 43A,A01,179683,Klosterman; Jeremy K,0,0,24,24
1681914596776,CHEM 43A,A02,179688,Klosterman; Jeremy K,14,0,24,10
1681914596776,CHEM 43A,A03,179689,Klosterman; Jeremy K,20,0,24,4
1681914596776,CHEM 43A,A04,179691,Klosterman; Jeremy K,18,0,24,6
1681914597800,CHEM 114A,A01,179693,Stallings; Dontarie M,77,0,100,23
1681914598825,CHEM 143B,A01,179698,Weizman; Haim,17,0,24,7
1681914598825,CHEM 143B,A02,179700,Weizman; Haim,24,0,24,0
1681914599851,CHIN 169A,A00,179701,Wang; Xiao,20,0,20,0
1681914600950,COGS 2,A01,179750,Boyle; Mary E. T.,17,0,30,13
1681914601979,COGS 9,A01,179759,Jones; Cameron Robert,43,0,50,7
1681914603007,COGS 14A,A01,179854,Staff,18,0,50,32
1681914604034,COGS 14B,A01,179856,Staff,54,0,60,6
1681914605062,COGS 17,A01,179874,Staff,71,0,75,4
1681914606094,COGS 18,A01,179884,Staff,63,0,80,17
1681914607121,COGS 100,A01,179886,Staff,40,0,60,20
1681914608148,COGS 101B,A01,179892,Staff,1,0,30,29
1681914609171,COGS 101C,A01,179894,Staff,28,0,30,2
1681914610196,COGS 107A,A01,179896,Boyle; Mary E. T.,31,0,40,9
1681914611223,COGS 108,A01,179898,Simpkins; Charles Alexander,0,17,60,60
1681914612245,COGS 109,A01,179900,Staff,34,0,40,6
1681914613269,COGS 118A,A01,179946,Staff,9,0,40,31
1681914614292,COGS 153,A00,179978,Staff,1,0,30,29
1681914615327,COGS 156,A01,179981,Staff,27,0,30,3
1681914617385,COGS 172,A01,179987,Staff,13,0,30,17
1681914619441,COGS 186,A01,179991,Staff,13,0,30,17
1681914620467,COMM 10,A01,180001,Staff,15,0,25,10
1681914620467,COMM 10,A02,180004,Staff,20,0,25,5
1681914621494,COMM 100A,A01,180016,Staff,18,0,25,7
1681914621494,COMM 100A,A02,180020,Staff,24,0,25,1
1681914622525,COMM 101T,A00,180029,Halm; Gavin Patrick,23,0,35,12
1681914623549,COMM 106V,A00,180043,Staff,34,0,35,1
1681914624576,COMM 109P,A00,180044,Staff,31,0,35,4
1681914625608,COMM 113T,A00,180045,Havis; Allan,37,0,45,8
1681914626633,COMM 132,A00,180046,McKenna; Denise,23,0,30,7
1681914627658,COMM 143,A00,180047,Staff,19,0,30,11
1681914628683,COMM 190,A00,180048,Conner; Thomas Hartnell,20,0,23,3
1681914629705,CSE 8A,A50,180053,Cao; Yingjun,25,0,50,25
1681914629705,CSE 8A,B50,180180,Staff,50,0,50,0
1681914630733,CSE 11,A01,180190,Cao; Yingjun,31,0,50,19
1681914631756,CSE 20,A01,180192,Briones; Jor-el Thomas Caparas,23,0,30,7
1681914632779,CSE 21,A01,194538,Briones; Jor-el Thomas Caparas,50,0,60,10
1681914633801,CSE 30,A01,180324,Eldon; John,78,0,100,22
1681914634823,CSE 101,A01,201353,Staff,0,20,40,40
1681914635851,CSE 134B,A01,180326,Powell; Thomas Allan,74,0,100,26
1681914636878,CSE 140,A01,180328,Staff,46,0,75,29
1681914637900,CSE 140L,A01,180344,Eldon; John,69,0,100,31
1681914638928,CSE 150A,A01,180411,Staff,0,7,50,50
1681914639952,CSE 151A,A01,180414,Staff,0,6,50,50
1681914640979,CSE 175,A01,222521,Kumar; Rakesh,50,0,50,0
1681914642005,CSE 190,A00,201419,Staff,45,0,49,4
1681914643028,CSS 1,A01,194536,Staff,38,0,50,12
1681914644071,DSC 30,A01,202385,Staff,48,0,50,2
1681914645097,DSC 40A,A01,202387,Albuyeh; Rod,50,0,50,0
1681914646125,DSC 190,A01,202389,Silberman; Jack,21,0,21,0
1681914647153,DSGN 100,A01,179993,Staff,16,0,30,14
1681914648177,ECE 65,A50,180708,Staff,10,0,20,10
1681914648177,ECE 65,A51,180739,Staff,19,0,20,1
1681914649207,ECON 1,A01,180427,Famulari; Melissa,67,0,70,3
1681914650231,ECON 2,A01,180450,Levkoff; Steven B.,64,0,70,6
1681914651260,ECON 4,A01,203351,Anderson; John Charles,7,0,10,3
1681914652287,ECON 100A,A01,180472,Famulari; Melissa,65,0,70,5
1681914653310,ECON 120A,A01,180549,Staff,64,0,70,6
1681914654333,ECON 120B,A01,180655,Ma; Xinwei,46,0,70,24
1681914655356,ECON 129,A00,203333,Eckert; Fabian Paul,15,0,35,20
1681914656379,ECON 131,A00,180656,Staff,9,0,35,26
1681914657410,ECON 172B,A01,180672,Levkoff; Steven B.,32,0,35,3
1681914658434,ECON 178,A01,203342,Zhu; Ying,11,0,35,24
1681914659457,EDS 108GS,A00,202383,Wishard Guerra; Alison G.,20,0,20,0
1681914660484,EDS 111GS,A00,202347,Wishard Guerra; Alison G.,20,0,20,0
1681914661510,EDS 112,A01,202323,Staff,56,0,60,4
1681914662552,EDS 113,A00,202340,Staff,33,0,35,2
1681914663576,EDS 118,A00,201231,Staff,20,0,30,10
1681914664603,EDS 119,A00,204994,Staff,8,0,10,2
1681914665627,EDS 124BR,A00,202324,Eguchi; Emi,5,0,25,20
1681914666652,EDS 126,A01,203208,Jones; Makeba,26,0,30,4
1681914667677,EDS 135,A01,202333,Staff,18,0,20,2
1681914668701,EDS 180,A00,202311,Staff,47,0,50,3
1681914669726,ERC 190GS,A01,253747,Staff,28,0,28,0
1681914670749,ETHN 104,A00,180742,Staff,24,0,35,11
1681914671775,ETHN 118,A00,180745,Staff,28,0,35,7
1681914672801,ETHN 127,A00,180747,Staff,12,0,16,4
1681914673827,ETHN 137,A00,180880,Staff,12,0,12,0
1681914674850,ETHN 147,A00,180890,Staff,8,0,10,2
1681914675875,ETHN 154,A00,180891,Staff,7,0,8,1
1681914676902,ETHN 168,A00,180892,Staff,9,0,10,1
1681914677926,GLBH 20,A00,201051,Hannah; Seth Donal,0,1,0,1
1681914678949,GLBH 111,A01,209338,Burgos; Jose L.,0,0,0,0
1681914679972,GLBH 150,A00,258300,Staff,0,3,0,0
1681914680998,GLBH 181,A00,201207,Staff,15,0,40,25
1681914682021,HIEU 109,A00,180898,Staff,20,0,20,0
1681914683048,HIEU 111,A00,180899,Staff,1,0,20,19
1681914684078,HIEU 124,A00,180900,Staff,18,0,20,2
1681914685100,HILA 122,A00,180901,Staff,18,0,20,2
1681914686126,HILA 132,A00,180902,Vitz; Matthew,2,0,20,18
1681914687157,HILD 10,A01,180896,Staff,15,0,20,5
1681914688181,HILD 30GS,A00,180897,Edington; Claire Ellen,0,0,0,0
1681914689219,HISC 105,A00,180903,Staff,20,0,20,0
1681914690247,HISC 117,A00,180904,Staff,11,0,20,9
1681914691270,HIUS 108B,A00,181005,Staff,18,0,20,2
1681914692302,HIUS 113,A00,181093,Staff,4,0,20,16
1681914693333,HUM 3,A01,181190,Patterson; Patrick H.,40,0,50,10
1681914693333,HUM 3,B01,181195,Staff,47,0,50,3
1681914694357,HUM 3GS,A00,181196,Herbst; Matthew,0,0,0,0
1681914695382,HUM 4,A01,181227,West; Geoffrey Scott,34,0,50,16
1681914695382,HUM 4,B01,181282,Staff,43,0,50,7
1681914696405,HUM 4GS,A00,181377,Lyon; Antony J.,0,0,0,0
1681914697435,HUM 5,A01,181536,Zavodny; Tatiana Sophia,31,0,50,19
1681914697435,HUM 5,B01,181908,Staff,36,0,50,14
1681914698460,INTL 190,A00,181909,Segui; Alan S,0,0,0,6
1681914698460,INTL 190,B00,181961,Segui; Alan S,0,0,0,7
1681914699484,JAPN 20AR,A01,182113,Ross; Kayoko F,15,0,20,5
1681914700510,LATI 50,A01,202391,Martin-Cabrera; Luis,19,0,30,11
1681914700510,LATI 50,A02,202392,Martin-Cabrera; Luis,26,0,30,4
1681914701537,LATI 180,A00,202393,Kokinis; Troy Andreas,25,0,25,0
1681914702565,LIFR 1A,A00,182119,Staff,14,0,14,0
1681914703589,LIFR 1AX,A00,182324,Staff,14,0,14,0
1681914704690,LIFR 1B,A00,182259,Staff,14,0,14,0
1681914705714,LIFR 1BX,A00,182273,Staff,14,0,14,0
1681914706736,LIGN 8,A00,182330,Staff,137,0,150,13
1681914707762,LIGN 9GS,A00,182362,Staff,20,0,20,0
1681914708785,LIGN 119,A00,204992,Takahashi; Maho,12,0,15,3
1681914709807,LIGN 130,A01,182384,Staff,47,0,50,3
1681914710829,LIGN 149GS,A00,182390,Staff,20,0,20,0
1681914711853,LIGN 170,A00,182404,Staff,24,0,30,6
1681914712878,LISP 1D,A00,182281,Staff,7,0,14,7
1681914712878,LISP 1D,B00,182287,Staff,14,0,14,0
1681914712878,LISP 1D,C00,182295,Staff,11,0,14,3
1681914712878,LISP 1D,D00,182301,Staff,14,0,14,0
1681914713901,LISP 1DX,A00,182309,Staff,20,0,28,8
1681914713901,LISP 1DX,B00,182316,Staff,26,0,28,2
1681914714931,LTAF 120GS,A00,182412,Zhiri; Oumelbanine,20,0,20,0
1681914715958,LTCS 172GS,A00,182437,Bronstein; Phoebe Malan,20,0,20,0
1681914716985,LTEA 138,A00,182457,Staff,22,0,40,18
1681914718010,LTEN 114,A01,182490,Staff,23,0,25,2
1681914719036,LTEN 130GS,A00,182491,Lyon; Antony J.,20,0,20,0
1681914720061,LTEN 169,A00,182493,Cuong; Marisol,20,0,25,5
1681914721091,LTEN 178,A00,182501,Staff,14,0,15,1
1681914722115,LTEN 181,A00,182515,Staff,22,0,25,3
1681914723142,LTEN 185GS,A00,197655,Forbes; Camille,20,0,20,0
1681914724167,LTSP 100B,A00,202208,Bessett; Ryan Matthew,24,0,25,1
1681914725191,LTWL 100,A00,182516,Myerston Santana; Jacobo,22,0,30,8
1681914726214,LTWR 100GS,A00,182518,Forbes; Camille,20,0,20,0
1681914727242,LTWR 102,A00,182522,Staff,15,0,15,0
1681914727242,LTWR 102,B00,182525,Staff,14,0,15,1
1681914728266,LTWR 115,A00,182526,Staff,12,0,15,3
1681914729290,MAE 8,A01,182528,Pham; Hieu Tan,68,0,70,2
1681914730319,MAE 11,A00,182529,Bahadori; Mohammad Yousef,94,0,100,6
1681914731346,MAE 20,A00,182530,Evdokimenko; Ekaterina,68,0,70,2
1681914732374,MAE 30A,A00,182532,Staff,44,0,45,1
1681914733397,MAE 101A,A00,182533,Bahadori; Mohammad Yousef,97,0,100,3
1681914734424,MAE 101C,A00,182538,Staff,62,0,70,8
1681914735454,MAE 104,A00,182539,Staff,45,0,50,5
1681914736480,MAE 131A,A00,182540,Ghazinejad; Maziar,41,0,45,4
1681914737508,MAE 143A,A00,182548,Bewley; Thomas R,43,0,50,7
1681914738532,MAE 150,A00,182549,Staff,28,0,40,12
1681914739561,MAE 160,A00,182550,Evdokimenko; Ekaterina,43,0,60,17
1681914740584,MATH 3C,A01,182725,Staff,27,0,30,3
1681914741608,MATH 10A,A01,182729,Staff,25,0,30,5
1681914741608,MATH 10A,B01,182732,Staff,26,0,30,4
1681914742637,MATH 10B,A01,182737,Staff,21,0,30,9
1681914742637,MATH 10B,A02,182738,Staff,27,0,30,3
1681914742637,MATH 10B,B01,182744,Staff,27,0,30,3
1681914742637,MATH 10B,B02,182745,Staff,27,0,30,3
1681914743662,MATH 18,A01,182750,Anzaldo; Leesa B,28,0,30,2
1681914743662,MATH 18,A02,182751,Anzaldo; Leesa B,29,0,30,1
1681914743662,MATH 18,A03,182753,Anzaldo; Leesa B,28,0,30,2
1681914743662,MATH 18,A04,182757,Anzaldo; Leesa B,29,0,30,1
1681914743662,MATH 18,B01,182761,Anzaldo; Leesa B,27,0,30,3
1681914743662,MATH 18,B02,182764,Anzaldo; Leesa B,27,0,30,3
1681914743662,MATH 18,B03,182765,Anzaldo; Leesa B,30,0,30,0
1681914743662,MATH 18,B04,182766,Anzaldo; Leesa B,30,0,30,0
1681914744687,MATH 20A,A01,182771,Suk; Andrew Hoon,28,0,30,2
1681914745712,MATH 20B,A01,182775,Bach; Quang Tran,30,0,30,0
1681914745712,MATH 20B,A02,182777,Bach; Quang Tran,29,0,30,1
1681914745712,MATH 20B,B01,182780,Bach; Quang Tran,27,0,30,3
1681914745712,MATH 20B,B02,182782,Bach; Quang Tran,30,0,30,0
1681914746736,MATH 20C,A01,182787,Staff,25,0,30,5
1681914746736,MATH 20C,A02,182790,Staff,29,0,30,1
1681914746736,MATH 20C,B01,182792,Staff,25,0,30,5
1681914746736,MATH 20C,B02,182796,Staff,27,0,30,3
1681914747763,MATH 20D,A01,182799,Staff,29,0,30,1
1681914747763,MATH 20D,A02,182802,Staff,30,0,30,0
1681914747763,MATH 20D,A03,182803,Staff,30,0,30,0
1681914748793,MATH 20E,A01,182809,Verstraete; Jacques Allan,24,0,30,6
1681914748793,MATH 20E,A02,182811,Verstraete; Jacques Allan,28,0,30,2
1681914748793,MATH 20E,B01,182814,Verstraete; Jacques Allan,23,0,30,7
1681914748793,MATH 20E,B02,182815,Verstraete; Jacques Allan,30,0,30,0
1681914749820,MATH 103A,A01,182820,Staff,9,0,30,21
1681914749820,MATH 103A,A02,182821,Staff,27,0,30,3
1681914749820,MATH 103A,A03,182822,Staff,23,0,30,7
1681914749820,MATH 103A,B01,182825,Staff,23,0,30,7
1681914749820,MATH 103A,B02,182826,Staff,30,0,30,0
1681914749820,MATH 103A,B03,182830,Staff,30,0,30,0
1681914750849,MATH 109,A01,182836,Chow; Bennett,24,0,30,6
1681914750849,MATH 109,A02,182838,Chow; Bennett,29,0,30,1
1681914750849,MATH 109,A03,182894,Chow; Bennett,29,0,30,1
1681914750849,MATH 109,B01,182908,Chow; Bennett,28,0,30,2
1681914750849,MATH 109,B02,182909,Chow; Bennett,30,0,30,0
1681914750849,MATH 109,B03,182910,Chow; Bennett,27,0,30,3
1681914751874,MATH 142A,A01,182925,Staff,11,0,30,19
1681914751874,MATH 142A,A02,182935,Staff,25,0,30,5
1681914751874,MATH 142A,A03,182967,Staff,26,0,30,4
1681914751874,MATH 142A,B01,183125,Staff,24,0,30,6
1681914751874,MATH 142A,B02,183157,Staff,28,0,30,2
1681914751874,MATH 142A,B03,183158,Staff,29,0,30,1
1681914752902,MATH 183,A01,183160,Arias-Castro; Ery,23,0,30,7
1681914752902,MATH 183,A02,183161,Arias-Castro; Ery,29,0,30,1
1681914752902,MATH 183,B01,183163,Arias-Castro; Ery,28,0,30,2
1681914752902,MATH 183,B02,183164,Arias-Castro; Ery,28,0,30,2
1681914753929,MATH 193A,A01,183167,Staff,4,0,35,31
1681914753929,MATH 193A,A02,183168,Staff,28,0,35,7
1681914753929,MATH 193A,A03,183169,Staff,34,0,35,1
1681914753929,MATH 193A,A04,183170,Staff,28,0,35,7
1681914754955,MGT 4,A01,202395,Anderson; John Charles,75,0,80,5
1681914755983,MGT 5,A00,202396,Houskeeper; Robert,80,0,90,10
1681914757007,MGT 103,A00,202397,Eberhard; Craig A,55,0,90,35
1681914758031,MGT 131A,A00,202398,Houskeeper; Robert,85,0,90,5
1681914759054,MGT 135,A00,202399,Anderson; John Charles,82,0,90,8
1681914760077,MGT 162R,A00,202403,Gneezy; Uri,150,0,200,50
1681914761103,MGT 172,A00,202404,Hedges; Kathleen,50,0,90,40
1681914762129,MGT 181,A00,202405,Dunn; Louis Jean,84,0,90,6
1681914763156,MMW 14,A01,183200,Staff,16,0,28,12
1681914763156,MMW 14,A02,183201,Staff,26,0,28,2
1681914763156,MMW 14,A03,183202,Staff,24,0,28,4
1681914763156,MMW 14,A04,183203,Staff,25,0,28,3
1681914763156,MMW 14,A05,183204,Staff,26,0,28,2
1681914763156,MMW 14,A06,183205,Staff,27,0,28,1
1681914763156,MMW 14,B01,183207,Staff,26,0,28,2
1681914763156,MMW 14,B02,183208,Staff,28,0,28,0
1681914763156,MMW 14,B03,183209,Staff,28,0,28,0
1681914763156,MMW 14,B04,183210,Staff,28,0,28,0
1681914763156,MMW 14,B05,183211,Staff,28,0,28,0
1681914763156,MMW 14,B06,183212,Staff,28,0,28,0
1681914764181,MMW 14GS,A00,183213,Zhiri; Oumelbanine,28,0,28,0
1681914765204,MMW 15GS,B00,183215,Rahimi; Babak,28,0,28,0
1681914766228,MMW 121,A01,183217,Patterson; Patrick H.,14,0,28,14
1681914766228,MMW 121,A02,183218,Patterson; Patrick H.,25,0,28,3
1681914767252,MUS 1A,A01,182554,Staff,8,0,35,27
1681914768274,MUS 5,A01,182558,Staff,20,0,35,15
1681914769296,MUS 6,A01,182562,Staff,25,0,35,10
1681914770323,MUS 8GS,A00,182563,Borgo; David Garcia,25,0,25,0
1681914771350,MUS 13,A01,182567,Staff,24,0,25,1
1681914772379,MUS 15,A01,182570,Staff,32,0,35,3
1681914772379,MUS 15,B01,182575,Staff,10,0,35,25
1681914773407,MUS 80,A00,182578,Staff,23,0,25,2
1681914773407,MUS 80,B00,182581,Staff,20,0,25,5
1681914774432,MUS 113,A00,182582,Staff,25,0,25,0
1681914775519,MUS 114,A00,182583,Staff,4,0,25,21
1681914776543,MUS 150GS,A01,182588,Borgo; David Garcia,25,0,25,0
1681914777569,PHIL 1,A00,182590,Staff,35,0,40,5
1681914778595,PHIL 10,A01,182596,Grush; Rick Scott,31,0,35,4
1681914778595,PHIL 10,A02,182597,Grush; Rick Scott,34,0,35,1
1681914779619,PHIL 15,A01,182601,Staff,31,0,35,4
1681914779619,PHIL 15,A02,182602,Staff,33,0,35,2
1681914780646,PHIL 27,A01,182604,Staff,30,0,35,5
1681914780646,PHIL 27,A02,182607,Staff,35,0,35,0
1681914781669,PHIL 32,A01,182609,Staff,35,0,35,0
1681914781669,PHIL 32,A02,182612,Staff,35,0,35,0
1681914782695,PHIL 130,A00,182614,Staff,63,0,70,7
1681914783722,PHIL 136,A00,182616,Cohen; Jonathan David,66,0,70,4
1681914784748,PHIL 155,A00,182617,Vargas; Manuel Rogelio,60,0,70,10
1681914785771,PHIL 163,A01,182620,Staff,15,0,20,5
1681914785771,PHIL 163,A02,182624,Staff,10,0,20,10
1681914786803,PHIL 164,A00,182627,Staff,30,0,40,10
1681914787832,PHIL 173,A00,182628,Staff,36,0,40,4
1681914788866,PHYS 1A,A00,183221,Staff,54,0,60,6
1681914789889,PHYS 1AL,001,183222,Staff,25,0,30,5
1681914789889,PHYS 1AL,002,183223,Staff,28,0,30,2
1681914790914,PHYS 1B,A00,183231,Staff,44,0,60,16
1681914791937,PHYS 1BL,001,183232,Staff,20,0,30,10
1681914791937,PHYS 1BL,002,183233,Staff,29,0,30,1
1681914792962,PHYS 1C,A00,183240,Staff,30,0,60,30
1681914793985,PHYS 1CL,001,183241,Staff,13,0,30,17
1681914793985,PHYS 1CL,002,183242,Staff,22,0,30,8
1681914795011,PHYS 2AR,A01,183250,Staff,44,0,50,6
1681914796035,PHYS 2B,A01,183252,Staff,106,0,115,9
1681914797067,PHYS 2BL,A01,183254,Staff,21,0,24,3
1681914797067,PHYS 2BL,A02,183255,Staff,22,0,24,2
1681914798092,PHYS 2C,A01,183522,Staff,105,0,115,10
1681914799118,PHYS 4A,A01,183524,Staff,49,0,50,1
1681914800143,POLI 5,A00,183525,Staff,44,0,50,6
1681914801167,POLI 12,A00,183540,Staff,48,0,50,2
1681914802192,POLI 13R,A00,183541,Forman; Fonna,42,0,50,8
1681914803216,POLI 30,A00,183542,Mignozzetti; Umberto,47,0,50,3
1681914804241,POLI 100A,A00,183543,Staff,45,0,50,5
1681914805269,POLI 100E,A00,223598,Staff,32,0,35,3
1681914806296,POLI 103A,A00,183564,Kousser; Thad,38,0,50,12
1681914807324,POLI 104B,A00,201329,Staff,29,0,35,6
1681914808420,POLI 113BR,A00,183576,Hoston; Germaine,27,0,50,23
1681914809444,POLI 114BR,A00,183588,Staff,27,0,30,3
1681914810469,POLI 117R,A00,183595,Forman; Fonna,9,0,20,11
1681914811491,POLI 120H,A00,183596,Fisk; David Lee,13,0,20,7
1681914812518,POLI 130AA,A00,183597,Staff,14,0,20,6
1681914813543,POLI 134AA,A00,183598,Staff,19,0,20,1
1681914814567,POLI 135,A00,183599,Fisk; David Lee,20,0,25,5
1681914815589,POLI 142P,A00,183623,Staff,37,0,40,3
1681914816620,POLI 144D,A00,183624,Staff,22,0,25,3
1681914817645,POLI 151,A00,183625,Staff,15,0,20,5
1681914818668,POLI 162,A00,183626,Mignozzetti; Umberto,18,0,20,2
1681914819693,PSYC 1,A00,253748,Staff,86,0,90,4
1681914820720,PSYC 2,A00,183627,Moranton; Nirelia Melbina-,25,0,35,10
1681914821746,PSYC 3,A00,183628,Staff,43,0,45,2
1681914823801,PSYC 60,A01,183631,Lowe; Angela Beth,35,0,40,5
1681914824824,PSYC 70,A01,253757,Staff,37,0,45,8
1681914825846,PSYC 101,A00,183632,Heyman; Gail D.,48,0,60,12
1681914826877,PSYC 105,A00,183848,Lowe; Angela Beth,50,0,60,10
1681914827909,PSYC 106,A00,183849,Dobkins; Karen R.,45,0,60,15
1681914828932,PSYC 108,A00,253750,Staff,24,0,60,36
1681914829957,PSYC 114,A01,184275,Winkielman; Piotr,0,6,30,30
1681914830984,PSYC 122,A00,183856,Moranton; Nirelia Melbina-,0,10,30,30
1681914832006,PSYC 124,A00,183865,Chapman; Eddie Nathaniel,52,0,80,28
1681914833029,PSYC 137,A00,183880,Staff,19,0,25,6
1681914835076,PSYC 154,A00,183910,Lacefield; Katharine I,0,2,90,90
1681914837126,PSYC 162,A00,183946,Wixted; John T,61,0,90,29
1681914838153,PSYC 172,A00,183947,Gorman; Michael R.,14,0,30,16
1681914839177,PSYC 178,A00,183963,Glaser; Dale,20,0,40,20
1681914840200,PSYC 181GS,A00,183964,Anagnostaras; Stephan,10,0,10,0
1681914841225,PSYC 186GS,A01,257660,Staff,10,0,10,0
1681914842248,PSYC 193,B00,253749,Staff,23,0,25,2
1681914844297,PSYC 193L,A01,184122,Staff,33,0,35,2
1681914844297,PSYC 193L,C01,184167,Winkielman; Piotr,16,0,30,14
1681914845319,RELI 188GS,A00,182629,Rahimi; Babak,20,0,20,0
1681914846346,SE 101A,A00,182646,Staff,26,0,30,4
1681914847375,SE 101C,A00,182650,Staff,18,0,20,2
1681914848398,SE 110A,A00,182651,Staff,28,0,28,0
1681914849433,SE 130A,A00,182652,Staff,39,0,40,1
1681914850460,SIO 46GS,A00,182636,Cook; Geoffrey W,28,0,28,0
1681914851482,SIO 109R,A00,194459,Staff,5,0,20,15
1681914852505,SIO 121GS,A00,182639,Cook; Geoffrey W,28,0,28,0
1681914853537,SIO 132,A01,182642,Staff,32,0,40,8
1681914854562,SIO 139,A00,182644,Kacev; David,36,0,40,4
1681914855590,SOCI 2,A01,258404,Staff,34,0,36,2
1681914855590,SOCI 2,A02,258405,Staff,35,0,36,1
1681914856618,SOCI 60,A01,258408,Staff,29,0,30,1
1681914856618,SOCI 60,A02,258413,Staff,30,0,30,0
1681914857648,SOCI 100,A01,258415,Staff,29,0,30,1
1681914857648,SOCI 100,A02,258416,Staff,28,0,30,2
1681914864328,SOCI 127,A00,258421,Staff,22,0,30,8
1681914865351,SOCI 132,A00,258422,Staff,45,0,50,5
1681914866375,SOCI 133,A00,258423,Staff,26,0,30,4
1681914867399,SOCI 138GS,A00,258424,Staff,15,0,15,0
1681914868427,SOCI 145,A00,258425,Staff,25,0,30,5
1681914869453,SOCI 148,A00,258426,Staff,26,0,30,4
1681914870475,SOCI 153,A00,199217,Staff,29,0,30,1
1681914871499,SOCI 160,A00,258427,Staff,28,0,30,2
1681914872526,SOCI 160E,A00,258435,Staff,56,0,60,4
1681914873549,SOCI 189GS,A00,258436,Staff,15,0,15,0
1681914874572,SOCI 190GS,A00,258437,Staff,15,0,15,0
1681914875598,SYN 2,001,182658,Staff,9,0,16,7
1681914875598,SYN 2,002,201439,Staff,15,0,16,1
1681914875598,SYN 2,003,201443,Staff,16,0,16,0
1681914876623,SYN 100,A01,182657,Staff,17,0,20,3
1681914877647,TDAC 1,A00,184381,Salovey; Todd,16,0,20,4
1681914877647,TDAC 1,B00,184385,Harting; Carla Kelso,19,0,20,1
1681914877647,TDAC 1,C00,184394,Staff,19,0,20,1
1681914878673,TDAC 101,A00,184483,Harting; Carla Kelso,19,0,20,1
1681914879697,TDDE 111,A00,184496,Staff,14,0,15,1
1681914880726,TDDE 131,A00,184504,Staff,20,0,20,0
1681914880726,TDDE 131,B00,184505,Staff,17,0,18,1
1681914880726,TDDE 131,C00,184534,Staff,49,0,50,1
1681914880726,TDDE 131,D00,184564,Staff,15,0,15,0
1681914880726,TDDE 131,E00,204725,Staff,19,0,20,1
1681914881749,TDGE 1,A01,184414,Salovey; Todd,37,0,50,13
1681914882774,TDGE 5,A01,184419,Staff,23,0,24,1
1681914883799,TDGE 10,A00,184428,Fulton; Julia,31,0,50,19
1681914884825,TDGE 124,A00,184565,Fulton; Julia,7,0,50,43
1681914885851,TDGE 125,B00,184567,Meyer; Ursula,9,0,25,16
1681914886877,TDHT 101,A00,184568,Staff,21,0,25,4
1681914886877,TDHT 101,B00,184569,Staff,20,0,20,0
1681914887902,TDHT 114,A00,184570,Staff,49,0,50,1
1681914888925,TDMV 1,A00,184437,Arcidiacono; Kristin,23,0,30,7
1681914888925,TDMV 1,B00,184448,Caligagan; Maria T.,22,0,30,8
1681914889947,TDMV 2,A00,184449,Weinberg; Sadie,27,0,30,3
1681914889947,TDMV 2,B00,184453,Arcidiacono; Kristin,29,0,30,1
1681914890974,TDMV 110,A00,184571,Weinberg; Sadie,30,0,30,0
1681914892005,TDMV 142,A00,184572,Caligagan; Tony,27,0,30,3
1681914892005,TDMV 142,B00,184573,Caligagan; Maria T.,27,0,30,3
1681914893031,TDTR 20,A00,184482,Jun; Grace Shin Hae,25,0,25,0
1681914894056,USP 2,A01,184290,Hinds; Juli Beth,24,0,25,1
1681914895079,USP 3,A01,184295,Staff,20,0,25,5
1681914896102,USP 4,A00,184304,McTague; Sarah,15,0,25,10
1681914897126,USP 100,A00,184315,Staff,17,0,25,8
1681914898149,USP 105,A00,184326,Staff,21,0,25,4
1681914899174,USP 151,A00,184327,Staff,20,0,25,5
1681914900196,USP 170,A00,184380,Hinds; Juli Beth,14,0,25,11
1681914901224,VIS 21B,A01,182660,Staff,28,0,31,3
1681914901224,VIS 21B,A02,182662,Staff,30,0,31,1
1681914902246,VIS 103D,A00,182663,Staff,74,0,75,1
1681914903268,VIS 105D,A00,182667,Li; Huai,15,0,22,7
1681914904299,VIS 122GS,A00,182668,Herbst; Matthew,20,0,20,0
1681914905326,VIS 128C,A00,182673,Staff,69,0,75,6
1681914906352,VIS 130,A00,182675,Staff,20,0,22,2
1681914907382,VIS 160A,A00,182678,Stalbaum; Brett,4,0,10,6
1681914909429,WCWP 10B,A00,201679,Staff,15,0,15,0
1681914909429,WCWP 10B,B00,201695,Staff,15,0,15,0
1681914910458,WCWP 100,A00,201716,Staff,15,0,15,0
1681914910458,WCWP 100,B00,201717,Staff,11,0,15,4
1681914912647,ANSC 105GS,A00,258289,Staff,0,0,0,0
1681914913672,ANSC 125GS,A00,258295,Staff,0,0,0,0
1681914914696,ANSC 150,A00,258267,Staff,30,0,40,10
1681914915721,ANSC 190GS,A00,258280,Staff,0,0,0,0
1681914916743,ANTH 1,A00,258264,Staff,38,0,40,2
1681914917770,ANTH 2,A01,258259,Staff,72,0,76,4
1681914918794,ANTH 23,A01,258228,Staff,36,0,40,4
1681914919819,ANTH 101,A01,258236,Staff,39,0,40,1
1681914920849,ANTH 102,A00,258272,Staff,59,0,60,1
1681914921872,ANTH 105,A00,258244,Staff,31,0,35,4
1681914922898,BENG 130,A00,253975,Staff,38,0,40,2
1681914923921,BIBC 102,A01,191866,Flagg; Matthew Paul,19,0,32,13
1681914923921,BIBC 102,A02,191867,Flagg; Matthew Paul,22,0,32,10
1681914923921,BIBC 102,A03,191868,Flagg; Matthew Paul,30,0,32,2
1681914923921,BIBC 102,A04,191936,Flagg; Matthew Paul,26,0,32,6
1681914923921,BIBC 102,A05,191937,Flagg; Matthew Paul,11,0,32,21
1681914924945,BICD 100,A01,191939,Cooper; Andrew Michael,28,0,32,4
1681914924945,BICD 100,A02,191940,Cooper; Andrew Michael,32,0,32,0
1681914924945,BICD 100,A03,191941,Cooper; Andrew Michael,32,0,32,0
1681914924945,BICD 100,A04,191942,Cooper; Andrew Michael,32,0,32,0
1681914924945,BICD 100,A05,191943,Cooper; Andrew Michael,32,0,32,0
1681914925972,BIEB 126,A01,191945,Cleland; Elsa Eleanor,1,0,32,31
1681914925972,BIEB 126,A02,191946,Cleland; Elsa Eleanor,28,0,32,4
1681914925972,BIEB 126,A03,191947,Cleland; Elsa Eleanor,29,0,32,3
1681914925972,BIEB 126,A04,191948,Cleland; Elsa Eleanor,23,0,32,9
1681914925972,BIEB 126,A05,191996,Cleland; Elsa Eleanor,28,0,32,4
1681914926995,BIEB 136GS,A00,191997,Shurin; Jonathan & Holway; David A.,0,0,0,0
1681914928021,BIEB 137GS,A01,191999,Shurin; Jonathan & Holway; David A.,0,0,0,0
1681914929044,BILD 1,A01,205385,Staff,31,0,32,1
1681914929044,BILD 1,A02,205386,Staff,30,0,32,2
1681914929044,BILD 1,A03,205387,Staff,32,0,32,0
1681914929044,BILD 1,A04,205388,Staff,28,0,32,4
1681914930068,BILD 2,A01,191774,Staff,28,0,32,4
1681914930068,BILD 2,A02,191775,Staff,30,0,32,2
1681914930068,BILD 2,A03,191777,Staff,30,0,32,2
1681914930068,BILD 2,A04,191856,Staff,31,0,32,1
1681914930068,BILD 2,A05,191857,Staff,32,0,32,0
1681914930068,BILD 2,A06,191858,Staff,32,0,32,0
1681914930068,BILD 2,A07,191859,Staff,31,0,32,1
1681914931091,BILD 3,A01,205391,Staff,29,0,32,3
1681914931091,BILD 3,A02,205393,Staff,32,0,32,0
1681914931091,BILD 3,A03,205394,Staff,28,0,32,4
1681914931091,BILD 3,A04,205395,Staff,32,0,32,0
1681914932121,BILD 20,A01,191861,Staff,32,0,32,0
1681914932121,BILD 20,A02,191862,Staff,32,0,32,0
1681914933146,BILD 30,A01,191864,Staff,31,0,32,1
1681914934171,BIMM 100,A01,192019,Staff,0,0,32,32
1681914934171,BIMM 100,A02,192020,Staff,23,0,32,9
1681914934171,BIMM 100,A03,192035,Staff,22,0,32,10
1681914935194,BIMM 110,A01,192037,Tat; John,0,0,32,32
1681914935194,BIMM 110,A02,192038,Tat; John,10,0,32,22
1681914936221,BIMM 120,A01,192040,Pickett; Brooke Elizabeth,2,0,32,30
1681914936221,BIMM 120,A02,192041,Pickett; Brooke Elizabeth,16,0,32,16
1681914936221,BIMM 120,A03,192042,Pickett; Brooke Elizabeth,16,0,32,16
1681914937244,BIPN 100,A01,192044,Armour; Jon Christopher,26,0,32,6
1681914937244,BIPN 100,A02,192059,Armour; Jon Christopher,30,0,32,2
1681914937244,BIPN 100,A03,192064,Armour; Jon Christopher,31,0,32,1
1681914937244,BIPN 100,A04,192073,Armour; Jon Christopher,28,0,32,4
1681914938268,BIPN 148,A01,205411,Leutgeb; Jill K.,16,0,32,16
1681914938268,BIPN 148,A02,205412,Leutgeb; Jill K.,31,0,32,1
1681914938268,BIPN 148,A03,205413,Leutgeb; Jill K.,30,0,32,2
1681914938268,BIPN 148,A04,205414,Leutgeb; Jill K.,30,0,32,2
1681914939297,BIPN 160,A01,192115,Marino; Marc J,19,0,32,13
1681914939297,BIPN 160,A02,192148,Marino; Marc J,27,0,32,5
1681914939297,BIPN 160,A03,192158,Marino; Marc J,31,0,32,1
1681914939297,BIPN 160,A04,192190,Marino; Marc J,32,0,32,0
1681914939297,BIPN 160,A05,192287,Marino; Marc J,32,0,32,0
1681914939297,BIPN 160,A06,192288,Marino; Marc J,32,0,32,0
1681914940326,BIPN 194,A00,206038,Staff,28,0,32,4
1681914941353,BISP 194,A00,192289,Leutgeb; Stefan,13,0,32,19
1681914941353,BISP 194,B00,245332,Nieh; James Charles,27,0,32,5
1681914942380,CAT 124,A01,202247,Staff,15,0,15,0
1681914943417,CAT 125,A00,202248,Staff,19,0,20,1
1681914943417,CAT 125,B00,202253,Staff,20,0,20,0
1681914943417,CAT 125,C00,202257,Staff,19,0,20,1
1681914944439,CAT 125GS,A01,202273,Bronstein; Phoebe Malan,20,0,20,0
1681914945466,CAT 125R,A00,202284,Staff,17,0,20,3
1681914945466,CAT 125R,C00,202286,Staff,10,0,20,10
1681914945466,CAT 125R,D00,202291,Staff,18,0,20,2
1681914945466,CAT 125R,E00,202295,Staff,13,0,20,7
1681914945466,CAT 125R,F00,202302,Staff,12,0,20,8
1681914946490,CENG 100,A00,204724,Opatkiewicz; Justin Paul,25,0,25,0
1681914947515,CGS 2A,A01,180420,Staff,31,0,36,5
1681914948537,CGS 101,A00,180421,Staff,16,0,20,4
1681914949562,CGS 112,A00,180422,Staff,10,0,16,6
1681914950585,CGS 113,A00,180423,Staff,18,0,20,2
1681914951609,CGS 137,A00,180424,Staff,12,0,12,0
1681914952633,CGS 147,A00,180425,Staff,10,0,10,0
1681914953657,CHEM 6A,A01,179556,Staff,97,0,100,3
1681914953657,CHEM 6A,A02,179558,Staff,0,0,0,0
1681914954680,CHEM 6B,A01,179560,Staff,100,0,100,0
1681914955717,CHEM 6C,A01,179565,Jazzar; Rodolphe,95,0,100,5
1681914956742,CHEM 7L,A01,179586,Schurmeier; Kimberly,13,0,24,11
1681914956742,CHEM 7L,A02,179587,Schurmeier; Kimberly,23,0,24,1
1681914956742,CHEM 7L,A03,179590,Schurmeier; Kimberly,22,0,24,2
1681914956742,CHEM 7L,A04,179591,Schurmeier; Kimberly,22,0,24,2
1681914956742,CHEM 7L,B01,179598,Schurmeier; Kimberly,17,0,24,7
1681914956742,CHEM 7L,B02,179599,Schurmeier; Kimberly,24,0,24,0
1681914956742,CHEM 7L,B03,179606,Schurmeier; Kimberly,23,0,24,1
1681914956742,CHEM 7L,B04,179607,Schurmeier; Kimberly,23,0,24,1
1681914957769,CHEM 11,A01,179609,Stallings; Dontarie M,88,0,100,12
1681914958793,CHEM 40A,A01,179621,Staff,41,0,50,9
1681914958793,CHEM 40A,A02,179622,Staff,47,0,50,3
1681914959817,CHEM 40B,A01,179630,Weizman; Haim,48,0,50,2
1681914959817,CHEM 40B,A02,179631,Weizman; Haim,45,0,50,5
1681914960846,CHEM 41A,A01,179660,Klosterman; Jeremy K,93,0,100,7
1681914961873,CHEM 43A,A01,179683,Klosterman; Jeremy K,0,0,24,24
1681914961873,CHEM 43A,A02,179688,Klosterman; Jeremy K,14,0,24,10
1681914961873,CHEM 43A,A03,179689,Klosterman; Jeremy K,20,0,24,4
1681914961873,CHEM 43A,A04,179691,Klosterman; Jeremy K,18,0,24,6
1681914962897,CHEM 114A,A01,179693,Stallings; Dontarie M,77,0,100,23
1681914963922,CHEM 143B,A01,179698,Weizman; Haim,17,0,24,7
1681914963922,CHEM 143B,A02,179700,Weizman; Haim,24,0,24,0
1681914964948,CHIN 169A,A00,179701,Wang; Xiao,20,0,20,0
1681914965979,COGS 2,A01,179750,Boyle; Mary E. T.,17,0,30,13
1681914967006,COGS 9,A01,179759,Jones; Cameron Robert,43,0,50,7
1681914968033,COGS 14A,A01,179854,Staff,18,0,50,32
1681914969062,COGS 14B,A01,179856,Staff,54,0,60,6
1681914970091,COGS 17,A01,179874,Staff,71,0,75,4
1681914971118,COGS 18,A01,179884,Staff,63,0,80,17
1681914972145,COGS 100,A01,179886,Staff,40,0,60,20
1681914973169,COGS 101B,A01,179892,Staff,1,0,30,29
1681914974205,COGS 101C,A01,179894,Staff,28,0,30,2
1681914975240,COGS 107A,A01,179896,Boyle; Mary E. T.,31,0,40,9
1681914976270,COGS 108,A01,179898,Simpkins; Charles Alexander,0,17,60,60
1681914977293,COGS 109,A01,179900,Staff,34,0,40,6
1681914978317,COGS 118A,A01,179946,Staff,9,0,40,31
1681914979345,COGS 153,A00,179978,Staff,1,0,30,29
1681914980373,COGS 156,A01,179981,Staff,27,0,30,3
1681914982420,COGS 172,A01,179987,Staff,13,0,30,17
1681914984467,COGS 186,A01,179991,Staff,13,0,30,17
1681914985493,COMM 10,A01,180001,Staff,15,0,25,10
1681914985493,COMM 10,A02,180004,Staff,20,0,25,5
1681914986515,COMM 100A,A01,180016,Staff,18,0,25,7
1681914986515,COMM 100A,A02,180020,Staff,24,0,25,1
1681914987545,COMM 101T,A00,180029,Halm; Gavin Patrick,23,0,35,12
1681914988572,COMM 106V,A00,180043,Staff,34,0,35,1
1681914989594,COMM 109P,A00,180044,Staff,31,0,35,4
1681914990620,COMM 113T,A00,180045,Havis; Allan,37,0,45,8
1681914991644,COMM 132,A00,180046,McKenna; Denise,23,0,30,7
1681914992726,COMM 143,A00,180047,Staff,19,0,30,11
1681914993754,COMM 190,A00,180048,Conner; Thomas Hartnell,20,0,23,3
1681914994783,CSE 8A,A50,180053,Cao; Yingjun,25,0,50,25
1681914994783,CSE 8A,B50,180180,Staff,50,0,50,0
1681914995807,CSE 11,A01,180190,Cao; Yingjun,31,0,50,19
1681914996831,CSE 20,A01,180192,Briones; Jor-el Thomas Caparas,23,0,30,7
1681914997858,CSE 21,A01,194538,Briones; Jor-el Thomas Caparas,50,0,60,10
1681914998881,CSE 30,A01,180324,Eldon; John,78,0,100,22
1681914999907,CSE 101,A01,201353,Staff,0,20,40,40
1681915000930,CSE 134B,A01,180326,Powell; Thomas Allan,74,0,100,26
1681915001957,CSE 140,A01,180328,Staff,46,0,75,29
1681915002983,CSE 140L,A01,180344,Eldon; John,69,0,100,31
1681915004006,CSE 150A,A01,180411,Staff,0,7,50,50
1681915005030,CSE 151A,A01,180414,Staff,0,6,50,50
1681915006054,CSE 175,A01,222521,Kumar; Rakesh,50,0,50,0
1681915007077,CSE 190,A00,201419,Staff,45,0,49,4
1681915008102,CSS 1,A01,194536,Staff,38,0,50,12
1681915009124,DSC 30,A01,202385,Staff,48,0,50,2
1681915010147,DSC 40A,A01,202387,Albuyeh; Rod,50,0,50,0
1681915011174,DSC 190,A01,202389,Silberman; Jack,21,0,21,0
1681915012197,DSGN 100,A01,179993,Staff,16,0,30,14
1681915013221,ECE 65,A50,180708,Staff,10,0,20,10
1681915013221,ECE 65,A51,180739,Staff,19,0,20,1
1681915014245,ECON 1,A01,180427,Famulari; Melissa,67,0,70,3
1681915015276,ECON 2,A01,180450,Levkoff; Steven B.,64,0,70,6
1681915016377,ECON 4,A01,203351,Anderson; John Charles,7,0,10,3
1681915017403,ECON 100A,A01,180472,Famulari; Melissa,65,0,70,5
1681915018427,ECON 120A,A01,180549,Staff,64,0,70,6
1681915019453,ECON 120B,A01,180655,Ma; Xinwei,46,0,70,24
1681915020475,ECON 129,A00,203333,Eckert; Fabian Paul,15,0,35,20
1681915021499,ECON 131,A00,180656,Staff,9,0,35,26
1681915022527,ECON 172B,A01,180672,Levkoff; Steven B.,32,0,35,3
1681915023553,ECON 178,A01,203342,Zhu; Ying,11,0,35,24
1681915024582,EDS 108GS,A00,202383,Wishard Guerra; Alison G.,20,0,20,0
1681915025606,EDS 111GS,A00,202347,Wishard Guerra; Alison G.,20,0,20,0
1681915026630,EDS 112,A01,202323,Staff,56,0,60,4
1681915027656,EDS 113,A00,202340,Staff,33,0,35,2
1681915028680,EDS 118,A00,201231,Staff,20,0,30,10
1681915029709,EDS 119,A00,204994,Staff,8,0,10,2
1681915030742,EDS 124BR,A00,202324,Eguchi; Emi,5,0,25,20
1681915031769,EDS 126,A01,203208,Jones; Makeba,26,0,30,4
1681915032795,EDS 135,A01,202333,Staff,18,0,20,2
1681915033822,EDS 180,A00,202311,Staff,47,0,50,3
1681915034847,ERC 190GS,A01,253747,Staff,28,0,28,0
1681915035869,ETHN 104,A00,180742,Staff,24,0,35,11
1681915036895,ETHN 118,A00,180745,Staff,28,0,35,7
1681915037918,ETHN 127,A00,180747,Staff,12,0,16,4
1681915038941,ETHN 137,A00,180880,Staff,12,0,12,0
1681915039964,ETHN 147,A00,180890,Staff,8,0,10,2
1681915040985,ETHN 154,A00,180891,Staff,7,0,8,1
1681915042013,ETHN 168,A00,180892,Staff,9,0,10,1
1681915043040,GLBH 20,A00,201051,Hannah; Seth Donal,0,1,0,1
1681915044066,GLBH 111,A01,209338,Burgos; Jose L.,0,0,0,0
1681915045088,GLBH 150,A00,258300,Staff,0,3,0,0
1681915046112,GLBH 181,A00,201207,Staff,15,0,40,25
1681915047135,HIEU 109,A00,180898,Staff,20,0,20,0
1681915048160,HIEU 111,A00,180899,Staff,1,0,20,19
1681915049184,HIEU 124,A00,180900,Staff,18,0,20,2
1681915050208,HILA 122,A00,180901,Staff,18,0,20,2
1681915051236,HILA 132,A00,180902,Vitz; Matthew,2,0,20,18
1681915052261,HILD 10,A01,180896,Staff,15,0,20,5
1681915053284,HILD 30GS,A00,180897,Edington; Claire Ellen,0,0,0,0
1681915054317,HISC 105,A00,180903,Staff,20,0,20,0
1681915055342,HISC 117,A00,180904,Staff,11,0,20,9
1681915056369,HIUS 108B,A00,181005,Staff,18,0,20,2
1681915057393,HIUS 113,A00,181093,Staff,4,0,20,16
1681915058421,HUM 3,A01,181190,Patterson; Patrick H.,40,0,50,10
1681915058421,HUM 3,B01,181195,Staff,47,0,50,3
1681915059446,HUM 3GS,A00,181196,Herbst; Matthew,0,0,0,0
1681915060472,HUM 4,A01,181227,West; Geoffrey Scott,34,0,50,16
1681915060472,HUM 4,B01,181282,Staff,43,0,50,7
1681915061501,HUM 4GS,A00,181377,Lyon; Antony J.,0,0,0,0
1681915062525,HUM 5,A01,181536,Zavodny; Tatiana Sophia,31,0,50,19
1681915062525,HUM 5,B01,181908,Staff,36,0,50,14
1681915063548,INTL 190,A00,181909,Segui; Alan S,0,0,0,6
1681915063548,INTL 190,B00,181961,Segui; Alan S,0,0,0,7
1681915064574,JAPN 20AR,A01,182113,Ross; Kayoko F,15,0,20,5
1681915065599,LATI 50,A01,202391,Martin-Cabrera; Luis,19,0,30,11
1681915065599,LATI 50,A02,202392,Martin-Cabrera; Luis,26,0,30,4
1681915066625,LATI 180,A00,202393,Kokinis; Troy Andreas,25,0,25,0
1681915067647,LIFR 1A,A00,182119,Staff,14,0,14,0
1681915068673,LIFR 1AX,A00,182324,Staff,14,0,14,0
1681915069699,LIFR 1B,A00,182259,Staff,14,0,14,0
1681915070724,LIFR 1BX,A00,182273,Staff,14,0,14,0
1681915071753,LIGN 8,A00,182330,Staff,137,0,150,13
1681915072776,LIGN 9GS,A00,182362,Staff,20,0,20,0
1681915073798,LIGN 119,A00,204992,Takahashi; Maho,12,0,15,3
1681915074821,LIGN 130,A01,182384,Staff,47,0,50,3
1681915075845,LIGN 149GS,A00,182390,Staff,20,0,20,0
1681915076871,LIGN 170,A00,182404,Staff,24,0,30,6
1681915077897,LISP 1D,A00,182281,Staff,7,0,14,7
1681915077897,LISP 1D,B00,182287,Staff,14,0,14,0
1681915077897,LISP 1D,C00,182295,Staff,11,0,14,3
1681915077897,LISP 1D,D00,182301,Staff,14,0,14,0
1681915078920,LISP 1DX,A00,182309,Staff,20,0,28,8
1681915078920,LISP 1DX,B00,182316,Staff,26,0,28,2
1681915079944,LTAF 120GS,A00,182412,Zhiri; Oumelbanine,20,0,20,0
1681915080968,LTCS 172GS,A00,182437,Bronstein; Phoebe Malan,20,0,20,0
1681915082002,LTEA 138,A00,182457,Staff,22,0,40,18
1681915083028,LTEN 114,A01,182490,Staff,23,0,25,2
1681915084060,LTEN 130GS,A00,182491,Lyon; Antony J.,20,0,20,0
1681915085091,LTEN 169,A00,182493,Cuong; Marisol,20,0,25,5
1681915086116,LTEN 178,A00,182501,Staff,14,0,15,1
1681915087138,LTEN 181,A00,182515,Staff,22,0,25,3
1681915088164,LTEN 185GS,A00,197655,Forbes; Camille,20,0,20,0
1681915089186,LTSP 100B,A00,202208,Bessett; Ryan Matthew,24,0,25,1
1681915090213,LTWL 100,A00,182516,Myerston Santana; Jacobo,22,0,30,8
1681915091236,LTWR 100GS,A00,182518,Forbes; Camille,20,0,20,0
1681915092258,LTWR 102,A00,182522,Staff,15,0,15,0
1681915092258,LTWR 102,B00,182525,Staff,14,0,15,1
1681915093281,LTWR 115,A00,182526,Staff,12,0,15,3
1681915094304,MAE 8,A01,182528,Pham; Hieu Tan,68,0,70,2
1681915095330,MAE 11,A00,182529,Bahadori; Mohammad Yousef,94,0,100,6
1681915096353,MAE 20,A00,182530,Evdokimenko; Ekaterina,68,0,70,2
1681915097376,MAE 30A,A00,182532,Staff,44,0,45,1
1681915098401,MAE 101A,A00,182533,Bahadori; Mohammad Yousef,97,0,100,3
1681915099427,MAE 101C,A00,182538,Staff,62,0,70,8
1681915100450,MAE 104,A00,182539,Staff,45,0,50,5
1681915101473,MAE 131A,A00,182540,Ghazinejad; Maziar,41,0,45,4
1681915102500,MAE 143A,A00,182548,Bewley; Thomas R,43,0,50,7
1681915103522,MAE 150,A00,182549,Staff,28,0,40,12
1681915104549,MAE 160,A00,182550,Evdokimenko; Ekaterina,43,0,60,17
1681915105573,MATH 3C,A01,182725,Staff,27,0,30,3
1681915106598,MATH 10A,A01,182729,Staff,25,0,30,5
1681915106598,MATH 10A,B01,182732,Staff,26,0,30,4
1681915107626,MATH 10B,A01,182737,Staff,21,0,30,9
1681915107626,MATH 10B,A02,182738,Staff,27,0,30,3
1681915107626,MATH 10B,B01,182744,Staff,27,0,30,3
1681915107626,MATH 10B,B02,182745,Staff,27,0,30,3
1681915108652,MATH 18,A01,182750,Anzaldo; Leesa B,28,0,30,2
1681915108652,MATH 18,A02,182751,Anzaldo; Leesa B,29,0,30,1
1681915108652,MATH 18,A03,182753,Anzaldo; Leesa B,28,0,30,2
1681915108652,MATH 18,A04,182757,Anzaldo; Leesa B,29,0,30,1
1681915108652,MATH 18,B01,182761,Anzaldo; Leesa B,27,0,30,3
1681915108652,MATH 18,B02,182764,Anzaldo; Leesa B,27,0,30,3
1681915108652,MATH 18,B03,182765,Anzaldo; Leesa B,30,0,30,0
1681915108652,MATH 18,B04,182766,Anzaldo; Leesa B,30,0,30,0
1681915109678,MATH 20A,A01,182771,Suk; Andrew Hoon,28,0,30,2
1681915110706,MATH 20B,A01,182775,Bach; Quang Tran,30,0,30,0
1681915110706,MATH 20B,A02,182777,Bach; Quang Tran,29,0,30,1
1681915110706,MATH 20B,B01,182780,Bach; Quang Tran,27,0,30,3
1681915110706,MATH 20B,B02,182782,Bach; Quang Tran,30,0,30,0
1681915111733,MATH 20C,A01,182787,Staff,25,0,30,5
1681915111733,MATH 20C,A02,182790,Staff,29,0,30,1
1681915111733,MATH 20C,B01,182792,Staff,25,0,30,5
1681915111733,MATH 20C,B02,182796,Staff,27,0,30,3
1681915112759,MATH 20D,A01,182799,Staff,29,0,30,1
1681915112759,MATH 20D,A02,182802,Staff,30,0,30,0
1681915112759,MATH 20D,A03,182803,Staff,30,0,30,0
1681915113782,MATH 20E,A01,182809,Verstraete; Jacques Allan,24,0,30,6
1681915113782,MATH 20E,A02,182811,Verstraete; Jacques Allan,28,0,30,2
1681915113782,MATH 20E,B01,182814,Verstraete; Jacques Allan,23,0,30,7
1681915113782,MATH 20E,B02,182815,Verstraete; Jacques Allan,30,0,30,0
1681915114808,MATH 103A,A01,182820,Staff,9,0,30,21
1681915114808,MATH 103A,A02,182821,Staff,27,0,30,3
1681915114808,MATH 103A,A03,182822,Staff,23,0,30,7
1681915114808,MATH 103A,B01,182825,Staff,23,0,30,7
1681915114808,MATH 103A,B02,182826,Staff,30,0,30,0
1681915114808,MATH 103A,B03,182830,Staff,30,0,30,0
1681915115837,MATH 109,A01,182836,Chow; Bennett,24,0,30,6
1681915115837,MATH 109,A02,182838,Chow; Bennett,29,0,30,1
1681915115837,MATH 109,A03,182894,Chow; Bennett,29,0,30,1
1681915115837,MATH 109,B01,182908,Chow; Bennett,28,0,30,2
1681915115837,MATH 109,B02,182909,Chow; Bennett,30,0,30,0
1681915115837,MATH 109,B03,182910,Chow; Bennett,27,0,30,3
1681915116863,MATH 142A,A01,182925,Staff,11,0,30,19
1681915116863,MATH 142A,A02,182935,Staff,25,0,30,5
1681915116863,MATH 142A,A03,182967,Staff,26,0,30,4
1681915116863,MATH 142A,B01,183125,Staff,24,0,30,6
1681915116863,MATH 142A,B02,183157,Staff,28,0,30,2
1681915116863,MATH 142A,B03,183158,Staff,29,0,30,1
1681915117886,MATH 183,A01,183160,Arias-Castro; Ery,23,0,30,7
1681915117886,MATH 183,A02,183161,Arias-Castro; Ery,29,0,30,1
1681915117886,MATH 183,B01,183163,Arias-Castro; Ery,28,0,30,2
1681915117886,MATH 183,B02,183164,Arias-Castro; Ery,28,0,30,2
1681915118910,MATH 193A,A01,183167,Staff,4,0,35,31
1681915118910,MATH 193A,A02,183168,Staff,28,0,35,7
1681915118910,MATH 193A,A03,183169,Staff,34,0,35,1
1681915118910,MATH 193A,A04,183170,Staff,28,0,35,7
1681915120010,MGT 4,A01,202395,Anderson; John Charles,75,0,80,5
1681915121041,MGT 5,A00,202396,Houskeeper; Robert,80,0,90,10
1681915122064,MGT 103,A00,202397,Eberhard; Craig A,55,0,90,35
1681915123086,MGT 131A,A00,202398,Houskeeper; Robert,85,0,90,5
1681915124113,MGT 135,A00,202399,Anderson; John Charles,82,0,90,8
1681915125135,MGT 162R,A00,202403,Gneezy; Uri,150,0,200,50
1681915126160,MGT 172,A00,202404,Hedges; Kathleen,50,0,90,40
1681915127185,MGT 181,A00,202405,Dunn; Louis Jean,84,0,90,6
1681915128209,MMW 14,A01,183200,Staff,16,0,28,12
1681915128209,MMW 14,A02,183201,Staff,26,0,28,2
1681915128209,MMW 14,A03,183202,Staff,24,0,28,4
1681915128209,MMW 14,A04,183203,Staff,25,0,28,3
1681915128209,MMW 14,A05,183204,Staff,26,0,28,2
1681915128209,MMW 14,A06,183205,Staff,27,0,28,1
1681915128209,MMW 14,B01,183207,Staff,26,0,28,2
1681915128209,MMW 14,B02,183208,Staff,28,0,28,0
1681915128209,MMW 14,B03,183209,Staff,28,0,28,0
1681915128209,MMW 14,B04,183210,Staff,28,0,28,0
1681915128209,MMW 14,B05,183211,Staff,28,0,28,0
1681915128209,MMW 14,B06,183212,Staff,28,0,28,0
1681915129234,MMW 14GS,A00,183213,Zhiri; Oumelbanine,28,0,28,0
1681915130262,MMW 15GS,B00,183215,Rahimi; Babak,28,0,28,0
1681915131285,MMW 121,A01,183217,Patterson; Patrick H.,14,0,28,14
1681915131285,MMW 121,A02,183218,Patterson; Patrick H.,25,0,28,3
1681915132307,MUS 1A,A01,182554,Staff,8,0,35,27
1681915133334,MUS 5,A01,182558,Staff,20,0,35,15
1681915134360,MUS 6,A01,182562,Staff,25,0,35,10
1681915135383,MUS 8GS,A00,182563,Borgo; David Garcia,25,0,25,0
1681915136409,MUS 13,A01,182567,Staff,24,0,25,1
1681915137436,MUS 15,A01,182570,Staff,32,0,35,3
1681915137436,MUS 15,B01,182575,Staff,10,0,35,25
1681915138461,MUS 80,A00,182578,Staff,23,0,25,2
1681915138461,MUS 80,B00,182581,Staff,20,0,25,5
1681915139484,MUS 113,A00,182582,Staff,25,0,25,0
1681915140507,MUS 114,A00,182583,Staff,4,0,25,21
1681915141534,MUS 150GS,A01,182588,Borgo; David Garcia,25,0,25,0
1681915142557,PHIL 1,A00,182590,Staff,35,0,40,5
1681915143584,PHIL 10,A01,182596,Grush; Rick Scott,31,0,35,4
1681915143584,PHIL 10,A02,182597,Grush; Rick Scott,34,0,35,1
1681915144607,PHIL 15,A01,182601,Staff,31,0,35,4
1681915144607,PHIL 15,A02,182602,Staff,33,0,35,2
1681915145630,PHIL 27,A01,182604,Staff,30,0,35,5
1681915145630,PHIL 27,A02,182607,Staff,35,0,35,0
1681915146653,PHIL 32,A01,182609,Staff,35,0,35,0
1681915146653,PHIL 32,A02,182612,Staff,35,0,35,0
1681915147680,PHIL 130,A00,182614,Staff,63,0,70,7
1681915148709,PHIL 136,A00,182616,Cohen; Jonathan David,66,0,70,4
1681915149732,PHIL 155,A00,182617,Vargas; Manuel Rogelio,60,0,70,10
1681915150768,PHIL 163,A01,182620,Staff,15,0,20,5
1681915150768,PHIL 163,A02,182624,Staff,10,0,20,10
1681915151799,PHIL 164,A00,182627,Staff,30,0,40,10
1681915152822,PHIL 173,A00,182628,Staff,36,0,40,4
1681915153849,PHYS 1A,A00,183221,Staff,54,0,60,6
1681915154873,PHYS 1AL,001,183222,Staff,25,0,30,5
1681915154873,PHYS 1AL,002,183223,Staff,28,0,30,2
1681915155897,PHYS 1B,A00,183231,Staff,44,0,60,16
1681915156921,PHYS 1BL,001,183232,Staff,20,0,30,10
1681915156921,PHYS 1BL,002,183233,Staff,29,0,30,1
1681915157950,PHYS 1C,A00,183240,Staff,30,0,60,30
1681915158973,PHYS 1CL,001,183241,Staff,13,0,30,17
1681915158973,PHYS 1CL,002,183242,Staff,22,0,30,8
1681915160001,PHYS 2AR,A01,183250,Staff,44,0,50,6
1681915161035,PHYS 2B,A01,183252,Staff,106,0,115,9
1681915162062,PHYS 2BL,A01,183254,Staff,21,0,24,3
1681915162062,PHYS 2BL,A02,183255,Staff,22,0,24,2
1681915163085,PHYS 2C,A01,183522,Staff,105,0,115,10
1681915164117,PHYS 4A,A01,183524,Staff,49,0,50,1
1681915165143,POLI 5,A00,183525,Staff,44,0,50,6
1681915166169,POLI 12,A00,183540,Staff,48,0,50,2
1681915167193,POLI 13R,A00,183541,Forman; Fonna,42,0,50,8
1681915168223,POLI 30,A00,183542,Mignozzetti; Umberto,47,0,50,3
1681915169256,POLI 100A,A00,183543,Staff,45,0,50,5
1681915170281,POLI 100E,A00,223598,Staff,32,0,35,3
1681915171308,POLI 103A,A00,183564,Kousser; Thad,38,0,50,12
1681915172331,POLI 104B,A00,201329,Staff,29,0,35,6
1681915173358,POLI 113BR,A00,183576,Hoston; Germaine,27,0,50,23
1681915174381,POLI 114BR,A00,183588,Staff,27,0,30,3
1681915175403,POLI 117R,A00,183595,Forman; Fonna,9,0,20,11
1681915176429,POLI 120H,A00,183596,Fisk; David Lee,13,0,20,7
1681915177459,POLI 130AA,A00,183597,Staff,14,0,20,6
1681915178482,POLI 134AA,A00,183598,Staff,19,0,20,1
1681915179505,POLI 135,A00,183599,Fisk; David Lee,20,0,25,5
1681915180529,POLI 142P,A00,183623,Staff,37,0,40,3
1681915181566,POLI 144D,A00,183624,Staff,22,0,25,3
1681915182589,POLI 151,A00,183625,Staff,15,0,20,5
1681915183615,POLI 162,A00,183626,Mignozzetti; Umberto,18,0,20,2
1681915184638,PSYC 1,A00,253748,Staff,86,0,90,4
1681915185665,PSYC 2,A00,183627,Moranton; Nirelia Melbina-,25,0,35,10
1681915186690,PSYC 3,A00,183628,Staff,43,0,45,2
1681915188737,PSYC 60,A01,183631,Lowe; Angela Beth,35,0,40,5
1681915189760,PSYC 70,A01,253757,Staff,37,0,45,8
1681915190791,PSYC 101,A00,183632,Heyman; Gail D.,48,0,60,12
1681915191819,PSYC 105,A00,183848,Lowe; Angela Beth,50,0,60,10
1681915192845,PSYC 106,A00,183849,Dobkins; Karen R.,45,0,60,15
1681915193869,PSYC 108,A00,253750,Staff,24,0,60,36
1681915194893,PSYC 114,A01,184275,Winkielman; Piotr,0,6,30,30
1681915195914,PSYC 122,A00,183856,Moranton; Nirelia Melbina-,0,10,30,30
1681915196939,PSYC 124,A00,183865,Chapman; Eddie Nathaniel,52,0,80,28
1681915197964,PSYC 137,A00,183880,Staff,19,0,25,6
1681915200065,PSYC 154,A00,183910,Lacefield; Katharine I,0,2,90,90
1681915202110,PSYC 162,A00,183946,Wixted; John T,61,0,90,29
1681915203139,PSYC 172,A00,183947,Gorman; Michael R.,14,0,30,16
1681915204163,PSYC 178,A00,183963,Glaser; Dale,20,0,40,20
1681915205188,PSYC 181GS,A00,183964,Anagnostaras; Stephan,10,0,10,0
1681915206215,PSYC 186GS,A01,257660,Staff,10,0,10,0
1681915207238,PSYC 193,B00,253749,Staff,23,0,25,2
1681915209291,PSYC 193L,A01,184122,Staff,33,0,35,2
1681915209291,PSYC 193L,C01,184167,Winkielman; Piotr,16,0,30,14
1681915210318,RELI 188GS,A00,182629,Rahimi; Babak,20,0,20,0
1681915211348,SE 101A,A00,182646,Staff,26,0,30,4
1681915212376,SE 101C,A00,182650,Staff,18,0,20,2
1681915213404,SE 110A,A00,182651,Staff,28,0,28,0
1681915214433,SE 130A,A00,182652,Staff,39,0,40,1
1681915215459,SIO 46GS,A00,182636,Cook; Geoffrey W,28,0,28,0
1681915216485,SIO 109R,A00,194459,Staff,5,0,20,15
1681915217517,SIO 121GS,A00,182639,Cook; Geoffrey W,28,0,28,0
1681915218539,SIO 132,A01,182642,Staff,32,0,40,8
1681915219562,SIO 139,A00,182644,Kacev; David,36,0,40,4
1681915220585,SOCI 2,A01,258404,Staff,34,0,36,2
1681915220585,SOCI 2,A02,258405,Staff,35,0,36,1
1681915221609,SOCI 60,A01,258408,Staff,29,0,30,1
1681915221609,SOCI 60,A02,258413,Staff,30,0,30,0
1681915222633,SOCI 100,A01,258415,Staff,29,0,30,1
1681915222633,SOCI 100,A02,258416,Staff,28,0,30,2
1681915228879,SOCI 127,A00,258421,Staff,22,0,30,8
1681915229902,SOCI 132,A00,258422,Staff,45,0,50,5
1681915230932,SOCI 133,A00,258423,Staff,26,0,30,4
1681915231955,SOCI 138GS,A00,258424,Staff,15,0,15,0
1681915232982,SOCI 145,A00,258425,Staff,25,0,30,5
1681915234007,SOCI 148,A00,258426,Staff,26,0,30,4
1681915235033,SOCI 153,A00,199217,Staff,29,0,30,1
1681915236068,SOCI 160,A00,258427,Staff,28,0,30,2
1681915237096,SOCI 160E,A00,258435,Staff,56,0,60,4
1681915238122,SOCI 189GS,A00,258436,Staff,15,0,15,0
1681915239145,SOCI 190GS,A00,258437,Staff,15,0,15,0
1681915240174,SYN 2,001,182658,Staff,9,0,16,7
1681915240174,SYN 2,002,201439,Staff,15,0,16,1
1681915240174,SYN 2,003,201443,Staff,16,0,16,0
1681915241199,SYN 100,A01,182657,Staff,17,0,20,3
1681915242226,TDAC 1,A00,184381,Salovey; Todd,16,0,20,4
1681915242226,TDAC 1,B00,184385,Harting; Carla Kelso,19,0,20,1
1681915242226,TDAC 1,C00,184394,Staff,19,0,20,1
1681915243248,TDAC 101,A00,184483,Harting; Carla Kelso,19,0,20,1
1681915244273,TDDE 111,A00,184496,Staff,14,0,15,1
1681915245295,TDDE 131,A00,184504,Staff,20,0,20,0
1681915245295,TDDE 131,B00,184505,Staff,17,0,18,1
1681915245295,TDDE 131,C00,184534,Staff,49,0,50,1
1681915245295,TDDE 131,D00,184564,Staff,15,0,15,0
1681915245295,TDDE 131,E00,204725,Staff,19,0,20,1
1681915246321,TDGE 1,A01,184414,Salovey; Todd,37,0,50,13
1681915247344,TDGE 5,A01,184419,Staff,23,0,24,1
1681915248367,TDGE 10,A00,184428,Fulton; Julia,31,0,50,19
1681915249391,TDGE 124,A00,184565,Fulton; Julia,7,0,50,43
1681915250414,TDGE 125,B00,184567,Meyer; Ursula,9,0,25,16
1681915251440,TDHT 101,A00,184568,Staff,21,0,25,4
1681915251440,TDHT 101,B00,184569,Staff,20,0,20,0
1681915252466,TDHT 114,A00,184570,Staff,49,0,50,1
1681915253493,TDMV 1,A00,184437,Arcidiacono; Kristin,23,0,30,7
1681915253493,TDMV 1,B00,184448,Caligagan; Maria T.,22,0,30,8
1681915254516,TDMV 2,A00,184449,Weinberg; Sadie,27,0,30,3
1681915254516,TDMV 2,B00,184453,Arcidiacono; Kristin,29,0,30,1
1681915255538,TDMV 110,A00,184571,Weinberg; Sadie,30,0,30,0
1681915256561,TDMV 142,A00,184572,Caligagan; Tony,27,0,30,3
1681915256561,TDMV 142,B00,184573,Caligagan; Maria T.,27,0,30,3
1681915257588,TDTR 20,A00,184482,Jun; Grace Shin Hae,25,0,25,0
1681915258616,USP 2,A01,184290,Hinds; Juli Beth,24,0,25,1
1681915259648,USP 3,A01,184295,Staff,20,0,25,5
1681915260675,USP 4,A00,184304,McTague; Sarah,15,0,25,10
1681915261701,USP 100,A00,184315,Staff,17,0,25,8
1681915262733,USP 105,A00,184326,Staff,21,0,25,4
1681915263759,USP 151,A00,184327,Staff,20,0,25,5
1681915264782,USP 170,A00,184380,Hinds; Juli Beth,14,0,25,11
1681915265806,VIS 21B,A01,182660,Staff,28,0,31,3
1681915265806,VIS 21B,A02,182662,Staff,30,0,31,1
1681915266834,VIS 103D,A00,182663,Staff,74,0,75,1
1681915267864,VIS 105D,A00,182667,Li; Huai,15,0,22,7
1681915268889,VIS 122GS,A00,182668,Herbst; Matthew,20,0,20,0
1681915269915,VIS 128C,A00,182673,Staff,69,0,75,6
1681915270938,VIS 130,A00,182675,Staff,20,0,22,2
1681915271974,VIS 160A,A00,182678,Stalbaum; Brett,4,0,10,6
1681915274026,WCWP 10B,A00,201679,Staff,15,0,15,0
1681915274026,WCWP 10B,B00,201695,Staff,15,0,15,0
1681915275049,WCWP 100,A00,201716,Staff,15,0,15,0
1681915275049,WCWP 100,B00,201717,Staff,11,0,15,4
1681915277109,ANSC 105GS,A00,258289,Staff,0,0,0,0
1681915278135,ANSC 125GS,A00,258295,Staff,0,0,0,0
1681915279161,ANSC 150,A00,258267,Staff,30,0,40,10
1681915280182,ANSC 190GS,A00,258280,Staff,0,0,0,0
1681915281206,ANTH 1,A00,258264,Staff,38,0,40,2
1681915282229,ANTH 2,A01,258259,Staff,72,0,76,4
1681915283256,ANTH 23,A01,258228,Staff,36,0,40,4
1681915284278,ANTH 101,A01,258236,Staff,39,0,40,1
1681915285304,ANTH 102,A00,258272,Staff,59,0,60,1
1681915286330,ANTH 105,A00,258244,Staff,31,0,35,4
1681915287355,BENG 130,A00,253975,Staff,38,0,40,2
1681915288381,BIBC 102,A01,191866,Flagg; Matthew Paul,19,0,32,13
1681915288381,BIBC 102,A02,191867,Flagg; Matthew Paul,22,0,32,10
1681915288381,BIBC 102,A03,191868,Flagg; Matthew Paul,30,0,32,2
1681915288381,BIBC 102,A04,191936,Flagg; Matthew Paul,26,0,32,6
1681915288381,BIBC 102,A05,191937,Flagg; Matthew Paul,11,0,32,21
1681915289408,BICD 100,A01,191939,Cooper; Andrew Michael,28,0,32,4
1681915289408,BICD 100,A02,191940,Cooper; Andrew Michael,32,0,32,0
1681915289408,BICD 100,A03,191941,Cooper; Andrew Michael,32,0,32,0
1681915289408,BICD 100,A04,191942,Cooper; Andrew Michael,32,0,32,0
1681915289408,BICD 100,A05,191943,Cooper; Andrew Michael,32,0,32,0
1681915290435,BIEB 126,A01,191945,Cleland; Elsa Eleanor,1,0,32,31
1681915290435,BIEB 126,A02,191946,Cleland; Elsa Eleanor,28,0,32,4
1681915290435,BIEB 126,A03,191947,Cleland; Elsa Eleanor,29,0,32,3
1681915290435,BIEB 126,A04,191948,Cleland; Elsa Eleanor,23,0,32,9
1681915290435,BIEB 126,A05,191996,Cleland; Elsa Eleanor,28,0,32,4
1681915291463,BIEB 136GS,A00,191997,Shurin; Jonathan & Holway; David A.,0,0,0,0
1681915292491,BIEB 137GS,A01,191999,Shurin; Jonathan & Holway; David A.,0,0,0,0
1681915293516,BILD 1,A01,205385,Staff,31,0,32,1
1681915293516,BILD 1,A02,205386,Staff,30,0,32,2
1681915293516,BILD 1,A03,205387,Staff,32,0,32,0
1681915293516,BILD 1,A04,205388,Staff,28,0,32,4
1681915294540,BILD 2,A01,191774,Staff,28,0,32,4
1681915294540,BILD 2,A02,191775,Staff,30,0,32,2
1681915294540,BILD 2,A03,191777,Staff,30,0,32,2
1681915294540,BILD 2,A04,191856,Staff,31,0,32,1
1681915294540,BILD 2,A05,191857,Staff,32,0,32,0
1681915294540,BILD 2,A06,191858,Staff,32,0,32,0
1681915294540,BILD 2,A07,191859,Staff,31,0,32,1
1681915295566,BILD 3,A01,205391,Staff,29,0,32,3
1681915295566,BILD 3,A02,205393,Staff,32,0,32,0
1681915295566,BILD 3,A03,205394,Staff,28,0,32,4
1681915295566,BILD 3,A04,205395,Staff,32,0,32,0
1681915296593,BILD 20,A01,191861,Staff,32,0,32,0
1681915296593,BILD 20,A02,191862,Staff,32,0,32,0
1681915297617,BILD 30,A01,191864,Staff,31,0,32,1
1681915298644,BIMM 100,A01,192019,Staff,0,0,32,32
1681915298644,BIMM 100,A02,192020,Staff,23,0,32,9
1681915298644,BIMM 100,A03,192035,Staff,22,0,32,10
1681915299670,BIMM 110,A01,192037,Tat; John,0,0,32,32
1681915299670,BIMM 110,A02,192038,Tat; John,10,0,32,22
1681915300692,BIMM 120,A01,192040,Pickett; Brooke Elizabeth,2,0,32,30
1681915300692,BIMM 120,A02,192041,Pickett; Brooke Elizabeth,16,0,32,16
1681915300692,BIMM 120,A03,192042,Pickett; Brooke Elizabeth,16,0,32,16
1681915301714,BIPN 100,A01,192044,Armour; Jon Christopher,26,0,32,6
1681915301714,BIPN 100,A02,192059,Armour; Jon Christopher,30,0,32,2
1681915301714,BIPN 100,A03,192064,Armour; Jon Christopher,31,0,32,1
1681915301714,BIPN 100,A04,192073,Armour; Jon Christopher,28,0,32,4
1681915302737,BIPN 148,A01,205411,Leutgeb; Jill K.,16,0,32,16
1681915302737,BIPN 148,A02,205412,Leutgeb; Jill K.,31,0,32,1
1681915302737,BIPN 148,A03,205413,Leutgeb; Jill K.,30,0,32,2
1681915302737,BIPN 148,A04,205414,Leutgeb; Jill K.,30,0,32,2
1681915303765,BIPN 160,A01,192115,Marino; Marc J,19,0,32,13
1681915303765,BIPN 160,A02,192148,Marino; Marc J,27,0,32,5
1681915303765,BIPN 160,A03,192158,Marino; Marc J,31,0,32,1
1681915303765,BIPN 160,A04,192190,Marino; Marc J,32,0,32,0
1681915303765,BIPN 160,A05,192287,Marino; Marc J,32,0,32,0
1681915303765,BIPN 160,A06,192288,Marino; Marc J,32,0,32,0
1681915304790,BIPN 194,A00,206038,Staff,28,0,32,4
1681915305815,BISP 194,A00,192289,Leutgeb; Stefan,13,0,32,19
1681915305815,BISP 194,B00,245332,Nieh; James Charles,27,0,32,5
1681915306837,CAT 124,A01,202247,Staff,15,0,15,0
1681915307860,CAT 125,A00,202248,Staff,19,0,20,1
1681915307860,CAT 125,B00,202253,Staff,20,0,20,0
1681915307860,CAT 125,C00,202257,Staff,19,0,20,1
1681915308884,CAT 125GS,A01,202273,Bronstein; Phoebe Malan,20,0,20,0
1681915309912,CAT 125R,A00,202284,Staff,17,0,20,3
1681915309912,CAT 125R,C00,202286,Staff,10,0,20,10
1681915309912,CAT 125R,D00,202291,Staff,18,0,20,2
1681915309912,CAT 125R,E00,202295,Staff,13,0,20,7
1681915309912,CAT 125R,F00,202302,Staff,12,0,20,8
1681915310935,CENG 100,A00,204724,Opatkiewicz; Justin Paul,25,0,25,0
1681915311959,CGS 2A,A01,180420,Staff,31,0,36,5
1681915312985,CGS 101,A00,180421,Staff,16,0,20,4
1681915314011,CGS 112,A00,180422,Staff,10,0,16,6
1681915315035,CGS 113,A00,180423,Staff,18,0,20,2
1681915316059,CGS 137,A00,180424,Staff,12,0,12,0
1681915317082,CGS 147,A00,180425,Staff,10,0,10,0
1681915318109,CHEM 6A,A01,179556,Staff,97,0,100,3
1681915318109,CHEM 6A,A02,179558,Staff,0,0,0,0
1681915319134,CHEM 6B,A01,179560,Staff,100,0,100,0
1681915320160,CHEM 6C,A01,179565,Jazzar; Rodolphe,95,0,100,5
1681915321183,CHEM 7L,A01,179586,Schurmeier; Kimberly,13,0,24,11
1681915321183,CHEM 7L,A02,179587,Schurmeier; Kimberly,23,0,24,1
1681915321183,CHEM 7L,A03,179590,Schurmeier; Kimberly,22,0,24,2
1681915321183,CHEM 7L,A04,179591,Schurmeier; Kimberly,22,0,24,2
1681915321183,CHEM 7L,B01,179598,Schurmeier; Kimberly,17,0,24,7
1681915321183,CHEM 7L,B02,179599,Schurmeier; Kimberly,24,0,24,0
1681915321183,CHEM 7L,B03,179606,Schurmeier; Kimberly,23,0,24,1
1681915321183,CHEM 7L,B04,179607,Schurmeier; Kimberly,23,0,24,1
1681915322217,CHEM 11,A01,179609,Stallings; Dontarie M,88,0,100,12
1681915323241,CHEM 40A,A01,179621,Staff,41,0,50,9
1681915323241,CHEM 40A,A02,179622,Staff,47,0,50,3
1681915324264,CHEM 40B,A01,179630,Weizman; Haim,48,0,50,2
1681915324264,CHEM 40B,A02,179631,Weizman; Haim,45,0,50,5
1681915325289,CHEM 41A,A01,179660,Klosterman; Jeremy K,93,0,100,7
1681915326313,CHEM 43A,A01,179683,Klosterman; Jeremy K,0,0,24,24
1681915326313,CHEM 43A,A02,179688,Klosterman; Jeremy K,14,0,24,10
1681915326313,CHEM 43A,A03,179689,Klosterman; Jeremy K,20,0,24,4
1681915326313,CHEM 43A,A04,179691,Klosterman; Jeremy K,18,0,24,6
1681915327411,CHEM 114A,A01,179693,Stallings; Dontarie M,77,0,100,23
1681915328438,CHEM 143B,A01,179698,Weizman; Haim,17,0,24,7
1681915328438,CHEM 143B,A02,179700,Weizman; Haim,24,0,24,0
1681915329467,CHIN 169A,A00,179701,Wang; Xiao,20,0,20,0
1681915330491,COGS 2,A01,179750,Boyle; Mary E. T.,17,0,30,13
1681915331518,COGS 9,A01,179759,Jones; Cameron Robert,43,0,50,7
1681915332542,COGS 14A,A01,179854,Staff,18,0,50,32
1681915333565,COGS 14B,A01,179856,Staff,54,0,60,6
1681915334591,COGS 17,A01,179874,Staff,71,0,75,4
1681915335615,COGS 18,A01,179884,Staff,63,0,80,17
1681915336637,COGS 100,A01,179886,Staff,40,0,60,20
1681915337665,COGS 101B,A01,179892,Staff,1,0,30,29
1681915338688,COGS 101C,A01,179894,Staff,28,0,30,2
1681915339716,COGS 107A,A01,179896,Boyle; Mary E. T.,31,0,40,9
1681915340743,COGS 108,A01,179898,Simpkins; Charles Alexander,0,17,60,60
1681915341772,COGS 109,A01,179900,Staff,34,0,40,6
1681915342797,COGS 118A,A01,179946,Staff,9,0,40,31
1681915343821,COGS 153,A00,179978,Staff,1,0,30,29
1681915344853,COGS 156,A01,179981,Staff,27,0,30,3
1681915346900,COGS 172,A01,179987,Staff,13,0,30,17
1681915348962,COGS 186,A01,179991,Staff,13,0,30,17
1681915349984,COMM 10,A01,180001,Staff,15,0,25,10
1681915349984,COMM 10,A02,180004,Staff,20,0,25,5
1681915351010,COMM 100A,A01,180016,Staff,18,0,25,7
1681915351010,COMM 100A,A02,180020,Staff,24,0,25,1
1681915352035,COMM 101T,A00,180029,Halm; Gavin Patrick,23,0,35,12
1681915353062,COMM 106V,A00,180043,Staff,34,0,35,1
1681915354086,COMM 109P,A00,180044,Staff,31,0,35,4
1681915355112,COMM 113T,A00,180045,Havis; Allan,37,0,45,8
1681915356137,COMM 132,A00,180046,McKenna; Denise,23,0,30,7
1681915357163,COMM 143,A00,180047,Staff,19,0,30,11
1681915358185,COMM 190,A00,180048,Conner; Thomas Hartnell,20,0,23,3
1681915359208,CSE 8A,A50,180053,Cao; Yingjun,25,0,50,25
1681915359208,CSE 8A,B50,180180,Staff,50,0,50,0
1681915360237,CSE 11,A01,180190,Cao; Yingjun,31,0,50,19
1681915361260,CSE 20,A01,180192,Briones; Jor-el Thomas Caparas,23,0,30,7
1681915362286,CSE 21,A01,194538,Briones; Jor-el Thomas Caparas,50,0,60,10
1681915363313,CSE 30,A01,180324,Eldon; John,78,0,100,22
1681915364341,CSE 101,A01,201353,Staff,0,20,40,40
1681915365364,CSE 134B,A01,180326,Powell; Thomas Allan,74,0,100,26
1681915366395,CSE 140,A01,180328,Staff,46,0,75,29
1681915367424,CSE 140L,A01,180344,Eldon; John,69,0,100,31
1681915368449,CSE 150A,A01,180411,Staff,0,7,50,50
1681915369472,CSE 151A,A01,180414,Staff,0,6,50,50
1681915370497,CSE 175,A01,222521,Kumar; Rakesh,50,0,50,0
1681915371520,CSE 190,A00,201419,Staff,45,0,49,4
1681915372545,CSS 1,A01,194536,Staff,38,0,50,12
1681915373569,DSC 30,A01,202385,Staff,48,0,50,2
1681915374602,DSC 40A,A01,202387,Albuyeh; Rod,50,0,50,0
1681915375625,DSC 190,A01,202389,Silberman; Jack,21,0,21,0
1681915376654,DSGN 100,A01,179993,Staff,16,0,30,14
1681915377677,ECE 65,A50,180708,Staff,10,0,20,10
1681915377677,ECE 65,A51,180739,Staff,19,0,20,1
1681915378713,ECON 1,A01,180427,Famulari; Melissa,67,0,70,3
1681915379735,ECON 2,A01,180450,Levkoff; Steven B.,64,0,70,6
1681915380767,ECON 4,A01,203351,Anderson; John Charles,7,0,10,3
1681915381794,ECON 100A,A01,180472,Famulari; Melissa,65,0,70,5
1681915382822,ECON 120A,A01,180549,Staff,64,0,70,6
1681915383844,ECON 120B,A01,180655,Ma; Xinwei,46,0,70,24
1681915384929,ECON 129,A00,203333,Eckert; Fabian Paul,15,0,35,20
1681915385954,ECON 131,A00,180656,Staff,9,0,35,26
1681915386982,ECON 172B,A01,180672,Levkoff; Steven B.,32,0,35,3
1681915388006,ECON 178,A01,203342,Zhu; Ying,11,0,35,24
1681915389029,EDS 108GS,A00,202383,Wishard Guerra; Alison G.,20,0,20,0
1681915390055,EDS 111GS,A00,202347,Wishard Guerra; Alison G.,20,0,20,0
1681915391077,EDS 112,A01,202323,Staff,56,0,60,4
1681915392099,EDS 113,A00,202340,Staff,33,0,35,2
1681915393132,EDS 118,A00,201231,Staff,20,0,30,10
1681915394158,EDS 119,A00,204994,Staff,8,0,10,2
1681915395187,EDS 124BR,A00,202324,Eguchi; Emi,5,0,25,20
1681915396214,EDS 126,A01,203208,Jones; Makeba,26,0,30,4
1681915397237,EDS 135,A01,202333,Staff,18,0,20,2
1681915398263,EDS 180,A00,202311,Staff,47,0,50,3
1681915399286,ERC 190GS,A01,253747,Staff,28,0,28,0
1681915400316,ETHN 104,A00,180742,Staff,24,0,35,11
1681915401341,ETHN 118,A00,180745,Staff,28,0,35,7
1681915402373,ETHN 127,A00,180747,Staff,12,0,16,4
1681915403398,ETHN 137,A00,180880,Staff,12,0,12,0
1681915404420,ETHN 147,A00,180890,Staff,8,0,10,2
1681915405445,ETHN 154,A00,180891,Staff,7,0,8,1
1681915406473,ETHN 168,A00,180892,Staff,9,0,10,1
1681915407497,GLBH 20,A00,201051,Hannah; Seth Donal,0,1,0,1
1681915408519,GLBH 111,A01,209338,Burgos; Jose L.,0,0,0,0
1681915409546,GLBH 150,A00,258300,Staff,0,3,0,0
1681915410569,GLBH 181,A00,201207,Staff,15,0,40,25
1681915411606,HIEU 109,A00,180898,Staff,20,0,20,0
1681915412630,HIEU 111,A00,180899,Staff,1,0,20,19
1681915413652,HIEU 124,A00,180900,Staff,18,0,20,2
1681915414676,HILA 122,A00,180901,Staff,18,0,20,2
1681915415700,HILA 132,A00,180902,Vitz; Matthew,2,0,20,18
1681915416724,HILD 10,A01,180896,Staff,15,0,20,5
1681915417750,HILD 30GS,A00,180897,Edington; Claire Ellen,0,0,0,0
1681915418774,HISC 105,A00,180903,Staff,20,0,20,0
1681915419804,HISC 117,A00,180904,Staff,11,0,20,9
1681915420830,HIUS 108B,A00,181005,Staff,18,0,20,2
1681915421867,HIUS 113,A00,181093,Staff,4,0,20,16
1681915422891,HUM 3,A01,181190,Patterson; Patrick H.,40,0,50,10
1681915422891,HUM 3,B01,181195,Staff,47,0,50,3
1681915423913,HUM 3GS,A00,181196,Herbst; Matthew,0,0,0,0
1681915424935,HUM 4,A01,181227,West; Geoffrey Scott,34,0,50,16
1681915424935,HUM 4,B01,181282,Staff,43,0,50,7
1681915425965,HUM 4GS,A00,181377,Lyon; Antony J.,0,0,0,0
1681915426994,HUM 5,A01,181536,Zavodny; Tatiana Sophia,31,0,50,19
1681915426994,HUM 5,B01,181908,Staff,36,0,50,14
1681915428022,INTL 190,A00,181909,Segui; Alan S,0,0,0,6
1681915428022,INTL 190,B00,181961,Segui; Alan S,0,0,0,7
1681915429063,JAPN 20AR,A01,182113,Ross; Kayoko F,15,0,20,5
1681915430086,LATI 50,A01,202391,Martin-Cabrera; Luis,19,0,30,11
1681915430086,LATI 50,A02,202392,Martin-Cabrera; Luis,26,0,30,4
1681915431187,LATI 180,A00,202393,Kokinis; Troy Andreas,25,0,25,0
1681915432210,LIFR 1A,A00,182119,Staff,14,0,14,0
1681915433240,LIFR 1AX,A00,182324,Staff,14,0,14,0
1681915434264,LIFR 1B,A00,182259,Staff,14,0,14,0
1681915435289,LIFR 1BX,A00,182273,Staff,14,0,14,0
1681915436313,LIGN 8,A00,182330,Staff,137,0,150,13
1681915437336,LIGN 9GS,A00,182362,Staff,20,0,20,0
1681915438360,LIGN 119,A00,204992,Takahashi; Maho,12,0,15,3
1681915439382,LIGN 130,A01,182384,Staff,47,0,50,3
1681915440410,LIGN 149GS,A00,182390,Staff,20,0,20,0
1681915441435,LIGN 170,A00,182404,Staff,24,0,30,6
1681915442459,LISP 1D,A00,182281,Staff,7,0,14,7
1681915442459,LISP 1D,B00,182287,Staff,14,0,14,0
1681915442459,LISP 1D,C00,182295,Staff,11,0,14,3
1681915442459,LISP 1D,D00,182301,Staff,14,0,14,0
1681915443487,LISP 1DX,A00,182309,Staff,20,0,28,8
1681915443487,LISP 1DX,B00,182316,Staff,26,0,28,2
1681915444510,LTAF 120GS,A00,182412,Zhiri; Oumelbanine,20,0,20,0
1681915445542,LTCS 172GS,A00,182437,Bronstein; Phoebe Malan,20,0,20,0
1681915446565,LTEA 138,A00,182457,Staff,22,0,40,18
1681915447591,LTEN 114,A01,182490,Staff,23,0,25,2
1681915448615,LTEN 130GS,A00,182491,Lyon; Antony J.,20,0,20,0
1681915449638,LTEN 169,A00,182493,Cuong; Marisol,20,0,25,5
1681915450661,LTEN 178,A00,182501,Staff,14,0,15,1
1681915451689,LTEN 181,A00,182515,Staff,22,0,25,3
1681915452717,LTEN 185GS,A00,197655,Forbes; Camille,20,0,20,0
1681915453747,LTSP 100B,A00,202208,Bessett; Ryan Matthew,24,0,25,1
1681915454775,LTWL 100,A00,182516,Myerston Santana; Jacobo,22,0,30,8
1681915455800,LTWR 100GS,A00,182518,Forbes; Camille,20,0,20,0
1681915456824,LTWR 102,A00,182522,Staff,15,0,15,0
1681915456824,LTWR 102,B00,182525,Staff,14,0,15,1
1681915457848,LTWR 115,A00,182526,Staff,12,0,15,3
1681915458876,MAE 8,A01,182528,Pham; Hieu Tan,68,0,70,2
1681915459903,MAE 11,A00,182529,Bahadori; Mohammad Yousef,94,0,100,6
1681915460928,MAE 20,A00,182530,Evdokimenko; Ekaterina,68,0,70,2
1681915461955,MAE 30A,A00,182532,Staff,44,0,45,1
1681915462979,MAE 101A,A00,182533,Bahadori; Mohammad Yousef,97,0,100,3
1681915464004,MAE 101C,A00,182538,Staff,62,0,70,8
1681915465042,MAE 104,A00,182539,Staff,45,0,50,5
1681915466071,MAE 131A,A00,182540,Ghazinejad; Maziar,41,0,45,4
1681915467099,MAE 143A,A00,182548,Bewley; Thomas R,43,0,50,7
1681915468124,MAE 150,A00,182549,Staff,28,0,40,12
1681915469150,MAE 160,A00,182550,Evdokimenko; Ekaterina,43,0,60,17
1681915470179,MATH 3C,A01,182725,Staff,27,0,30,3
1681915471204,MATH 10A,A01,182729,Staff,25,0,30,5
1681915471204,MATH 10A,B01,182732,Staff,26,0,30,4
1681915472229,MATH 10B,A01,182737,Staff,21,0,30,9
1681915472229,MATH 10B,A02,182738,Staff,27,0,30,3
1681915472229,MATH 10B,B01,182744,Staff,27,0,30,3
1681915472229,MATH 10B,B02,182745,Staff,27,0,30,3
1681915473255,MATH 18,A01,182750,Anzaldo; Leesa B,28,0,30,2
1681915473255,MATH 18,A02,182751,Anzaldo; Leesa B,29,0,30,1
1681915473255,MATH 18,A03,182753,Anzaldo; Leesa B,28,0,30,2
1681915473255,MATH 18,A04,182757,Anzaldo; Leesa B,29,0,30,1
1681915473255,MATH 18,B01,182761,Anzaldo; Leesa B,27,0,30,3
1681915473255,MATH 18,B02,182764,Anzaldo; Leesa B,27,0,30,3
1681915473255,MATH 18,B03,182765,Anzaldo; Leesa B,30,0,30,0
1681915473255,MATH 18,B04,182766,Anzaldo; Leesa B,30,0,30,0
1681915474279,MATH 20A,A01,182771,Suk; Andrew Hoon,28,0,30,2
1681915475306,MATH 20B,A01,182775,Bach; Quang Tran,30,0,30,0
1681915475306,MATH 20B,A02,182777,Bach; Quang Tran,29,0,30,1
1681915475306,MATH 20B,B01,182780,Bach; Quang Tran,27,0,30,3
1681915475306,MATH 20B,B02,182782,Bach; Quang Tran,30,0,30,0
1681915476329,MATH 20C,A01,182787,Staff,25,0,30,5
1681915476329,MATH 20C,A02,182790,Staff,29,0,30,1
1681915476329,MATH 20C,B01,182792,Staff,25,0,30,5
1681915476329,MATH 20C,B02,182796,Staff,27,0,30,3
1681915477354,MATH 20D,A01,182799,Staff,29,0,30,1
1681915477354,MATH 20D,A02,182802,Staff,30,0,30,0
1681915477354,MATH 20D,A03,182803,Staff,30,0,30,0
1681915478381,MATH 20E,A01,182809,Verstraete; Jacques Allan,24,0,30,6
1681915478381,MATH 20E,A02,182811,Verstraete; Jacques Allan,28,0,30,2
1681915478381,MATH 20E,B01,182814,Verstraete; Jacques Allan,23,0,30,7
1681915478381,MATH 20E,B02,182815,Verstraete; Jacques Allan,30,0,30,0
1681915479403,MATH 103A,A01,182820,Staff,9,0,30,21
1681915479403,MATH 103A,A02,182821,Staff,27,0,30,3
1681915479403,MATH 103A,A03,182822,Staff,23,0,30,7
1681915479403,MATH 103A,B01,182825,Staff,23,0,30,7
1681915479403,MATH 103A,B02,182826,Staff,30,0,30,0
1681915479403,MATH 103A,B03,182830,Staff,30,0,30,0
1681915480438,MATH 109,A01,182836,Chow; Bennett,24,0,30,6
1681915480438,MATH 109,A02,182838,Chow; Bennett,29,0,30,1
1681915480438,MATH 109,A03,182894,Chow; Bennett,29,0,30,1
1681915480438,MATH 109,B01,182908,Chow; Bennett,28,0,30,2
1681915480438,MATH 109,B02,182909,Chow; Bennett,30,0,30,0
1681915480438,MATH 109,B03,182910,Chow; Bennett,27,0,30,3
1681915481462,MATH 142A,A01,182925,Staff,11,0,30,19
1681915481462,MATH 142A,A02,182935,Staff,24,0,30,6
1681915481462,MATH 142A,A03,182967,Staff,26,0,30,4
1681915481462,MATH 142A,B01,183125,Staff,24,0,30,6
1681915481462,MATH 142A,B02,183157,Staff,28,0,30,2
1681915481462,MATH 142A,B03,183158,Staff,29,0,30,1
1681915482486,MATH 183,A01,183160,Arias-Castro; Ery,23,0,30,7
1681915482486,MATH 183,A02,183161,Arias-Castro; Ery,29,0,30,1
1681915482486,MATH 183,B01,183163,Arias-Castro; Ery,28,0,30,2
1681915482486,MATH 183,B02,183164,Arias-Castro; Ery,28,0,30,2
1681915483524,MATH 193A,A01,183167,Staff,4,0,35,31
1681915483524,MATH 193A,A02,183168,Staff,28,0,35,7
1681915483524,MATH 193A,A03,183169,Staff,34,0,35,1
1681915483524,MATH 193A,A04,183170,Staff,28,0,35,7
1681915484549,MGT 4,A01,202395,Anderson; John Charles,75,0,80,5
1681915485573,MGT 5,A00,202396,Houskeeper; Robert,80,0,90,10
1681915486599,MGT 103,A00,202397,Eberhard; Craig A,55,0,90,35
1681915487622,MGT 131A,A00,202398,Houskeeper; Robert,85,0,90,5
1681915488647,MGT 135,A00,202399,Anderson; John Charles,82,0,90,8
1681915489675,MGT 162R,A00,202403,Gneezy; Uri,150,0,200,50
1681915490697,MGT 172,A00,202404,Hedges; Kathleen,50,0,90,40
1681915491721,MGT 181,A00,202405,Dunn; Louis Jean,84,0,90,6
1681915492747,MMW 14,A01,183200,Staff,16,0,28,12
1681915492747,MMW 14,A02,183201,Staff,26,0,28,2
1681915492747,MMW 14,A03,183202,Staff,24,0,28,4
1681915492747,MMW 14,A04,183203,Staff,25,0,28,3
1681915492747,MMW 14,A05,183204,Staff,26,0,28,2
1681915492747,MMW 14,A06,183205,Staff,27,0,28,1
1681915492747,MMW 14,B01,183207,Staff,26,0,28,2
1681915492747,MMW 14,B02,183208,Staff,28,0,28,0
1681915492747,MMW 14,B03,183209,Staff,28,0,28,0
1681915492747,MMW 14,B04,183210,Staff,28,0,28,0
1681915492747,MMW 14,B05,183211,Staff,28,0,28,0
1681915492747,MMW 14,B06,183212,Staff,28,0,28,0
1681915493769,MMW 14GS,A00,183213,Zhiri; Oumelbanine,28,0,28,0
1681915494794,MMW 15GS,B00,183215,Rahimi; Babak,28,0,28,0
1681915495819,MMW 121,A01,183217,Patterson; Patrick H.,14,0,28,14
1681915495819,MMW 121,A02,183218,Patterson; Patrick H.,25,0,28,3
1681915496845,MUS 1A,A01,182554,Staff,8,0,35,27
1681915497872,MUS 5,A01,182558,Staff,20,0,35,15
1681915498900,MUS 6,A01,182562,Staff,25,0,35,10
1681915499922,MUS 8GS,A00,182563,Borgo; David Garcia,25,0,25,0
1681915500945,MUS 13,A01,182567,Staff,24,0,25,1
1681915501970,MUS 15,A01,182570,Staff,32,0,35,3
1681915501970,MUS 15,B01,182575,Staff,10,0,35,25
1681915502999,MUS 80,A00,182578,Staff,23,0,25,2
1681915502999,MUS 80,B00,182581,Staff,20,0,25,5
1681915504023,MUS 113,A00,182582,Staff,25,0,25,0
1681915505047,MUS 114,A00,182583,Staff,4,0,25,21
1681915506071,MUS 150GS,A01,182588,Borgo; David Garcia,25,0,25,0
1681915507095,PHIL 1,A00,182590,Staff,35,0,40,5
1681915508125,PHIL 10,A01,182596,Grush; Rick Scott,31,0,35,4
1681915508125,PHIL 10,A02,182597,Grush; Rick Scott,34,0,35,1
1681915509149,PHIL 15,A01,182601,Staff,31,0,35,4
1681915509149,PHIL 15,A02,182602,Staff,33,0,35,2
1681915510182,PHIL 27,A01,182604,Staff,30,0,35,5
1681915510182,PHIL 27,A02,182607,Staff,35,0,35,0
1681915511206,PHIL 32,A01,182609,Staff,35,0,35,0
1681915511206,PHIL 32,A02,182612,Staff,35,0,35,0
1681915512230,PHIL 130,A00,182614,Staff,63,0,70,7
1681915513253,PHIL 136,A00,182616,Cohen; Jonathan David,66,0,70,4
1681915514278,PHIL 155,A00,182617,Vargas; Manuel Rogelio,60,0,70,10
1681915515314,PHIL 163,A01,182620,Staff,15,0,20,5
1681915515314,PHIL 163,A02,182624,Staff,10,0,20,10
1681915516342,PHIL 164,A00,182627,Staff,30,0,40,10
1681915517365,PHIL 173,A00,182628,Staff,36,0,40,4
1681915518393,PHYS 1A,A00,183221,Staff,54,0,60,6
1681915519418,PHYS 1AL,001,183222,Staff,25,0,30,5
1681915519418,PHYS 1AL,002,183223,Staff,28,0,30,2
1681915520467,PHYS 1B,A00,183231,Staff,44,0,60,16
1681915521498,PHYS 1BL,001,183232,Staff,20,0,30,10
1681915521498,PHYS 1BL,002,183233,Staff,29,0,30,1
1681915522525,PHYS 1C,A00,183240,Staff,30,0,60,30
1681915523549,PHYS 1CL,001,183241,Staff,13,0,30,17
1681915523549,PHYS 1CL,002,183242,Staff,22,0,30,8
1681915524573,PHYS 2AR,A01,183250,Staff,44,0,50,6
1681915525595,PHYS 2B,A01,183252,Staff,106,0,115,9
1681915526618,PHYS 2BL,A01,183254,Staff,21,0,24,3
1681915526618,PHYS 2BL,A02,183255,Staff,22,0,24,2
1681915527652,PHYS 2C,A01,183522,Staff,105,0,115,10
1681915528680,PHYS 4A,A01,183524,Staff,49,0,50,1
1681915529705,POLI 5,A00,183525,Staff,44,0,50,6
1681915530731,POLI 12,A00,183540,Staff,48,0,50,2
1681915531754,POLI 13R,A00,183541,Forman; Fonna,42,0,50,8
1681915532789,POLI 30,A00,183542,Mignozzetti; Umberto,47,0,50,3
1681915533813,POLI 100A,A00,183543,Staff,45,0,50,5
1681915534916,POLI 100E,A00,223598,Staff,32,0,35,3
1681915535940,POLI 103A,A00,183564,Kousser; Thad,38,0,50,12
1681915536963,POLI 104B,A00,201329,Staff,29,0,35,6
1681915537991,POLI 113BR,A00,183576,Hoston; Germaine,27,0,50,23
1681915539014,POLI 114BR,A00,183588,Staff,27,0,30,3
1681915540037,POLI 117R,A00,183595,Forman; Fonna,9,0,20,11
1681915541060,POLI 120H,A00,183596,Fisk; David Lee,13,0,20,7
1681915542087,POLI 130AA,A00,183597,Staff,14,0,20,6
1681915543112,POLI 134AA,A00,183598,Staff,19,0,20,1
1681915544139,POLI 135,A00,183599,Fisk; David Lee,20,0,25,5
1681915545165,POLI 142P,A00,183623,Staff,37,0,40,3
1681915546192,POLI 144D,A00,183624,Staff,22,0,25,3
1681915547224,POLI 151,A00,183625,Staff,15,0,20,5
1681915548249,POLI 162,A00,183626,Mignozzetti; Umberto,18,0,20,2
1681915549275,PSYC 1,A00,253748,Staff,86,0,90,4
1681915550300,PSYC 2,A00,183627,Moranton; Nirelia Melbina-,25,0,35,10
1681915551335,PSYC 3,A00,183628,Staff,43,0,45,2
1681915553391,PSYC 60,A01,183631,Lowe; Angela Beth,35,0,40,5
1681915554418,PSYC 70,A01,253757,Staff,37,0,45,8
1681915555444,PSYC 101,A00,183632,Heyman; Gail D.,48,0,60,12
1681915556480,PSYC 105,A00,183848,Lowe; Angela Beth,50,0,60,10
1681915557507,PSYC 106,A00,183849,Dobkins; Karen R.,45,0,60,15
1681915558533,PSYC 108,A00,253750,Staff,24,0,60,36
1681915559560,PSYC 114,A01,184275,Winkielman; Piotr,0,6,30,30
1681915560591,PSYC 122,A00,183856,Moranton; Nirelia Melbina-,0,10,30,30
1681915561613,PSYC 124,A00,183865,Chapman; Eddie Nathaniel,52,0,80,28
1681915562640,PSYC 137,A00,183880,Staff,19,0,25,6
1681915564686,PSYC 154,A00,183910,Lacefield; Katharine I,0,2,90,90
1681915566741,PSYC 162,A00,183946,Wixted; John T,61,0,90,29
1681915567769,PSYC 172,A00,183947,Gorman; Michael R.,14,0,30,16
1681915568808,PSYC 178,A00,183963,Glaser; Dale,20,0,40,20
1681915569835,PSYC 181GS,A00,183964,Anagnostaras; Stephan,10,0,10,0
1681915570859,PSYC 186GS,A01,257660,Staff,10,0,10,0
1681915571883,PSYC 193,B00,253749,Staff,23,0,25,2
1681915573941,PSYC 193L,A01,184122,Staff,33,0,35,2
1681915573941,PSYC 193L,C01,184167,Winkielman; Piotr,16,0,30,14
1681915574966,RELI 188GS,A00,182629,Rahimi; Babak,20,0,20,0
1681915575996,SE 101A,A00,182646,Staff,26,0,30,4
1681915577022,SE 101C,A00,182650,Staff,18,0,20,2
1681915578045,SE 110A,A00,182651,Staff,28,0,28,0
1681915579068,SE 130A,A00,182652,Staff,39,0,40,1
1681915580091,SIO 46GS,A00,182636,Cook; Geoffrey W,28,0,28,0
1681915581113,SIO 109R,A00,194459,Staff,5,0,20,15
1681915582145,SIO 121GS,A00,182639,Cook; Geoffrey W,28,0,28,0
1681915583168,SIO 132,A01,182642,Staff,32,0,40,8
1681915584192,SIO 139,A00,182644,Kacev; David,36,0,40,4
1681915585216,SOCI 2,A01,258404,Staff,34,0,36,2
1681915585216,SOCI 2,A02,258405,Staff,35,0,36,1
1681915586239,SOCI 60,A01,258408,Staff,29,0,30,1
1681915586239,SOCI 60,A02,258413,Staff,30,0,30,0
1681915587262,SOCI 100,A01,258415,Staff,29,0,30,1
1681915587262,SOCI 100,A02,258416,Staff,28,0,30,2
1681915593428,SOCI 127,A00,258421,Staff,22,0,30,8
1681915594450,SOCI 132,A00,258422,Staff,45,0,50,5
1681915595474,SOCI 133,A00,258423,Staff,26,0,30,4
1681915596497,SOCI 138GS,A00,258424,Staff,15,0,15,0
1681915597519,SOCI 145,A00,258425,Staff,25,0,30,5
1681915598543,SOCI 148,A00,258426,Staff,26,0,30,4
1681915599569,SOCI 153,A00,199217,Staff,29,0,30,1
1681915600592,SOCI 160,A00,258427,Staff,28,0,30,2
1681915601622,SOCI 160E,A00,258435,Staff,56,0,60,4
1681915602644,SOCI 189GS,A00,258436,Staff,15,0,15,0
1681915603669,SOCI 190GS,A00,258437,Staff,15,0,15,0
1681915604692,SYN 2,001,182658,Staff,9,0,16,7
1681915604692,SYN 2,002,201439,Staff,15,0,16,1
1681915604692,SYN 2,003,201443,Staff,16,0,16,0
1681915605715,SYN 100,A01,182657,Staff,17,0,20,3
1681915606745,TDAC 1,A00,184381,Salovey; Todd,16,0,20,4
1681915606745,TDAC 1,B00,184385,Harting; Carla Kelso,19,0,20,1
1681915606745,TDAC 1,C00,184394,Staff,19,0,20,1
1681915607771,TDAC 101,A00,184483,Harting; Carla Kelso,19,0,20,1
1681915608802,TDDE 111,A00,184496,Staff,14,0,15,1
1681915609827,TDDE 131,A00,184504,Staff,20,0,20,0
1681915609827,TDDE 131,B00,184505,Staff,17,0,18,1
1681915609827,TDDE 131,C00,184534,Staff,49,0,50,1
1681915609827,TDDE 131,D00,184564,Staff,15,0,15,0
1681915609827,TDDE 131,E00,204725,Staff,19,0,20,1
1681915610850,TDGE 1,A01,184414,Salovey; Todd,37,0,50,13
1681915611875,TDGE 5,A01,184419,Staff,23,0,24,1
1681915612908,TDGE 10,A00,184428,Fulton; Julia,31,0,50,19
1681915613932,TDGE 124,A00,184565,Fulton; Julia,7,0,50,43
1681915614957,TDGE 125,B00,184567,Meyer; Ursula,9,0,25,16
1681915615982,TDHT 101,A00,184568,Staff,21,0,25,4
1681915615982,TDHT 101,B00,184569,Staff,20,0,20,0
1681915617007,TDHT 114,A00,184570,Staff,49,0,50,1
1681915618034,TDMV 1,A00,184437,Arcidiacono; Kristin,23,0,30,7
1681915618034,TDMV 1,B00,184448,Caligagan; Maria T.,22,0,30,8
1681915619060,TDMV 2,A00,184449,Weinberg; Sadie,27,0,30,3
1681915619060,TDMV 2,B00,184453,Arcidiacono; Kristin,29,0,30,1
1681915620083,TDMV 110,A00,184571,Weinberg; Sadie,30,0,30,0
1681915621108,TDMV 142,A00,184572,Caligagan; Tony,27,0,30,3
1681915621108,TDMV 142,B00,184573,Caligagan; Maria T.,27,0,30,3
1681915622135,TDTR 20,A00,184482,Jun; Grace Shin Hae,25,0,25,0
1681915623159,USP 2,A01,184290,Hinds; Juli Beth,24,0,25,1
1681915624186,USP 3,A01,184295,Staff,20,0,25,5
1681915625215,USP 4,A00,184304,McTague; Sarah,15,0,25,10
1681915626238,USP 100,A00,184315,Staff,17,0,25,8
1681915627266,USP 105,A00,184326,Staff,21,0,25,4
1681915628290,USP 151,A00,184327,Staff,20,0,25,5
1681915629312,USP 170,A00,184380,Hinds; Juli Beth,14,0,25,11
1681915630340,VIS 21B,A01,182660,Staff,28,0,31,3
1681915630340,VIS 21B,A02,182662,Staff,30,0,31,1
1681915631366,VIS 103D,A00,182663,Staff,74,0,75,1
1681915632388,VIS 105D,A00,182667,Li; Huai,15,0,22,7
1681915633414,VIS 122GS,A00,182668,Herbst; Matthew,20,0,20,0
1681915634442,VIS 128C,A00,182673,Staff,69,0,75,6
1681915635468,VIS 130,A00,182675,Staff,20,0,22,2
1681915636495,VIS 160A,A00,182678,Stalbaum; Brett,4,0,10,6
1681915638618,WCWP 10B,A00,201679,Staff,15,0,15,0
1681915638618,WCWP 10B,B00,201695,Staff,15,0,15,0
1681915639644,WCWP 100,A00,201716,Staff,15,0,15,0
1681915639644,WCWP 100,B00,201717,Staff,11,0,15,4
1681915641761,ANSC 105GS,A00,258289,Staff,0,0,0,0
1681915642787,ANSC 125GS,A00,258295,Staff,0,0,0,0
1681915643810,ANSC 150,A00,258267,Staff,30,0,40,10
1681915644836,ANSC 190GS,A00,258280,Staff,0,0,0,0
1681915645859,ANTH 1,A00,258264,Staff,38,0,40,2
1681915646885,ANTH 2,A01,258259,Staff,72,0,76,4
1681915647910,ANTH 23,A01,258228,Staff,36,0,40,4
1681915648934,ANTH 101,A01,258236,Staff,39,0,40,1
1681915649957,ANTH 102,A00,258272,Staff,59,0,60,1
1681915650984,ANTH 105,A00,258244,Staff,31,0,35,4
1681915652013,BENG 130,A00,253975,Staff,38,0,40,2
1681915653043,BIBC 102,A01,191866,Flagg; Matthew Paul,19,0,32,13
1681915653043,BIBC 102,A02,191867,Flagg; Matthew Paul,22,0,32,10
1681915653043,BIBC 102,A03,191868,Flagg; Matthew Paul,30,0,32,2
1681915653043,BIBC 102,A04,191936,Flagg; Matthew Paul,26,0,32,6
1681915653043,BIBC 102,A05,191937,Flagg; Matthew Paul,11,0,32,21
1681915654068,BICD 100,A01,191939,Cooper; Andrew Michael,28,0,32,4
1681915654068,BICD 100,A02,191940,Cooper; Andrew Michael,32,0,32,0
1681915654068,BICD 100,A03,191941,Cooper; Andrew Michael,32,0,32,0
1681915654068,BICD 100,A04,191942,Cooper; Andrew Michael,32,0,32,0
1681915654068,BICD 100,A05,191943,Cooper; Andrew Michael,32,0,32,0
1681915655093,BIEB 126,A01,191945,Cleland; Elsa Eleanor,1,0,32,31
1681915655093,BIEB 126,A02,191946,Cleland; Elsa Eleanor,28,0,32,4
1681915655093,BIEB 126,A03,191947,Cleland; Elsa Eleanor,29,0,32,3
1681915655093,BIEB 126,A04,191948,Cleland; Elsa Eleanor,23,0,32,9
1681915655093,BIEB 126,A05,191996,Cleland; Elsa Eleanor,28,0,32,4
1681915656117,BIEB 136GS,A00,191997,Shurin; Jonathan & Holway; David A.,0,0,0,0
1681915657141,BIEB 137GS,A01,191999,Shurin; Jonathan & Holway; David A.,0,0,0,0
1681915658169,BILD 1,A01,205385,Staff,31,0,32,1
1681915658169,BILD 1,A02,205386,Staff,30,0,32,2
1681915658169,BILD 1,A03,205387,Staff,32,0,32,0
1681915658169,BILD 1,A04,205388,Staff,28,0,32,4
1681915659194,BILD 2,A01,191774,Staff,28,0,32,4
1681915659194,BILD 2,A02,191775,Staff,30,0,32,2
1681915659194,BILD 2,A03,191777,Staff,30,0,32,2
1681915659194,BILD 2,A04,191856,Staff,31,0,32,1
1681915659194,BILD 2,A05,191857,Staff,32,0,32,0
1681915659194,BILD 2,A06,191858,Staff,32,0,32,0
1681915659194,BILD 2,A07,191859,Staff,31,0,32,1
1681915660222,BILD 3,A01,205391,Staff,29,0,32,3
1681915660222,BILD 3,A02,205393,Staff,32,0,32,0
1681915660222,BILD 3,A03,205394,Staff,28,0,32,4
1681915660222,BILD 3,A04,205395,Staff,32,0,32,0
1681915661249,BILD 20,A01,191861,Staff,32,0,32,0
1681915661249,BILD 20,A02,191862,Staff,32,0,32,0
1681915662272,BILD 30,A01,191864,Staff,31,0,32,1
1681915663297,BIMM 100,A01,192019,Staff,0,0,32,32
1681915663297,BIMM 100,A02,192020,Staff,23,0,32,9
1681915663297,BIMM 100,A03,192035,Staff,22,0,32,10
1681915664325,BIMM 110,A01,192037,Tat; John,0,0,32,32
1681915664325,BIMM 110,A02,192038,Tat; John,10,0,32,22
1681915665357,BIMM 120,A01,192040,Pickett; Brooke Elizabeth,2,0,32,30
1681915665357,BIMM 120,A02,192041,Pickett; Brooke Elizabeth,16,0,32,16
1681915665357,BIMM 120,A03,192042,Pickett; Brooke Elizabeth,16,0,32,16
1681915666380,BIPN 100,A01,192044,Armour; Jon Christopher,26,0,32,6
1681915666380,BIPN 100,A02,192059,Armour; Jon Christopher,30,0,32,2
1681915666380,BIPN 100,A03,192064,Armour; Jon Christopher,31,0,32,1
1681915666380,BIPN 100,A04,192073,Armour; Jon Christopher,28,0,32,4
1681915667403,BIPN 148,A01,205411,Leutgeb; Jill K.,16,0,32,16
1681915667403,BIPN 148,A02,205412,Leutgeb; Jill K.,31,0,32,1
1681915667403,BIPN 148,A03,205413,Leutgeb; Jill K.,30,0,32,2
1681915667403,BIPN 148,A04,205414,Leutgeb; Jill K.,30,0,32,2
1681915668432,BIPN 160,A01,192115,Marino; Marc J,19,0,32,13
1681915668432,BIPN 160,A02,192148,Marino; Marc J,27,0,32,5
1681915668432,BIPN 160,A03,192158,Marino; Marc J,31,0,32,1
1681915668432,BIPN 160,A04,192190,Marino; Marc J,32,0,32,0
1681915668432,BIPN 160,A05,192287,Marino; Marc J,32,0,32,0
1681915668432,BIPN 160,A06,192288,Marino; Marc J,32,0,32,0
1681915669461,BIPN 194,A00,206038,Staff,28,0,32,4
1681915670490,BISP 194,A00,192289,Leutgeb; Stefan,13,0,32,19
1681915670490,BISP 194,B00,245332,Nieh; James Charles,27,0,32,5
1681915671513,CAT 124,A01,202247,Staff,15,0,15,0
1681915672538,CAT 125,A00,202248,Staff,19,0,20,1
1681915672538,CAT 125,B00,202253,Staff,20,0,20,0
1681915672538,CAT 125,C00,202257,Staff,19,0,20,1
1681915673562,CAT 125GS,A01,202273,Bronstein; Phoebe Malan,20,0,20,0
1681915674586,CAT 125R,A00,202284,Staff,17,0,20,3
1681915674586,CAT 125R,C00,202286,Staff,10,0,20,10
1681915674586,CAT 125R,D00,202291,Staff,18,0,20,2
1681915674586,CAT 125R,E00,202295,Staff,13,0,20,7
1681915674586,CAT 125R,F00,202302,Staff,12,0,20,8
1681915675613,CENG 100,A00,204724,Opatkiewicz; Justin Paul,25,0,25,0
1681915676637,CGS 2A,A01,180420,Staff,31,0,36,5
1681915677662,CGS 101,A00,180421,Staff,16,0,20,4
1681915678693,CGS 112,A00,180422,Staff,10,0,16,6
1681915679719,CGS 113,A00,180423,Staff,18,0,20,2
1681915680742,CGS 137,A00,180424,Staff,12,0,12,0
1681915681765,CGS 147,A00,180425,Staff,10,0,10,0
1681915682792,CHEM 6A,A01,179556,Staff,97,0,100,3
1681915682792,CHEM 6A,A02,179558,Staff,0,0,0,0
1681915683816,CHEM 6B,A01,179560,Staff,100,0,100,0
1681915684841,CHEM 6C,A01,179565,Jazzar; Rodolphe,95,0,100,5
1681915685874,CHEM 7L,A01,179586,Schurmeier; Kimberly,13,0,24,11
1681915685874,CHEM 7L,A02,179587,Schurmeier; Kimberly,23,0,24,1
1681915685874,CHEM 7L,A03,179590,Schurmeier; Kimberly,22,0,24,2
1681915685874,CHEM 7L,A04,179591,Schurmeier; Kimberly,22,0,24,2
1681915685874,CHEM 7L,B01,179598,Schurmeier; Kimberly,17,0,24,7
1681915685874,CHEM 7L,B02,179599,Schurmeier; Kimberly,24,0,24,0
1681915685874,CHEM 7L,B03,179606,Schurmeier; Kimberly,23,0,24,1
1681915685874,CHEM 7L,B04,179607,Schurmeier; Kimberly,23,0,24,1
1681915686898,CHEM 11,A01,179609,Stallings; Dontarie M,88,0,100,12
1681915687923,CHEM 40A,A01,179621,Staff,41,0,50,9
1681915687923,CHEM 40A,A02,179622,Staff,47,0,50,3
1681915688947,CHEM 40B,A01,179630,Weizman; Haim,48,0,50,2
1681915688947,CHEM 40B,A02,179631,Weizman; Haim,45,0,50,5
1681915689978,CHEM 41A,A01,179660,Klosterman; Jeremy K,93,0,100,7
1681915691002,CHEM 43A,A01,179683,Klosterman; Jeremy K,0,0,24,24
1681915691002,CHEM 43A,A02,179688,Klosterman; Jeremy K,14,0,24,10
1681915691002,CHEM 43A,A03,179689,Klosterman; Jeremy K,20,0,24,4
1681915691002,CHEM 43A,A04,179691,Klosterman; Jeremy K,18,0,24,6
1681915692027,CHEM 114A,A01,179693,Stallings; Dontarie M,77,0,100,23
1681915693050,CHEM 143B,A01,179698,Weizman; Haim,17,0,24,7
1681915693050,CHEM 143B,A02,179700,Weizman; Haim,24,0,24,0
1681915694074,CHIN 169A,A00,179701,Wang; Xiao,20,0,20,0
1681915695100,COGS 2,A01,179750,Boyle; Mary E. T.,17,0,30,13
1681915696124,COGS 9,A01,179759,Jones; Cameron Robert,43,0,50,7
1681915697148,COGS 14A,A01,179854,Staff,18,0,50,32
1681915698174,COGS 14B,A01,179856,Staff,54,0,60,6
1681915699198,COGS 17,A01,179874,Staff,71,0,75,4
1681915700228,COGS 18,A01,179884,Staff,63,0,80,17
1681915701255,COGS 100,A01,179886,Staff,40,0,60,20
1681915702279,COGS 101B,A01,179892,Staff,1,0,30,29
1681915703306,COGS 101C,A01,179894,Staff,28,0,30,2
1681915704337,COGS 107A,A01,179896,Boyle; Mary E. T.,31,0,40,9
1681915705364,COGS 108,A01,179898,Simpkins; Charles Alexander,0,17,60,60
1681915706403,COGS 109,A01,179900,Staff,34,0,40,6
1681915707427,COGS 118A,A01,179946,Staff,9,0,40,31
1681915708453,COGS 153,A00,179978,Staff,1,0,30,29
1681915709478,COGS 156,A01,179981,Staff,27,0,30,3
1681915711527,COGS 172,A01,179987,Staff,13,0,30,17
1681915713576,COGS 186,A01,179991,Staff,13,0,30,17
1681915714602,COMM 10,A01,180001,Staff,15,0,25,10
1681915714602,COMM 10,A02,180004,Staff,20,0,25,5
1681915715629,COMM 100A,A01,180016,Staff,18,0,25,7
1681915715629,COMM 100A,A02,180020,Staff,24,0,25,1
1681915716654,COMM 101T,A00,180029,Halm; Gavin Patrick,23,0,35,12
1681915717676,COMM 106V,A00,180043,Staff,34,0,35,1
1681915718699,COMM 109P,A00,180044,Staff,31,0,35,4
1681915719723,COMM 113T,A00,180045,Havis; Allan,37,0,45,8
1681915720750,COMM 132,A00,180046,McKenna; Denise,23,0,30,7
1681915721772,COMM 143,A00,180047,Staff,19,0,30,11
1681915722797,COMM 190,A00,180048,Conner; Thomas Hartnell,20,0,23,3
1681915723825,CSE 8A,A50,180053,Cao; Yingjun,25,0,50,25
1681915723825,CSE 8A,B50,180180,Staff,50,0,50,0
1681915724852,CSE 11,A01,180190,Cao; Yingjun,31,0,50,19
1681915725888,CSE 20,A01,180192,Briones; Jor-el Thomas Caparas,23,0,30,7
1681915726913,CSE 21,A01,194538,Briones; Jor-el Thomas Caparas,50,0,60,10
1681915727937,CSE 30,A01,180324,Eldon; John,78,0,100,22
1681915728960,CSE 101,A01,201353,Staff,0,20,40,40
1681915729986,CSE 134B,A01,180326,Powell; Thomas Allan,74,0,100,26
1681915731009,CSE 140,A01,180328,Staff,46,0,75,29
1681915732033,CSE 140L,A01,180344,Eldon; John,69,0,100,31
1681915733057,CSE 150A,A01,180411,Staff,0,7,50,50
1681915734083,CSE 151A,A01,180414,Staff,0,6,50,50
1681915735109,CSE 175,A01,222521,Kumar; Rakesh,50,0,50,0
1681915736131,CSE 190,A00,201419,Staff,45,0,49,4
1681915737155,CSS 1,A01,194536,Staff,38,0,50,12
1681915738182,DSC 30,A01,202385,Staff,48,0,50,2
1681915739206,DSC 40A,A01,202387,Albuyeh; Rod,50,0,50,0
1681915740232,DSC 190,A01,202389,Silberman; Jack,21,0,21,0
1681915741265,DSGN 100,A01,179993,Staff,16,0,30,14
1681915742363,ECE 65,A50,180708,Staff,10,0,20,10
1681915742363,ECE 65,A51,180739,Staff,19,0,20,1
1681915743394,ECON 1,A01,180427,Famulari; Melissa,67,0,70,3
1681915744417,ECON 2,A01,180450,Levkoff; Steven B.,64,0,70,6
1681915745449,ECON 4,A01,203351,Anderson; John Charles,7,0,10,3
1681915746474,ECON 100A,A01,180472,Famulari; Melissa,65,0,70,5
1681915747497,ECON 120A,A01,180549,Staff,64,0,70,6
1681915748521,ECON 120B,A01,180655,Ma; Xinwei,46,0,70,24
1681915749543,ECON 129,A00,203333,Eckert; Fabian Paul,15,0,35,20
1681915750568,ECON 131,A00,180656,Staff,9,0,35,26
1681915751595,ECON 172B,A01,180672,Levkoff; Steven B.,32,0,35,3
1681915752633,ECON 178,A01,203342,Zhu; Ying,11,0,35,24
1681915753657,EDS 108GS,A00,202383,Wishard Guerra; Alison G.,20,0,20,0
1681915754679,EDS 111GS,A00,202347,Wishard Guerra; Alison G.,20,0,20,0
1681915755706,EDS 112,A01,202323,Staff,56,0,60,4
1681915756733,EDS 113,A00,202340,Staff,33,0,35,2
1681915757756,EDS 118,A00,201231,Staff,20,0,30,10
1681915758782,EDS 119,A00,204994,Staff,8,0,10,2
1681915759808,EDS 124BR,A00,202324,Eguchi; Emi,5,0,25,20
1681915760835,EDS 126,A01,203208,Jones; Makeba,26,0,30,4
1681915761861,EDS 135,A01,202333,Staff,18,0,20,2
1681915762885,EDS 180,A00,202311,Staff,47,0,50,3
1681915763908,ERC 190GS,A01,253747,Staff,28,0,28,0
1681915764934,ETHN 104,A00,180742,Staff,24,0,35,11
1681915765956,ETHN 118,A00,180745,Staff,28,0,35,7
1681915766979,ETHN 127,A00,180747,Staff,12,0,16,4
1681915768009,ETHN 137,A00,180880,Staff,12,0,12,0
1681915769032,ETHN 147,A00,180890,Staff,8,0,10,2
1681915770056,ETHN 154,A00,180891,Staff,7,0,8,1
1681915771079,ETHN 168,A00,180892,Staff,9,0,10,1
1681915772106,GLBH 20,A00,201051,Hannah; Seth Donal,0,1,0,1
1681915773130,GLBH 111,A01,209338,Burgos; Jose L.,0,0,0,0
1681915774155,GLBH 150,A00,258300,Staff,0,3,0,0
1681915775178,GLBH 181,A00,201207,Staff,15,0,40,25
1681915776203,HIEU 109,A00,180898,Staff,20,0,20,0
1681915777228,HIEU 111,A00,180899,Staff,1,0,20,19
1681915778250,HIEU 124,A00,180900,Staff,18,0,20,2
1681915779276,HILA 122,A00,180901,Staff,18,0,20,2
1681915780299,HILA 132,A00,180902,Vitz; Matthew,2,0,20,18
1681915781323,HILD 10,A01,180896,Staff,15,0,20,5
1681915782347,HILD 30GS,A00,180897,Edington; Claire Ellen,0,0,0,0
1681915783374,HISC 105,A00,180903,Staff,20,0,20,0
1681915784396,HISC 117,A00,180904,Staff,11,0,20,9
1681915785423,HIUS 108B,A00,181005,Staff,18,0,20,2
1681915786448,HIUS 113,A00,181093,Staff,4,0,20,16
1681915787472,HUM 3,A01,181190,Patterson; Patrick H.,40,0,50,10
1681915787472,HUM 3,B01,181195,Staff,46,0,50,4
1681915788501,HUM 3GS,A00,181196,Herbst; Matthew,0,0,0,0
1681915789524,HUM 4,A01,181227,West; Geoffrey Scott,34,0,50,16
1681915789524,HUM 4,B01,181282,Staff,43,0,50,7
1681915790549,HUM 4GS,A00,181377,Lyon; Antony J.,0,0,0,0
1681915791574,HUM 5,A01,181536,Zavodny; Tatiana Sophia,31,0,50,19
1681915791574,HUM 5,B01,181908,Staff,36,0,50,14
1681915792596,INTL 190,A00,181909,Segui; Alan S,0,0,0,6
1681915792596,INTL 190,B00,181961,Segui; Alan S,0,0,0,7
1681915793618,JAPN 20AR,A01,182113,Ross; Kayoko F,15,0,20,5
1681915794642,LATI 50,A01,202391,Martin-Cabrera; Luis,19,0,30,11
1681915794642,LATI 50,A02,202392,Martin-Cabrera; Luis,26,0,30,4
1681915795665,LATI 180,A00,202393,Kokinis; Troy Andreas,25,0,25,0
1681915796687,LIFR 1A,A00,182119,Staff,14,0,14,0
1681915797714,LIFR 1AX,A00,182324,Staff,14,0,14,0
1681915798738,LIFR 1B,A00,182259,Staff,14,0,14,0
1681915799761,LIFR 1BX,A00,182273,Staff,14,0,14,0
1681915800790,LIGN 8,A00,182330,Staff,137,0,150,13
1681915801814,LIGN 9GS,A00,182362,Staff,20,0,20,0
1681915802840,LIGN 119,A00,204992,Takahashi; Maho,12,0,15,3
1681915803872,LIGN 130,A01,182384,Staff,47,0,50,3
1681915804895,LIGN 149GS,A00,182390,Staff,20,0,20,0
1681915805917,LIGN 170,A00,182404,Staff,24,0,30,6
1681915806943,LISP 1D,A00,182281,Staff,7,0,14,7
1681915806943,LISP 1D,B00,182287,Staff,14,0,14,0
1681915806943,LISP 1D,C00,182295,Staff,11,0,14,3
1681915806943,LISP 1D,D00,182301,Staff,14,0,14,0
1681915807969,LISP 1DX,A00,182309,Staff,20,0,28,8
1681915807969,LISP 1DX,B00,182316,Staff,26,0,28,2
1681915808995,LTAF 120GS,A00,182412,Zhiri; Oumelbanine,20,0,20,0
1681915810019,LTCS 172GS,A00,182437,Bronstein; Phoebe Malan,20,0,20,0
1681915811045,LTEA 138,A00,182457,Staff,22,0,40,18
1681915812073,LTEN 114,A01,182490,Staff,23,0,25,2
1681915813096,LTEN 130GS,A00,182491,Lyon; Antony J.,20,0,20,0
1681915814121,LTEN 169,A00,182493,Cuong; Marisol,20,0,25,5
1681915815152,LTEN 178,A00,182501,Staff,14,0,15,1
1681915816186,LTEN 181,A00,182515,Staff,22,0,25,3
1681915817211,LTEN 185GS,A00,197655,Forbes; Camille,20,0,20,0
1681915818235,LTSP 100B,A00,202208,Bessett; Ryan Matthew,24,0,25,1
1681915819260,LTWL 100,A00,182516,Myerston Santana; Jacobo,22,0,30,8
1681915820285,LTWR 100GS,A00,182518,Forbes; Camille,20,0,20,0
1681915821319,LTWR 102,A00,182522,Staff,15,0,15,0
1681915821319,LTWR 102,B00,182525,Staff,14,0,15,1
1681915822341,LTWR 115,A00,182526,Staff,12,0,15,3
1681915823367,MAE 8,A01,182528,Pham; Hieu Tan,68,0,70,2
1681915824394,MAE 11,A00,182529,Bahadori; Mohammad Yousef,94,0,100,6
1681915825416,MAE 20,A00,182530,Evdokimenko; Ekaterina,68,0,70,2
1681915826439,MAE 30A,A00,182532,Staff,44,0,45,1
1681915827465,MAE 101A,A00,182533,Bahadori; Mohammad Yousef,97,0,100,3
1681915828490,MAE 101C,A00,182538,Staff,62,0,70,8
1681915829514,MAE 104,A00,182539,Staff,45,0,50,5
1681915830538,MAE 131A,A00,182540,Ghazinejad; Maziar,41,0,45,4
1681915831566,MAE 143A,A00,182548,Bewley; Thomas R,43,0,50,7
1681915832589,MAE 150,A00,182549,Staff,28,0,40,12
1681915833613,MAE 160,A00,182550,Evdokimenko; Ekaterina,43,0,60,17
1681915834639,MATH 3C,A01,182725,Staff,27,0,30,3
1681915835662,MATH 10A,A01,182729,Staff,25,0,30,5
1681915835662,MATH 10A,B01,182732,Staff,26,0,30,4
1681915836689,MATH 10B,A01,182737,Staff,21,0,30,9
1681915836689,MATH 10B,A02,182738,Staff,27,0,30,3
1681915836689,MATH 10B,B01,182744,Staff,27,0,30,3
1681915836689,MATH 10B,B02,182745,Staff,27,0,30,3
1681915837721,MATH 18,A01,182750,Anzaldo; Leesa B,28,0,30,2
1681915837721,MATH 18,A02,182751,Anzaldo; Leesa B,29,0,30,1
1681915837721,MATH 18,A03,182753,Anzaldo; Leesa B,28,0,30,2
1681915837721,MATH 18,A04,182757,Anzaldo; Leesa B,29,0,30,1
1681915837721,MATH 18,B01,182761,Anzaldo; Leesa B,27,0,30,3
1681915837721,MATH 18,B02,182764,Anzaldo; Leesa B,27,0,30,3
1681915837721,MATH 18,B03,182765,Anzaldo; Leesa B,30,0,30,0
1681915837721,MATH 18,B04,182766,Anzaldo; Leesa B,30,0,30,0
1681915838744,MATH 20A,A01,182771,Suk; Andrew Hoon,28,0,30,2
1681915839768,MATH 20B,A01,182775,Bach; Quang Tran,30,0,30,0
1681915839768,MATH 20B,A02,182777,Bach; Quang Tran,29,0,30,1
1681915839768,MATH 20B,B01,182780,Bach; Quang Tran,27,0,30,3
1681915839768,MATH 20B,B02,182782,Bach; Quang Tran,30,0,30,0
1681915840791,MATH 20C,A01,182787,Staff,25,0,30,5
1681915840791,MATH 20C,A02,182790,Staff,29,0,30,1
1681915840791,MATH 20C,B01,182792,Staff,25,0,30,5
1681915840791,MATH 20C,B02,182796,Staff,27,0,30,3
1681915841814,MATH 20D,A01,182799,Staff,29,0,30,1
1681915841814,MATH 20D,A02,182802,Staff,30,0,30,0
1681915841814,MATH 20D,A03,182803,Staff,30,0,30,0
1681915842849,MATH 20E,A01,182809,Verstraete; Jacques Allan,24,0,30,6
1681915842849,MATH 20E,A02,182811,Verstraete; Jacques Allan,28,0,30,2
1681915842849,MATH 20E,B01,182814,Verstraete; Jacques Allan,23,0,30,7
1681915842849,MATH 20E,B02,182815,Verstraete; Jacques Allan,30,0,30,0
1681915843877,MATH 103A,A01,182820,Staff,9,0,30,21
1681915843877,MATH 103A,A02,182821,Staff,27,0,30,3
1681915843877,MATH 103A,A03,182822,Staff,23,0,30,7
1681915843877,MATH 103A,B01,182825,Staff,23,0,30,7
1681915843877,MATH 103A,B02,182826,Staff,30,0,30,0
1681915843877,MATH 103A,B03,182830,Staff,30,0,30,0
1681915844902,MATH 109,A01,182836,Chow; Bennett,24,0,30,6
1681915844902,MATH 109,A02,182838,Chow; Bennett,29,0,30,1
1681915844902,MATH 109,A03,182894,Chow; Bennett,29,0,30,1
1681915844902,MATH 109,B01,182908,Chow; Bennett,28,0,30,2
1681915844902,MATH 109,B02,182909,Chow; Bennett,30,0,30,0
1681915844902,MATH 109,B03,182910,Chow; Bennett,27,0,30,3
1681915845999,MATH 142A,A01,182925,Staff,11,0,30,19
1681915845999,MATH 142A,A02,182935,Staff,24,0,30,6
1681915845999,MATH 142A,A03,182967,Staff,26,0,30,4
1681915845999,MATH 142A,B01,183125,Staff,24,0,30,6
1681915845999,MATH 142A,B02,183157,Staff,28,0,30,2
1681915845999,MATH 142A,B03,183158,Staff,29,0,30,1
1681915847022,MATH 183,A01,183160,Arias-Castro; Ery,23,0,30,7
1681915847022,MATH 183,A02,183161,Arias-Castro; Ery,29,0,30,1
1681915847022,MATH 183,B01,183163,Arias-Castro; Ery,28,0,30,2
1681915847022,MATH 183,B02,183164,Arias-Castro; Ery,28,0,30,2
1681915848048,MATH 193A,A01,183167,Staff,4,0,35,31
1681915848048,MATH 193A,A02,183168,Staff,28,0,35,7
1681915848048,MATH 193A,A03,183169,Staff,34,0,35,1
1681915848048,MATH 193A,A04,183170,Staff,28,0,35,7
1681915849072,MGT 4,A01,202395,Anderson; John Charles,75,0,80,5
1681915850098,MGT 5,A00,202396,Houskeeper; Robert,80,0,90,10
1681915851122,MGT 103,A00,202397,Eberhard; Craig A,55,0,90,35
1681915852146,MGT 131A,A00,202398,Houskeeper; Robert,85,0,90,5
1681915853172,MGT 135,A00,202399,Anderson; John Charles,82,0,90,8
1681915854201,MGT 162R,A00,202403,Gneezy; Uri,150,0,200,50
1681915855225,MGT 172,A00,202404,Hedges; Kathleen,50,0,90,40
1681915856252,MGT 181,A00,202405,Dunn; Louis Jean,84,0,90,6
1681915857277,MMW 14,A01,183200,Staff,16,0,28,12
1681915857277,MMW 14,A02,183201,Staff,26,0,28,2
1681915857277,MMW 14,A03,183202,Staff,24,0,28,4
1681915857277,MMW 14,A04,183203,Staff,25,0,28,3
1681915857277,MMW 14,A05,183204,Staff,26,0,28,2
1681915857277,MMW 14,A06,183205,Staff,27,0,28,1
1681915857277,MMW 14,B01,183207,Staff,26,0,28,2
1681915857277,MMW 14,B02,183208,Staff,28,0,28,0
1681915857277,MMW 14,B03,183209,Staff,28,0,28,0
1681915857277,MMW 14,B04,183210,Staff,28,0,28,0
1681915857277,MMW 14,B05,183211,Staff,28,0,28,0
1681915857277,MMW 14,B06,183212,Staff,28,0,28,0
1681915858306,MMW 14GS,A00,183213,Zhiri; Oumelbanine,28,0,28,0
1681915859328,MMW 15GS,B00,183215,Rahimi; Babak,28,0,28,0
1681915860361,MMW 121,A01,183217,Patterson; Patrick H.,14,0,28,14
1681915860361,MMW 121,A02,183218,Patterson; Patrick H.,25,0,28,3
1681915861385,MUS 1A,A01,182554,Staff,8,0,35,27
1681915862410,MUS 5,A01,182558,Staff,20,0,35,15
1681915863433,MUS 6,A01,182562,Staff,25,0,35,10
1681915864458,MUS 8GS,A00,182563,Borgo; David Garcia,25,0,25,0
1681915865486,MUS 13,A01,182567,Staff,24,0,25,1
1681915866510,MUS 15,A01,182570,Staff,32,0,35,3
1681915866510,MUS 15,B01,182575,Staff,10,0,35,25
1681915867535,MUS 80,A00,182578,Staff,23,0,25,2
1681915867535,MUS 80,B00,182581,Staff,20,0,25,5
1681915868561,MUS 113,A00,182582,Staff,25,0,25,0
1681915869583,MUS 114,A00,182583,Staff,4,0,25,21
1681915870607,MUS 150GS,A01,182588,Borgo; David Garcia,25,0,25,0
1681915871633,PHIL 1,A00,182590,Staff,35,0,40,5
1681915872656,PHIL 10,A01,182596,Grush; Rick Scott,31,0,35,4
1681915872656,PHIL 10,A02,182597,Grush; Rick Scott,34,0,35,1
1681915873688,PHIL 15,A01,182601,Staff,31,0,35,4
1681915873688,PHIL 15,A02,182602,Staff,33,0,35,2
1681915874714,PHIL 27,A01,182604,Staff,30,0,35,5
1681915874714,PHIL 27,A02,182607,Staff,35,0,35,0
1681915875737,PHIL 32,A01,182609,Staff,35,0,35,0
1681915875737,PHIL 32,A02,182612,Staff,35,0,35,0
1681915876761,PHIL 130,A00,182614,Staff,63,0,70,7
1681915877788,PHIL 136,A00,182616,Cohen; Jonathan David,66,0,70,4
1681915878813,PHIL 155,A00,182617,Vargas; Manuel Rogelio,60,0,70,10
1681915879838,PHIL 163,A01,182620,Staff,15,0,20,5
1681915879838,PHIL 163,A02,182624,Staff,10,0,20,10
1681915880861,PHIL 164,A00,182627,Staff,30,0,40,10
1681915881884,PHIL 173,A00,182628,Staff,36,0,40,4
1681915882917,PHYS 1A,A00,183221,Staff,54,0,60,6
1681915883941,PHYS 1AL,001,183222,Staff,25,0,30,5
1681915883941,PHYS 1AL,002,183223,Staff,28,0,30,2
1681915884967,PHYS 1B,A00,183231,Staff,44,0,60,16
1681915885995,PHYS 1BL,001,183232,Staff,20,0,30,10
1681915885995,PHYS 1BL,002,183233,Staff,29,0,30,1
1681915887017,PHYS 1C,A00,183240,Staff,30,0,60,30
1681915888039,PHYS 1CL,001,183241,Staff,13,0,30,17
1681915888039,PHYS 1CL,002,183242,Staff,22,0,30,8
1681915889064,PHYS 2AR,A01,183250,Staff,44,0,50,6
1681915890089,PHYS 2B,A01,183252,Staff,106,0,115,9
1681915891115,PHYS 2BL,A01,183254,Staff,21,0,24,3
1681915891115,PHYS 2BL,A02,183255,Staff,22,0,24,2
1681915892139,PHYS 2C,A01,183522,Staff,105,0,115,10
1681915893169,PHYS 4A,A01,183524,Staff,49,0,50,1
1681915894196,POLI 5,A00,183525,Staff,44,0,50,6
1681915895227,POLI 12,A00,183540,Staff,48,0,50,2
1681915896250,POLI 13R,A00,183541,Forman; Fonna,42,0,50,8
1681915897272,POLI 30,A00,183542,Mignozzetti; Umberto,47,0,50,3
1681915898298,POLI 100A,A00,183543,Staff,45,0,50,5
1681915899321,POLI 100E,A00,223598,Staff,32,0,35,3
1681915900343,POLI 103A,A00,183564,Kousser; Thad,38,0,50,12
1681915901370,POLI 104B,A00,201329,Staff,29,0,35,6
1681915902395,POLI 113BR,A00,183576,Hoston; Germaine,27,0,50,23
1681915903418,POLI 114BR,A00,183588,Staff,27,0,30,3
1681915904441,POLI 117R,A00,183595,Forman; Fonna,9,0,20,11
1681915905467,POLI 120H,A00,183596,Fisk; David Lee,13,0,20,7
1681915906496,POLI 130AA,A00,183597,Staff,14,0,20,6
1681915907518,POLI 134AA,A00,183598,Staff,19,0,20,1
1681915908542,POLI 135,A00,183599,Fisk; David Lee,20,0,25,5
1681915909568,POLI 142P,A00,183623,Staff,37,0,40,3
1681915910595,POLI 144D,A00,183624,Staff,22,0,25,3
1681915911618,POLI 151,A00,183625,Staff,15,0,20,5
1681915912640,POLI 162,A00,183626,Mignozzetti; Umberto,18,0,20,2
1681915913661,PSYC 1,A00,253748,Staff,86,0,90,4
1681915914687,PSYC 2,A00,183627,Moranton; Nirelia Melbina-,25,0,35,10
1681915915713,PSYC 3,A00,183628,Staff,43,0,45,2
1681915917762,PSYC 60,A01,183631,Lowe; Angela Beth,35,0,40,5
1681915918786,PSYC 70,A01,253757,Staff,37,0,45,8
1681915919818,PSYC 101,A00,183632,Heyman; Gail D.,48,0,60,12
1681915920840,PSYC 105,A00,183848,Lowe; Angela Beth,50,0,60,10
1681915921874,PSYC 106,A00,183849,Dobkins; Karen R.,45,0,60,15
1681915922904,PSYC 108,A00,253750,Staff,24,0,60,36
1681915923927,PSYC 114,A01,184275,Winkielman; Piotr,0,6,30,30
1681915924949,PSYC 122,A00,183856,Moranton; Nirelia Melbina-,0,10,30,30
1681915925975,PSYC 124,A00,183865,Chapman; Eddie Nathaniel,52,0,80,28
1681915927000,PSYC 137,A00,183880,Staff,19,0,25,6
1681915929058,PSYC 154,A00,183910,Lacefield; Katharine I,0,2,90,90
1681915931107,PSYC 162,A00,183946,Wixted; John T,61,0,90,29
1681915932137,PSYC 172,A00,183947,Gorman; Michael R.,14,0,30,16
1681915933162,PSYC 178,A00,183963,Glaser; Dale,20,0,40,20
1681915934187,PSYC 181GS,A00,183964,Anagnostaras; Stephan,10,0,10,0
1681915935217,PSYC 186GS,A01,257660,Staff,10,0,10,0
1681915936244,PSYC 193,B00,253749,Staff,23,0,25,2
1681915938298,PSYC 193L,A01,184122,Staff,33,0,35,2
1681915938298,PSYC 193L,C01,184167,Winkielman; Piotr,16,0,30,14
1681915939323,RELI 188GS,A00,182629,Rahimi; Babak,20,0,20,0
1681915940350,SE 101A,A00,182646,Staff,26,0,30,4
1681915941376,SE 101C,A00,182650,Staff,18,0,20,2
1681915942398,SE 110A,A00,182651,Staff,28,0,28,0
1681915943425,SE 130A,A00,182652,Staff,39,0,40,1
1681915944449,SIO 46GS,A00,182636,Cook; Geoffrey W,28,0,28,0
1681915945476,SIO 109R,A00,194459,Staff,5,0,20,15
1681915946506,SIO 121GS,A00,182639,Cook; Geoffrey W,28,0,28,0
1681915947532,SIO 132,A01,182642,Staff,32,0,40,8
1681915948557,SIO 139,A00,182644,Kacev; David,36,0,40,4
1681915949656,SOCI 2,A01,258404,Staff,34,0,36,2
1681915949656,SOCI 2,A02,258405,Staff,35,0,36,1
1681915950683,SOCI 60,A01,258408,Staff,29,0,30,1
1681915950683,SOCI 60,A02,258413,Staff,30,0,30,0
1681915951716,SOCI 100,A01,258415,Staff,29,0,30,1
1681915951716,SOCI 100,A02,258416,Staff,28,0,30,2
1681915957893,SOCI 127,A00,258421,Staff,22,0,30,8
1681915958918,SOCI 132,A00,258422,Staff,45,0,50,5
1681915959949,SOCI 133,A00,258423,Staff,26,0,30,4
1681915960980,SOCI 138GS,A00,258424,Staff,15,0,15,0
1681915962005,SOCI 145,A00,258425,Staff,25,0,30,5
1681915963031,SOCI 148,A00,258426,Staff,26,0,30,4
1681915964057,SOCI 153,A00,199217,Staff,29,0,30,1
1681915965083,SOCI 160,A00,258427,Staff,28,0,30,2
1681915966110,SOCI 160E,A00,258435,Staff,56,0,60,4
1681915967137,SOCI 189GS,A00,258436,Staff,15,0,15,0
1681915968163,SOCI 190GS,A00,258437,Staff,15,0,15,0
1681915969189,SYN 2,001,182658,Staff,9,0,16,7
1681915969189,SYN 2,002,201439,Staff,15,0,16,1
1681915969189,SYN 2,003,201443,Staff,16,0,16,0
1681915970212,SYN 100,A01,182657,Staff,17,0,20,3
1681915971240,TDAC 1,A00,184381,Salovey; Todd,16,0,20,4
1681915971240,TDAC 1,B00,184385,Harting; Carla Kelso,19,0,20,1
1681915971240,TDAC 1,C00,184394,Staff,19,0,20,1
1681915972265,TDAC 101,A00,184483,Harting; Carla Kelso,19,0,20,1
1681915973289,TDDE 111,A00,184496,Staff,14,0,15,1
1681915974314,TDDE 131,A00,184504,Staff,20,0,20,0
1681915974314,TDDE 131,B00,184505,Staff,17,0,18,1
1681915974314,TDDE 131,C00,184534,Staff,49,0,50,1
1681915974314,TDDE 131,D00,184564,Staff,15,0,15,0
1681915974314,TDDE 131,E00,204725,Staff,19,0,20,1
1681915975349,TDGE 1,A01,184414,Salovey; Todd,37,0,50,13
1681915976375,TDGE 5,A01,184419,Staff,23,0,24,1
1681915977399,TDGE 10,A00,184428,Fulton; Julia,31,0,50,19
1681915978422,TDGE 124,A00,184565,Fulton; Julia,7,0,50,43
1681915979446,TDGE 125,B00,184567,Meyer; Ursula,9,0,25,16
1681915980470,TDHT 101,A00,184568,Staff,21,0,25,4
1681915980470,TDHT 101,B00,184569,Staff,20,0,20,0
1681915981497,TDHT 114,A00,184570,Staff,49,0,50,1
1681915982525,TDMV 1,A00,184437,Arcidiacono; Kristin,23,0,30,7
1681915982525,TDMV 1,B00,184448,Caligagan; Maria T.,22,0,30,8
1681915983549,TDMV 2,A00,184449,Weinberg; Sadie,27,0,30,3
1681915983549,TDMV 2,B00,184453,Arcidiacono; Kristin,29,0,30,1
1681915984573,TDMV 110,A00,184571,Weinberg; Sadie,30,0,30,0
1681915985600,TDMV 142,A00,184572,Caligagan; Tony,27,0,30,3
1681915985600,TDMV 142,B00,184573,Caligagan; Maria T.,27,0,30,3
1681915986637,TDTR 20,A00,184482,Jun; Grace Shin Hae,25,0,25,0
1681915987663,USP 2,A01,184290,Hinds; Juli Beth,24,0,25,1
1681915988688,USP 3,A01,184295,Staff,20,0,25,5
1681915989715,USP 4,A00,184304,McTague; Sarah,15,0,25,10
1681915990739,USP 100,A00,184315,Staff,17,0,25,8
1681915991762,USP 105,A00,184326,Staff,21,0,25,4
1681915992787,USP 151,A00,184327,Staff,20,0,25,5
1681915993813,USP 170,A00,184380,Hinds; Juli Beth,14,0,25,11
1681915994835,VIS 21B,A01,182660,Staff,28,0,31,3
1681915994835,VIS 21B,A02,182662,Staff,30,0,31,1
1681915995856,VIS 103D,A00,182663,Staff,74,0,75,1
1681915996879,VIS 105D,A00,182667,Li; Huai,15,0,22,7
1681915997907,VIS 122GS,A00,182668,Herbst; Matthew,20,0,20,0
1681915998934,VIS 128C,A00,182673,Staff,69,0,75,6
1681915999957,VIS 130,A00,182675,Staff,20,0,22,2
1681916000985,VIS 160A,A00,182678,Stalbaum; Brett,4,0,10,6
1681916003033,WCWP 10B,A00,201679,Staff,15,0,15,0
1681916003033,WCWP 10B,B00,201695,Staff,15,0,15,0
1681916004062,WCWP 100,A00,201716,Staff,15,0,15,0
1681916004062,WCWP 100,B00,201717,Staff,11,0,15,4
1681916006159,ANSC 105GS,A00,258289,Staff,0,0,0,0
1681916007184,ANSC 125GS,A00,258295,Staff,0,0,0,0
1681916008211,ANSC 150,A00,258267,Staff,30,0,40,10
1681916009242,ANSC 190GS,A00,258280,Staff,0,0,0,0
1681916010264,ANTH 1,A00,258264,Staff,38,0,40,2
1681916011286,ANTH 2,A01,258259,Staff,72,0,76,4
1681916012314,ANTH 23,A01,258228,Staff,36,0,40,4
1681916013346,ANTH 101,A01,258236,Staff,39,0,40,1
1681916014394,ANTH 102,A00,258272,Staff,59,0,60,1
1681916015421,ANTH 105,A00,258244,Staff,31,0,35,4
1681916016446,BENG 130,A00,253975,Staff,38,0,40,2
1681916017469,BIBC 102,A01,191866,Flagg; Matthew Paul,19,0,32,13
1681916017469,BIBC 102,A02,191867,Flagg; Matthew Paul,22,0,32,10
1681916017469,BIBC 102,A03,191868,Flagg; Matthew Paul,30,0,32,2
1681916017469,BIBC 102,A04,191936,Flagg; Matthew Paul,26,0,32,6
1681916017469,BIBC 102,A05,191937,Flagg; Matthew Paul,11,0,32,21
1681916018496,BICD 100,A01,191939,Cooper; Andrew Michael,28,0,32,4
1681916018496,BICD 100,A02,191940,Cooper; Andrew Michael,32,0,32,0
1681916018496,BICD 100,A03,191941,Cooper; Andrew Michael,32,0,32,0
1681916018496,BICD 100,A04,191942,Cooper; Andrew Michael,32,0,32,0
1681916018496,BICD 100,A05,191943,Cooper; Andrew Michael,32,0,32,0
1681916019522,BIEB 126,A01,191945,Cleland; Elsa Eleanor,1,0,32,31
1681916019522,BIEB 126,A02,191946,Cleland; Elsa Eleanor,28,0,32,4
1681916019522,BIEB 126,A03,191947,Cleland; Elsa Eleanor,29,0,32,3
1681916019522,BIEB 126,A04,191948,Cleland; Elsa Eleanor,23,0,32,9
1681916019522,BIEB 126,A05,191996,Cleland; Elsa Eleanor,28,0,32,4
1681916020545,BIEB 136GS,A00,191997,Shurin; Jonathan & Holway; David A.,0,0,0,0
1681916021567,BIEB 137GS,A01,191999,Shurin; Jonathan & Holway; David A.,0,0,0,0
1681916022589,BILD 1,A01,205385,Staff,31,0,32,1
1681916022589,BILD 1,A02,205386,Staff,30,0,32,2
1681916022589,BILD 1,A03,205387,Staff,32,0,32,0
1681916022589,BILD 1,A04,205388,Staff,28,0,32,4
1681916023623,BILD 2,A01,191774,Staff,28,0,32,4
1681916023623,BILD 2,A02,191775,Staff,30,0,32,2
1681916023623,BILD 2,A03,191777,Staff,30,0,32,2
1681916023623,BILD 2,A04,191856,Staff,31,0,32,1
1681916023623,BILD 2,A05,191857,Staff,32,0,32,0
1681916023623,BILD 2,A06,191858,Staff,32,0,32,0
1681916023623,BILD 2,A07,191859,Staff,31,0,32,1
1681916024646,BILD 3,A01,205391,Staff,29,0,32,3
1681916024646,BILD 3,A02,205393,Staff,32,0,32,0
1681916024646,BILD 3,A03,205394,Staff,28,0,32,4
1681916024646,BILD 3,A04,205395,Staff,32,0,32,0
1681916025672,BILD 20,A01,191861,Staff,32,0,32,0
1681916025672,BILD 20,A02,191862,Staff,32,0,32,0
1681916026694,BILD 30,A01,191864,Staff,31,0,32,1
1681916027722,BIMM 100,A01,192019,Staff,0,0,32,32
1681916027722,BIMM 100,A02,192020,Staff,23,0,32,9
1681916027722,BIMM 100,A03,192035,Staff,22,0,32,10
1681916028745,BIMM 110,A01,192037,Tat; John,0,0,32,32
1681916028745,BIMM 110,A02,192038,Tat; John,10,0,32,22
1681916029771,BIMM 120,A01,192040,Pickett; Brooke Elizabeth,2,0,32,30
1681916029771,BIMM 120,A02,192041,Pickett; Brooke Elizabeth,16,0,32,16
1681916029771,BIMM 120,A03,192042,Pickett; Brooke Elizabeth,16,0,32,16
1681916030798,BIPN 100,A01,192044,Armour; Jon Christopher,26,0,32,6
1681916030798,BIPN 100,A02,192059,Armour; Jon Christopher,30,0,32,2
1681916030798,BIPN 100,A03,192064,Armour; Jon Christopher,31,0,32,1
1681916030798,BIPN 100,A04,192073,Armour; Jon Christopher,28,0,32,4
1681916031822,BIPN 148,A01,205411,Leutgeb; Jill K.,16,0,32,16
1681916031822,BIPN 148,A02,205412,Leutgeb; Jill K.,31,0,32,1
1681916031822,BIPN 148,A03,205413,Leutgeb; Jill K.,30,0,32,2
1681916031822,BIPN 148,A04,205414,Leutgeb; Jill K.,30,0,32,2
1681916032852,BIPN 160,A01,192115,Marino; Marc J,19,0,32,13
1681916032852,BIPN 160,A02,192148,Marino; Marc J,27,0,32,5
1681916032852,BIPN 160,A03,192158,Marino; Marc J,31,0,32,1
1681916032852,BIPN 160,A04,192190,Marino; Marc J,32,0,32,0
1681916032852,BIPN 160,A05,192287,Marino; Marc J,32,0,32,0
1681916032852,BIPN 160,A06,192288,Marino; Marc J,32,0,32,0
1681916033880,BIPN 194,A00,206038,Staff,28,0,32,4
1681916034914,BISP 194,A00,192289,Leutgeb; Stefan,13,0,32,19
1681916034914,BISP 194,B00,245332,Nieh; James Charles,27,0,32,5
1681916035937,CAT 124,A01,202247,Staff,15,0,15,0
1681916036962,CAT 125,A00,202248,Staff,19,0,20,1
1681916036962,CAT 125,B00,202253,Staff,20,0,20,0
1681916036962,CAT 125,C00,202257,Staff,19,0,20,1
1681916037985,CAT 125GS,A01,202273,Bronstein; Phoebe Malan,20,0,20,0
1681916039017,CAT 125R,A00,202284,Staff,17,0,20,3
1681916039017,CAT 125R,C00,202286,Staff,10,0,20,10
1681916039017,CAT 125R,D00,202291,Staff,18,0,20,2
1681916039017,CAT 125R,E00,202295,Staff,13,0,20,7
1681916039017,CAT 125R,F00,202302,Staff,12,0,20,8
1681916040042,CENG 100,A00,204724,Opatkiewicz; Justin Paul,25,0,25,0
1681916041064,CGS 2A,A01,180420,Staff,31,0,36,5
1681916042091,CGS 101,A00,180421,Staff,16,0,20,4
1681916043116,CGS 112,A00,180422,Staff,10,0,16,6
1681916044151,CGS 113,A00,180423,Staff,18,0,20,2
1681916045175,CGS 137,A00,180424,Staff,12,0,12,0
1681916046204,CGS 147,A00,180425,Staff,10,0,10,0
1681916047230,CHEM 6A,A01,179556,Staff,97,0,100,3
1681916047230,CHEM 6A,A02,179558,Staff,0,0,0,0
1681916048257,CHEM 6B,A01,179560,Staff,100,0,100,0
1681916049285,CHEM 6C,A01,179565,Jazzar; Rodolphe,95,0,100,5
1681916050327,CHEM 7L,A01,179586,Schurmeier; Kimberly,13,0,24,11
1681916050327,CHEM 7L,A02,179587,Schurmeier; Kimberly,23,0,24,1
1681916050327,CHEM 7L,A03,179590,Schurmeier; Kimberly,22,0,24,2
1681916050327,CHEM 7L,A04,179591,Schurmeier; Kimberly,22,0,24,2
1681916050327,CHEM 7L,B01,179598,Schurmeier; Kimberly,17,0,24,7
1681916050327,CHEM 7L,B02,179599,Schurmeier; Kimberly,24,0,24,0
1681916050327,CHEM 7L,B03,179606,Schurmeier; Kimberly,23,0,24,1
1681916050327,CHEM 7L,B04,179607,Schurmeier; Kimberly,23,0,24,1
1681916051353,CHEM 11,A01,179609,Stallings; Dontarie M,88,0,100,12
1681916052380,CHEM 40A,A01,179621,Staff,41,0,50,9
1681916052380,CHEM 40A,A02,179622,Staff,47,0,50,3
1681916053477,CHEM 40B,A01,179630,Weizman; Haim,48,0,50,2
1681916053477,CHEM 40B,A02,179631,Weizman; Haim,45,0,50,5
1681916054503,CHEM 41A,A01,179660,Klosterman; Jeremy K,93,0,100,7
1681916055527,CHEM 43A,A01,179683,Klosterman; Jeremy K,0,0,24,24
1681916055527,CHEM 43A,A02,179688,Klosterman; Jeremy K,14,0,24,10
1681916055527,CHEM 43A,A03,179689,Klosterman; Jeremy K,20,0,24,4
1681916055527,CHEM 43A,A04,179691,Klosterman; Jeremy K,18,0,24,6
1681916056549,CHEM 114A,A01,179693,Stallings; Dontarie M,77,0,100,23
1681916057576,CHEM 143B,A01,179698,Weizman; Haim,17,0,24,7
1681916057576,CHEM 143B,A02,179700,Weizman; Haim,24,0,24,0
1681916058597,CHIN 169A,A00,179701,Wang; Xiao,20,0,20,0
1681916059628,COGS 2,A01,179750,Boyle; Mary E. T.,17,0,30,13
1681916060651,COGS 9,A01,179759,Jones; Cameron Robert,43,0,50,7
1681916061678,COGS 14A,A01,179854,Staff,18,0,50,32
1681916062701,COGS 14B,A01,179856,Staff,54,0,60,6
1681916063725,COGS 17,A01,179874,Staff,71,0,75,4
1681916064754,COGS 18,A01,179884,Staff,63,0,80,17
1681916065778,COGS 100,A01,179886,Staff,40,0,60,20
1681916066804,COGS 101B,A01,179892,Staff,1,0,30,29
1681916067826,COGS 101C,A01,179894,Staff,28,0,30,2
1681916068848,COGS 107A,A01,179896,Boyle; Mary E. T.,31,0,40,9
1681916069871,COGS 108,A01,179898,Simpkins; Charles Alexander,0,17,60,60
1681916070894,COGS 109,A01,179900,Staff,34,0,40,6
1681916071917,COGS 118A,A01,179946,Staff,9,0,40,31
1681916072941,COGS 153,A00,179978,Staff,1,0,30,29
1681916073964,COGS 156,A01,179981,Staff,27,0,30,3
1681916076018,COGS 172,A01,179987,Staff,13,0,30,17
1681916078067,COGS 186,A01,179991,Staff,13,0,30,17
1681916079090,COMM 10,A01,180001,Staff,15,0,25,10
1681916079090,COMM 10,A02,180004,Staff,20,0,25,5
1681916080117,COMM 100A,A01,180016,Staff,18,0,25,7
1681916080117,COMM 100A,A02,180020,Staff,24,0,25,1
1681916081145,COMM 101T,A00,180029,Halm; Gavin Patrick,23,0,35,12
1681916082166,COMM 106V,A00,180043,Staff,34,0,35,1
1681916083189,COMM 109P,A00,180044,Staff,31,0,35,4
1681916084212,COMM 113T,A00,180045,Havis; Allan,37,0,45,8
1681916085235,COMM 132,A00,180046,McKenna; Denise,23,0,30,7
1681916086257,COMM 143,A00,180047,Staff,19,0,30,11
1681916087280,COMM 190,A00,180048,Conner; Thomas Hartnell,20,0,23,3
1681916088304,CSE 8A,A50,180053,Cao; Yingjun,25,0,50,25
1681916088304,CSE 8A,B50,180180,Staff,50,0,50,0
1681916089327,CSE 11,A01,180190,Cao; Yingjun,31,0,50,19
1681916090354,CSE 20,A01,180192,Briones; Jor-el Thomas Caparas,23,0,30,7
1681916091379,CSE 21,A01,194538,Briones; Jor-el Thomas Caparas,50,0,60,10
1681916092402,CSE 30,A01,180324,Eldon; John,78,0,100,22
1681916093424,CSE 101,A01,201353,Staff,0,20,40,40
1681916094457,CSE 134B,A01,180326,Powell; Thomas Allan,74,0,100,26
1681916095481,CSE 140,A01,180328,Staff,46,0,75,29
1681916096504,CSE 140L,A01,180344,Eldon; John,69,0,100,31
1681916097530,CSE 150A,A01,180411,Staff,0,7,50,50
1681916098552,CSE 151A,A01,180414,Staff,0,6,50,50
1681916099577,CSE 175,A01,222521,Kumar; Rakesh,50,0,50,0
1681916100602,CSE 190,A00,201419,Staff,45,0,49,4
1681916101627,CSS 1,A01,194536,Staff,38,0,50,12
1681916102653,DSC 30,A01,202385,Staff,48,0,50,2
1681916103681,DSC 40A,A01,202387,Albuyeh; Rod,50,0,50,0
1681916104708,DSC 190,A01,202389,Silberman; Jack,21,0,21,0
1681916105731,DSGN 100,A01,179993,Staff,16,0,30,14
1681916106753,ECE 65,A50,180708,Staff,10,0,20,10
1681916106753,ECE 65,A51,180739,Staff,19,0,20,1
1681916107775,ECON 1,A01,180427,Famulari; Melissa,67,0,70,3
1681916108798,ECON 2,A01,180450,Levkoff; Steven B.,64,0,70,6
1681916109820,ECON 4,A01,203351,Anderson; John Charles,7,0,10,3
1681916110843,ECON 100A,A01,180472,Famulari; Melissa,65,0,70,5
1681916111874,ECON 120A,A01,180549,Staff,64,0,70,6
1681916112897,ECON 120B,A01,180655,Ma; Xinwei,46,0,70,24
1681916113919,ECON 129,A00,203333,Eckert; Fabian Paul,15,0,35,20
1681916114945,ECON 131,A00,180656,Staff,9,0,35,26
1681916115971,ECON 172B,A01,180672,Levkoff; Steven B.,32,0,35,3
1681916116994,ECON 178,A01,203342,Zhu; Ying,11,0,35,24
1681916118019,EDS 108GS,A00,202383,Wishard Guerra; Alison G.,20,0,20,0
1681916119046,EDS 111GS,A00,202347,Wishard Guerra; Alison G.,20,0,20,0
1681916120069,EDS 112,A01,202323,Staff,56,0,60,4
1681916121095,EDS 113,A00,202340,Staff,33,0,35,2
1681916122120,EDS 118,A00,201231,Staff,20,0,30,10
1681916123145,EDS 119,A00,204994,Staff,8,0,10,2
1681916124171,EDS 124BR,A00,202324,Eguchi; Emi,5,0,25,20
1681916125193,EDS 126,A01,203208,Jones; Makeba,26,0,30,4
1681916126222,EDS 135,A01,202333,Staff,18,0,20,2
1681916127251,EDS 180,A00,202311,Staff,47,0,50,3
1681916128273,ERC 190GS,A01,253747,Staff,28,0,28,0
1681916129299,ETHN 104,A00,180742,Staff,24,0,35,11
1681916130324,ETHN 118,A00,180745,Staff,28,0,35,7
1681916131347,ETHN 127,A00,180747,Staff,12,0,16,4
1681916132370,ETHN 137,A00,180880,Staff,12,0,12,0
1681916133392,ETHN 147,A00,180890,Staff,8,0,10,2
1681916134415,ETHN 154,A00,180891,Staff,7,0,8,1
1681916135441,ETHN 168,A00,180892,Staff,9,0,10,1
1681916136464,GLBH 20,A00,201051,Hannah; Seth Donal,0,1,0,1
1681916137491,GLBH 111,A01,209338,Burgos; Jose L.,0,0,0,0
1681916138512,GLBH 150,A00,258300,Staff,0,3,0,0
1681916139542,GLBH 181,A00,201207,Staff,15,0,40,25
1681916140564,HIEU 109,A00,180898,Staff,20,0,20,0
1681916141597,HIEU 111,A00,180899,Staff,1,0,20,19
1681916142623,HIEU 124,A00,180900,Staff,18,0,20,2
1681916143647,HILA 122,A00,180901,Staff,18,0,20,2
1681916144673,HILA 132,A00,180902,Vitz; Matthew,2,0,20,18
1681916145697,HILD 10,A01,180896,Staff,15,0,20,5
1681916146722,HILD 30GS,A00,180897,Edington; Claire Ellen,0,0,0,0
1681916147747,HISC 105,A00,180903,Staff,20,0,20,0
1681916148770,HISC 117,A00,180904,Staff,11,0,20,9
1681916149796,HIUS 108B,A00,181005,Staff,18,0,20,2
1681916150822,HIUS 113,A00,181093,Staff,4,0,20,16
1681916151845,HUM 3,A01,181190,Patterson; Patrick H.,40,0,50,10
1681916151845,HUM 3,B01,181195,Staff,46,0,50,4
1681916152870,HUM 3GS,A00,181196,Herbst; Matthew,0,0,0,0
1681916153894,HUM 4,A01,181227,West; Geoffrey Scott,34,0,50,16
1681916153894,HUM 4,B01,181282,Staff,43,0,50,7
1681916154919,HUM 4GS,A00,181377,Lyon; Antony J.,0,0,0,0
1681916155946,HUM 5,A01,181536,Zavodny; Tatiana Sophia,31,0,50,19
1681916155946,HUM 5,B01,181908,Staff,36,0,50,14
1681916157045,INTL 190,A00,181909,Segui; Alan S,0,0,0,6
1681916157045,INTL 190,B00,181961,Segui; Alan S,0,0,0,7
1681916158067,JAPN 20AR,A01,182113,Ross; Kayoko F,15,0,20,5
1681916159093,LATI 50,A01,202391,Martin-Cabrera; Luis,19,0,30,11
1681916159093,LATI 50,A02,202392,Martin-Cabrera; Luis,26,0,30,4
1681916160120,LATI 180,A00,202393,Kokinis; Troy Andreas,25,0,25,0
1681916161144,LIFR 1A,A00,182119,Staff,14,0,14,0
1681916162177,LIFR 1AX,A00,182324,Staff,14,0,14,0
1681916163199,LIFR 1B,A00,182259,Staff,14,0,14,0
1681916164226,LIFR 1BX,A00,182273,Staff,14,0,14,0
1681916165249,LIGN 8,A00,182330,Staff,137,0,150,13
1681916166270,LIGN 9GS,A00,182362,Staff,20,0,20,0
1681916167294,LIGN 119,A00,204992,Takahashi; Maho,12,0,15,3
1681916168317,LIGN 130,A01,182384,Staff,47,0,50,3
1681916169351,LIGN 149GS,A00,182390,Staff,20,0,20,0
1681916170383,LIGN 170,A00,182404,Staff,24,0,30,6
1681916171408,LISP 1D,A00,182281,Staff,7,0,14,7
1681916171408,LISP 1D,B00,182287,Staff,14,0,14,0
1681916171408,LISP 1D,C00,182295,Staff,11,0,14,3
1681916171408,LISP 1D,D00,182301,Staff,14,0,14,0
1681916172431,LISP 1DX,A00,182309,Staff,20,0,28,8
1681916172431,LISP 1DX,B00,182316,Staff,26,0,28,2
1681916173454,LTAF 120GS,A00,182412,Zhiri; Oumelbanine,20,0,20,0
1681916174481,LTCS 172GS,A00,182437,Bronstein; Phoebe Malan,20,0,20,0
1681916175507,LTEA 138,A00,182457,Staff,22,0,40,18
1681916176541,LTEN 114,A01,182490,Staff,23,0,25,2
1681916177564,LTEN 130GS,A00,182491,Lyon; Antony J.,20,0,20,0
1681916178590,LTEN 169,A00,182493,Cuong; Marisol,20,0,25,5
1681916179620,LTEN 178,A00,182501,Staff,14,0,15,1
1681916180646,LTEN 181,A00,182515,Staff,22,0,25,3
1681916181674,LTEN 185GS,A00,197655,Forbes; Camille,20,0,20,0
1681916182697,LTSP 100B,A00,202208,Bessett; Ryan Matthew,24,0,25,1
1681916183719,LTWL 100,A00,182516,Myerston Santana; Jacobo,22,0,30,8
1681916184746,LTWR 100GS,A00,182518,Forbes; Camille,20,0,20,0
1681916185769,LTWR 102,A00,182522,Staff,15,0,15,0
1681916185769,LTWR 102,B00,182525,Staff,14,0,15,1
1681916186791,LTWR 115,A00,182526,Staff,12,0,15,3
1681916187815,MAE 8,A01,182528,Pham; Hieu Tan,68,0,70,2
1681916188841,MAE 11,A00,182529,Bahadori; Mohammad Yousef,94,0,100,6
1681916189864,MAE 20,A00,182530,Evdokimenko; Ekaterina,68,0,70,2
1681916190887,MAE 30A,A00,182532,Staff,44,0,45,1
1681916191912,MAE 101A,A00,182533,Bahadori; Mohammad Yousef,97,0,100,3
1681916192938,MAE 101C,A00,182538,Staff,62,0,70,8
1681916193964,MAE 104,A00,182539,Staff,45,0,50,5
1681916194990,MAE 131A,A00,182540,Ghazinejad; Maziar,41,0,45,4
1681916196018,MAE 143A,A00,182548,Bewley; Thomas R,43,0,50,7
1681916197042,MAE 150,A00,182549,Staff,28,0,40,12
1681916198065,MAE 160,A00,182550,Evdokimenko; Ekaterina,43,0,60,17
1681916199095,MATH 3C,A01,182725,Staff,27,0,30,3
1681916200119,MATH 10A,A01,182729,Staff,25,0,30,5
1681916200119,MATH 10A,B01,182732,Staff,26,0,30,4
1681916201146,MATH 10B,A01,182737,Staff,21,0,30,9
1681916201146,MATH 10B,A02,182738,Staff,27,0,30,3
1681916201146,MATH 10B,B01,182744,Staff,27,0,30,3
1681916201146,MATH 10B,B02,182745,Staff,27,0,30,3
1681916202183,MATH 18,A01,182750,Anzaldo; Leesa B,28,0,30,2
1681916202183,MATH 18,A02,182751,Anzaldo; Leesa B,29,0,30,1
1681916202183,MATH 18,A03,182753,Anzaldo; Leesa B,28,0,30,2
1681916202183,MATH 18,A04,182757,Anzaldo; Leesa B,29,0,30,1
1681916202183,MATH 18,B01,182761,Anzaldo; Leesa B,27,0,30,3
1681916202183,MATH 18,B02,182764,Anzaldo; Leesa B,27,0,30,3
1681916202183,MATH 18,B03,182765,Anzaldo; Leesa B,30,0,30,0
1681916202183,MATH 18,B04,182766,Anzaldo; Leesa B,30,0,30,0
1681916203209,MATH 20A,A01,182771,Suk; Andrew Hoon,28,0,30,2
1681916204231,MATH 20B,A01,182775,Bach; Quang Tran,30,0,30,0
1681916204231,MATH 20B,A02,182777,Bach; Quang Tran,29,0,30,1
1681916204231,MATH 20B,B01,182780,Bach; Quang Tran,27,0,30,3
1681916204231,MATH 20B,B02,182782,Bach; Quang Tran,30,0,30,0
1681916205254,MATH 20C,A01,182787,Staff,25,0,30,5
1681916205254,MATH 20C,A02,182790,Staff,29,0,30,1
1681916205254,MATH 20C,B01,182792,Staff,25,0,30,5
1681916205254,MATH 20C,B02,182796,Staff,27,0,30,3
1681916206277,MATH 20D,A01,182799,Staff,29,0,30,1
1681916206277,MATH 20D,A02,182802,Staff,30,0,30,0
1681916206277,MATH 20D,A03,182803,Staff,30,0,30,0
1681916207303,MATH 20E,A01,182809,Verstraete; Jacques Allan,24,0,30,6
1681916207303,MATH 20E,A02,182811,Verstraete; Jacques Allan,28,0,30,2
1681916207303,MATH 20E,B01,182814,Verstraete; Jacques Allan,23,0,30,7
1681916207303,MATH 20E,B02,182815,Verstraete; Jacques Allan,30,0,30,0
1681916208327,MATH 103A,A01,182820,Staff,9,0,30,21
1681916208327,MATH 103A,A02,182821,Staff,27,0,30,3
1681916208327,MATH 103A,A03,182822,Staff,23,0,30,7
1681916208327,MATH 103A,B01,182825,Staff,23,0,30,7
1681916208327,MATH 103A,B02,182826,Staff,30,0,30,0
1681916208327,MATH 103A,B03,182830,Staff,30,0,30,0
1681916209351,MATH 109,A01,182836,Chow; Bennett,24,0,30,6
1681916209351,MATH 109,A02,182838,Chow; Bennett,29,0,30,1
1681916209351,MATH 109,A03,182894,Chow; Bennett,29,0,30,1
1681916209351,MATH 109,B01,182908,Chow; Bennett,28,0,30,2
1681916209351,MATH 109,B02,182909,Chow; Bennett,30,0,30,0
1681916209351,MATH 109,B03,182910,Chow; Bennett,27,0,30,3
1681916210377,MATH 142A,A01,182925,Staff,11,0,30,19
1681916210377,MATH 142A,A02,182935,Staff,24,0,30,6
1681916210377,MATH 142A,A03,182967,Staff,26,0,30,4
1681916210377,MATH 142A,B01,183125,Staff,24,0,30,6
1681916210377,MATH 142A,B02,183157,Staff,28,0,30,2
1681916210377,MATH 142A,B03,183158,Staff,29,0,30,1
1681916211403,MATH 183,A01,183160,Arias-Castro; Ery,23,0,30,7
1681916211403,MATH 183,A02,183161,Arias-Castro; Ery,29,0,30,1
1681916211403,MATH 183,B01,183163,Arias-Castro; Ery,28,0,30,2
1681916211403,MATH 183,B02,183164,Arias-Castro; Ery,28,0,30,2
1681916212426,MATH 193A,A01,183167,Staff,4,0,35,31
1681916212426,MATH 193A,A02,183168,Staff,28,0,35,7
1681916212426,MATH 193A,A03,183169,Staff,34,0,35,1
1681916212426,MATH 193A,A04,183170,Staff,28,0,35,7
1681916213452,MGT 4,A01,202395,Anderson; John Charles,75,0,80,5
1681916214479,MGT 5,A00,202396,Houskeeper; Robert,80,0,90,10
1681916215505,MGT 103,A00,202397,Eberhard; Craig A,55,0,90,35
1681916216534,MGT 131A,A00,202398,Houskeeper; Robert,85,0,90,5
1681916217560,MGT 135,A00,202399,Anderson; John Charles,82,0,90,8
1681916218582,MGT 162R,A00,202403,Gneezy; Uri,150,0,200,50
1681916219607,MGT 172,A00,202404,Hedges; Kathleen,50,0,90,40
1681916220637,MGT 181,A00,202405,Dunn; Louis Jean,84,0,90,6
1681916221663,MMW 14,A01,183200,Staff,16,0,28,12
1681916221663,MMW 14,A02,183201,Staff,26,0,28,2
1681916221663,MMW 14,A03,183202,Staff,24,0,28,4
1681916221663,MMW 14,A04,183203,Staff,25,0,28,3
1681916221663,MMW 14,A05,183204,Staff,26,0,28,2
1681916221663,MMW 14,A06,183205,Staff,27,0,28,1
1681916221663,MMW 14,B01,183207,Staff,26,0,28,2
1681916221663,MMW 14,B02,183208,Staff,28,0,28,0
1681916221663,MMW 14,B03,183209,Staff,28,0,28,0
1681916221663,MMW 14,B04,183210,Staff,28,0,28,0
1681916221663,MMW 14,B05,183211,Staff,28,0,28,0
1681916221663,MMW 14,B06,183212,Staff,28,0,28,0
1681916222685,MMW 14GS,A00,183213,Zhiri; Oumelbanine,28,0,28,0
1681916223710,MMW 15GS,B00,183215,Rahimi; Babak,28,0,28,0
1681916224732,MMW 121,A01,183217,Patterson; Patrick H.,14,0,28,14
1681916224732,MMW 121,A02,183218,Patterson; Patrick H.,25,0,28,3
1681916225760,MUS 1A,A01,182554,Staff,8,0,35,27
1681916226784,MUS 5,A01,182558,Staff,20,0,35,15
1681916227810,MUS 6,A01,182562,Staff,25,0,35,10
1681916228833,MUS 8GS,A00,182563,Borgo; David Garcia,25,0,25,0
1681916229857,MUS 13,A01,182567,Staff,24,0,25,1
1681916230879,MUS 15,A01,182570,Staff,32,0,35,3
1681916230879,MUS 15,B01,182575,Staff,10,0,35,25
1681916231905,MUS 80,A00,182578,Staff,23,0,25,2
1681916231905,MUS 80,B00,182581,Staff,20,0,25,5
1681916232927,MUS 113,A00,182582,Staff,25,0,25,0
1681916233950,MUS 114,A00,182583,Staff,4,0,25,21
1681916234976,MUS 150GS,A01,182588,Borgo; David Garcia,25,0,25,0
1681916235999,PHIL 1,A00,182590,Staff,35,0,40,5
1681916237031,PHIL 10,A01,182596,Grush; Rick Scott,31,0,35,4
1681916237031,PHIL 10,A02,182597,Grush; Rick Scott,34,0,35,1
1681916238054,PHIL 15,A01,182601,Staff,31,0,35,4
1681916238054,PHIL 15,A02,182602,Staff,33,0,35,2
1681916239078,PHIL 27,A01,182604,Staff,30,0,35,5
1681916239078,PHIL 27,A02,182607,Staff,35,0,35,0
1681916240101,PHIL 32,A01,182609,Staff,35,0,35,0
1681916240101,PHIL 32,A02,182612,Staff,35,0,35,0
1681916241123,PHIL 130,A00,182614,Staff,63,0,70,7
1681916242150,PHIL 136,A00,182616,Cohen; Jonathan David,66,0,70,4
1681916243181,PHIL 155,A00,182617,Vargas; Manuel Rogelio,60,0,70,10
1681916244204,PHIL 163,A01,182620,Staff,15,0,20,5
1681916244204,PHIL 163,A02,182624,Staff,10,0,20,10
1681916245234,PHIL 164,A00,182627,Staff,30,0,40,10
1681916246256,PHIL 173,A00,182628,Staff,36,0,40,4
1681916247279,PHYS 1A,A00,183221,Staff,54,0,60,6
1681916248305,PHYS 1AL,001,183222,Staff,25,0,30,5
1681916248305,PHYS 1AL,002,183223,Staff,28,0,30,2
1681916249326,PHYS 1B,A00,183231,Staff,44,0,60,16
1681916250347,PHYS 1BL,001,183232,Staff,20,0,30,10
1681916250347,PHYS 1BL,002,183233,Staff,29,0,30,1
1681916251375,PHYS 1C,A00,183240,Staff,30,0,60,30
1681916252402,PHYS 1CL,001,183241,Staff,13,0,30,17
1681916252402,PHYS 1CL,002,183242,Staff,22,0,30,8
1681916253424,PHYS 2AR,A01,183250,Staff,44,0,50,6
1681916254449,PHYS 2B,A01,183252,Staff,106,0,115,9
1681916255472,PHYS 2BL,A01,183254,Staff,21,0,24,3
1681916255472,PHYS 2BL,A02,183255,Staff,22,0,24,2
1681916256497,PHYS 2C,A01,183522,Staff,105,0,115,10
1681916257520,PHYS 4A,A01,183524,Staff,49,0,50,1
1681916258546,POLI 5,A00,183525,Staff,44,0,50,6
1681916259569,POLI 12,A00,183540,Staff,48,0,50,2
1681916260667,POLI 13R,A00,183541,Forman; Fonna,42,0,50,8
1681916261694,POLI 30,A00,183542,Mignozzetti; Umberto,47,0,50,3
1681916262717,POLI 100A,A00,183543,Staff,45,0,50,5
1681916263742,POLI 100E,A00,223598,Staff,32,0,35,3
1681916264765,POLI 103A,A00,183564,Kousser; Thad,38,0,50,12
1681916265791,POLI 104B,A00,201329,Staff,29,0,35,6
1681916266813,POLI 113BR,A00,183576,Hoston; Germaine,27,0,50,23
1681916267836,POLI 114BR,A00,183588,Staff,27,0,30,3
1681916268859,POLI 117R,A00,183595,Forman; Fonna,9,0,20,11
1681916269887,POLI 120H,A00,183596,Fisk; David Lee,13,0,20,7
1681916270913,POLI 130AA,A00,183597,Staff,14,0,20,6
1681916271944,POLI 134AA,A00,183598,Staff,19,0,20,1
1681916272971,POLI 135,A00,183599,Fisk; David Lee,20,0,25,5
1681916273997,POLI 142P,A00,183623,Staff,37,0,40,3
1681916275021,POLI 144D,A00,183624,Staff,22,0,25,3
1681916276044,POLI 151,A00,183625,Staff,15,0,20,5
1681916277068,POLI 162,A00,183626,Mignozzetti; Umberto,18,0,20,2
1681916278091,PSYC 1,A00,253748,Staff,86,0,90,4
1681916279113,PSYC 2,A00,183627,Moranton; Nirelia Melbina-,25,0,35,10
1681916280143,PSYC 3,A00,183628,Staff,43,0,45,2
1681916282197,PSYC 60,A01,183631,Lowe; Angela Beth,35,0,40,5
1681916283223,PSYC 70,A01,253757,Staff,37,0,45,8
1681916284250,PSYC 101,A00,183632,Heyman; Gail D.,48,0,60,12
1681916285285,PSYC 105,A00,183848,Lowe; Angela Beth,50,0,60,10
1681916286313,PSYC 106,A00,183849,Dobkins; Karen R.,45,0,60,15
1681916287335,PSYC 108,A00,253750,Staff,24,0,60,36
1681916288363,PSYC 114,A01,184275,Winkielman; Piotr,0,6,30,30
1681916289388,PSYC 122,A00,183856,Moranton; Nirelia Melbina-,0,10,30,30
1681916290411,PSYC 124,A00,183865,Chapman; Eddie Nathaniel,52,0,80,28
1681916291438,PSYC 137,A00,183880,Staff,19,0,25,6
1681916293487,PSYC 154,A00,183910,Lacefield; Katharine I,0,2,90,90
1681916295536,PSYC 162,A00,183946,Wixted; John T,61,0,90,29
1681916296563,PSYC 172,A00,183947,Gorman; Michael R.,14,0,30,16
1681916297590,PSYC 178,A00,183963,Glaser; Dale,20,0,40,20
1681916298613,PSYC 181GS,A00,183964,Anagnostaras; Stephan,10,0,10,0
1681916299638,PSYC 186GS,A01,257660,Staff,10,0,10,0
1681916300663,PSYC 193,B00,253749,Staff,23,0,25,2
1681916302710,PSYC 193L,A01,184122,Staff,33,0,35,2
1681916302710,PSYC 193L,C01,184167,Winkielman; Piotr,16,0,30,14
1681916303736,RELI 188GS,A00,182629,Rahimi; Babak,20,0,20,0
1681916304763,SE 101A,A00,182646,Staff,26,0,30,4
1681916305785,SE 101C,A00,182650,Staff,18,0,20,2
1681916306811,SE 110A,A00,182651,Staff,28,0,28,0
1681916307835,SE 130A,A00,182652,Staff,39,0,40,1
1681916308856,SIO 46GS,A00,182636,Cook; Geoffrey W,28,0,28,0
1681916309882,SIO 109R,A00,194459,Staff,5,0,20,15
1681916310912,SIO 121GS,A00,182639,Cook; Geoffrey W,28,0,28,0
1681916311940,SIO 132,A01,182642,Staff,32,0,40,8
1681916312966,SIO 139,A00,182644,Kacev; David,36,0,40,4
1681916313989,SOCI 2,A01,258404,Staff,34,0,36,2
1681916313989,SOCI 2,A02,258405,Staff,35,0,36,1
1681916315011,SOCI 60,A01,258408,Staff,29,0,30,1
1681916315011,SOCI 60,A02,258413,Staff,30,0,30,0
1681916316040,SOCI 100,A01,258415,Staff,29,0,30,1
1681916316040,SOCI 100,A02,258416,Staff,28,0,30,2
1681916322198,SOCI 127,A00,258421,Staff,22,0,30,8
1681916323221,SOCI 132,A00,258422,Staff,45,0,50,5
1681916324247,SOCI 133,A00,258423,Staff,26,0,30,4
1681916325272,SOCI 138GS,A00,258424,Staff,15,0,15,0
1681916326296,SOCI 145,A00,258425,Staff,25,0,30,5
1681916327321,SOCI 148,A00,258426,Staff,26,0,30,4
1681916328344,SOCI 153,A00,199217,Staff,29,0,30,1
1681916329366,SOCI 160,A00,258427,Staff,28,0,30,2
1681916330390,SOCI 160E,A00,258435,Staff,56,0,60,4
1681916331430,SOCI 189GS,A00,258436,Staff,15,0,15,0
1681916332452,SOCI 190GS,A00,258437,Staff,15,0,15,0
1681916333475,SYN 2,001,182658,Staff,9,0,16,7
1681916333475,SYN 2,002,201439,Staff,15,0,16,1
1681916333475,SYN 2,003,201443,Staff,16,0,16,0
1681916334498,SYN 100,A01,182657,Staff,17,0,20,3
1681916335520,TDAC 1,A00,184381,Salovey; Todd,16,0,20,4
1681916335520,TDAC 1,B00,184385,Harting; Carla Kelso,19,0,20,1
1681916335520,TDAC 1,C00,184394,Staff,19,0,20,1
1681916336542,TDAC 101,A00,184483,Harting; Carla Kelso,19,0,20,1
1681916337568,TDDE 111,A00,184496,Staff,14,0,15,1
1681916338595,TDDE 131,A00,184504,Staff,20,0,20,0
1681916338595,TDDE 131,B00,184505,Staff,17,0,18,1
1681916338595,TDDE 131,C00,184534,Staff,49,0,50,1
1681916338595,TDDE 131,D00,184564,Staff,15,0,15,0
1681916338595,TDDE 131,E00,204725,Staff,19,0,20,1
1681916339616,TDGE 1,A01,184414,Salovey; Todd,37,0,50,13
1681916340643,TDGE 5,A01,184419,Staff,23,0,24,1
1681916341669,TDGE 10,A00,184428,Fulton; Julia,31,0,50,19
1681916342694,TDGE 124,A00,184565,Fulton; Julia,7,0,50,43
1681916343716,TDGE 125,B00,184567,Meyer; Ursula,9,0,25,16
1681916344739,TDHT 101,A00,184568,Staff,21,0,25,4
1681916344739,TDHT 101,B00,184569,Staff,20,0,20,0
1681916345771,TDHT 114,A00,184570,Staff,49,0,50,1
1681916346797,TDMV 1,A00,184437,Arcidiacono; Kristin,23,0,30,7
1681916346797,TDMV 1,B00,184448,Caligagan; Maria T.,22,0,30,8
1681916347824,TDMV 2,A00,184449,Weinberg; Sadie,27,0,30,3
1681916347824,TDMV 2,B00,184453,Arcidiacono; Kristin,29,0,30,1
1681916348849,TDMV 110,A00,184571,Weinberg; Sadie,30,0,30,0
1681916349882,TDMV 142,A00,184572,Caligagan; Tony,27,0,30,3
1681916349882,TDMV 142,B00,184573,Caligagan; Maria T.,27,0,30,3
1681916350907,TDTR 20,A00,184482,Jun; Grace Shin Hae,25,0,25,0
1681916351930,USP 2,A01,184290,Hinds; Juli Beth,24,0,25,1
1681916352956,USP 3,A01,184295,Staff,20,0,25,5
1681916353978,USP 4,A00,184304,McTague; Sarah,15,0,25,10
1681916355009,USP 100,A00,184315,Staff,17,0,25,8
1681916356034,USP 105,A00,184326,Staff,21,0,25,4
1681916357058,USP 151,A00,184327,Staff,20,0,25,5
1681916358080,USP 170,A00,184380,Hinds; Juli Beth,14,0,25,11
1681916359103,VIS 21B,A01,182660,Staff,28,0,31,3
1681916359103,VIS 21B,A02,182662,Staff,30,0,31,1
1681916360129,VIS 103D,A00,182663,Staff,74,0,75,1
1681916361155,VIS 105D,A00,182667,Li; Huai,15,0,22,7
1681916362178,VIS 122GS,A00,182668,Herbst; Matthew,20,0,20,0
1681916363201,VIS 128C,A00,182673,Staff,69,0,75,6
1681916364299,VIS 130,A00,182675,Staff,20,0,22,2
1681916365324,VIS 160A,A00,182678,Stalbaum; Brett,4,0,10,6
1681916367371,WCWP 10B,A00,201679,Staff,15,0,15,0
1681916367371,WCWP 10B,B00,201695,Staff,15,0,15,0
1681916368401,WCWP 100,A00,201716,Staff,15,0,15,0
1681916368401,WCWP 100,B00,201717,Staff,11,0,15,4
1681916370474,ANSC 105GS,A00,258289,Staff,0,0,0,0
1681916371503,ANSC 125GS,A00,258295,Staff,0,0,0,0
1681916372528,ANSC 150,A00,258267,Staff,30,0,40,10
1681916373552,ANSC 190GS,A00,258280,Staff,0,0,0,0
1681916374577,ANTH 1,A00,258264,Staff,38,0,40,2
1681916375600,ANTH 2,A01,258259,Staff,72,0,76,4
1681916376626,ANTH 23,A01,258228,Staff,36,0,40,4
1681916377648,ANTH 101,A01,258236,Staff,39,0,40,1
1681916378676,ANTH 102,A00,258272,Staff,59,0,60,1
1681916379701,ANTH 105,A00,258244,Staff,31,0,35,4
1681916380726,BENG 130,A00,253975,Staff,38,0,40,2
1681916381753,BIBC 102,A01,191866,Flagg; Matthew Paul,19,0,32,13
1681916381753,BIBC 102,A02,191867,Flagg; Matthew Paul,22,0,32,10
1681916381753,BIBC 102,A03,191868,Flagg; Matthew Paul,30,0,32,2
1681916381753,BIBC 102,A04,191936,Flagg; Matthew Paul,26,0,32,6
1681916381753,BIBC 102,A05,191937,Flagg; Matthew Paul,11,0,32,21
1681916382774,BICD 100,A01,191939,Cooper; Andrew Michael,28,0,32,4
1681916382774,BICD 100,A02,191940,Cooper; Andrew Michael,32,0,32,0
1681916382774,BICD 100,A03,191941,Cooper; Andrew Michael,32,0,32,0
1681916382774,BICD 100,A04,191942,Cooper; Andrew Michael,32,0,32,0
1681916382774,BICD 100,A05,191943,Cooper; Andrew Michael,32,0,32,0
1681916383796,BIEB 126,A01,191945,Cleland; Elsa Eleanor,1,0,32,31
1681916383796,BIEB 126,A02,191946,Cleland; Elsa Eleanor,28,0,32,4
1681916383796,BIEB 126,A03,191947,Cleland; Elsa Eleanor,29,0,32,3
1681916383796,BIEB 126,A04,191948,Cleland; Elsa Eleanor,23,0,32,9
1681916383796,BIEB 126,A05,191996,Cleland; Elsa Eleanor,28,0,32,4
1681916384822,BIEB 136GS,A00,191997,Shurin; Jonathan & Holway; David A.,0,0,0,0
1681916385849,BIEB 137GS,A01,191999,Shurin; Jonathan & Holway; David A.,0,0,0,0
1681916386874,BILD 1,A01,205385,Staff,31,0,32,1
1681916386874,BILD 1,A02,205386,Staff,30,0,32,2
1681916386874,BILD 1,A03,205387,Staff,32,0,32,0
1681916386874,BILD 1,A04,205388,Staff,28,0,32,4
1681916387902,BILD 2,A01,191774,Staff,28,0,32,4
1681916387902,BILD 2,A02,191775,Staff,30,0,32,2
1681916387902,BILD 2,A03,191777,Staff,30,0,32,2
1681916387902,BILD 2,A04,191856,Staff,31,0,32,1
1681916387902,BILD 2,A05,191857,Staff,32,0,32,0
1681916387902,BILD 2,A06,191858,Staff,32,0,32,0
1681916387902,BILD 2,A07,191859,Staff,31,0,32,1
1681916388926,BILD 3,A01,205391,Staff,29,0,32,3
1681916388926,BILD 3,A02,205393,Staff,32,0,32,0
1681916388926,BILD 3,A03,205394,Staff,28,0,32,4
1681916388926,BILD 3,A04,205395,Staff,32,0,32,0
1681916389953,BILD 20,A01,191861,Staff,32,0,32,0
1681916389953,BILD 20,A02,191862,Staff,32,0,32,0
1681916390975,BILD 30,A01,191864,Staff,31,0,32,1
1681916391998,BIMM 100,A01,192019,Staff,0,0,32,32
1681916391998,BIMM 100,A02,192020,Staff,23,0,32,9
1681916391998,BIMM 100,A03,192035,Staff,22,0,32,10
1681916393025,BIMM 110,A01,192037,Tat; John,0,0,32,32
1681916393025,BIMM 110,A02,192038,Tat; John,10,0,32,22
1681916394047,BIMM 120,A01,192040,Pickett; Brooke Elizabeth,2,0,32,30
1681916394047,BIMM 120,A02,192041,Pickett; Brooke Elizabeth,16,0,32,16
1681916394047,BIMM 120,A03,192042,Pickett; Brooke Elizabeth,16,0,32,16
1681916395075,BIPN 100,A01,192044,Armour; Jon Christopher,26,0,32,6
1681916395075,BIPN 100,A02,192059,Armour; Jon Christopher,30,0,32,2
1681916395075,BIPN 100,A03,192064,Armour; Jon Christopher,31,0,32,1
1681916395075,BIPN 100,A04,192073,Armour; Jon Christopher,28,0,32,4
1681916396109,BIPN 148,A01,205411,Leutgeb; Jill K.,16,0,32,16
1681916396109,BIPN 148,A02,205412,Leutgeb; Jill K.,31,0,32,1
1681916396109,BIPN 148,A03,205413,Leutgeb; Jill K.,30,0,32,2
1681916396109,BIPN 148,A04,205414,Leutgeb; Jill K.,30,0,32,2
1681916397140,BIPN 160,A01,192115,Marino; Marc J,19,0,32,13
1681916397140,BIPN 160,A02,192148,Marino; Marc J,27,0,32,5
1681916397140,BIPN 160,A03,192158,Marino; Marc J,31,0,32,1
1681916397140,BIPN 160,A04,192190,Marino; Marc J,32,0,32,0
1681916397140,BIPN 160,A05,192287,Marino; Marc J,32,0,32,0
1681916397140,BIPN 160,A06,192288,Marino; Marc J,32,0,32,0
1681916398164,BIPN 194,A00,206038,Staff,28,0,32,4
1681916399199,BISP 194,A00,192289,Leutgeb; Stefan,13,0,32,19
1681916399199,BISP 194,B00,245332,Nieh; James Charles,27,0,32,5
1681916400229,CAT 124,A01,202247,Staff,15,0,15,0
1681916401255,CAT 125,A00,202248,Staff,19,0,20,1
1681916401255,CAT 125,B00,202253,Staff,20,0,20,0
1681916401255,CAT 125,C00,202257,Staff,19,0,20,1
1681916402278,CAT 125GS,A01,202273,Bronstein; Phoebe Malan,20,0,20,0
1681916403309,CAT 125R,A00,202284,Staff,17,0,20,3
1681916403309,CAT 125R,C00,202286,Staff,10,0,20,10
1681916403309,CAT 125R,D00,202291,Staff,18,0,20,2
1681916403309,CAT 125R,E00,202295,Staff,13,0,20,7
1681916403309,CAT 125R,F00,202302,Staff,12,0,20,8
1681916404331,CENG 100,A00,204724,Opatkiewicz; Justin Paul,25,0,25,0
1681916405361,CGS 2A,A01,180420,Staff,31,0,36,5
1681916406385,CGS 101,A00,180421,Staff,16,0,20,4
1681916407410,CGS 112,A00,180422,Staff,10,0,16,6
1681916408437,CGS 113,A00,180423,Staff,18,0,20,2
1681916409460,CGS 137,A00,180424,Staff,12,0,12,0
1681916410488,CGS 147,A00,180425,Staff,10,0,10,0
1681916411511,CHEM 6A,A01,179556,Staff,97,0,100,3
1681916411511,CHEM 6A,A02,179558,Staff,0,0,0,0
1681916412537,CHEM 6B,A01,179560,Staff,100,0,100,0
1681916413564,CHEM 6C,A01,179565,Jazzar; Rodolphe,95,0,100,5
1681916414589,CHEM 7L,A01,179586,Schurmeier; Kimberly,13,0,24,11
1681916414589,CHEM 7L,A02,179587,Schurmeier; Kimberly,23,0,24,1
1681916414589,CHEM 7L,A03,179590,Schurmeier; Kimberly,22,0,24,2
1681916414589,CHEM 7L,A04,179591,Schurmeier; Kimberly,22,0,24,2
1681916414589,CHEM 7L,B01,179598,Schurmeier; Kimberly,17,0,24,7
1681916414589,CHEM 7L,B02,179599,Schurmeier; Kimberly,24,0,24,0
1681916414589,CHEM 7L,B03,179606,Schurmeier; Kimberly,23,0,24,1
1681916414589,CHEM 7L,B04,179607,Schurmeier; Kimberly,23,0,24,1
1681916415613,CHEM 11,A01,179609,Stallings; Dontarie M,88,0,100,12
1681916416640,CHEM 40A,A01,179621,Staff,41,0,50,9
1681916416640,CHEM 40A,A02,179622,Staff,47,0,50,3
1681916417663,CHEM 40B,A01,179630,Weizman; Haim,48,0,50,2
1681916417663,CHEM 40B,A02,179631,Weizman; Haim,45,0,50,5
1681916418687,CHEM 41A,A01,179660,Klosterman; Jeremy K,93,0,100,7
1681916419711,CHEM 43A,A01,179683,Klosterman; Jeremy K,0,0,24,24
1681916419711,CHEM 43A,A02,179688,Klosterman; Jeremy K,14,0,24,10
1681916419711,CHEM 43A,A03,179689,Klosterman; Jeremy K,20,0,24,4
1681916419711,CHEM 43A,A04,179691,Klosterman; Jeremy K,18,0,24,6
1681916420734,CHEM 114A,A01,179693,Stallings; Dontarie M,77,0,100,23
1681916421757,CHEM 143B,A01,179698,Weizman; Haim,17,0,24,7
1681916421757,CHEM 143B,A02,179700,Weizman; Haim,24,0,24,0
1681916422779,CHIN 169A,A00,179701,Wang; Xiao,20,0,20,0
1681916423809,COGS 2,A01,179750,Boyle; Mary E. T.,17,0,30,13
1681916424839,COGS 9,A01,179759,Jones; Cameron Robert,43,0,50,7
1681916425876,COGS 14A,A01,179854,Staff,18,0,50,32
1681916426904,COGS 14B,A01,179856,Staff,54,0,60,6
1681916427927,COGS 17,A01,179874,Staff,71,0,75,4
1681916428950,COGS 18,A01,179884,Staff,63,0,80,17
1681916429975,COGS 100,A01,179886,Staff,40,0,60,20
1681916430999,COGS 101B,A01,179892,Staff,1,0,30,29
1681916432023,COGS 101C,A01,179894,Staff,28,0,30,2
1681916433048,COGS 107A,A01,179896,Boyle; Mary E. T.,31,0,40,9
1681916434070,COGS 108,A01,179898,Simpkins; Charles Alexander,0,17,60,60
1681916435097,COGS 109,A01,179900,Staff,34,0,40,6
1681916436121,COGS 118A,A01,179946,Staff,9,0,40,31
1681916437144,COGS 153,A00,179978,Staff,1,0,30,29
1681916438170,COGS 156,A01,179981,Staff,27,0,30,3
1681916440217,COGS 172,A01,179987,Staff,13,0,30,17
1681916442280,COGS 186,A01,179991,Staff,13,0,30,17
1681916443306,COMM 10,A01,180001,Staff,15,0,25,10
1681916443306,COMM 10,A02,180004,Staff,20,0,25,5
1681916444332,COMM 100A,A01,180016,Staff,18,0,25,7
1681916444332,COMM 100A,A02,180020,Staff,24,0,25,1
1681916445355,COMM 101T,A00,180029,Halm; Gavin Patrick,23,0,35,12
1681916446382,COMM 106V,A00,180043,Staff,34,0,35,1
1681916447408,COMM 109P,A00,180044,Staff,31,0,35,4
1681916448437,COMM 113T,A00,180045,Havis; Allan,37,0,45,8
1681916449464,COMM 132,A00,180046,McKenna; Denise,23,0,30,7
1681916450488,COMM 143,A00,180047,Staff,19,0,30,11
1681916451514,COMM 190,A00,180048,Conner; Thomas Hartnell,20,0,23,3
1681916452546,CSE 8A,A50,180053,Cao; Yingjun,25,0,50,25
1681916452546,CSE 8A,B50,180180,Staff,50,0,50,0
1681916453575,CSE 11,A01,180190,Cao; Yingjun,31,0,50,19
1681916454599,CSE 20,A01,180192,Briones; Jor-el Thomas Caparas,23,0,30,7
1681916455622,CSE 21,A01,194538,Briones; Jor-el Thomas Caparas,50,0,60,10
1681916456648,CSE 30,A01,180324,Eldon; John,78,0,100,22
1681916457680,CSE 101,A01,201353,Staff,0,20,40,40
1681916458703,CSE 134B,A01,180326,Powell; Thomas Allan,74,0,100,26
1681916459730,CSE 140,A01,180328,Staff,46,0,75,29
1681916460757,CSE 140L,A01,180344,Eldon; John,69,0,100,31
1681916461781,CSE 150A,A01,180411,Staff,0,7,50,50
1681916462805,CSE 151A,A01,180414,Staff,0,6,50,50
1681916463831,CSE 175,A01,222521,Kumar; Rakesh,50,0,50,0
1681916464854,CSE 190,A00,201419,Staff,45,0,49,4
1681916465878,CSS 1,A01,194536,Staff,38,0,50,12
1681916466901,DSC 30,A01,202385,Staff,48,0,50,2
1681916467997,DSC 40A,A01,202387,Albuyeh; Rod,50,0,50,0
1681916469024,DSC 190,A01,202389,Silberman; Jack,21,0,21,0
1681916470059,DSGN 100,A01,179993,Staff,16,0,30,14
1681916471085,ECE 65,A50,180708,Staff,10,0,20,10
1681916471085,ECE 65,A51,180739,Staff,19,0,20,1
1681916472108,ECON 1,A01,180427,Famulari; Melissa,67,0,70,3
1681916473209,ECON 2,A01,180450,Levkoff; Steven B.,64,0,70,6
1681916474244,ECON 4,A01,203351,Anderson; John Charles,7,0,10,3
1681916475272,ECON 100A,A01,180472,Famulari; Melissa,65,0,70,5
1681916476297,ECON 120A,A01,180549,Staff,64,0,70,6
1681916477322,ECON 120B,A01,180655,Ma; Xinwei,46,0,70,24
1681916478345,ECON 129,A00,203333,Eckert; Fabian Paul,15,0,35,20
1681916479370,ECON 131,A00,180656,Staff,8,0,35,27
1681916480401,ECON 172B,A01,180672,Levkoff; Steven B.,32,0,35,3
1681916481425,ECON 178,A01,203342,Zhu; Ying,10,0,35,25
1681916482448,EDS 108GS,A00,202383,Wishard Guerra; Alison G.,20,0,20,0
1681916483472,EDS 111GS,A00,202347,Wishard Guerra; Alison G.,20,0,20,0
1681916484496,EDS 112,A01,202323,Staff,56,0,60,4
1681916485522,EDS 113,A00,202340,Staff,33,0,35,2
1681916486545,EDS 118,A00,201231,Staff,20,0,30,10
1681916487568,EDS 119,A00,204994,Staff,8,0,10,2
1681916488590,EDS 124BR,A00,202324,Eguchi; Emi,4,0,25,21
1681916489612,EDS 126,A01,203208,Jones; Makeba,26,0,30,4
1681916490647,EDS 135,A01,202333,Staff,18,0,20,2
1681916491669,EDS 180,A00,202311,Staff,47,0,50,3
1681916492695,ERC 190GS,A01,253747,Staff,28,0,28,0
1681916493720,ETHN 104,A00,180742,Staff,24,0,35,11
1681916494745,ETHN 118,A00,180745,Staff,28,0,35,7
1681916495775,ETHN 127,A00,180747,Staff,12,0,16,4
1681916496797,ETHN 137,A00,180880,Staff,12,0,12,0
1681916497820,ETHN 147,A00,180890,Staff,8,0,10,2
1681916498846,ETHN 154,A00,180891,Staff,7,0,8,1
1681916499873,ETHN 168,A00,180892,Staff,9,0,10,1
1681916500896,GLBH 20,A00,201051,Hannah; Seth Donal,0,1,0,1
1681916501922,GLBH 111,A01,209338,Burgos; Jose L.,0,0,0,0
1681916502945,GLBH 150,A00,258300,Staff,0,3,0,0
1681916503973,GLBH 181,A00,201207,Staff,15,0,40,25
1681916504996,HIEU 109,A00,180898,Staff,20,0,20,0
1681916506018,HIEU 111,A00,180899,Staff,1,0,20,19
1681916507040,HIEU 124,A00,180900,Staff,18,0,20,2
1681916508065,HILA 122,A00,180901,Staff,18,0,20,2
1681916509087,HILA 132,A00,180902,Vitz; Matthew,2,0,20,18
1681916510110,HILD 10,A01,180896,Staff,15,0,20,5
1681916511136,HILD 30GS,A00,180897,Edington; Claire Ellen,0,0,0,0
1681916512159,HISC 105,A00,180903,Staff,20,0,20,0
1681916513182,HISC 117,A00,180904,Staff,11,0,20,9
1681916514205,HIUS 108B,A00,181005,Staff,18,0,20,2
1681916515230,HIUS 113,A00,181093,Staff,3,0,20,17
1681916516253,HUM 3,A01,181190,Patterson; Patrick H.,40,0,50,10
1681916516253,HUM 3,B01,181195,Staff,46,0,50,4
1681916517276,HUM 3GS,A00,181196,Herbst; Matthew,0,0,0,0
1681916518305,HUM 4,A01,181227,West; Geoffrey Scott,34,0,50,16
1681916518305,HUM 4,B01,181282,Staff,43,0,50,7
1681916519331,HUM 4GS,A00,181377,Lyon; Antony J.,0,0,0,0
1681916520356,HUM 5,A01,181536,Zavodny; Tatiana Sophia,31,0,50,19
1681916520356,HUM 5,B01,181908,Staff,36,0,50,14
1681916521382,INTL 190,A00,181909,Segui; Alan S,0,0,0,6
1681916521382,INTL 190,B00,181961,Segui; Alan S,0,0,0,7
1681916522406,JAPN 20AR,A01,182113,Ross; Kayoko F,15,0,20,5
1681916523433,LATI 50,A01,202391,Martin-Cabrera; Luis,19,0,30,11
1681916523433,LATI 50,A02,202392,Martin-Cabrera; Luis,26,0,30,4
1681916524457,LATI 180,A00,202393,Kokinis; Troy Andreas,25,0,25,0
1681916525482,LIFR 1A,A00,182119,Staff,14,0,14,0
1681916526510,LIFR 1AX,A00,182324,Staff,14,0,14,0
1681916527532,LIFR 1B,A00,182259,Staff,14,0,14,0
1681916528561,LIFR 1BX,A00,182273,Staff,14,0,14,0
1681916529586,LIGN 8,A00,182330,Staff,137,0,150,13
1681916530609,LIGN 9GS,A00,182362,Staff,20,0,20,0
1681916531633,LIGN 119,A00,204992,Takahashi; Maho,12,0,15,3
1681916532656,LIGN 130,A01,182384,Staff,47,0,50,3
1681916533681,LIGN 149GS,A00,182390,Staff,20,0,20,0
1681916534704,LIGN 170,A00,182404,Staff,24,0,30,6
1681916535727,LISP 1D,A00,182281,Staff,7,0,14,7
1681916535727,LISP 1D,B00,182287,Staff,14,0,14,0
1681916535727,LISP 1D,C00,182295,Staff,11,0,14,3
1681916535727,LISP 1D,D00,182301,Staff,14,0,14,0
1681916536753,LISP 1DX,A00,182309,Staff,20,0,28,8
1681916536753,LISP 1DX,B00,182316,Staff,26,0,28,2
1681916537779,LTAF 120GS,A00,182412,Zhiri; Oumelbanine,20,0,20,0
1681916538802,LTCS 172GS,A00,182437,Bronstein; Phoebe Malan,20,0,20,0
1681916539827,LTEA 138,A00,182457,Staff,21,0,40,19
1681916540850,LTEN 114,A01,182490,Staff,23,0,25,2
1681916541873,LTEN 130GS,A00,182491,Lyon; Antony J.,20,0,20,0
1681916542905,LTEN 169,A00,182493,Cuong; Marisol,20,0,25,5
1681916543928,LTEN 178,A00,182501,Staff,14,0,15,1
1681916544952,LTEN 181,A00,182515,Staff,22,0,25,3
1681916545975,LTEN 185GS,A00,197655,Forbes; Camille,20,0,20,0
1681916547005,LTSP 100B,A00,202208,Bessett; Ryan Matthew,24,0,25,1
1681916548028,LTWL 100,A00,182516,Myerston Santana; Jacobo,22,0,30,8
1681916549054,LTWR 100GS,A00,182518,Forbes; Camille,20,0,20,0
1681916550084,LTWR 102,A00,182522,Staff,15,0,15,0
1681916550084,LTWR 102,B00,182525,Staff,14,0,15,1
1681916551110,LTWR 115,A00,182526,Staff,12,0,15,3
1681916552141,MAE 8,A01,182528,Pham; Hieu Tan,68,0,70,2
1681916553163,MAE 11,A00,182529,Bahadori; Mohammad Yousef,94,0,100,6
1681916554197,MAE 20,A00,182530,Evdokimenko; Ekaterina,68,0,70,2
1681916555220,MAE 30A,A00,182532,Staff,44,0,45,1
1681916556245,MAE 101A,A00,182533,Bahadori; Mohammad Yousef,97,0,100,3
1681916557268,MAE 101C,A00,182538,Staff,62,0,70,8
1681916558290,MAE 104,A00,182539,Staff,45,0,50,5
1681916559313,MAE 131A,A00,182540,Ghazinejad; Maziar,41,0,45,4
1681916560336,MAE 143A,A00,182548,Bewley; Thomas R,43,0,50,7
1681916561363,MAE 150,A00,182549,Staff,28,0,40,12
1681916562386,MAE 160,A00,182550,Evdokimenko; Ekaterina,43,0,60,17
1681916563412,MATH 3C,A01,182725,Staff,27,0,30,3
1681916564437,MATH 10A,A01,182729,Staff,25,0,30,5
1681916564437,MATH 10A,B01,182732,Staff,26,0,30,4
1681916565460,MATH 10B,A01,182737,Staff,21,0,30,9
1681916565460,MATH 10B,A02,182738,Staff,27,0,30,3
1681916565460,MATH 10B,B01,182744,Staff,27,0,30,3
1681916565460,MATH 10B,B02,182745,Staff,27,0,30,3
1681916566484,MATH 18,A01,182750,Anzaldo; Leesa B,28,0,30,2
1681916566484,MATH 18,A02,182751,Anzaldo; Leesa B,29,0,30,1
1681916566484,MATH 18,A03,182753,Anzaldo; Leesa B,28,0,30,2
1681916566484,MATH 18,A04,182757,Anzaldo; Leesa B,29,0,30,1
1681916566484,MATH 18,B01,182761,Anzaldo; Leesa B,27,0,30,3
1681916566484,MATH 18,B02,182764,Anzaldo; Leesa B,27,0,30,3
1681916566484,MATH 18,B03,182765,Anzaldo; Leesa B,30,0,30,0
1681916566484,MATH 18,B04,182766,Anzaldo; Leesa B,30,0,30,0
1681916567506,MATH 20A,A01,182771,Suk; Andrew Hoon,28,0,30,2
1681916568532,MATH 20B,A01,182775,Bach; Quang Tran,30,0,30,0
1681916568532,MATH 20B,A02,182777,Bach; Quang Tran,29,0,30,1
1681916568532,MATH 20B,B01,182780,Bach; Quang Tran,27,0,30,3
1681916568532,MATH 20B,B02,182782,Bach; Quang Tran,30,0,30,0
1681916569556,MATH 20C,A01,182787,Staff,25,0,30,5
1681916569556,MATH 20C,A02,182790,Staff,29,0,30,1
1681916569556,MATH 20C,B01,182792,Staff,25,0,30,5
1681916569556,MATH 20C,B02,182796,Staff,27,0,30,3
1681916570579,MATH 20D,A01,182799,Staff,29,0,30,1
1681916570579,MATH 20D,A02,182802,Staff,30,0,30,0
1681916570579,MATH 20D,A03,182803,Staff,30,0,30,0
1681916571698,MATH 20E,A01,182809,Verstraete; Jacques Allan,24,0,30,6
1681916571698,MATH 20E,A02,182811,Verstraete; Jacques Allan,28,0,30,2
1681916571698,MATH 20E,B01,182814,Verstraete; Jacques Allan,23,0,30,7
1681916571698,MATH 20E,B02,182815,Verstraete; Jacques Allan,30,0,30,0
1681916572727,MATH 103A,A01,182820,Staff,9,0,30,21
1681916572727,MATH 103A,A02,182821,Staff,27,0,30,3
1681916572727,MATH 103A,A03,182822,Staff,23,0,30,7
1681916572727,MATH 103A,B01,182825,Staff,23,0,30,7
1681916572727,MATH 103A,B02,182826,Staff,30,0,30,0
1681916572727,MATH 103A,B03,182830,Staff,30,0,30,0
1681916573751,MATH 109,A01,182836,Chow; Bennett,24,0,30,6
1681916573751,MATH 109,A02,182838,Chow; Bennett,29,0,30,1
1681916573751,MATH 109,A03,182894,Chow; Bennett,29,0,30,1
1681916573751,MATH 109,B01,182908,Chow; Bennett,28,0,30,2
1681916573751,MATH 109,B02,182909,Chow; Bennett,30,0,30,0
1681916573751,MATH 109,B03,182910,Chow; Bennett,27,0,30,3
1681916574788,MATH 142A,A01,182925,Staff,11,0,30,19
1681916574788,MATH 142A,A02,182935,Staff,24,0,30,6
1681916574788,MATH 142A,A03,182967,Staff,26,0,30,4
1681916574788,MATH 142A,B01,183125,Staff,24,0,30,6
1681916574788,MATH 142A,B02,183157,Staff,28,0,30,2
1681916574788,MATH 142A,B03,183158,Staff,29,0,30,1
1681916575816,MATH 183,A01,183160,Arias-Castro; Ery,23,0,30,7
1681916575816,MATH 183,A02,183161,Arias-Castro; Ery,29,0,30,1
1681916575816,MATH 183,B01,183163,Arias-Castro; Ery,28,0,30,2
1681916575816,MATH 183,B02,183164,Arias-Castro; Ery,28,0,30,2
1681916576844,MATH 193A,A01,183167,Staff,4,0,35,31
1681916576844,MATH 193A,A02,183168,Staff,28,0,35,7
1681916576844,MATH 193A,A03,183169,Staff,34,0,35,1
1681916576844,MATH 193A,A04,183170,Staff,28,0,35,7
1681916577867,MGT 4,A01,202395,Anderson; John Charles,75,0,80,5
1681916578892,MGT 5,A00,202396,Houskeeper; Robert,80,0,90,10
1681916579919,MGT 103,A00,202397,Eberhard; Craig A,55,0,90,35
1681916580950,MGT 131A,A00,202398,Houskeeper; Robert,85,0,90,5
1681916581974,MGT 135,A00,202399,Anderson; John Charles,82,0,90,8
1681916582999,MGT 162R,A00,202403,Gneezy; Uri,150,0,200,50
1681916584021,MGT 172,A00,202404,Hedges; Kathleen,50,0,90,40
1681916585043,MGT 181,A00,202405,Dunn; Louis Jean,84,0,90,6
1681916586067,MMW 14,A01,183200,Staff,15,0,28,13
1681916586067,MMW 14,A02,183201,Staff,26,0,28,2
1681916586067,MMW 14,A03,183202,Staff,24,0,28,4
1681916586067,MMW 14,A04,183203,Staff,25,0,28,3
1681916586067,MMW 14,A05,183204,Staff,26,0,28,2
1681916586067,MMW 14,A06,183205,Staff,27,0,28,1
1681916586067,MMW 14,B01,183207,Staff,26,0,28,2
1681916586067,MMW 14,B02,183208,Staff,28,0,28,0
1681916586067,MMW 14,B03,183209,Staff,28,0,28,0
1681916586067,MMW 14,B04,183210,Staff,28,0,28,0
1681916586067,MMW 14,B05,183211,Staff,28,0,28,0
1681916586067,MMW 14,B06,183212,Staff,28,0,28,0
1681916587093,MMW 14GS,A00,183213,Zhiri; Oumelbanine,28,0,28,0
1681916588118,MMW 15GS,B00,183215,Rahimi; Babak,28,0,28,0
1681916589141,MMW 121,A01,183217,Patterson; Patrick H.,14,0,28,14
1681916589141,MMW 121,A02,183218,Patterson; Patrick H.,25,0,28,3
1681916590167,MUS 1A,A01,182554,Staff,8,0,35,27
1681916591189,MUS 5,A01,182558,Staff,20,0,35,15
1681916592213,MUS 6,A01,182562,Staff,25,0,35,10
1681916593236,MUS 8GS,A00,182563,Borgo; David Garcia,25,0,25,0
1681916594258,MUS 13,A01,182567,Staff,24,0,25,1
1681916595286,MUS 15,A01,182570,Staff,32,0,35,3
1681916595286,MUS 15,B01,182575,Staff,10,0,35,25
1681916596309,MUS 80,A00,182578,Staff,23,0,25,2
1681916596309,MUS 80,B00,182581,Staff,20,0,25,5
1681916597335,MUS 113,A00,182582,Staff,25,0,25,0
1681916598873,MUS 114,A00,182583,Staff,4,0,25,21
1681916599896,MUS 150GS,A01,182588,Borgo; David Garcia,25,0,25,0
1681916600926,PHIL 1,A00,182590,Staff,35,0,40,5
1681916601948,PHIL 10,A01,182596,Grush; Rick Scott,31,0,35,4
1681916601948,PHIL 10,A02,182597,Grush; Rick Scott,34,0,35,1
1681916602970,PHIL 15,A01,182601,Staff,31,0,35,4
1681916602970,PHIL 15,A02,182602,Staff,33,0,35,2
1681916603993,PHIL 27,A01,182604,Staff,30,0,35,5
1681916603993,PHIL 27,A02,182607,Staff,35,0,35,0
1681916605019,PHIL 32,A01,182609,Staff,35,0,35,0
1681916605019,PHIL 32,A02,182612,Staff,35,0,35,0
1681916606044,PHIL 130,A00,182614,Staff,63,0,70,7
1681916607072,PHIL 136,A00,182616,Cohen; Jonathan David,66,0,70,4
1681916608096,PHIL 155,A00,182617,Vargas; Manuel Rogelio,60,0,70,10
1681916609125,PHIL 163,A01,182620,Staff,15,0,20,5
1681916609125,PHIL 163,A02,182624,Staff,10,0,20,10
1681916610148,PHIL 164,A00,182627,Staff,30,0,40,10
1681916611171,PHIL 173,A00,182628,Staff,36,0,40,4
1681916612196,PHYS 1A,A00,183221,Staff,54,0,60,6
1681916613225,PHYS 1AL,001,183222,Staff,25,0,30,5
1681916613225,PHYS 1AL,002,183223,Staff,28,0,30,2
1681916614248,PHYS 1B,A00,183231,Staff,43,0,60,17
1681916615271,PHYS 1BL,001,183232,Staff,20,0,30,10
1681916615271,PHYS 1BL,002,183233,Staff,28,0,30,2
1681916616293,PHYS 1C,A00,183240,Staff,30,0,60,30
1681916617316,PHYS 1CL,001,183241,Staff,13,0,30,17
1681916617316,PHYS 1CL,002,183242,Staff,22,0,30,8
1681916618338,PHYS 2AR,A01,183250,Staff,44,0,50,6
1681916619361,PHYS 2B,A01,183252,Staff,106,0,115,9
1681916620384,PHYS 2BL,A01,183254,Staff,21,0,24,3
1681916620384,PHYS 2BL,A02,183255,Staff,22,0,24,2
1681916621411,PHYS 2C,A01,183522,Staff,105,0,115,10
1681916622436,PHYS 4A,A01,183524,Staff,49,0,50,1
1681916623459,POLI 5,A00,183525,Staff,44,0,50,6
1681916624485,POLI 12,A00,183540,Staff,48,0,50,2
1681916625517,POLI 13R,A00,183541,Forman; Fonna,42,0,50,8
1681916626541,POLI 30,A00,183542,Mignozzetti; Umberto,47,0,50,3
1681916627567,POLI 100A,A00,183543,Staff,45,0,50,5
1681916628593,POLI 100E,A00,223598,Staff,32,0,35,3
1681916629618,POLI 103A,A00,183564,Kousser; Thad,38,0,50,12
1681916630653,POLI 104B,A00,201329,Staff,29,0,35,6
1681916631678,POLI 113BR,A00,183576,Hoston; Germaine,26,0,50,24
1681916632707,POLI 114BR,A00,183588,Staff,27,0,30,3
1681916633734,POLI 117R,A00,183595,Forman; Fonna,9,0,20,11
1681916634756,POLI 120H,A00,183596,Fisk; David Lee,13,0,20,7
1681916635778,POLI 130AA,A00,183597,Staff,14,0,20,6
1681916636807,POLI 134AA,A00,183598,Staff,19,0,20,1
1681916637832,POLI 135,A00,183599,Fisk; David Lee,20,0,25,5
1681916638854,POLI 142P,A00,183623,Staff,37,0,40,3
1681916639878,POLI 144D,A00,183624,Staff,22,0,25,3
1681916640907,POLI 151,A00,183625,Staff,15,0,20,5
1681916641929,POLI 162,A00,183626,Mignozzetti; Umberto,18,0,20,2
1681916642955,PSYC 1,A00,253748,Staff,86,0,90,4
1681916643976,PSYC 2,A00,183627,Moranton; Nirelia Melbina-,25,0,35,10
1681916644998,PSYC 3,A00,183628,Staff,43,0,45,2
1681916647063,PSYC 60,A01,183631,Lowe; Angela Beth,35,0,40,5
1681916648088,PSYC 70,A01,253757,Staff,37,0,45,8
1681916649114,PSYC 101,A00,183632,Heyman; Gail D.,48,0,60,12
1681916650136,PSYC 105,A00,183848,Lowe; Angela Beth,49,0,60,11
1681916651163,PSYC 106,A00,183849,Dobkins; Karen R.,44,0,60,16
1681916652189,PSYC 108,A00,253750,Staff,24,0,60,36
1681916653221,PSYC 114,A01,184275,Winkielman; Piotr,0,6,30,30
1681916654322,PSYC 122,A00,183856,Moranton; Nirelia Melbina-,0,10,30,30
1681916655345,PSYC 124,A00,183865,Chapman; Eddie Nathaniel,52,0,80,28
1681916656367,PSYC 137,A00,183880,Staff,19,0,25,6
1681916658417,PSYC 154,A00,183910,Lacefield; Katharine I,0,2,90,90
1681916660462,PSYC 162,A00,183946,Wixted; John T,61,0,90,29
1681916661487,PSYC 172,A00,183947,Gorman; Michael R.,13,0,30,17
1681916662517,PSYC 178,A00,183963,Glaser; Dale,20,0,40,20
1681916663542,PSYC 181GS,A00,183964,Anagnostaras; Stephan,10,0,10,0
1681916664573,PSYC 186GS,A01,257660,Staff,10,0,10,0
1681916665604,PSYC 193,B00,253749,Staff,23,0,25,2
1681916667654,PSYC 193L,A01,184122,Staff,33,0,35,2
1681916667654,PSYC 193L,C01,184167,Winkielman; Piotr,16,0,30,14
1681916668688,RELI 188GS,A00,182629,Rahimi; Babak,20,0,20,0
1681916669710,SE 101A,A00,182646,Staff,26,0,30,4
1681916670736,SE 101C,A00,182650,Staff,18,0,20,2
1681916671762,SE 110A,A00,182651,Staff,28,0,28,0
1681916672789,SE 130A,A00,182652,Staff,39,0,40,1
1681916673814,SIO 46GS,A00,182636,Cook; Geoffrey W,28,0,28,0
1681916674838,SIO 109R,A00,194459,Staff,5,0,20,15
1681916675942,SIO 121GS,A00,182639,Cook; Geoffrey W,28,0,28,0
1681916676965,SIO 132,A01,182642,Staff,32,0,40,8
1681916677989,SIO 139,A00,182644,Kacev; David,36,0,40,4
1681916679015,SOCI 2,A01,258404,Staff,34,0,36,2
1681916679015,SOCI 2,A02,258405,Staff,35,0,36,1
1681916680038,SOCI 60,A01,258408,Staff,29,0,30,1
1681916680038,SOCI 60,A02,258413,Staff,30,0,30,0
1681916681061,SOCI 100,A01,258415,Staff,29,0,30,1
1681916681061,SOCI 100,A02,258416,Staff,28,0,30,2
1681916687214,SOCI 127,A00,258421,Staff,22,0,30,8
1681916688237,SOCI 132,A00,258422,Staff,45,0,50,5
1681916689262,SOCI 133,A00,258423,Staff,26,0,30,4
1681916690285,SOCI 138GS,A00,258424,Staff,15,0,15,0
1681916691307,SOCI 145,A00,258425,Staff,25,0,30,5
1681916692333,SOCI 148,A00,258426,Staff,26,0,30,4
1681916693359,SOCI 153,A00,199217,Staff,29,0,30,1
1681916694383,SOCI 160,A00,258427,Staff,28,0,30,2
1681916695408,SOCI 160E,A00,258435,Staff,56,0,60,4
1681916696430,SOCI 189GS,A00,258436,Staff,15,0,15,0
1681916697454,SOCI 190GS,A00,258437,Staff,15,0,15,0
1681916698481,SYN 2,001,182658,Staff,9,0,16,7
1681916698481,SYN 2,002,201439,Staff,15,0,16,1
1681916698481,SYN 2,003,201443,Staff,16,0,16,0
1681916699504,SYN 100,A01,182657,Staff,17,0,20,3
1681916700531,TDAC 1,A00,184381,Salovey; Todd,16,0,20,4
1681916700531,TDAC 1,B00,184385,Harting; Carla Kelso,19,0,20,1
1681916700531,TDAC 1,C00,184394,Staff,19,0,20,1
1681916701561,TDAC 101,A00,184483,Harting; Carla Kelso,19,0,20,1
1681916702582,TDDE 111,A00,184496,Staff,14,0,15,1
1681916703610,TDDE 131,A00,184504,Staff,20,0,20,0
1681916703610,TDDE 131,B00,184505,Staff,17,0,18,1
1681916703610,TDDE 131,C00,184534,Staff,49,0,50,1
1681916703610,TDDE 131,D00,184564,Staff,15,0,15,0
1681916703610,TDDE 131,E00,204725,Staff,19,0,20,1
1681916704636,TDGE 1,A01,184414,Salovey; Todd,37,0,50,13
1681916705659,TDGE 5,A01,184419,Staff,23,0,24,1
1681916706684,TDGE 10,A00,184428,Fulton; Julia,31,0,50,19
1681916707709,TDGE 124,A00,184565,Fulton; Julia,7,0,50,43
1681916708749,TDGE 125,B00,184567,Meyer; Ursula,9,0,25,16
1681916709775,TDHT 101,A00,184568,Staff,21,0,25,4
1681916709775,TDHT 101,B00,184569,Staff,20,0,20,0
1681916710799,TDHT 114,A00,184570,Staff,49,0,50,1
1681916711822,TDMV 1,A00,184437,Arcidiacono; Kristin,23,0,30,7
1681916711822,TDMV 1,B00,184448,Caligagan; Maria T.,22,0,30,8
1681916712854,TDMV 2,A00,184449,Weinberg; Sadie,27,0,30,3
1681916712854,TDMV 2,B00,184453,Arcidiacono; Kristin,29,0,30,1
1681916713880,TDMV 110,A00,184571,Weinberg; Sadie,30,0,30,0
1681916714905,TDMV 142,A00,184572,Caligagan; Tony,27,0,30,3
1681916714905,TDMV 142,B00,184573,Caligagan; Maria T.,27,0,30,3
1681916715928,TDTR 20,A00,184482,Jun; Grace Shin Hae,25,0,25,0
1681916716952,USP 2,A01,184290,Hinds; Juli Beth,24,0,25,1
1681916717982,USP 3,A01,184295,Staff,20,0,25,5
1681916719006,USP 4,A00,184304,McTague; Sarah,15,0,25,10
1681916720029,USP 100,A00,184315,Staff,17,0,25,8
1681916721052,USP 105,A00,184326,Staff,21,0,25,4
1681916722076,USP 151,A00,184327,Staff,20,0,25,5
1681916723099,USP 170,A00,184380,Hinds; Juli Beth,14,0,25,11
1681916724122,VIS 21B,A01,182660,Staff,28,0,31,3
1681916724122,VIS 21B,A02,182662,Staff,30,0,31,1
1681916725146,VIS 103D,A00,182663,Staff,74,0,75,1
1681916726170,VIS 105D,A00,182667,Li; Huai,15,0,22,7
1681916727192,VIS 122GS,A00,182668,Herbst; Matthew,20,0,20,0
1681916728214,VIS 128C,A00,182673,Staff,69,0,75,6
1681916729239,VIS 130,A00,182675,Staff,20,0,22,2
1681916730262,VIS 160A,A00,182678,Stalbaum; Brett,4,0,10,6
1681916732308,WCWP 10B,A00,201679,Staff,15,0,15,0
1681916732308,WCWP 10B,B00,201695,Staff,15,0,15,0
1681916733332,WCWP 100,A00,201716,Staff,15,0,15,0
1681916733332,WCWP 100,B00,201717,Staff,11,0,15,4
1681916735391,ANSC 105GS,A00,258289,Staff,0,0,0,0
1681916736416,ANSC 125GS,A00,258295,Staff,0,0,0,0
1681916737438,ANSC 150,A00,258267,Staff,30,0,40,10
1681916738461,ANSC 190GS,A00,258280,Staff,0,0,0,0
1681916739487,ANTH 1,A00,258264,Staff,38,0,40,2
1681916740512,ANTH 2,A01,258259,Staff,72,0,76,4
1681916741536,ANTH 23,A01,258228,Staff,36,0,40,4
1681916742560,ANTH 101,A01,258236,Staff,39,0,40,1
1681916743583,ANTH 102,A00,258272,Staff,59,0,60,1
1681916744604,ANTH 105,A00,258244,Staff,31,0,35,4
1681916745631,BENG 130,A00,253975,Staff,38,0,40,2
1681916746657,BIBC 102,A01,191866,Flagg; Matthew Paul,19,0,32,13
1681916746657,BIBC 102,A02,191867,Flagg; Matthew Paul,22,0,32,10
1681916746657,BIBC 102,A03,191868,Flagg; Matthew Paul,29,0,32,3
1681916746657,BIBC 102,A04,191936,Flagg; Matthew Paul,26,0,32,6
1681916746657,BIBC 102,A05,191937,Flagg; Matthew Paul,10,0,32,22
1681916747686,BICD 100,A01,191939,Cooper; Andrew Michael,28,0,32,4
1681916747686,BICD 100,A02,191940,Cooper; Andrew Michael,32,0,32,0
1681916747686,BICD 100,A03,191941,Cooper; Andrew Michael,32,0,32,0
1681916747686,BICD 100,A04,191942,Cooper; Andrew Michael,32,0,32,0
1681916747686,BICD 100,A05,191943,Cooper; Andrew Michael,32,0,32,0
1681916748722,BIEB 126,A01,191945,Cleland; Elsa Eleanor,0,0,32,32
1681916748722,BIEB 126,A02,191946,Cleland; Elsa Eleanor,28,0,32,4
1681916748722,BIEB 126,A03,191947,Cleland; Elsa Eleanor,29,0,32,3
1681916748722,BIEB 126,A04,191948,Cleland; Elsa Eleanor,23,0,32,9
1681916748722,BIEB 126,A05,191996,Cleland; Elsa Eleanor,28,0,32,4
1681916749745,BIEB 136GS,A00,191997,Shurin; Jonathan & Holway; David A.,0,0,0,0
1681916750774,BIEB 137GS,A01,191999,Shurin; Jonathan & Holway; David A.,0,0,0,0
1681916751797,BILD 1,A01,205385,Staff,31,0,32,1
1681916751797,BILD 1,A02,205386,Staff,30,0,32,2
1681916751797,BILD 1,A03,205387,Staff,32,0,32,0
1681916751797,BILD 1,A04,205388,Staff,28,0,32,4
1681916752819,BILD 2,A01,191774,Staff,28,0,32,4
1681916752819,BILD 2,A02,191775,Staff,30,0,32,2
1681916752819,BILD 2,A03,191777,Staff,30,0,32,2
1681916752819,BILD 2,A04,191856,Staff,31,0,32,1
1681916752819,BILD 2,A05,191857,Staff,32,0,32,0
1681916752819,BILD 2,A06,191858,Staff,32,0,32,0
1681916752819,BILD 2,A07,191859,Staff,31,0,32,1
1681916753842,BILD 3,A01,205391,Staff,29,0,32,3
1681916753842,BILD 3,A02,205393,Staff,32,0,32,0
1681916753842,BILD 3,A03,205394,Staff,28,0,32,4
1681916753842,BILD 3,A04,205395,Staff,32,0,32,0
1681916754869,BILD 20,A01,191861,Staff,32,0,32,0
1681916754869,BILD 20,A02,191862,Staff,32,0,32,0
1681916755900,BILD 30,A01,191864,Staff,31,0,32,1
1681916756923,BIMM 100,A01,192019,Staff,0,0,32,32
1681916756923,BIMM 100,A02,192020,Staff,23,0,32,9
1681916756923,BIMM 100,A03,192035,Staff,22,0,32,10
1681916757951,BIMM 110,A01,192037,Tat; John,0,0,32,32
1681916757951,BIMM 110,A02,192038,Tat; John,10,0,32,22
1681916758974,BIMM 120,A01,192040,Pickett; Brooke Elizabeth,2,0,32,30
1681916758974,BIMM 120,A02,192041,Pickett; Brooke Elizabeth,16,0,32,16
1681916758974,BIMM 120,A03,192042,Pickett; Brooke Elizabeth,15,0,32,17
1681916760006,BIPN 100,A01,192044,Armour; Jon Christopher,26,0,32,6
1681916760006,BIPN 100,A02,192059,Armour; Jon Christopher,30,0,32,2
1681916760006,BIPN 100,A03,192064,Armour; Jon Christopher,31,0,32,1
1681916760006,BIPN 100,A04,192073,Armour; Jon Christopher,28,0,32,4
1681916761033,BIPN 148,A01,205411,Leutgeb; Jill K.,16,0,32,16
1681916761033,BIPN 148,A02,205412,Leutgeb; Jill K.,31,0,32,1
1681916761033,BIPN 148,A03,205413,Leutgeb; Jill K.,30,0,32,2
1681916761033,BIPN 148,A04,205414,Leutgeb; Jill K.,30,0,32,2
1681916762062,BIPN 160,A01,192115,Marino; Marc J,19,0,32,13
1681916762062,BIPN 160,A02,192148,Marino; Marc J,27,0,32,5
1681916762062,BIPN 160,A03,192158,Marino; Marc J,31,0,32,1
1681916762062,BIPN 160,A04,192190,Marino; Marc J,32,0,32,0
1681916762062,BIPN 160,A05,192287,Marino; Marc J,32,0,32,0
1681916762062,BIPN 160,A06,192288,Marino; Marc J,32,0,32,0
1681916763088,BIPN 194,A00,206038,Staff,28,0,32,4
1681916764110,BISP 194,A00,192289,Leutgeb; Stefan,13,0,32,19
1681916764110,BISP 194,B00,245332,Nieh; James Charles,27,0,32,5
1681916765134,CAT 124,A01,202247,Staff,15,0,15,0
1681916766161,CAT 125,A00,202248,Staff,19,0,20,1
1681916766161,CAT 125,B00,202253,Staff,20,0,20,0
1681916766161,CAT 125,C00,202257,Staff,18,0,20,2
1681916767187,CAT 125GS,A01,202273,Bronstein; Phoebe Malan,20,0,20,0
1681916768215,CAT 125R,A00,202284,Staff,17,0,20,3
1681916768215,CAT 125R,C00,202286,Staff,10,0,20,10
1681916768215,CAT 125R,D00,202291,Staff,18,0,20,2
1681916768215,CAT 125R,E00,202295,Staff,13,0,20,7
1681916768215,CAT 125R,F00,202302,Staff,12,0,20,8
1681916769238,CENG 100,A00,204724,Opatkiewicz; Justin Paul,25,0,25,0
1681916770269,CGS 2A,A01,180420,Staff,31,0,36,5
1681916771308,CGS 101,A00,180421,Staff,16,0,20,4
1681916772332,CGS 112,A00,180422,Staff,10,0,16,6
1681916773356,CGS 113,A00,180423,Staff,18,0,20,2
1681916774381,CGS 137,A00,180424,Staff,12,0,12,0
1681916775404,CGS 147,A00,180425,Staff,10,0,10,0
1681916776427,CHEM 6A,A01,179556,Staff,97,0,100,3
1681916776427,CHEM 6A,A02,179558,Staff,0,0,0,0
1681916777455,CHEM 6B,A01,179560,Staff,100,0,100,0
1681916778479,CHEM 6C,A01,179565,Jazzar; Rodolphe,95,0,100,5
1681916779588,CHEM 7L,A01,179586,Schurmeier; Kimberly,13,0,24,11
1681916779588,CHEM 7L,A02,179587,Schurmeier; Kimberly,23,0,24,1
1681916779588,CHEM 7L,A03,179590,Schurmeier; Kimberly,22,0,24,2
1681916779588,CHEM 7L,A04,179591,Schurmeier; Kimberly,22,0,24,2
1681916779588,CHEM 7L,B01,179598,Schurmeier; Kimberly,17,0,24,7
1681916779588,CHEM 7L,B02,179599,Schurmeier; Kimberly,24,0,24,0
1681916779588,CHEM 7L,B03,179606,Schurmeier; Kimberly,23,0,24,1
1681916779588,CHEM 7L,B04,179607,Schurmeier; Kimberly,23,0,24,1
1681916780610,CHEM 11,A01,179609,Stallings; Dontarie M,88,0,100,12
1681916781634,CHEM 40A,A01,179621,Staff,41,0,50,9
1681916781634,CHEM 40A,A02,179622,Staff,47,0,50,3
1681916782657,CHEM 40B,A01,179630,Weizman; Haim,48,0,50,2
1681916782657,CHEM 40B,A02,179631,Weizman; Haim,45,0,50,5
1681916783680,CHEM 41A,A01,179660,Klosterman; Jeremy K,93,0,100,7
1681916784707,CHEM 43A,A01,179683,Klosterman; Jeremy K,0,0,24,24
1681916784707,CHEM 43A,A02,179688,Klosterman; Jeremy K,13,0,24,11
1681916784707,CHEM 43A,A03,179689,Klosterman; Jeremy K,20,0,24,4
1681916784707,CHEM 43A,A04,179691,Klosterman; Jeremy K,18,0,24,6
1681916785730,CHEM 114A,A01,179693,Stallings; Dontarie M,76,0,100,24
1681916786753,CHEM 143B,A01,179698,Weizman; Haim,17,0,24,7
1681916786753,CHEM 143B,A02,179700,Weizman; Haim,24,0,24,0
1681916787779,CHIN 169A,A00,179701,Wang; Xiao,20,0,20,0
1681916788805,COGS 2,A01,179750,Boyle; Mary E. T.,17,0,30,13
1681916789827,COGS 9,A01,179759,Jones; Cameron Robert,43,0,50,7
1681916790858,COGS 14A,A01,179854,Staff,18,0,50,32
1681916791882,COGS 14B,A01,179856,Staff,54,0,60,6
1681916792908,COGS 17,A01,179874,Staff,71,0,75,4
1681916793932,COGS 18,A01,179884,Staff,63,0,80,17
1681916794954,COGS 100,A01,179886,Staff,40,0,60,20
1681916795978,COGS 101B,A01,179892,Staff,1,0,30,29
1681916797006,COGS 101C,A01,179894,Staff,28,0,30,2
1681916798032,COGS 107A,A01,179896,Boyle; Mary E. T.,31,0,40,9
1681916799063,COGS 108,A01,179898,Simpkins; Charles Alexander,0,17,60,60
1681916800087,COGS 109,A01,179900,Staff,34,0,40,6
1681916801111,COGS 118A,A01,179946,Staff,9,0,40,31
1681916802136,COGS 153,A00,179978,Staff,1,0,30,29
1681916803162,COGS 156,A01,179981,Staff,27,0,30,3
1681916805216,COGS 172,A01,179987,Staff,13,0,30,17
1681916807263,COGS 186,A01,179991,Staff,13,0,30,17
1681916808291,COMM 10,A01,180001,Staff,15,0,25,10
1681916808291,COMM 10,A02,180004,Staff,20,0,25,5
1681916809319,COMM 100A,A01,180016,Staff,18,0,25,7
1681916809319,COMM 100A,A02,180020,Staff,24,0,25,1
1681916810342,COMM 101T,A00,180029,Halm; Gavin Patrick,23,0,35,12
1681916811365,COMM 106V,A00,180043,Staff,34,0,35,1
1681916812388,COMM 109P,A00,180044,Staff,31,0,35,4
1681916813410,COMM 113T,A00,180045,Havis; Allan,37,0,45,8
1681916814447,COMM 132,A00,180046,McKenna; Denise,23,0,30,7
1681916815472,COMM 143,A00,180047,Staff,19,0,30,11
1681916816495,COMM 190,A00,180048,Conner; Thomas Hartnell,20,0,23,3
1681916817519,CSE 8A,A50,180053,Cao; Yingjun,25,0,50,25
1681916817519,CSE 8A,B50,180180,Staff,50,0,50,0
1681916818544,CSE 11,A01,180190,Cao; Yingjun,30,0,50,20
1681916819567,CSE 20,A01,180192,Briones; Jor-el Thomas Caparas,23,0,30,7
1681916820590,CSE 21,A01,194538,Briones; Jor-el Thomas Caparas,50,0,60,10
1681916821615,CSE 30,A01,180324,Eldon; John,77,0,100,23
1681916822641,CSE 101,A01,201353,Staff,0,21,40,40
1681916823664,CSE 134B,A01,180326,Powell; Thomas Allan,74,0,100,26
1681916824687,CSE 140,A01,180328,Staff,46,0,75,29
1681916825709,CSE 140L,A01,180344,Eldon; John,69,0,100,31
1681916826731,CSE 150A,A01,180411,Staff,0,7,50,50
1681916827760,CSE 151A,A01,180414,Staff,0,6,50,50
1681916828784,CSE 175,A01,222521,Kumar; Rakesh,50,0,50,0
1681916829808,CSE 190,A00,201419,Staff,45,0,49,4
1681916830836,CSS 1,A01,194536,Staff,38,0,50,12
1681916831863,DSC 30,A01,202385,Staff,48,0,50,2
1681916832889,DSC 40A,A01,202387,Albuyeh; Rod,50,0,50,0
1681916833912,DSC 190,A01,202389,Silberman; Jack,21,0,21,0
1681916834939,DSGN 100,A01,179993,Staff,16,0,30,14
1681916835961,ECE 65,A50,180708,Staff,10,0,20,10
1681916835961,ECE 65,A51,180739,Staff,19,0,20,1
1681916836983,ECON 1,A01,180427,Famulari; Melissa,67,0,70,3
1681916838009,ECON 2,A01,180450,Levkoff; Steven B.,64,0,70,6
1681916839035,ECON 4,A01,203351,Anderson; John Charles,7,0,10,3
1681916840061,ECON 100A,A01,180472,Famulari; Melissa,65,0,70,5
1681916841093,ECON 120A,A01,180549,Staff,64,0,70,6
1681916842117,ECON 120B,A01,180655,Ma; Xinwei,46,0,70,24
1681916843143,ECON 129,A00,203333,Eckert; Fabian Paul,15,0,35,20
1681916844171,ECON 131,A00,180656,Staff,8,0,35,27
1681916845193,ECON 172B,A01,180672,Levkoff; Steven B.,32,0,35,3
1681916846218,ECON 178,A01,203342,Zhu; Ying,10,0,35,25
1681916847246,EDS 108GS,A00,202383,Wishard Guerra; Alison G.,20,0,20,0
1681916848274,EDS 111GS,A00,202347,Wishard Guerra; Alison G.,20,0,20,0
1681916849301,EDS 112,A01,202323,Staff,56,0,60,4
1681916850324,EDS 113,A00,202340,Staff,33,0,35,2
1681916851347,EDS 118,A00,201231,Staff,20,0,30,10
1681916852371,EDS 119,A00,204994,Staff,8,0,10,2
1681916853393,EDS 124BR,A00,202324,Eguchi; Emi,4,0,25,21
1681916854427,EDS 126,A01,203208,Jones; Makeba,26,0,30,4
1681916855452,EDS 135,A01,202333,Staff,18,0,20,2
1681916856484,EDS 180,A00,202311,Staff,47,0,50,3
1681916857510,ERC 190GS,A01,253747,Staff,28,0,28,0
1681916858533,ETHN 104,A00,180742,Staff,24,0,35,11
1681916859559,ETHN 118,A00,180745,Staff,28,0,35,7
1681916860585,ETHN 127,A00,180747,Staff,12,0,16,4
1681916861619,ETHN 137,A00,180880,Staff,12,0,12,0
1681916862659,ETHN 147,A00,180890,Staff,8,0,10,2
1681916863684,ETHN 154,A00,180891,Staff,7,0,8,1
1681916864709,ETHN 168,A00,180892,Staff,9,0,10,1
1681916865737,GLBH 20,A00,201051,Hannah; Seth Donal,0,1,0,1
1681916866769,GLBH 111,A01,209338,Burgos; Jose L.,0,0,0,0
1681916867795,GLBH 150,A00,258300,Staff,0,3,0,0
1681916868818,GLBH 181,A00,201207,Staff,15,0,40,25
1681916869841,HIEU 109,A00,180898,Staff,20,0,20,0
1681916870864,HIEU 111,A00,180899,Staff,1,0,20,19
1681916871886,HIEU 124,A00,180900,Staff,18,0,20,2
1681916872922,HILA 122,A00,180901,Staff,18,0,20,2
1681916873944,HILA 132,A00,180902,Vitz; Matthew,2,0,20,18
1681916874967,HILD 10,A01,180896,Staff,15,0,20,5
1681916875990,HILD 30GS,A00,180897,Edington; Claire Ellen,0,0,0,0
1681916877015,HISC 105,A00,180903,Staff,20,0,20,0
1681916878037,HISC 117,A00,180904,Staff,11,0,20,9
1681916879069,HIUS 108B,A00,181005,Staff,18,0,20,2
1681916880092,HIUS 113,A00,181093,Staff,3,0,20,17
1681916881115,HUM 3,A01,181190,Patterson; Patrick H.,40,0,50,10
1681916881115,HUM 3,B01,181195,Staff,46,0,50,4
1681916882139,HUM 3GS,A00,181196,Herbst; Matthew,0,0,0,0
1681916883240,HUM 4,A01,181227,West; Geoffrey Scott,34,0,50,16
1681916883240,HUM 4,B01,181282,Staff,43,0,50,7
1681916884267,HUM 4GS,A00,181377,Lyon; Antony J.,0,0,0,0
1681916885292,HUM 5,A01,181536,Zavodny; Tatiana Sophia,31,0,50,19
1681916885292,HUM 5,B01,181908,Staff,36,0,50,14
1681916886316,INTL 190,A00,181909,Segui; Alan S,0,0,0,6
1681916886316,INTL 190,B00,181961,Segui; Alan S,0,0,0,7
1681916887338,JAPN 20AR,A01,182113,Ross; Kayoko F,15,0,20,5
1681916888370,LATI 50,A01,202391,Martin-Cabrera; Luis,19,0,30,11
1681916888370,LATI 50,A02,202392,Martin-Cabrera; Luis,26,0,30,4
1681916889396,LATI 180,A00,202393,Kokinis; Troy Andreas,25,0,25,0
1681916890420,LIFR 1A,A00,182119,Staff,14,0,14,0
1681916891446,LIFR 1AX,A00,182324,Staff,14,0,14,0
1681916892468,LIFR 1B,A00,182259,Staff,14,0,14,0
1681916893502,LIFR 1BX,A00,182273,Staff,14,0,14,0
1681916894526,LIGN 8,A00,182330,Staff,137,0,150,13
1681916895558,LIGN 9GS,A00,182362,Staff,20,0,20,0
1681916896582,LIGN 119,A00,204992,Takahashi; Maho,12,0,15,3
1681916897614,LIGN 130,A01,182384,Staff,47,0,50,3
1681916898635,LIGN 149GS,A00,182390,Staff,20,0,20,0
1681916899664,LIGN 170,A00,182404,Staff,24,0,30,6
1681916900692,LISP 1D,A00,182281,Staff,7,0,14,7
1681916900692,LISP 1D,B00,182287,Staff,14,0,14,0
1681916900692,LISP 1D,C00,182295,Staff,11,0,14,3
1681916900692,LISP 1D,D00,182301,Staff,14,0,14,0
1681916901731,LISP 1DX,A00,182309,Staff,20,0,28,8
1681916901731,LISP 1DX,B00,182316,Staff,26,0,28,2
1681916902764,LTAF 120GS,A00,182412,Zhiri; Oumelbanine,20,0,20,0
1681916903794,LTCS 172GS,A00,182437,Bronstein; Phoebe Malan,20,0,20,0
1681916904821,LTEA 138,A00,182457,Staff,21,0,40,19
1681916905843,LTEN 114,A01,182490,Staff,23,0,25,2
1681916906876,LTEN 130GS,A00,182491,Lyon; Antony J.,20,0,20,0
1681916907902,LTEN 169,A00,182493,Cuong; Marisol,20,0,25,5
1681916908924,LTEN 178,A00,182501,Staff,14,0,15,1
1681916909947,LTEN 181,A00,182515,Staff,22,0,25,3
1681916910970,LTEN 185GS,A00,197655,Forbes; Camille,20,0,20,0
1681916912001,LTSP 100B,A00,202208,Bessett; Ryan Matthew,24,0,25,1
1681916913026,LTWL 100,A00,182516,Myerston Santana; Jacobo,22,0,30,8
1681916914050,LTWR 100GS,A00,182518,Forbes; Camille,20,0,20,0
1681916915083,LTWR 102,A00,182522,Staff,15,0,15,0
1681916915083,LTWR 102,B00,182525,Staff,14,0,15,1
1681916916110,LTWR 115,A00,182526,Staff,12,0,15,3
1681916917137,MAE 8,A01,182528,Pham; Hieu Tan,68,0,70,2
1681916918163,MAE 11,A00,182529,Bahadori; Mohammad Yousef,94,0,100,6
1681916919190,MAE 20,A00,182530,Evdokimenko; Ekaterina,68,0,70,2
1681916920214,MAE 30A,A00,182532,Staff,44,0,45,1
1681916921241,MAE 101A,A00,182533,Bahadori; Mohammad Yousef,97,0,100,3
1681916922268,MAE 101C,A00,182538,Staff,62,0,70,8
1681916923291,MAE 104,A00,182539,Staff,45,0,50,5
1681916924317,MAE 131A,A00,182540,Ghazinejad; Maziar,41,0,45,4
1681916925341,MAE 143A,A00,182548,Bewley; Thomas R,43,0,50,7
1681916926363,MAE 150,A00,182549,Staff,28,0,40,12
1681916927394,MAE 160,A00,182550,Evdokimenko; Ekaterina,43,0,60,17
1681916928427,MATH 3C,A01,182725,Staff,27,0,30,3
1681916929450,MATH 10A,A01,182729,Staff,25,0,30,5
1681916929450,MATH 10A,B01,182732,Staff,26,0,30,4
1681916930477,MATH 10B,A01,182737,Staff,21,0,30,9
1681916930477,MATH 10B,A02,182738,Staff,27,0,30,3
1681916930477,MATH 10B,B01,182744,Staff,27,0,30,3
1681916930477,MATH 10B,B02,182745,Staff,27,0,30,3
1681916931508,MATH 18,A01,182750,Anzaldo; Leesa B,28,0,30,2
1681916931508,MATH 18,A02,182751,Anzaldo; Leesa B,29,0,30,1
1681916931508,MATH 18,A03,182753,Anzaldo; Leesa B,28,0,30,2
1681916931508,MATH 18,A04,182757,Anzaldo; Leesa B,29,0,30,1
1681916931508,MATH 18,B01,182761,Anzaldo; Leesa B,27,0,30,3
1681916931508,MATH 18,B02,182764,Anzaldo; Leesa B,27,0,30,3
1681916931508,MATH 18,B03,182765,Anzaldo; Leesa B,30,0,30,0
1681916931508,MATH 18,B04,182766,Anzaldo; Leesa B,30,0,30,0
1681916932534,MATH 20A,A01,182771,Suk; Andrew Hoon,28,0,30,2
1681916933562,MATH 20B,A01,182775,Bach; Quang Tran,30,0,30,0
1681916933562,MATH 20B,A02,182777,Bach; Quang Tran,29,0,30,1
1681916933562,MATH 20B,B01,182780,Bach; Quang Tran,27,0,30,3
1681916933562,MATH 20B,B02,182782,Bach; Quang Tran,30,0,30,0
1681916934585,MATH 20C,A01,182787,Staff,25,0,30,5
1681916934585,MATH 20C,A02,182790,Staff,29,0,30,1
1681916934585,MATH 20C,B01,182792,Staff,25,0,30,5
1681916934585,MATH 20C,B02,182796,Staff,27,0,30,3
1681916935608,MATH 20D,A01,182799,Staff,29,0,30,1
1681916935608,MATH 20D,A02,182802,Staff,30,0,30,0
1681916935608,MATH 20D,A03,182803,Staff,30,0,30,0
1681916936647,MATH 20E,A01,182809,Verstraete; Jacques Allan,24,0,30,6
1681916936647,MATH 20E,A02,182811,Verstraete; Jacques Allan,28,0,30,2
1681916936647,MATH 20E,B01,182814,Verstraete; Jacques Allan,23,0,30,7
1681916936647,MATH 20E,B02,182815,Verstraete; Jacques Allan,30,0,30,0
1681916937671,MATH 103A,A01,182820,Staff,9,0,30,21
1681916937671,MATH 103A,A02,182821,Staff,27,0,30,3
1681916937671,MATH 103A,A03,182822,Staff,23,0,30,7
1681916937671,MATH 103A,B01,182825,Staff,23,0,30,7
1681916937671,MATH 103A,B02,182826,Staff,30,0,30,0
1681916937671,MATH 103A,B03,182830,Staff,30,0,30,0
1681916938701,MATH 109,A01,182836,Chow; Bennett,24,0,30,6
1681916938701,MATH 109,A02,182838,Chow; Bennett,29,0,30,1
1681916938701,MATH 109,A03,182894,Chow; Bennett,29,0,30,1
1681916938701,MATH 109,B01,182908,Chow; Bennett,28,0,30,2
1681916938701,MATH 109,B02,182909,Chow; Bennett,30,0,30,0
1681916938701,MATH 109,B03,182910,Chow; Bennett,27,0,30,3
1681916939723,MATH 142A,A01,182925,Staff,11,0,30,19
1681916939723,MATH 142A,A02,182935,Staff,24,0,30,6
1681916939723,MATH 142A,A03,182967,Staff,26,0,30,4
1681916939723,MATH 142A,B01,183125,Staff,24,0,30,6
1681916939723,MATH 142A,B02,183157,Staff,28,0,30,2
1681916939723,MATH 142A,B03,183158,Staff,29,0,30,1
1681916940745,MATH 183,A01,183160,Arias-Castro; Ery,23,0,30,7
1681916940745,MATH 183,A02,183161,Arias-Castro; Ery,29,0,30,1
1681916940745,MATH 183,B01,183163,Arias-Castro; Ery,28,0,30,2
1681916940745,MATH 183,B02,183164,Arias-Castro; Ery,28,0,30,2
1681916941771,MATH 193A,A01,183167,Staff,4,0,35,31
1681916941771,MATH 193A,A02,183168,Staff,28,0,35,7
1681916941771,MATH 193A,A03,183169,Staff,34,0,35,1
1681916941771,MATH 193A,A04,183170,Staff,28,0,35,7
1681916942798,MGT 4,A01,202395,Anderson; John Charles,75,0,80,5
1681916943825,MGT 5,A00,202396,Houskeeper; Robert,80,0,90,10
1681916944849,MGT 103,A00,202397,Eberhard; Craig A,55,0,90,35
1681916945874,MGT 131A,A00,202398,Houskeeper; Robert,85,0,90,5
1681916946896,MGT 135,A00,202399,Anderson; John Charles,82,0,90,8
1681916947923,MGT 162R,A00,202403,Gneezy; Uri,150,0,200,50
1681916948951,MGT 172,A00,202404,Hedges; Kathleen,50,0,90,40
1681916949976,MGT 181,A00,202405,Dunn; Louis Jean,84,0,90,6
1681916951004,MMW 14,A01,183200,Staff,15,0,28,13
1681916951004,MMW 14,A02,183201,Staff,26,0,28,2
1681916951004,MMW 14,A03,183202,Staff,24,0,28,4
1681916951004,MMW 14,A04,183203,Staff,25,0,28,3
1681916951004,MMW 14,A05,183204,Staff,26,0,28,2
1681916951004,MMW 14,A06,183205,Staff,27,0,28,1
1681916951004,MMW 14,B01,183207,Staff,26,0,28,2
1681916951004,MMW 14,B02,183208,Staff,28,0,28,0
1681916951004,MMW 14,B03,183209,Staff,28,0,28,0
1681916951004,MMW 14,B04,183210,Staff,28,0,28,0
1681916951004,MMW 14,B05,183211,Staff,28,0,28,0
1681916951004,MMW 14,B06,183212,Staff,28,0,28,0
1681916952029,MMW 14GS,A00,183213,Zhiri; Oumelbanine,28,0,28,0
1681916953056,MMW 15GS,B00,183215,Rahimi; Babak,28,0,28,0
1681916954078,MMW 121,A01,183217,Patterson; Patrick H.,14,0,28,14
1681916954078,MMW 121,A02,183218,Patterson; Patrick H.,25,0,28,3
1681916955102,MUS 1A,A01,182554,Staff,8,0,35,27
1681916956124,MUS 5,A01,182558,Staff,20,0,35,15
1681916957147,MUS 6,A01,182562,Staff,25,0,35,10
1681916958170,MUS 8GS,A00,182563,Borgo; David Garcia,25,0,25,0
1681916959198,MUS 13,A01,182567,Staff,24,0,25,1
1681916960233,MUS 15,A01,182570,Staff,32,0,35,3
1681916960233,MUS 15,B01,182575,Staff,10,0,35,25
1681916961256,MUS 80,A00,182578,Staff,23,0,25,2
1681916961256,MUS 80,B00,182581,Staff,20,0,25,5
1681916962283,MUS 113,A00,182582,Staff,25,0,25,0
1681916963305,MUS 114,A00,182583,Staff,4,0,25,21
1681916964328,MUS 150GS,A01,182588,Borgo; David Garcia,25,0,25,0
1681916965359,PHIL 1,A00,182590,Staff,35,0,40,5
1681916966385,PHIL 10,A01,182596,Grush; Rick Scott,31,0,35,4
1681916966385,PHIL 10,A02,182597,Grush; Rick Scott,34,0,35,1
1681916967413,PHIL 15,A01,182601,Staff,31,0,35,4
1681916967413,PHIL 15,A02,182602,Staff,33,0,35,2
1681916968435,PHIL 27,A01,182604,Staff,30,0,35,5
1681916968435,PHIL 27,A02,182607,Staff,35,0,35,0
1681916969458,PHIL 32,A01,182609,Staff,35,0,35,0
1681916969458,PHIL 32,A02,182612,Staff,35,0,35,0
1681916970484,PHIL 130,A00,182614,Staff,63,0,70,7
1681916971519,PHIL 136,A00,182616,Cohen; Jonathan David,66,0,70,4
1681916972542,PHIL 155,A00,182617,Vargas; Manuel Rogelio,60,0,70,10
1681916973567,PHIL 163,A01,182620,Staff,15,0,20,5
1681916973567,PHIL 163,A02,182624,Staff,10,0,20,10
1681916974589,PHIL 164,A00,182627,Staff,30,0,40,10
1681916975611,PHIL 173,A00,182628,Staff,36,0,40,4
1681916976634,PHYS 1A,A00,183221,Staff,54,0,60,6
1681916977660,PHYS 1AL,001,183222,Staff,25,0,30,5
1681916977660,PHYS 1AL,002,183223,Staff,28,0,30,2
1681916978690,PHYS 1B,A00,183231,Staff,43,0,60,17
1681916979716,PHYS 1BL,001,183232,Staff,20,0,30,10
1681916979716,PHYS 1BL,002,183233,Staff,28,0,30,2
1681916980742,PHYS 1C,A00,183240,Staff,30,0,60,30
1681916981784,PHYS 1CL,001,183241,Staff,13,0,30,17
1681916981784,PHYS 1CL,002,183242,Staff,22,0,30,8
1681916982807,PHYS 2AR,A01,183250,Staff,44,0,50,6
1681916983832,PHYS 2B,A01,183252,Staff,106,0,115,9
1681916984855,PHYS 2BL,A01,183254,Staff,21,0,24,3
1681916984855,PHYS 2BL,A02,183255,Staff,22,0,24,2
1681916985878,PHYS 2C,A01,183522,Staff,105,0,115,10
1681916986988,PHYS 4A,A01,183524,Staff,49,0,50,1
1681916988013,POLI 5,A00,183525,Staff,44,0,50,6
1681916989039,POLI 12,A00,183540,Staff,48,0,50,2
1681916990065,POLI 13R,A00,183541,Forman; Fonna,42,0,50,8
1681916991094,POLI 30,A00,183542,Mignozzetti; Umberto,47,0,50,3
1681916992118,POLI 100A,A00,183543,Staff,45,0,50,5
1681916993142,POLI 100E,A00,223598,Staff,32,0,35,3
1681916994168,POLI 103A,A00,183564,Kousser; Thad,38,0,50,12
1681916995192,POLI 104B,A00,201329,Staff,29,0,35,6
1681916996215,POLI 113BR,A00,183576,Hoston; Germaine,26,0,50,24
1681916997243,POLI 114BR,A00,183588,Staff,27,0,30,3
1681916998269,POLI 117R,A00,183595,Forman; Fonna,9,0,20,11
1681916999294,POLI 120H,A00,183596,Fisk; David Lee,13,0,20,7
1681917000316,POLI 130AA,A00,183597,Staff,14,0,20,6
1681917001341,POLI 134AA,A00,183598,Staff,19,0,20,1
1681917002366,POLI 135,A00,183599,Fisk; David Lee,20,0,25,5
1681917003389,POLI 142P,A00,183623,Staff,37,0,40,3
1681917004418,POLI 144D,A00,183624,Staff,22,0,25,3
1681917005442,POLI 151,A00,183625,Staff,15,0,20,5
1681917006465,POLI 162,A00,183626,Mignozzetti; Umberto,18,0,20,2
1681917007489,PSYC 1,A00,253748,Staff,86,0,90,4
1681917008512,PSYC 2,A00,183627,Moranton; Nirelia Melbina-,25,0,35,10
1681917009534,PSYC 3,A00,183628,Staff,43,0,45,2
1681917011593,PSYC 60,A01,183631,Lowe; Angela Beth,35,0,40,5
1681917012616,PSYC 70,A01,253757,Staff,37,0,45,8
1681917013639,PSYC 101,A00,183632,Heyman; Gail D.,48,0,60,12
1681917014668,PSYC 105,A00,183848,Lowe; Angela Beth,49,0,60,11
1681917015692,PSYC 106,A00,183849,Dobkins; Karen R.,44,0,60,16
1681917016731,PSYC 108,A00,253750,Staff,24,0,60,36
1681917017757,PSYC 114,A01,184275,Winkielman; Piotr,0,6,30,30
1681917018780,PSYC 122,A00,183856,Moranton; Nirelia Melbina-,0,10,30,30
1681917019814,PSYC 124,A00,183865,Chapman; Eddie Nathaniel,52,0,80,28
1681917020837,PSYC 137,A00,183880,Staff,19,0,25,6
1681917022901,PSYC 154,A00,183910,Lacefield; Katharine I,0,3,90,90
1681917024954,PSYC 162,A00,183946,Wixted; John T,61,0,90,29
1681917025980,PSYC 172,A00,183947,Gorman; Michael R.,13,0,30,17
1681917027003,PSYC 178,A00,183963,Glaser; Dale,20,0,40,20
1681917028028,PSYC 181GS,A00,183964,Anagnostaras; Stephan,10,0,10,0
1681917029051,PSYC 186GS,A01,257660,Staff,10,0,10,0
1681917030074,PSYC 193,B00,253749,Staff,23,0,25,2
1681917032124,PSYC 193L,A01,184122,Staff,33,0,35,2
1681917032124,PSYC 193L,C01,184167,Winkielman; Piotr,16,0,30,14
1681917033153,RELI 188GS,A00,182629,Rahimi; Babak,20,0,20,0
1681917034176,SE 101A,A00,182646,Staff,26,0,30,4
1681917035201,SE 101C,A00,182650,Staff,18,0,20,2
1681917036224,SE 110A,A00,182651,Staff,28,0,28,0
1681917037254,SE 130A,A00,182652,Staff,39,0,40,1
1681917038277,SIO 46GS,A00,182636,Cook; Geoffrey W,28,0,28,0
1681917039302,SIO 109R,A00,194459,Staff,5,0,20,15
1681917040330,SIO 121GS,A00,182639,Cook; Geoffrey W,28,0,28,0
1681917041352,SIO 132,A01,182642,Staff,32,0,40,8
1681917042378,SIO 139,A00,182644,Kacev; David,36,0,40,4
1681917043401,SOCI 2,A01,258404,Staff,34,0,36,2
1681917043401,SOCI 2,A02,258405,Staff,35,0,36,1
1681917044422,SOCI 60,A01,258408,Staff,29,0,30,1
1681917044422,SOCI 60,A02,258413,Staff,30,0,30,0
1681917045447,SOCI 100,A01,258415,Staff,29,0,30,1
1681917045447,SOCI 100,A02,258416,Staff,28,0,30,2
1681917051590,SOCI 127,A00,258421,Staff,22,0,30,8
1681917052613,SOCI 132,A00,258422,Staff,45,0,50,5
1681917053635,SOCI 133,A00,258423,Staff,26,0,30,4
1681917054660,SOCI 138GS,A00,258424,Staff,15,0,15,0
1681917055685,SOCI 145,A00,258425,Staff,25,0,30,5
1681917056706,SOCI 148,A00,258426,Staff,26,0,30,4
1681917057731,SOCI 153,A00,199217,Staff,29,0,30,1
1681917058756,SOCI 160,A00,258427,Staff,28,0,30,2
1681917059777,SOCI 160E,A00,258435,Staff,56,0,60,4
1681917060800,SOCI 189GS,A00,258436,Staff,15,0,15,0
1681917061825,SOCI 190GS,A00,258437,Staff,15,0,15,0
1681917062851,SYN 2,001,182658,Staff,9,0,16,7
1681917062851,SYN 2,002,201439,Staff,15,0,16,1
1681917062851,SYN 2,003,201443,Staff,16,0,16,0
1681917063876,SYN 100,A01,182657,Staff,17,0,20,3
1681917064902,TDAC 1,A00,184381,Salovey; Todd,16,0,20,4
1681917064902,TDAC 1,B00,184385,Harting; Carla Kelso,19,0,20,1
1681917064902,TDAC 1,C00,184394,Staff,19,0,20,1
1681917065924,TDAC 101,A00,184483,Harting; Carla Kelso,19,0,20,1
1681917066951,TDDE 111,A00,184496,Staff,14,0,15,1
1681917067975,TDDE 131,A00,184504,Staff,20,0,20,0
1681917067975,TDDE 131,B00,184505,Staff,17,0,18,1
1681917067975,TDDE 131,C00,184534,Staff,49,0,50,1
1681917067975,TDDE 131,D00,184564,Staff,15,0,15,0
1681917067975,TDDE 131,E00,204725,Staff,19,0,20,1
1681917069000,TDGE 1,A01,184414,Salovey; Todd,36,0,50,14
1681917070030,TDGE 5,A01,184419,Staff,23,0,24,1
1681917071055,TDGE 10,A00,184428,Fulton; Julia,30,0,50,20
1681917072079,TDGE 124,A00,184565,Fulton; Julia,7,0,50,43
1681917073105,TDGE 125,B00,184567,Meyer; Ursula,9,0,25,16
1681917074132,TDHT 101,A00,184568,Staff,21,0,25,4
1681917074132,TDHT 101,B00,184569,Staff,20,0,20,0
1681917075154,TDHT 114,A00,184570,Staff,49,0,50,1
1681917076184,TDMV 1,A00,184437,Arcidiacono; Kristin,23,0,30,7
1681917076184,TDMV 1,B00,184448,Caligagan; Maria T.,22,0,30,8
1681917077215,TDMV 2,A00,184449,Weinberg; Sadie,27,0,30,3
1681917077215,TDMV 2,B00,184453,Arcidiacono; Kristin,29,0,30,1
1681917078237,TDMV 110,A00,184571,Weinberg; Sadie,30,0,30,0
1681917079270,TDMV 142,A00,184572,Caligagan; Tony,27,0,30,3
1681917079270,TDMV 142,B00,184573,Caligagan; Maria T.,27,0,30,3
1681917080294,TDTR 20,A00,184482,Jun; Grace Shin Hae,25,0,25,0
1681917081317,USP 2,A01,184290,Hinds; Juli Beth,24,0,25,1
1681917082342,USP 3,A01,184295,Staff,20,0,25,5
1681917083366,USP 4,A00,184304,McTague; Sarah,15,0,25,10
1681917084391,USP 100,A00,184315,Staff,17,0,25,8
1681917085415,USP 105,A00,184326,Staff,21,0,25,4
1681917086438,USP 151,A00,184327,Staff,20,0,25,5
1681917087460,USP 170,A00,184380,Hinds; Juli Beth,14,0,25,11
1681917088485,VIS 21B,A01,182660,Staff,28,0,31,3
1681917088485,VIS 21B,A02,182662,Staff,30,0,31,1
1681917089510,VIS 103D,A00,182663,Staff,74,0,75,1
1681917090626,VIS 105D,A00,182667,Li; Huai,15,0,22,7
1681917091648,VIS 122GS,A00,182668,Herbst; Matthew,20,0,20,0
1681917092671,VIS 128C,A00,182673,Staff,69,0,75,6
1681917093700,VIS 130,A00,182675,Staff,20,0,22,2
1681917094722,VIS 160A,A00,182678,Stalbaum; Brett,4,0,10,6
1681917096770,WCWP 10B,A00,201679,Staff,15,0,15,0
1681917096770,WCWP 10B,B00,201695,Staff,15,0,15,0
1681917097796,WCWP 100,A00,201716,Staff,15,0,15,0
1681917097796,WCWP 100,B00,201717,Staff,10,0,15,5
1681917099879,ANSC 105GS,A00,258289,Staff,0,0,0,0
1681917100903,ANSC 125GS,A00,258295,Staff,0,0,0,0
1681917101926,ANSC 150,A00,258267,Staff,30,0,40,10
1681917102953,ANSC 190GS,A00,258280,Staff,0,0,0,0
1681917103981,ANTH 1,A00,258264,Staff,38,0,40,2
1681917105004,ANTH 2,A01,258259,Staff,72,0,76,4
1681917106030,ANTH 23,A01,258228,Staff,36,0,40,4
1681917107064,ANTH 101,A01,258236,Staff,39,0,40,1
1681917108086,ANTH 102,A00,258272,Staff,59,0,60,1
1681917109121,ANTH 105,A00,258244,Staff,31,0,35,4
1681917110151,BENG 130,A00,253975,Staff,38,0,40,2
1681917111173,BIBC 102,A01,191866,Flagg; Matthew Paul,19,0,32,13
1681917111173,BIBC 102,A02,191867,Flagg; Matthew Paul,22,0,32,10
1681917111173,BIBC 102,A03,191868,Flagg; Matthew Paul,29,0,32,3
1681917111173,BIBC 102,A04,191936,Flagg; Matthew Paul,26,0,32,6
1681917111173,BIBC 102,A05,191937,Flagg; Matthew Paul,10,0,32,22
1681917112196,BICD 100,A01,191939,Cooper; Andrew Michael,28,0,32,4
1681917112196,BICD 100,A02,191940,Cooper; Andrew Michael,32,0,32,0
1681917112196,BICD 100,A03,191941,Cooper; Andrew Michael,32,0,32,0
1681917112196,BICD 100,A04,191942,Cooper; Andrew Michael,32,0,32,0
1681917112196,BICD 100,A05,191943,Cooper; Andrew Michael,32,0,32,0
1681917113219,BIEB 126,A01,191945,Cleland; Elsa Eleanor,0,0,32,32
1681917113219,BIEB 126,A02,191946,Cleland; Elsa Eleanor,27,0,32,5
1681917113219,BIEB 126,A03,191947,Cleland; Elsa Eleanor,29,0,32,3
1681917113219,BIEB 126,A04,191948,Cleland; Elsa Eleanor,23,0,32,9
1681917113219,BIEB 126,A05,191996,Cleland; Elsa Eleanor,28,0,32,4
1681917114243,BIEB 136GS,A00,191997,Shurin; Jonathan & Holway; David A.,0,0,0,0
1681917115276,BIEB 137GS,A01,191999,Shurin; Jonathan & Holway; David A.,0,0,0,0
1681917116299,BILD 1,A01,205385,Staff,31,0,32,1
1681917116299,BILD 1,A02,205386,Staff,30,0,32,2
1681917116299,BILD 1,A03,205387,Staff,32,0,32,0
1681917116299,BILD 1,A04,205388,Staff,28,0,32,4
1681917117324,BILD 2,A01,191774,Staff,28,0,32,4
1681917117324,BILD 2,A02,191775,Staff,30,0,32,2
1681917117324,BILD 2,A03,191777,Staff,30,0,32,2
1681917117324,BILD 2,A04,191856,Staff,31,0,32,1
1681917117324,BILD 2,A05,191857,Staff,32,0,32,0
1681917117324,BILD 2,A06,191858,Staff,32,0,32,0
1681917117324,BILD 2,A07,191859,Staff,31,0,32,1
1681917118346,BILD 3,A01,205391,Staff,29,0,32,3
1681917118346,BILD 3,A02,205393,Staff,32,0,32,0
1681917118346,BILD 3,A03,205394,Staff,28,0,32,4
1681917118346,BILD 3,A04,205395,Staff,32,0,32,0
1681917119371,BILD 20,A01,191861,Staff,32,0,32,0
1681917119371,BILD 20,A02,191862,Staff,32,0,32,0
1681917120399,BILD 30,A01,191864,Staff,31,0,32,1
1681917121420,BIMM 100,A01,192019,Staff,0,0,32,32
1681917121420,BIMM 100,A02,192020,Staff,23,0,32,9
1681917121420,BIMM 100,A03,192035,Staff,22,0,32,10
1681917122456,BIMM 110,A01,192037,Tat; John,0,0,32,32
1681917122456,BIMM 110,A02,192038,Tat; John,10,0,32,22
1681917123479,BIMM 120,A01,192040,Pickett; Brooke Elizabeth,2,0,32,30
1681917123479,BIMM 120,A02,192041,Pickett; Brooke Elizabeth,16,0,32,16
1681917123479,BIMM 120,A03,192042,Pickett; Brooke Elizabeth,15,0,32,17
1681917124510,BIPN 100,A01,192044,Armour; Jon Christopher,26,0,32,6
1681917124510,BIPN 100,A02,192059,Armour; Jon Christopher,30,0,32,2
1681917124510,BIPN 100,A03,192064,Armour; Jon Christopher,31,0,32,1
1681917124510,BIPN 100,A04,192073,Armour; Jon Christopher,28,0,32,4
1681917125533,BIPN 148,A01,205411,Leutgeb; Jill K.,16,0,32,16
1681917125533,BIPN 148,A02,205412,Leutgeb; Jill K.,31,0,32,1
1681917125533,BIPN 148,A03,205413,Leutgeb; Jill K.,30,0,32,2
1681917125533,BIPN 148,A04,205414,Leutgeb; Jill K.,30,0,32,2
1681917126556,BIPN 160,A01,192115,Marino; Marc J,18,0,32,14
1681917126556,BIPN 160,A02,192148,Marino; Marc J,27,0,32,5
1681917126556,BIPN 160,A03,192158,Marino; Marc J,31,0,32,1
1681917126556,BIPN 160,A04,192190,Marino; Marc J,32,0,32,0
1681917126556,BIPN 160,A05,192287,Marino; Marc J,32,0,32,0
1681917126556,BIPN 160,A06,192288,Marino; Marc J,32,0,32,0
1681917127584,BIPN 194,A00,206038,Staff,28,0,32,4
1681917128606,BISP 194,A00,192289,Leutgeb; Stefan,13,0,32,19
1681917128606,BISP 194,B00,245332,Nieh; James Charles,27,0,32,5
1681917129629,CAT 124,A01,202247,Staff,15,0,15,0
1681917130661,CAT 125,A00,202248,Staff,19,0,20,1
1681917130661,CAT 125,B00,202253,Staff,20,0,20,0
1681917130661,CAT 125,C00,202257,Staff,18,0,20,2
1681917131688,CAT 125GS,A01,202273,Bronstein; Phoebe Malan,20,0,20,0
1681917132716,CAT 125R,A00,202284,Staff,17,0,20,3
1681917132716,CAT 125R,C00,202286,Staff,10,0,20,10
1681917132716,CAT 125R,D00,202291,Staff,18,0,20,2
1681917132716,CAT 125R,E00,202295,Staff,13,0,20,7
1681917132716,CAT 125R,F00,202302,Staff,12,0,20,8
1681917133739,CENG 100,A00,204724,Opatkiewicz; Justin Paul,25,0,25,0
1681917134762,CGS 2A,A01,180420,Staff,31,0,36,5
1681917135787,CGS 101,A00,180421,Staff,16,0,20,4
1681917136809,CGS 112,A00,180422,Staff,9,0,16,7
1681917137832,CGS 113,A00,180423,Staff,18,0,20,2
1681917138858,CGS 137,A00,180424,Staff,12,0,12,0
1681917139883,CGS 147,A00,180425,Staff,10,0,10,0
1681917140907,CHEM 6A,A01,179556,Staff,97,0,100,3
1681917140907,CHEM 6A,A02,179558,Staff,0,0,0,0
1681917141936,CHEM 6B,A01,179560,Staff,100,0,100,0
1681917142964,CHEM 6C,A01,179565,Jazzar; Rodolphe,95,0,100,5
1681917143989,CHEM 7L,A01,179586,Schurmeier; Kimberly,13,0,24,11
1681917143989,CHEM 7L,A02,179587,Schurmeier; Kimberly,23,0,24,1
1681917143989,CHEM 7L,A03,179590,Schurmeier; Kimberly,22,0,24,2
1681917143989,CHEM 7L,A04,179591,Schurmeier; Kimberly,22,0,24,2
1681917143989,CHEM 7L,B01,179598,Schurmeier; Kimberly,17,0,24,7
1681917143989,CHEM 7L,B02,179599,Schurmeier; Kimberly,24,0,24,0
1681917143989,CHEM 7L,B03,179606,Schurmeier; Kimberly,23,0,24,1
1681917143989,CHEM 7L,B04,179607,Schurmeier; Kimberly,23,0,24,1
1681917145011,CHEM 11,A01,179609,Stallings; Dontarie M,88,0,100,12
1681917146033,CHEM 40A,A01,179621,Staff,41,0,50,9
1681917146033,CHEM 40A,A02,179622,Staff,47,0,50,3
1681917147056,CHEM 40B,A01,179630,Weizman; Haim,48,0,50,2
1681917147056,CHEM 40B,A02,179631,Weizman; Haim,45,0,50,5
1681917148080,CHEM 41A,A01,179660,Klosterman; Jeremy K,93,0,100,7
1681917149114,CHEM 43A,A01,179683,Klosterman; Jeremy K,0,0,24,24
1681917149114,CHEM 43A,A02,179688,Klosterman; Jeremy K,13,0,24,11
1681917149114,CHEM 43A,A03,179689,Klosterman; Jeremy K,20,0,24,4
1681917149114,CHEM 43A,A04,179691,Klosterman; Jeremy K,18,0,24,6
1681917150137,CHEM 114A,A01,179693,Stallings; Dontarie M,76,0,100,24
1681917151165,CHEM 143B,A01,179698,Weizman; Haim,17,0,24,7
1681917151165,CHEM 143B,A02,179700,Weizman; Haim,24,0,24,0
1681917152195,CHIN 169A,A00,179701,Wang; Xiao,20,0,20,0
1681917153261,COGS 2,A01,179750,Boyle; Mary E. T.,17,0,30,13
1681917154284,COGS 9,A01,179759,Jones; Cameron Robert,43,0,50,7
1681917155310,COGS 14A,A01,179854,Staff,18,0,50,32
1681917156336,COGS 14B,A01,179856,Staff,54,0,60,6
1681917157363,COGS 17,A01,179874,Staff,71,0,75,4
1681917158385,COGS 18,A01,179884,Staff,63,0,80,17
1681917159408,COGS 100,A01,179886,Staff,40,0,60,20
1681917160431,COGS 101B,A01,179892,Staff,1,0,30,29
1681917161465,COGS 101C,A01,179894,Staff,28,0,30,2
1681917162489,COGS 107A,A01,179896,Boyle; Mary E. T.,31,0,40,9
1681917163516,COGS 108,A01,179898,Simpkins; Charles Alexander,0,18,60,60
1681917164538,COGS 109,A01,179900,Staff,34,0,40,6
1681917165561,COGS 118A,A01,179946,Staff,9,0,40,31
1681917166594,COGS 153,A00,179978,Staff,0,0,30,30
1681917167619,COGS 156,A01,179981,Staff,27,0,30,3
1681917169672,COGS 172,A01,179987,Staff,13,0,30,17
1681917171720,COGS 186,A01,179991,Staff,12,0,30,18
1681917172745,COMM 10,A01,180001,Staff,15,0,25,10
1681917172745,COMM 10,A02,180004,Staff,20,0,25,5
1681917173782,COMM 100A,A01,180016,Staff,18,0,25,7
1681917173782,COMM 100A,A02,180020,Staff,24,0,25,1
1681917174810,COMM 101T,A00,180029,Halm; Gavin Patrick,23,0,35,12
1681917175842,COMM 106V,A00,180043,Staff,34,0,35,1
1681917176880,COMM 109P,A00,180044,Staff,31,0,35,4
1681917177905,COMM 113T,A00,180045,Havis; Allan,37,0,45,8
1681917178931,COMM 132,A00,180046,McKenna; Denise,23,0,30,7
1681917179957,COMM 143,A00,180047,Staff,19,0,30,11
1681917180981,COMM 190,A00,180048,Conner; Thomas Hartnell,20,0,23,3
1681917182007,CSE 8A,A50,180053,Cao; Yingjun,25,0,50,25
1681917182007,CSE 8A,B50,180180,Staff,50,0,50,0
1681917183029,CSE 11,A01,180190,Cao; Yingjun,30,0,50,20
1681917184054,CSE 20,A01,180192,Briones; Jor-el Thomas Caparas,23,0,30,7
1681917185077,CSE 21,A01,194538,Briones; Jor-el Thomas Caparas,50,0,60,10
1681917186109,CSE 30,A01,180324,Eldon; John,77,0,100,23
1681917187133,CSE 101,A01,201353,Staff,0,21,40,40
1681917188155,CSE 134B,A01,180326,Powell; Thomas Allan,74,0,100,26
1681917189178,CSE 140,A01,180328,Staff,46,0,75,29
1681917190200,CSE 140L,A01,180344,Eldon; John,69,0,100,31
1681917191224,CSE 150A,A01,180411,Staff,0,7,50,50
1681917192251,CSE 151A,A01,180414,Staff,0,6,50,50
1681917193274,CSE 175,A01,222521,Kumar; Rakesh,50,0,50,0
1681917194379,CSE 190,A00,201419,Staff,45,0,49,4
1681917195400,CSS 1,A01,194536,Staff,38,0,50,12
1681917196425,DSC 30,A01,202385,Staff,48,0,50,2
1681917197450,DSC 40A,A01,202387,Albuyeh; Rod,50,0,50,0
1681917198474,DSC 190,A01,202389,Silberman; Jack,21,0,21,0
1681917199497,DSGN 100,A01,179993,Staff,16,0,30,14
1681917200519,ECE 65,A50,180708,Staff,10,0,20,10
1681917200519,ECE 65,A51,180739,Staff,19,0,20,1
1681917201545,ECON 1,A01,180427,Famulari; Melissa,67,0,70,3
1681917202573,ECON 2,A01,180450,Levkoff; Steven B.,64,0,70,6
1681917203596,ECON 4,A01,203351,Anderson; John Charles,7,0,10,3
1681917204619,ECON 100A,A01,180472,Famulari; Melissa,65,0,70,5
1681917205641,ECON 120A,A01,180549,Staff,64,0,70,6
1681917206664,ECON 120B,A01,180655,Ma; Xinwei,45,0,70,25
1681917207686,ECON 129,A00,203333,Eckert; Fabian Paul,15,0,35,20
1681917208711,ECON 131,A00,180656,Staff,8,0,35,27
1681917209736,ECON 172B,A01,180672,Levkoff; Steven B.,32,0,35,3
1681917210764,ECON 178,A01,203342,Zhu; Ying,10,0,35,25
1681917211790,EDS 108GS,A00,202383,Wishard Guerra; Alison G.,20,0,20,0
1681917212815,EDS 111GS,A00,202347,Wishard Guerra; Alison G.,20,0,20,0
1681917213841,EDS 112,A01,202323,Staff,56,0,60,4
1681917214864,EDS 113,A00,202340,Staff,33,0,35,2
1681917215889,EDS 118,A00,201231,Staff,20,0,30,10
1681917216911,EDS 119,A00,204994,Staff,8,0,10,2
1681917217932,EDS 124BR,A00,202324,Eguchi; Emi,4,0,25,21
1681917218955,EDS 126,A01,203208,Jones; Makeba,26,0,30,4
1681917219978,EDS 135,A01,202333,Staff,18,0,20,2
1681917221001,EDS 180,A00,202311,Staff,47,0,50,3
1681917222025,ERC 190GS,A01,253747,Staff,28,0,28,0
1681917223050,ETHN 104,A00,180742,Staff,24,0,35,11
1681917224073,ETHN 118,A00,180745,Staff,28,0,35,7
1681917225097,ETHN 127,A00,180747,Staff,12,0,16,4
1681917226121,ETHN 137,A00,180880,Staff,12,0,12,0
1681917227148,ETHN 147,A00,180890,Staff,8,0,10,2
1681917228171,ETHN 154,A00,180891,Staff,7,0,8,1
1681917229198,ETHN 168,A00,180892,Staff,9,0,10,1
1681917230222,GLBH 20,A00,201051,Hannah; Seth Donal,0,1,0,1
1681917231247,GLBH 111,A01,209338,Burgos; Jose L.,0,0,0,0
1681917232272,GLBH 150,A00,258300,Staff,0,3,0,0
1681917233303,GLBH 181,A00,201207,Staff,15,0,40,25
1681917234327,HIEU 109,A00,180898,Staff,20,0,20,0
1681917235352,HIEU 111,A00,180899,Staff,0,0,20,20
1681917236378,HIEU 124,A00,180900,Staff,18,0,20,2
1681917237401,HILA 122,A00,180901,Staff,18,0,20,2
1681917238424,HILA 132,A00,180902,Vitz; Matthew,2,0,20,18
1681917239449,HILD 10,A01,180896,Staff,15,0,20,5
1681917240471,HILD 30GS,A00,180897,Edington; Claire Ellen,0,0,0,0
1681917241495,HISC 105,A00,180903,Staff,20,0,20,0
1681917242517,HISC 117,A00,180904,Staff,11,0,20,9
1681917243538,HIUS 108B,A00,181005,Staff,18,0,20,2
1681917244564,HIUS 113,A00,181093,Staff,3,0,20,17
1681917245588,HUM 3,A01,181190,Patterson; Patrick H.,40,0,50,10
1681917245588,HUM 3,B01,181195,Staff,46,0,50,4
1681917246613,HUM 3GS,A00,181196,Herbst; Matthew,0,0,0,0
1681917247637,HUM 4,A01,181227,West; Geoffrey Scott,34,0,50,16
1681917247637,HUM 4,B01,181282,Staff,43,0,50,7
1681917248662,HUM 4GS,A00,181377,Lyon; Antony J.,0,0,0,0
1681917249684,HUM 5,A01,181536,Zavodny; Tatiana Sophia,31,0,50,19
1681917249684,HUM 5,B01,181908,Staff,36,0,50,14
1681917250710,INTL 190,A00,181909,Segui; Alan S,0,0,0,6
1681917250710,INTL 190,B00,181961,Segui; Alan S,0,0,0,7
1681917251733,JAPN 20AR,A01,182113,Ross; Kayoko F,15,0,20,5
1681917252762,LATI 50,A01,202391,Martin-Cabrera; Luis,19,0,30,11
1681917252762,LATI 50,A02,202392,Martin-Cabrera; Luis,26,0,30,4
1681917253785,LATI 180,A00,202393,Kokinis; Troy Andreas,25,0,25,0
1681917254811,LIFR 1A,A00,182119,Staff,14,0,14,0
1681917255836,LIFR 1AX,A00,182324,Staff,14,0,14,0
1681917256866,LIFR 1B,A00,182259,Staff,14,0,14,0
1681917257891,LIFR 1BX,A00,182273,Staff,14,0,14,0
1681917258914,LIGN 8,A00,182330,Staff,137,0,150,13
1681917259937,LIGN 9GS,A00,182362,Staff,20,0,20,0
1681917260961,LIGN 119,A00,204992,Takahashi; Maho,12,0,15,3
1681917261984,LIGN 130,A01,182384,Staff,47,0,50,3
1681917263006,LIGN 149GS,A00,182390,Staff,20,0,20,0
1681917264031,LIGN 170,A00,182404,Staff,24,0,30,6
1681917265069,LISP 1D,A00,182281,Staff,7,0,14,7
1681917265069,LISP 1D,B00,182287,Staff,14,0,14,0
1681917265069,LISP 1D,C00,182295,Staff,11,0,14,3
1681917265069,LISP 1D,D00,182301,Staff,14,0,14,0
1681917266091,LISP 1DX,A00,182309,Staff,20,0,28,8
1681917266091,LISP 1DX,B00,182316,Staff,26,0,28,2
1681917267114,LTAF 120GS,A00,182412,Zhiri; Oumelbanine,20,0,20,0
1681917268136,LTCS 172GS,A00,182437,Bronstein; Phoebe Malan,20,0,20,0
1681917269167,LTEA 138,A00,182457,Staff,21,0,40,19
1681917270190,LTEN 114,A01,182490,Staff,23,0,25,2
1681917271225,LTEN 130GS,A00,182491,Lyon; Antony J.,20,0,20,0
1681917272253,LTEN 169,A00,182493,Cuong; Marisol,20,0,25,5
1681917273285,LTEN 178,A00,182501,Staff,14,0,15,1
1681917274308,LTEN 181,A00,182515,Staff,22,0,25,3
1681917275334,LTEN 185GS,A00,197655,Forbes; Camille,20,0,20,0
1681917276357,LTSP 100B,A00,202208,Bessett; Ryan Matthew,24,0,25,1
1681917277383,LTWL 100,A00,182516,Myerston Santana; Jacobo,22,0,30,8
1681917278416,LTWR 100GS,A00,182518,Forbes; Camille,20,0,20,0
1681917279446,LTWR 102,A00,182522,Staff,15,0,15,0
1681917279446,LTWR 102,B00,182525,Staff,14,0,15,1
1681917280469,LTWR 115,A00,182526,Staff,11,0,15,4
1681917281497,MAE 8,A01,182528,Pham; Hieu Tan,68,0,70,2
1681917282520,MAE 11,A00,182529,Bahadori; Mohammad Yousef,94,0,100,6
1681917283545,MAE 20,A00,182530,Evdokimenko; Ekaterina,68,0,70,2
1681917284569,MAE 30A,A00,182532,Staff,44,0,45,1
1681917285593,MAE 101A,A00,182533,Bahadori; Mohammad Yousef,97,0,100,3
1681917286618,MAE 101C,A00,182538,Staff,62,0,70,8
1681917287650,MAE 104,A00,182539,Staff,45,0,50,5
1681917288683,MAE 131A,A00,182540,Ghazinejad; Maziar,41,0,45,4
1681917289707,MAE 143A,A00,182548,Bewley; Thomas R,43,0,50,7
1681917290728,MAE 150,A00,182549,Staff,28,0,40,12
1681917291752,MAE 160,A00,182550,Evdokimenko; Ekaterina,43,0,60,17
1681917292780,MATH 3C,A01,182725,Staff,27,0,30,3
1681917293803,MATH 10A,A01,182729,Staff,25,0,30,5
1681917293803,MATH 10A,B01,182732,Staff,26,0,30,4
1681917294827,MATH 10B,A01,182737,Staff,21,0,30,9
1681917294827,MATH 10B,A02,182738,Staff,27,0,30,3
1681917294827,MATH 10B,B01,182744,Staff,27,0,30,3
1681917294827,MATH 10B,B02,182745,Staff,27,0,30,3
1681917295854,MATH 18,A01,182750,Anzaldo; Leesa B,28,0,30,2
1681917295854,MATH 18,A02,182751,Anzaldo; Leesa B,29,0,30,1
1681917295854,MATH 18,A03,182753,Anzaldo; Leesa B,28,0,30,2
1681917295854,MATH 18,A04,182757,Anzaldo; Leesa B,29,0,30,1
1681917295854,MATH 18,B01,182761,Anzaldo; Leesa B,27,0,30,3
1681917295854,MATH 18,B02,182764,Anzaldo; Leesa B,27,0,30,3
1681917295854,MATH 18,B03,182765,Anzaldo; Leesa B,30,0,30,0
1681917295854,MATH 18,B04,182766,Anzaldo; Leesa B,30,0,30,0
1681917296883,MATH 20A,A01,182771,Suk; Andrew Hoon,28,0,30,2
1681917297981,MATH 20B,A01,182775,Bach; Quang Tran,30,0,30,0
1681917297981,MATH 20B,A02,182777,Bach; Quang Tran,29,0,30,1
1681917297981,MATH 20B,B01,182780,Bach; Quang Tran,27,0,30,3
1681917297981,MATH 20B,B02,182782,Bach; Quang Tran,30,0,30,0
1681917299009,MATH 20C,A01,182787,Staff,25,0,30,5
1681917299009,MATH 20C,A02,182790,Staff,29,0,30,1
1681917299009,MATH 20C,B01,182792,Staff,25,0,30,5
1681917299009,MATH 20C,B02,182796,Staff,27,0,30,3
1681917300035,MATH 20D,A01,182799,Staff,29,0,30,1
1681917300035,MATH 20D,A02,182802,Staff,30,0,30,0
1681917300035,MATH 20D,A03,182803,Staff,30,0,30,0
1681917301063,MATH 20E,A01,182809,Verstraete; Jacques Allan,24,0,30,6
1681917301063,MATH 20E,A02,182811,Verstraete; Jacques Allan,28,0,30,2
1681917301063,MATH 20E,B01,182814,Verstraete; Jacques Allan,23,0,30,7
1681917301063,MATH 20E,B02,182815,Verstraete; Jacques Allan,30,0,30,0
1681917302095,MATH 103A,A01,182820,Staff,9,0,30,21
1681917302095,MATH 103A,A02,182821,Staff,27,0,30,3
1681917302095,MATH 103A,A03,182822,Staff,23,0,30,7
1681917302095,MATH 103A,B01,182825,Staff,23,0,30,7
1681917302095,MATH 103A,B02,182826,Staff,30,0,30,0
1681917302095,MATH 103A,B03,182830,Staff,30,0,30,0
1681917303132,MATH 109,A01,182836,Chow; Bennett,24,0,30,6
1681917303132,MATH 109,A02,182838,Chow; Bennett,29,0,30,1
1681917303132,MATH 109,A03,182894,Chow; Bennett,29,0,30,1
1681917303132,MATH 109,B01,182908,Chow; Bennett,28,0,30,2
1681917303132,MATH 109,B02,182909,Chow; Bennett,30,0,30,0
1681917303132,MATH 109,B03,182910,Chow; Bennett,27,0,30,3
1681917304155,MATH 142A,A01,182925,Staff,11,0,30,19
1681917304155,MATH 142A,A02,182935,Staff,24,0,30,6
1681917304155,MATH 142A,A03,182967,Staff,26,0,30,4
1681917304155,MATH 142A,B01,183125,Staff,24,0,30,6
1681917304155,MATH 142A,B02,183157,Staff,28,0,30,2
1681917304155,MATH 142A,B03,183158,Staff,29,0,30,1
1681917305178,MATH 183,A01,183160,Arias-Castro; Ery,23,0,30,7
1681917305178,MATH 183,A02,183161,Arias-Castro; Ery,29,0,30,1
1681917305178,MATH 183,B01,183163,Arias-Castro; Ery,28,0,30,2
1681917305178,MATH 183,B02,183164,Arias-Castro; Ery,28,0,30,2
1681917306200,MATH 193A,A01,183167,Staff,4,0,35,31
1681917306200,MATH 193A,A02,183168,Staff,28,0,35,7
1681917306200,MATH 193A,A03,183169,Staff,34,0,35,1
1681917306200,MATH 193A,A04,183170,Staff,28,0,35,7
1681917307226,MGT 4,A01,202395,Anderson; John Charles,75,0,80,5
1681917308252,MGT 5,A00,202396,Houskeeper; Robert,80,0,90,10
1681917309274,MGT 103,A00,202397,Eberhard; Craig A,54,0,90,36
1681917310297,MGT 131A,A00,202398,Houskeeper; Robert,85,0,90,5
1681917311324,MGT 135,A00,202399,Anderson; John Charles,82,0,90,8
1681917312349,MGT 162R,A00,202403,Gneezy; Uri,148,0,200,52
1681917313372,MGT 172,A00,202404,Hedges; Kathleen,49,0,90,41
1681917314395,MGT 181,A00,202405,Dunn; Louis Jean,84,0,90,6
1681917315418,MMW 14,A01,183200,Staff,15,0,28,13
1681917315418,MMW 14,A02,183201,Staff,26,0,28,2
1681917315418,MMW 14,A03,183202,Staff,24,0,28,4
1681917315418,MMW 14,A04,183203,Staff,25,0,28,3
1681917315418,MMW 14,A05,183204,Staff,26,0,28,2
1681917315418,MMW 14,A06,183205,Staff,27,0,28,1
1681917315418,MMW 14,B01,183207,Staff,26,0,28,2
1681917315418,MMW 14,B02,183208,Staff,28,0,28,0
1681917315418,MMW 14,B03,183209,Staff,28,0,28,0
1681917315418,MMW 14,B04,183210,Staff,28,0,28,0
1681917315418,MMW 14,B05,183211,Staff,28,0,28,0
1681917315418,MMW 14,B06,183212,Staff,28,0,28,0
1681917316440,MMW 14GS,A00,183213,Zhiri; Oumelbanine,28,0,28,0
1681917317462,MMW 15GS,B00,183215,Rahimi; Babak,28,0,28,0
1681917318488,MMW 121,A01,183217,Patterson; Patrick H.,14,0,28,14
1681917318488,MMW 121,A02,183218,Patterson; Patrick H.,25,0,28,3
1681917319517,MUS 1A,A01,182554,Staff,7,0,35,28
1681917320539,MUS 5,A01,182558,Staff,19,0,35,16
1681917321563,MUS 6,A01,182562,Staff,25,0,35,10
1681917322586,MUS 8GS,A00,182563,Borgo; David Garcia,25,0,25,0
1681917323607,MUS 13,A01,182567,Staff,24,0,25,1
1681917324638,MUS 15,A01,182570,Staff,32,0,35,3
1681917324638,MUS 15,B01,182575,Staff,10,0,35,25
1681917325661,MUS 80,A00,182578,Staff,23,0,25,2
1681917325661,MUS 80,B00,182581,Staff,20,0,25,5
1681917326683,MUS 113,A00,182582,Staff,25,0,25,0
1681917327768,MUS 114,A00,182583,Staff,4,0,25,21
1681917328794,MUS 150GS,A01,182588,Borgo; David Garcia,25,0,25,0
1681917329817,PHIL 1,A00,182590,Staff,35,0,40,5
1681917330840,PHIL 10,A01,182596,Grush; Rick Scott,31,0,35,4
1681917330840,PHIL 10,A02,182597,Grush; Rick Scott,34,0,35,1
1681917331870,PHIL 15,A01,182601,Staff,31,0,35,4
1681917331870,PHIL 15,A02,182602,Staff,33,0,35,2
1681917332894,PHIL 27,A01,182604,Staff,30,0,35,5
1681917332894,PHIL 27,A02,182607,Staff,35,0,35,0
1681917333919,PHIL 32,A01,182609,Staff,35,0,35,0
1681917333919,PHIL 32,A02,182612,Staff,35,0,35,0
1681917334942,PHIL 130,A00,182614,Staff,63,0,70,7
1681917335965,PHIL 136,A00,182616,Cohen; Jonathan David,66,0,70,4
1681917336987,PHIL 155,A00,182617,Vargas; Manuel Rogelio,60,0,70,10
1681917338013,PHIL 163,A01,182620,Staff,15,0,20,5
1681917338013,PHIL 163,A02,182624,Staff,10,0,20,10
1681917339035,PHIL 164,A00,182627,Staff,30,0,40,10
1681917340058,PHIL 173,A00,182628,Staff,36,0,40,4
1681917341080,PHYS 1A,A00,183221,Staff,54,0,60,6
1681917342103,PHYS 1AL,001,183222,Staff,25,0,30,5
1681917342103,PHYS 1AL,002,183223,Staff,28,0,30,2
1681917343129,PHYS 1B,A00,183231,Staff,43,0,60,17
1681917344151,PHYS 1BL,001,183232,Staff,20,0,30,10
1681917344151,PHYS 1BL,002,183233,Staff,28,0,30,2
1681917345174,PHYS 1C,A00,183240,Staff,30,0,60,30
1681917346205,PHYS 1CL,001,183241,Staff,13,0,30,17
1681917346205,PHYS 1CL,002,183242,Staff,22,0,30,8
1681917347227,PHYS 2AR,A01,183250,Staff,44,0,50,6
1681917348250,PHYS 2B,A01,183252,Staff,105,0,115,10
1681917349274,PHYS 2BL,A01,183254,Staff,21,0,24,3
1681917349274,PHYS 2BL,A02,183255,Staff,22,0,24,2
1681917350305,PHYS 2C,A01,183522,Staff,105,0,115,10
1681917351331,PHYS 4A,A01,183524,Staff,49,0,50,1
1681917352357,POLI 5,A00,183525,Staff,44,0,50,6
1681917353382,POLI 12,A00,183540,Staff,48,0,50,2
1681917354405,POLI 13R,A00,183541,Forman; Fonna,42,0,50,8
1681917355428,POLI 30,A00,183542,Mignozzetti; Umberto,47,0,50,3
1681917356453,POLI 100A,A00,183543,Staff,45,0,50,5
1681917357476,POLI 100E,A00,223598,Staff,32,0,35,3
1681917358502,POLI 103A,A00,183564,Kousser; Thad,38,0,50,12
1681917359526,POLI 104B,A00,201329,Staff,29,0,35,6
1681917360551,POLI 113BR,A00,183576,Hoston; Germaine,26,0,50,24
1681917361575,POLI 114BR,A00,183588,Staff,27,0,30,3
1681917362600,POLI 117R,A00,183595,Forman; Fonna,9,0,20,11
1681917363625,POLI 120H,A00,183596,Fisk; David Lee,13,0,20,7
1681917364649,POLI 130AA,A00,183597,Staff,14,0,20,6
1681917365672,POLI 134AA,A00,183598,Staff,19,0,20,1
1681917366705,POLI 135,A00,183599,Fisk; David Lee,20,0,25,5
1681917367733,POLI 142P,A00,183623,Staff,37,0,40,3
1681917368758,POLI 144D,A00,183624,Staff,22,0,25,3
1681917369787,POLI 151,A00,183625,Staff,15,0,20,5
1681917370810,POLI 162,A00,183626,Mignozzetti; Umberto,18,0,20,2
1681917371841,PSYC 1,A00,253748,Staff,86,0,90,4
1681917372868,PSYC 2,A00,183627,Moranton; Nirelia Melbina-,25,0,35,10
1681917373896,PSYC 3,A00,183628,Staff,43,0,45,2
1681917375955,PSYC 60,A01,183631,Lowe; Angela Beth,35,0,40,5
1681917376981,PSYC 70,A01,253757,Staff,37,0,45,8
1681917378009,PSYC 101,A00,183632,Heyman; Gail D.,48,0,60,12
1681917379039,PSYC 105,A00,183848,Lowe; Angela Beth,49,0,60,11
1681917380061,PSYC 106,A00,183849,Dobkins; Karen R.,44,0,60,16
1681917381087,PSYC 108,A00,253750,Staff,24,0,60,36
1681917382109,PSYC 114,A01,184275,Winkielman; Piotr,0,7,30,30
1681917383134,PSYC 122,A00,183856,Moranton; Nirelia Melbina-,0,10,30,30
1681917384161,PSYC 124,A00,183865,Chapman; Eddie Nathaniel,52,0,80,28
1681917385188,PSYC 137,A00,183880,Staff,19,0,25,6
1681917387239,PSYC 154,A00,183910,Lacefield; Katharine I,0,5,90,90
1681917389290,PSYC 162,A00,183946,Wixted; John T,61,0,90,29
1681917390313,PSYC 172,A00,183947,Gorman; Michael R.,13,0,30,17
1681917391338,PSYC 178,A00,183963,Glaser; Dale,20,0,40,20
1681917392360,PSYC 181GS,A00,183964,Anagnostaras; Stephan,10,0,10,0
1681917393384,PSYC 186GS,A01,257660,Staff,10,0,10,0
1681917394417,PSYC 193,B00,253749,Staff,23,0,25,2
1681917396469,PSYC 193L,A01,184122,Staff,33,0,35,2
1681917396469,PSYC 193L,C01,184167,Winkielman; Piotr,15,0,30,15
1681917397494,RELI 188GS,A00,182629,Rahimi; Babak,20,0,20,0
1681917398520,SE 101A,A00,182646,Staff,26,0,30,4
1681917399554,SE 101C,A00,182650,Staff,18,0,20,2
1681917400578,SE 110A,A00,182651,Staff,28,0,28,0
1681917401675,SE 130A,A00,182652,Staff,39,0,40,1
1681917402701,SIO 46GS,A00,182636,Cook; Geoffrey W,28,0,28,0
1681917403744,SIO 109R,A00,194459,Staff,5,0,20,15
1681917404767,SIO 121GS,A00,182639,Cook; Geoffrey W,28,0,28,0
1681917405793,SIO 132,A01,182642,Staff,32,0,40,8
1681917406815,SIO 139,A00,182644,Kacev; David,36,0,40,4
1681917407838,SOCI 2,A01,258404,Staff,34,0,36,2
1681917407838,SOCI 2,A02,258405,Staff,35,0,36,1
1681917408860,SOCI 60,A01,258408,Staff,29,0,30,1
1681917408860,SOCI 60,A02,258413,Staff,30,0,30,0
1681917409891,SOCI 100,A01,258415,Staff,29,0,30,1
1681917409891,SOCI 100,A02,258416,Staff,28,0,30,2
1681917416042,SOCI 127,A00,258421,Staff,22,0,30,8
1681917417064,SOCI 132,A00,258422,Staff,45,0,50,5
1681917418093,SOCI 133,A00,258423,Staff,26,0,30,4
1681917419116,SOCI 138GS,A00,258424,Staff,15,0,15,0
1681917420139,SOCI 145,A00,258425,Staff,25,0,30,5
1681917421169,SOCI 148,A00,258426,Staff,26,0,30,4
1681917422191,SOCI 153,A00,199217,Staff,29,0,30,1
1681917423215,SOCI 160,A00,258427,Staff,28,0,30,2
1681917424238,SOCI 160E,A00,258435,Staff,56,0,60,4
1681917425264,SOCI 189GS,A00,258436,Staff,15,0,15,0
1681917426300,SOCI 190GS,A00,258437,Staff,15,0,15,0
1681917427326,SYN 2,001,182658,Staff,9,0,16,7
1681917427326,SYN 2,002,201439,Staff,15,0,16,1
1681917427326,SYN 2,003,201443,Staff,16,0,16,0
1681917428361,SYN 100,A01,182657,Staff,17,0,20,3
1681917429383,TDAC 1,A00,184381,Salovey; Todd,16,0,20,4
1681917429383,TDAC 1,B00,184385,Harting; Carla Kelso,19,0,20,1
1681917429383,TDAC 1,C00,184394,Staff,19,0,20,1
1681917430405,TDAC 101,A00,184483,Harting; Carla Kelso,19,0,20,1
1681917431429,TDDE 111,A00,184496,Staff,14,0,15,1
1681917432452,TDDE 131,A00,184504,Staff,20,0,20,0
1681917432452,TDDE 131,B00,184505,Staff,17,0,18,1
1681917432452,TDDE 131,C00,184534,Staff,49,0,50,1
1681917432452,TDDE 131,D00,184564,Staff,15,0,15,0
1681917432452,TDDE 131,E00,204725,Staff,19,0,20,1
1681917433478,TDGE 1,A01,184414,Salovey; Todd,36,0,50,14
1681917434506,TDGE 5,A01,184419,Staff,23,0,24,1
1681917435529,TDGE 10,A00,184428,Fulton; Julia,30,0,50,20
1681917436555,TDGE 124,A00,184565,Fulton; Julia,7,0,50,43
1681917437577,TDGE 125,B00,184567,Meyer; Ursula,9,0,25,16
1681917438604,TDHT 101,A00,184568,Staff,21,0,25,4
1681917438604,TDHT 101,B00,184569,Staff,20,0,20,0
1681917439628,TDHT 114,A00,184570,Staff,49,0,50,1
1681917440654,TDMV 1,A00,184437,Arcidiacono; Kristin,23,0,30,7
1681917440654,TDMV 1,B00,184448,Caligagan; Maria T.,22,0,30,8
1681917441677,TDMV 2,A00,184449,Weinberg; Sadie,27,0,30,3
1681917441677,TDMV 2,B00,184453,Arcidiacono; Kristin,29,0,30,1
1681917442698,TDMV 110,A00,184571,Weinberg; Sadie,30,0,30,0
1681917443738,TDMV 142,A00,184572,Caligagan; Tony,27,0,30,3
1681917443738,TDMV 142,B00,184573,Caligagan; Maria T.,27,0,30,3
1681917444769,TDTR 20,A00,184482,Jun; Grace Shin Hae,25,0,25,0
1681917445792,USP 2,A01,184290,Hinds; Juli Beth,24,0,25,1
1681917446819,USP 3,A01,184295,Staff,20,0,25,5
1681917447844,USP 4,A00,184304,McTague; Sarah,15,0,25,10
1681917448870,USP 100,A00,184315,Staff,17,0,25,8
1681917449897,USP 105,A00,184326,Staff,21,0,25,4
1681917450923,USP 151,A00,184327,Staff,20,0,25,5
1681917451946,USP 170,A00,184380,Hinds; Juli Beth,14,0,25,11
1681917452973,VIS 21B,A01,182660,Staff,28,0,31,3
1681917452973,VIS 21B,A02,182662,Staff,30,0,31,1
1681917454006,VIS 103D,A00,182663,Staff,74,0,75,1
1681917455032,VIS 105D,A00,182667,Li; Huai,15,0,22,7
1681917456057,VIS 122GS,A00,182668,Herbst; Matthew,20,0,20,0
1681917457079,VIS 128C,A00,182673,Staff,69,0,75,6
1681917458102,VIS 130,A00,182675,Staff,20,0,22,2
1681917459124,VIS 160A,A00,182678,Stalbaum; Brett,4,0,10,6
1681917461176,WCWP 10B,A00,201679,Staff,15,0,15,0
1681917461176,WCWP 10B,B00,201695,Staff,15,0,15,0
1681917462205,WCWP 100,A00,201716,Staff,15,0,15,0
1681917462205,WCWP 100,B00,201717,Staff,10,0,15,5
1681917464303,ANSC 105GS,A00,258289,Staff,0,0,0,0
1681917465331,ANSC 125GS,A00,258295,Staff,0,0,0,0
1681917466355,ANSC 150,A00,258267,Staff,30,0,40,10
1681917467384,ANSC 190GS,A00,258280,Staff,0,0,0,0
1681917468423,ANTH 1,A00,258264,Staff,38,0,40,2
1681917469449,ANTH 2,A01,258259,Staff,72,0,76,4
1681917470474,ANTH 23,A01,258228,Staff,36,0,40,4
1681917471497,ANTH 101,A01,258236,Staff,39,0,40,1
1681917472521,ANTH 102,A00,258272,Staff,59,0,60,1
1681917473547,ANTH 105,A00,258244,Staff,31,0,35,4
1681917474573,BENG 130,A00,253975,Staff,38,0,40,2
1681917475603,BIBC 102,A01,191866,Flagg; Matthew Paul,19,0,32,13
1681917475603,BIBC 102,A02,191867,Flagg; Matthew Paul,22,0,32,10
1681917475603,BIBC 102,A03,191868,Flagg; Matthew Paul,29,0,32,3
1681917475603,BIBC 102,A04,191936,Flagg; Matthew Paul,26,0,32,6
1681917475603,BIBC 102,A05,191937,Flagg; Matthew Paul,10,0,32,22
1681917476625,BICD 100,A01,191939,Cooper; Andrew Michael,28,0,32,4
1681917476625,BICD 100,A02,191940,Cooper; Andrew Michael,32,0,32,0
1681917476625,BICD 100,A03,191941,Cooper; Andrew Michael,32,0,32,0
1681917476625,BICD 100,A04,191942,Cooper; Andrew Michael,32,0,32,0
1681917476625,BICD 100,A05,191943,Cooper; Andrew Michael,32,0,32,0
1681917477654,BIEB 126,A01,191945,Cleland; Elsa Eleanor,0,0,32,32
1681917477654,BIEB 126,A02,191946,Cleland; Elsa Eleanor,27,0,32,5
1681917477654,BIEB 126,A03,191947,Cleland; Elsa Eleanor,29,0,32,3
1681917477654,BIEB 126,A04,191948,Cleland; Elsa Eleanor,23,0,32,9
1681917477654,BIEB 126,A05,191996,Cleland; Elsa Eleanor,28,0,32,4
1681917478681,BIEB 136GS,A00,191997,Shurin; Jonathan & Holway; David A.,0,0,0,0
1681917479703,BIEB 137GS,A01,191999,Shurin; Jonathan & Holway; David A.,0,0,0,0
1681917480931,BILD 1,A01,205385,Staff,31,0,32,1
1681917480931,BILD 1,A02,205386,Staff,30,0,32,2
1681917480931,BILD 1,A03,205387,Staff,32,0,32,0
1681917480931,BILD 1,A04,205388,Staff,28,0,32,4
1681917481954,BILD 2,A01,191774,Staff,28,0,32,4
1681917481954,BILD 2,A02,191775,Staff,30,0,32,2
1681917481954,BILD 2,A03,191777,Staff,30,0,32,2
1681917481954,BILD 2,A04,191856,Staff,31,0,32,1
1681917481954,BILD 2,A05,191857,Staff,32,0,32,0
1681917481954,BILD 2,A06,191858,Staff,32,0,32,0
1681917481954,BILD 2,A07,191859,Staff,31,0,32,1
1681917482981,BILD 3,A01,205391,Staff,29,0,32,3
1681917482981,BILD 3,A02,205393,Staff,32,0,32,0
1681917482981,BILD 3,A03,205394,Staff,28,0,32,4
1681917482981,BILD 3,A04,205395,Staff,32,0,32,0
1681917484003,BILD 20,A01,191861,Staff,32,0,32,0
1681917484003,BILD 20,A02,191862,Staff,32,0,32,0
1681917485026,BILD 30,A01,191864,Staff,31,0,32,1
1681917486049,BIMM 100,A01,192019,Staff,0,0,32,32
1681917486049,BIMM 100,A02,192020,Staff,23,0,32,9
1681917486049,BIMM 100,A03,192035,Staff,22,0,32,10
1681917487073,BIMM 110,A01,192037,Tat; John,0,0,32,32
1681917487073,BIMM 110,A02,192038,Tat; John,10,0,32,22
1681917488098,BIMM 120,A01,192040,Pickett; Brooke Elizabeth,2,0,32,30
1681917488098,BIMM 120,A02,192041,Pickett; Brooke Elizabeth,16,0,32,16
1681917488098,BIMM 120,A03,192042,Pickett; Brooke Elizabeth,15,0,32,17
1681917489121,BIPN 100,A01,192044,Armour; Jon Christopher,26,0,32,6
1681917489121,BIPN 100,A02,192059,Armour; Jon Christopher,30,0,32,2
1681917489121,BIPN 100,A03,192064,Armour; Jon Christopher,31,0,32,1
1681917489121,BIPN 100,A04,192073,Armour; Jon Christopher,28,0,32,4
1681917490156,BIPN 148,A01,205411,Leutgeb; Jill K.,16,0,32,16
1681917490156,BIPN 148,A02,205412,Leutgeb; Jill K.,31,0,32,1
1681917490156,BIPN 148,A03,205413,Leutgeb; Jill K.,30,0,32,2
1681917490156,BIPN 148,A04,205414,Leutgeb; Jill K.,30,0,32,2
1681917491180,BIPN 160,A01,192115,Marino; Marc J,18,0,32,14
1681917491180,BIPN 160,A02,192148,Marino; Marc J,27,0,32,5
1681917491180,BIPN 160,A03,192158,Marino; Marc J,31,0,32,1
1681917491180,BIPN 160,A04,192190,Marino; Marc J,32,0,32,0
1681917491180,BIPN 160,A05,192287,Marino; Marc J,32,0,32,0
1681917491180,BIPN 160,A06,192288,Marino; Marc J,32,0,32,0
1681917492208,BIPN 194,A00,206038,Staff,28,0,32,4
1681917493235,BISP 194,A00,192289,Leutgeb; Stefan,13,0,32,19
1681917493235,BISP 194,B00,245332,Nieh; James Charles,27,0,32,5
1681917494257,CAT 124,A01,202247,Staff,15,0,15,0
1681917495281,CAT 125,A00,202248,Staff,19,0,20,1
1681917495281,CAT 125,B00,202253,Staff,20,0,20,0
1681917495281,CAT 125,C00,202257,Staff,18,0,20,2
1681917496303,CAT 125GS,A01,202273,Bronstein; Phoebe Malan,20,0,20,0
1681917497325,CAT 125R,A00,202284,Staff,17,0,20,3
1681917497325,CAT 125R,C00,202286,Staff,10,0,20,10
1681917497325,CAT 125R,D00,202291,Staff,18,0,20,2
1681917497325,CAT 125R,E00,202295,Staff,13,0,20,7
1681917497325,CAT 125R,F00,202302,Staff,12,0,20,8
1681917498351,CENG 100,A00,204724,Opatkiewicz; Justin Paul,25,0,25,0
1681917499375,CGS 2A,A01,180420,Staff,31,0,36,5
1681917500406,CGS 101,A00,180421,Staff,16,0,20,4
1681917501429,CGS 112,A00,180422,Staff,9,0,16,7
1681917502452,CGS 113,A00,180423,Staff,18,0,20,2
1681917503474,CGS 137,A00,180424,Staff,12,0,12,0
1681917504502,CGS 147,A00,180425,Staff,10,0,10,0
1681917505602,CHEM 6A,A01,179556,Staff,97,0,100,3
1681917505602,CHEM 6A,A02,179558,Staff,0,0,0,0
1681917506628,CHEM 6B,A01,179560,Staff,100,0,100,0
1681917507651,CHEM 6C,A01,179565,Jazzar; Rodolphe,95,0,100,5
1681917508676,CHEM 7L,A01,179586,Schurmeier; Kimberly,13,0,24,11
1681917508676,CHEM 7L,A02,179587,Schurmeier; Kimberly,23,0,24,1
1681917508676,CHEM 7L,A03,179590,Schurmeier; Kimberly,22,0,24,2
1681917508676,CHEM 7L,A04,179591,Schurmeier; Kimberly,22,0,24,2
1681917508676,CHEM 7L,B01,179598,Schurmeier; Kimberly,17,0,24,7
1681917508676,CHEM 7L,B02,179599,Schurmeier; Kimberly,24,0,24,0
1681917508676,CHEM 7L,B03,179606,Schurmeier; Kimberly,23,0,24,1
1681917508676,CHEM 7L,B04,179607,Schurmeier; Kimberly,23,0,24,1
1681917509697,CHEM 11,A01,179609,Stallings; Dontarie M,88,0,100,12
1681917510723,CHEM 40A,A01,179621,Staff,41,0,50,9
1681917510723,CHEM 40A,A02,179622,Staff,47,0,50,3
1681917511760,CHEM 40B,A01,179630,Weizman; Haim,48,0,50,2
1681917511760,CHEM 40B,A02,179631,Weizman; Haim,45,0,50,5
1681917512788,CHEM 41A,A01,179660,Klosterman; Jeremy K,93,0,100,7
1681917513813,CHEM 43A,A01,179683,Klosterman; Jeremy K,0,0,24,24
1681917513813,CHEM 43A,A02,179688,Klosterman; Jeremy K,13,0,24,11
1681917513813,CHEM 43A,A03,179689,Klosterman; Jeremy K,20,0,24,4
1681917513813,CHEM 43A,A04,179691,Klosterman; Jeremy K,18,0,24,6
1681917514845,CHEM 114A,A01,179693,Stallings; Dontarie M,76,0,100,24
1681917515872,CHEM 143B,A01,179698,Weizman; Haim,17,0,24,7
1681917515872,CHEM 143B,A02,179700,Weizman; Haim,24,0,24,0
1681917516896,CHIN 169A,A00,179701,Wang; Xiao,20,0,20,0
1681917517919,COGS 2,A01,179750,Boyle; Mary E. T.,17,0,30,13
1681917518943,COGS 9,A01,179759,Jones; Cameron Robert,43,0,50,7
1681917519965,COGS 14A,A01,179854,Staff,18,0,50,32
1681917520995,COGS 14B,A01,179856,Staff,54,0,60,6
1681917522018,COGS 17,A01,179874,Staff,71,0,75,4
1681917523044,COGS 18,A01,179884,Staff,63,0,80,17
1681917524070,COGS 100,A01,179886,Staff,40,0,60,20
1681917525100,COGS 101B,A01,179892,Staff,1,0,30,29
1681917526126,COGS 101C,A01,179894,Staff,28,0,30,2
1681917527151,COGS 107A,A01,179896,Boyle; Mary E. T.,31,0,40,9
1681917528177,COGS 108,A01,179898,Simpkins; Charles Alexander,0,18,60,60
1681917529200,COGS 109,A01,179900,Staff,34,0,40,6
1681917530227,COGS 118A,A01,179946,Staff,9,0,40,31
1681917531251,COGS 153,A00,179978,Staff,0,0,30,30
1681917532275,COGS 156,A01,179981,Staff,27,0,30,3
1681917534338,COGS 172,A01,179987,Staff,13,0,30,17
1681917536384,COGS 186,A01,179991,Staff,12,0,30,18
1681917537406,COMM 10,A01,180001,Staff,15,0,25,10
1681917537406,COMM 10,A02,180004,Staff,19,0,25,6
1681917538429,COMM 100A,A01,180016,Staff,18,0,25,7
1681917538429,COMM 100A,A02,180020,Staff,24,0,25,1
1681917539451,COMM 101T,A00,180029,Halm; Gavin Patrick,23,0,35,12
1681917540481,COMM 106V,A00,180043,Staff,34,0,35,1
1681917541523,COMM 109P,A00,180044,Staff,31,0,35,4
1681917542554,COMM 113T,A00,180045,Havis; Allan,37,0,45,8
1681917543591,COMM 132,A00,180046,McKenna; Denise,23,0,30,7
1681917544614,COMM 143,A00,180047,Staff,19,0,30,11
1681917545636,COMM 190,A00,180048,Conner; Thomas Hartnell,20,0,23,3
1681917546661,CSE 8A,A50,180053,Cao; Yingjun,25,0,50,25
1681917546661,CSE 8A,B50,180180,Staff,50,0,50,0
1681917547689,CSE 11,A01,180190,Cao; Yingjun,30,0,50,20
1681917548713,CSE 20,A01,180192,Briones; Jor-el Thomas Caparas,23,0,30,7
1681917549740,CSE 21,A01,194538,Briones; Jor-el Thomas Caparas,50,0,60,10
1681917550766,CSE 30,A01,180324,Eldon; John,77,0,100,23
1681917551792,CSE 101,A01,201353,Staff,0,21,40,40
1681917552819,CSE 134B,A01,180326,Powell; Thomas Allan,74,0,100,26
1681917553841,CSE 140,A01,180328,Staff,46,0,75,29
1681917554871,CSE 140L,A01,180344,Eldon; John,69,0,100,31
1681917555898,CSE 150A,A01,180411,Staff,0,7,50,50
1681917556921,CSE 151A,A01,180414,Staff,0,6,50,50
1681917558000,CSE 175,A01,222521,Kumar; Rakesh,50,0,50,0
1681917559023,CSE 190,A00,201419,Staff,45,0,49,4
1681917560046,CSS 1,A01,194536,Staff,37,0,50,13
1681917561069,DSC 30,A01,202385,Staff,48,0,50,2
1681917562097,DSC 40A,A01,202387,Albuyeh; Rod,50,0,50,0
1681917563125,DSC 190,A01,202389,Silberman; Jack,21,0,21,0
1681917564160,DSGN 100,A01,179993,Staff,16,0,30,14
1681917565194,ECE 65,A50,180708,Staff,10,0,20,10
1681917565194,ECE 65,A51,180739,Staff,19,0,20,1
1681917566222,ECON 1,A01,180427,Famulari; Melissa,67,0,70,3
1681917567255,ECON 2,A01,180450,Levkoff; Steven B.,64,0,70,6
1681917568278,ECON 4,A01,203351,Anderson; John Charles,7,0,10,3
1681917569301,ECON 100A,A01,180472,Famulari; Melissa,65,0,70,5
1681917570327,ECON 120A,A01,180549,Staff,64,0,70,6
1681917571352,ECON 120B,A01,180655,Ma; Xinwei,45,0,70,25
1681917572378,ECON 129,A00,203333,Eckert; Fabian Paul,15,0,35,20
1681917573401,ECON 131,A00,180656,Staff,8,0,35,27
1681917574426,ECON 172B,A01,180672,Levkoff; Steven B.,32,0,35,3
1681917575451,ECON 178,A01,203342,Zhu; Ying,10,0,35,25
1681917576480,EDS 108GS,A00,202383,Wishard Guerra; Alison G.,20,0,20,0
1681917577507,EDS 111GS,A00,202347,Wishard Guerra; Alison G.,20,0,20,0
1681917578538,EDS 112,A01,202323,Staff,56,0,60,4
1681917579564,EDS 113,A00,202340,Staff,33,0,35,2
1681917580588,EDS 118,A00,201231,Staff,20,0,30,10
1681917581614,EDS 119,A00,204994,Staff,8,0,10,2
1681917582641,EDS 124BR,A00,202324,Eguchi; Emi,4,0,25,21
1681917583666,EDS 126,A01,203208,Jones; Makeba,26,0,30,4
1681917584688,EDS 135,A01,202333,Staff,18,0,20,2
1681917585714,EDS 180,A00,202311,Staff,47,0,50,3
1681917586739,ERC 190GS,A01,253747,Staff,28,0,28,0
1681917587761,ETHN 104,A00,180742,Staff,24,0,35,11
1681917588792,ETHN 118,A00,180745,Staff,28,0,35,7
1681917589818,ETHN 127,A00,180747,Staff,12,0,16,4
1681917590843,ETHN 137,A00,180880,Staff,12,0,12,0
1681917591866,ETHN 147,A00,180890,Staff,8,0,10,2
1681917592896,ETHN 154,A00,180891,Staff,7,0,8,1
1681917593929,ETHN 168,A00,180892,Staff,9,0,10,1
1681917594954,GLBH 20,A00,201051,Hannah; Seth Donal,0,1,0,1
1681917595980,GLBH 111,A01,209338,Burgos; Jose L.,0,0,0,0
1681917597006,GLBH 150,A00,258300,Staff,0,3,0,0
1681917598028,GLBH 181,A00,201207,Staff,15,0,40,25
1681917599053,HIEU 109,A00,180898,Staff,20,0,20,0
1681917600076,HIEU 111,A00,180899,Staff,0,0,20,20
1681917601107,HIEU 124,A00,180900,Staff,18,0,20,2
1681917602131,HILA 122,A00,180901,Staff,18,0,20,2
1681917603157,HILA 132,A00,180902,Vitz; Matthew,2,0,20,18
1681917604183,HILD 10,A01,180896,Staff,15,0,20,5
1681917605211,HILD 30GS,A00,180897,Edington; Claire Ellen,0,0,0,0
1681917606234,HISC 105,A00,180903,Staff,20,0,20,0
1681917607259,HISC 117,A00,180904,Staff,11,0,20,9
1681917608282,HIUS 108B,A00,181005,Staff,18,0,20,2
1681917609379,HIUS 113,A00,181093,Staff,3,0,20,17
1681917610404,HUM 3,A01,181190,Patterson; Patrick H.,40,0,50,10
1681917610404,HUM 3,B01,181195,Staff,46,0,50,4
1681917611426,HUM 3GS,A00,181196,Herbst; Matthew,0,0,0,0
1681917612454,HUM 4,A01,181227,West; Geoffrey Scott,34,0,50,16
1681917612454,HUM 4,B01,181282,Staff,43,0,50,7
1681917613478,HUM 4GS,A00,181377,Lyon; Antony J.,0,0,0,0
1681917614506,HUM 5,A01,181536,Zavodny; Tatiana Sophia,31,0,50,19
1681917614506,HUM 5,B01,181908,Staff,36,0,50,14
1681917615538,INTL 190,A00,181909,Segui; Alan S,0,0,0,7
1681917615538,INTL 190,B00,181961,Segui; Alan S,0,0,0,7
1681917616567,JAPN 20AR,A01,182113,Ross; Kayoko F,15,0,20,5
1681917617593,LATI 50,A01,202391,Martin-Cabrera; Luis,19,0,30,11
1681917617593,LATI 50,A02,202392,Martin-Cabrera; Luis,26,0,30,4
1681917618624,LATI 180,A00,202393,Kokinis; Troy Andreas,24,0,25,1
1681917619649,LIFR 1A,A00,182119,Staff,14,0,14,0
1681917620675,LIFR 1AX,A00,182324,Staff,14,0,14,0
1681917621699,LIFR 1B,A00,182259,Staff,14,0,14,0
1681917622722,LIFR 1BX,A00,182273,Staff,14,0,14,0
1681917623745,LIGN 8,A00,182330,Staff,137,0,150,13
1681917624772,LIGN 9GS,A00,182362,Staff,20,0,20,0
1681917625800,LIGN 119,A00,204992,Takahashi; Maho,12,0,15,3
1681917626828,LIGN 130,A01,182384,Staff,47,0,50,3
1681917627851,LIGN 149GS,A00,182390,Staff,20,0,20,0
1681917628874,LIGN 170,A00,182404,Staff,24,0,30,6
1681917629902,LISP 1D,A00,182281,Staff,7,0,14,7
1681917629902,LISP 1D,B00,182287,Staff,14,0,14,0
1681917629902,LISP 1D,C00,182295,Staff,11,0,14,3
1681917629902,LISP 1D,D00,182301,Staff,14,0,14,0
1681917630926,LISP 1DX,A00,182309,Staff,20,0,28,8
1681917630926,LISP 1DX,B00,182316,Staff,26,0,28,2
1681917631949,LTAF 120GS,A00,182412,Zhiri; Oumelbanine,20,0,20,0
1681917632979,LTCS 172GS,A00,182437,Bronstein; Phoebe Malan,20,0,20,0
1681917634002,LTEA 138,A00,182457,Staff,21,0,40,19
1681917635031,LTEN 114,A01,182490,Staff,23,0,25,2
1681917636053,LTEN 130GS,A00,182491,Lyon; Antony J.,20,0,20,0
1681917637077,LTEN 169,A00,182493,Cuong; Marisol,20,0,25,5
1681917638100,LTEN 178,A00,182501,Staff,14,0,15,1
1681917639128,LTEN 181,A00,182515,Staff,22,0,25,3
1681917640156,LTEN 185GS,A00,197655,Forbes; Camille,20,0,20,0
1681917641179,LTSP 100B,A00,202208,Bessett; Ryan Matthew,24,0,25,1
1681917642202,LTWL 100,A00,182516,Myerston Santana; Jacobo,22,0,30,8
1681917643234,LTWR 100GS,A00,182518,Forbes; Camille,20,0,20,0
1681917644257,LTWR 102,A00,182522,Staff,15,0,15,0
1681917644257,LTWR 102,B00,182525,Staff,14,0,15,1
1681917645288,LTWR 115,A00,182526,Staff,11,0,15,4
1681917646310,MAE 8,A01,182528,Pham; Hieu Tan,68,0,70,2
1681917647334,MAE 11,A00,182529,Bahadori; Mohammad Yousef,94,0,100,6
1681917648362,MAE 20,A00,182530,Evdokimenko; Ekaterina,68,0,70,2
1681917649393,MAE 30A,A00,182532,Staff,44,0,45,1
1681917650419,MAE 101A,A00,182533,Bahadori; Mohammad Yousef,97,0,100,3
1681917651447,MAE 101C,A00,182538,Staff,62,0,70,8
1681917652471,MAE 104,A00,182539,Staff,45,0,50,5
1681917653492,MAE 131A,A00,182540,Ghazinejad; Maziar,41,0,45,4
1681917654514,MAE 143A,A00,182548,Bewley; Thomas R,43,0,50,7
1681917655538,MAE 150,A00,182549,Staff,28,0,40,12
1681917656561,MAE 160,A00,182550,Evdokimenko; Ekaterina,43,0,60,17
1681917657584,MATH 3C,A01,182725,Staff,27,0,30,3
1681917658611,MATH 10A,A01,182729,Staff,25,0,30,5
1681917658611,MATH 10A,B01,182732,Staff,26,0,30,4
1681917659636,MATH 10B,A01,182737,Staff,21,0,30,9
1681917659636,MATH 10B,A02,182738,Staff,27,0,30,3
1681917659636,MATH 10B,B01,182744,Staff,27,0,30,3
1681917659636,MATH 10B,B02,182745,Staff,27,0,30,3
1681917660664,MATH 18,A01,182750,Anzaldo; Leesa B,28,0,30,2
1681917660664,MATH 18,A02,182751,Anzaldo; Leesa B,29,0,30,1
1681917660664,MATH 18,A03,182753,Anzaldo; Leesa B,28,0,30,2
1681917660664,MATH 18,A04,182757,Anzaldo; Leesa B,29,0,30,1
1681917660664,MATH 18,B01,182761,Anzaldo; Leesa B,27,0,30,3
1681917660664,MATH 18,B02,182764,Anzaldo; Leesa B,27,0,30,3
1681917660664,MATH 18,B03,182765,Anzaldo; Leesa B,30,0,30,0
1681917660664,MATH 18,B04,182766,Anzaldo; Leesa B,30,0,30,0
1681917661699,MATH 20A,A01,182771,Suk; Andrew Hoon,28,0,30,2
1681917662723,MATH 20B,A01,182775,Bach; Quang Tran,30,0,30,0
1681917662723,MATH 20B,A02,182777,Bach; Quang Tran,29,0,30,1
1681917662723,MATH 20B,B01,182780,Bach; Quang Tran,27,0,30,3
1681917662723,MATH 20B,B02,182782,Bach; Quang Tran,30,0,30,0
1681917663746,MATH 20C,A01,182787,Staff,25,0,30,5
1681917663746,MATH 20C,A02,182790,Staff,29,0,30,1
1681917663746,MATH 20C,B01,182792,Staff,25,0,30,5
1681917663746,MATH 20C,B02,182796,Staff,27,0,30,3
1681917664767,MATH 20D,A01,182799,Staff,29,0,30,1
1681917664767,MATH 20D,A02,182802,Staff,30,0,30,0
1681917664767,MATH 20D,A03,182803,Staff,30,0,30,0
1681917665789,MATH 20E,A01,182809,Verstraete; Jacques Allan,24,0,30,6
1681917665789,MATH 20E,A02,182811,Verstraete; Jacques Allan,28,0,30,2
1681917665789,MATH 20E,B01,182814,Verstraete; Jacques Allan,23,0,30,7
1681917665789,MATH 20E,B02,182815,Verstraete; Jacques Allan,30,0,30,0
1681917666819,MATH 103A,A01,182820,Staff,8,0,30,22
1681917666819,MATH 103A,A02,182821,Staff,27,0,30,3
1681917666819,MATH 103A,A03,182822,Staff,23,0,30,7
1681917666819,MATH 103A,B01,182825,Staff,23,0,30,7
1681917666819,MATH 103A,B02,182826,Staff,30,0,30,0
1681917666819,MATH 103A,B03,182830,Staff,30,0,30,0
1681917667846,MATH 109,A01,182836,Chow; Bennett,24,0,30,6
1681917667846,MATH 109,A02,182838,Chow; Bennett,29,0,30,1
1681917667846,MATH 109,A03,182894,Chow; Bennett,29,0,30,1
1681917667846,MATH 109,B01,182908,Chow; Bennett,28,0,30,2
1681917667846,MATH 109,B02,182909,Chow; Bennett,30,0,30,0
1681917667846,MATH 109,B03,182910,Chow; Bennett,27,0,30,3
1681917668876,MATH 142A,A01,182925,Staff,11,0,30,19
1681917668876,MATH 142A,A02,182935,Staff,24,0,30,6
1681917668876,MATH 142A,A03,182967,Staff,26,0,30,4
1681917668876,MATH 142A,B01,183125,Staff,24,0,30,6
1681917668876,MATH 142A,B02,183157,Staff,28,0,30,2
1681917668876,MATH 142A,B03,183158,Staff,29,0,30,1
1681917669913,MATH 183,A01,183160,Arias-Castro; Ery,23,0,30,7
1681917669913,MATH 183,A02,183161,Arias-Castro; Ery,29,0,30,1
1681917669913,MATH 183,B01,183163,Arias-Castro; Ery,28,0,30,2
1681917669913,MATH 183,B02,183164,Arias-Castro; Ery,28,0,30,2
1681917670938,MATH 193A,A01,183167,Staff,4,0,35,31
1681917670938,MATH 193A,A02,183168,Staff,28,0,35,7
1681917670938,MATH 193A,A03,183169,Staff,34,0,35,1
1681917670938,MATH 193A,A04,183170,Staff,28,0,35,7
1681917671961,MGT 4,A01,202395,Anderson; John Charles,75,0,80,5
1681917672984,MGT 5,A00,202396,Houskeeper; Robert,80,0,90,10
1681917674010,MGT 103,A00,202397,Eberhard; Craig A,54,0,90,36
1681917675032,MGT 131A,A00,202398,Houskeeper; Robert,85,0,90,5
1681917676054,MGT 135,A00,202399,Anderson; John Charles,81,0,90,9
1681917677081,MGT 162R,A00,202403,Gneezy; Uri,147,0,200,53
1681917678104,MGT 172,A00,202404,Hedges; Kathleen,49,0,90,41
1681917679130,MGT 181,A00,202405,Dunn; Louis Jean,84,0,90,6
1681917680158,MMW 14,A01,183200,Staff,15,0,28,13
1681917680158,MMW 14,A02,183201,Staff,26,0,28,2
1681917680158,MMW 14,A03,183202,Staff,24,0,28,4
1681917680158,MMW 14,A04,183203,Staff,25,0,28,3
1681917680158,MMW 14,A05,183204,Staff,26,0,28,2
1681917680158,MMW 14,A06,183205,Staff,27,0,28,1
1681917680158,MMW 14,B01,183207,Staff,26,0,28,2
1681917680158,MMW 14,B02,183208,Staff,28,0,28,0
1681917680158,MMW 14,B03,183209,Staff,28,0,28,0
1681917680158,MMW 14,B04,183210,Staff,28,0,28,0
1681917680158,MMW 14,B05,183211,Staff,28,0,28,0
1681917680158,MMW 14,B06,183212,Staff,28,0,28,0
1681917681182,MMW 14GS,A00,183213,Zhiri; Oumelbanine,28,0,28,0
1681917682208,MMW 15GS,B00,183215,Rahimi; Babak,28,0,28,0
1681917683234,MMW 121,A01,183217,Patterson; Patrick H.,14,0,28,14
1681917683234,MMW 121,A02,183218,Patterson; Patrick H.,25,0,28,3
1681917684257,MUS 1A,A01,182554,Staff,7,0,35,28
1681917685279,MUS 5,A01,182558,Staff,19,0,35,16
1681917686305,MUS 6,A01,182562,Staff,25,0,35,10
1681917687330,MUS 8GS,A00,182563,Borgo; David Garcia,25,0,25,0
1681917688356,MUS 13,A01,182567,Staff,24,0,25,1
1681917689381,MUS 15,A01,182570,Staff,32,0,35,3
1681917689381,MUS 15,B01,182575,Staff,10,0,35,25
1681917690404,MUS 80,A00,182578,Staff,23,0,25,2
1681917690404,MUS 80,B00,182581,Staff,20,0,25,5
1681917691442,MUS 113,A00,182582,Staff,25,0,25,0
1681917692466,MUS 114,A00,182583,Staff,4,0,25,21
1681917693494,MUS 150GS,A01,182588,Borgo; David Garcia,25,0,25,0
1681917694519,PHIL 1,A00,182590,Staff,35,0,40,5
1681917695541,PHIL 10,A01,182596,Grush; Rick Scott,31,0,35,4
1681917695541,PHIL 10,A02,182597,Grush; Rick Scott,34,0,35,1
1681917696563,PHIL 15,A01,182601,Staff,31,0,35,4
1681917696563,PHIL 15,A02,182602,Staff,33,0,35,2
1681917697595,PHIL 27,A01,182604,Staff,30,0,35,5
1681917697595,PHIL 27,A02,182607,Staff,35,0,35,0
1681917698617,PHIL 32,A01,182609,Staff,35,0,35,0
1681917698617,PHIL 32,A02,182612,Staff,35,0,35,0
1681917699646,PHIL 130,A00,182614,Staff,63,0,70,7
1681917700679,PHIL 136,A00,182616,Cohen; Jonathan David,66,0,70,4
1681917701705,PHIL 155,A00,182617,Vargas; Manuel Rogelio,60,0,70,10
1681917702727,PHIL 163,A01,182620,Staff,15,0,20,5
1681917702727,PHIL 163,A02,182624,Staff,10,0,20,10
1681917703750,PHIL 164,A00,182627,Staff,30,0,40,10
1681917704774,PHIL 173,A00,182628,Staff,36,0,40,4
1681917705796,PHYS 1A,A00,183221,Staff,54,0,60,6
1681917706821,PHYS 1AL,001,183222,Staff,25,0,30,5
1681917706821,PHYS 1AL,002,183223,Staff,28,0,30,2
1681917707850,PHYS 1B,A00,183231,Staff,43,0,60,17
1681917708881,PHYS 1BL,001,183232,Staff,20,0,30,10
1681917708881,PHYS 1BL,002,183233,Staff,27,0,30,3
1681917709902,PHYS 1C,A00,183240,Staff,30,0,60,30
1681917710924,PHYS 1CL,001,183241,Staff,13,0,30,17
1681917710924,PHYS 1CL,002,183242,Staff,22,0,30,8
1681917711947,PHYS 2AR,A01,183250,Staff,44,0,50,6
1681917713044,PHYS 2B,A01,183252,Staff,105,0,115,10
1681917714073,PHYS 2BL,A01,183254,Staff,21,0,24,3
1681917714073,PHYS 2BL,A02,183255,Staff,22,0,24,2
1681917715100,PHYS 2C,A01,183522,Staff,105,0,115,10
1681917716127,PHYS 4A,A01,183524,Staff,49,0,50,1
1681917717150,POLI 5,A00,183525,Staff,44,0,50,6
1681917718172,POLI 12,A00,183540,Staff,48,0,50,2
1681917719205,POLI 13R,A00,183541,Forman; Fonna,42,0,50,8
1681917720235,POLI 30,A00,183542,Mignozzetti; Umberto,47,0,50,3
1681917721258,POLI 100A,A00,183543,Staff,45,0,50,5
1681917722279,POLI 100E,A00,223598,Staff,32,0,35,3
1681917723309,POLI 103A,A00,183564,Kousser; Thad,37,0,50,13
1681917724334,POLI 104B,A00,201329,Staff,29,0,35,6
1681917725358,POLI 113BR,A00,183576,Hoston; Germaine,26,0,50,24
1681917726383,POLI 114BR,A00,183588,Staff,27,0,30,3
1681917727406,POLI 117R,A00,183595,Forman; Fonna,9,0,20,11
1681917728431,POLI 120H,A00,183596,Fisk; David Lee,13,0,20,7
1681917729457,POLI 130AA,A00,183597,Staff,14,0,20,6
1681917730483,POLI 134AA,A00,183598,Staff,19,0,20,1
1681917731509,POLI 135,A00,183599,Fisk; David Lee,20,0,25,5
1681917732543,POLI 142P,A00,183623,Staff,37,0,40,3
1681917733566,POLI 144D,A00,183624,Staff,22,0,25,3
1681917734588,POLI 151,A00,183625,Staff,15,0,20,5
1681917735618,POLI 162,A00,183626,Mignozzetti; Umberto,18,0,20,2
1681917736644,PSYC 1,A00,253748,Staff,86,0,90,4
1681917737667,PSYC 2,A00,183627,Moranton; Nirelia Melbina-,25,0,35,10
1681917738697,PSYC 3,A00,183628,Staff,43,0,45,2
1681917740745,PSYC 60,A01,183631,Lowe; Angela Beth,35,0,40,5
1681917741768,PSYC 70,A01,253757,Staff,37,0,45,8
1681917742796,PSYC 101,A00,183632,Heyman; Gail D.,48,0,60,12
1681917743822,PSYC 105,A00,183848,Lowe; Angela Beth,49,0,60,11
1681917744849,PSYC 106,A00,183849,Dobkins; Karen R.,44,0,60,16
1681917745873,PSYC 108,A00,253750,Staff,24,0,60,36
1681917746900,PSYC 114,A01,184275,Winkielman; Piotr,0,7,30,30
1681917747927,PSYC 122,A00,183856,Moranton; Nirelia Melbina-,0,10,30,30
1681917748950,PSYC 124,A00,183865,Chapman; Eddie Nathaniel,52,0,80,28
1681917749977,PSYC 137,A00,183880,Staff,19,0,25,6
1681917752025,PSYC 154,A00,183910,Lacefield; Katharine I,0,5,90,90
1681917754077,PSYC 162,A00,183946,Wixted; John T,61,0,90,29
1681917755103,PSYC 172,A00,183947,Gorman; Michael R.,13,0,30,17
1681917756142,PSYC 178,A00,183963,Glaser; Dale,20,0,40,20
1681917757166,PSYC 181GS,A00,183964,Anagnostaras; Stephan,10,0,10,0
1681917758188,PSYC 186GS,A01,257660,Staff,10,0,10,0
1681917759210,PSYC 193,B00,253749,Staff,23,0,25,2
1681917761260,PSYC 193L,A01,184122,Staff,33,0,35,2
1681917761260,PSYC 193L,C01,184167,Winkielman; Piotr,15,0,30,15
1681917762282,RELI 188GS,A00,182629,Rahimi; Babak,20,0,20,0
1681917763303,SE 101A,A00,182646,Staff,26,0,30,4
1681917764326,SE 101C,A00,182650,Staff,18,0,20,2
1681917765353,SE 110A,A00,182651,Staff,28,0,28,0
1681917766376,SE 130A,A00,182652,Staff,39,0,40,1
1681917767399,SIO 46GS,A00,182636,Cook; Geoffrey W,28,0,28,0
1681917768430,SIO 109R,A00,194459,Staff,4,0,20,16
1681917769456,SIO 121GS,A00,182639,Cook; Geoffrey W,28,0,28,0
1681917770510,SIO 132,A01,182642,Staff,32,0,40,8
1681917771533,SIO 139,A00,182644,Kacev; David,36,0,40,4
1681917772559,SOCI 2,A01,258404,Staff,34,0,36,2
1681917772559,SOCI 2,A02,258405,Staff,35,0,36,1
1681917773584,SOCI 60,A01,258408,Staff,29,0,30,1
1681917773584,SOCI 60,A02,258413,Staff,30,0,30,0
1681917774608,SOCI 100,A01,258415,Staff,29,0,30,1
1681917774608,SOCI 100,A02,258416,Staff,28,0,30,2
1681917780770,SOCI 127,A00,258421,Staff,22,0,30,8
1681917781801,SOCI 132,A00,258422,Staff,45,0,50,5
1681917782829,SOCI 133,A00,258423,Staff,26,0,30,4
1681917783855,SOCI 138GS,A00,258424,Staff,15,0,15,0
1681917784881,SOCI 145,A00,258425,Staff,25,0,30,5
1681917785926,SOCI 148,A00,258426,Staff,26,0,30,4
1681917786949,SOCI 153,A00,199217,Staff,29,0,30,1
1681917787981,SOCI 160,A00,258427,Staff,28,0,30,2
1681917789003,SOCI 160E,A00,258435,Staff,56,0,60,4
1681917790026,SOCI 189GS,A00,258436,Staff,15,0,15,0
1681917791049,SOCI 190GS,A00,258437,Staff,15,0,15,0
1681917792073,SYN 2,001,182658,Staff,9,0,16,7
1681917792073,SYN 2,002,201439,Staff,15,0,16,1
1681917792073,SYN 2,003,201443,Staff,16,0,16,0
1681917793099,SYN 100,A01,182657,Staff,17,0,20,3
1681917794123,TDAC 1,A00,184381,Salovey; Todd,16,0,20,4
1681917794123,TDAC 1,B00,184385,Harting; Carla Kelso,19,0,20,1
1681917794123,TDAC 1,C00,184394,Staff,19,0,20,1
1681917795146,TDAC 101,A00,184483,Harting; Carla Kelso,19,0,20,1
1681917796169,TDDE 111,A00,184496,Staff,14,0,15,1
1681917797194,TDDE 131,A00,184504,Staff,20,0,20,0
1681917797194,TDDE 131,B00,184505,Staff,17,0,18,1
1681917797194,TDDE 131,C00,184534,Staff,49,0,50,1
1681917797194,TDDE 131,D00,184564,Staff,15,0,15,0
1681917797194,TDDE 131,E00,204725,Staff,19,0,20,1
1681917798216,TDGE 1,A01,184414,Salovey; Todd,36,0,50,14
1681917799239,TDGE 5,A01,184419,Staff,23,0,24,1
1681917800263,TDGE 10,A00,184428,Fulton; Julia,30,0,50,20
1681917801287,TDGE 124,A00,184565,Fulton; Julia,7,0,50,43
1681917802310,TDGE 125,B00,184567,Meyer; Ursula,9,0,25,16
1681917803340,TDHT 101,A00,184568,Staff,21,0,25,4
1681917803340,TDHT 101,B00,184569,Staff,20,0,20,0
1681917804362,TDHT 114,A00,184570,Staff,49,0,50,1
1681917805388,TDMV 1,A00,184437,Arcidiacono; Kristin,23,0,30,7
1681917805388,TDMV 1,B00,184448,Caligagan; Maria T.,22,0,30,8
1681917806412,TDMV 2,A00,184449,Weinberg; Sadie,27,0,30,3
1681917806412,TDMV 2,B00,184453,Arcidiacono; Kristin,29,0,30,1
1681917807435,TDMV 110,A00,184571,Weinberg; Sadie,30,0,30,0
1681917808458,TDMV 142,A00,184572,Caligagan; Tony,27,0,30,3
1681917808458,TDMV 142,B00,184573,Caligagan; Maria T.,27,0,30,3
1681917809481,TDTR 20,A00,184482,Jun; Grace Shin Hae,25,0,25,0
1681917810513,USP 2,A01,184290,Hinds; Juli Beth,24,0,25,1
1681917811542,USP 3,A01,184295,Staff,20,0,25,5
1681917812569,USP 4,A00,184304,McTague; Sarah,15,0,25,10
1681917813591,USP 100,A00,184315,Staff,17,0,25,8
1681917814617,USP 105,A00,184326,Staff,21,0,25,4
1681917815640,USP 151,A00,184327,Staff,20,0,25,5
1681917816740,USP 170,A00,184380,Hinds; Juli Beth,14,0,25,11
1681917817766,VIS 21B,A01,182660,Staff,28,0,31,3
1681917817766,VIS 21B,A02,182662,Staff,30,0,31,1
1681917818790,VIS 103D,A00,182663,Staff,74,0,75,1
1681917819814,VIS 105D,A00,182667,Li; Huai,15,0,22,7
1681917820838,VIS 122GS,A00,182668,Herbst; Matthew,20,0,20,0
1681917821866,VIS 128C,A00,182673,Staff,69,0,75,6
1681917822888,VIS 130,A00,182675,Staff,20,0,22,2
1681917823917,VIS 160A,A00,182678,Stalbaum; Brett,4,0,10,6
1681917825966,WCWP 10B,A00,201679,Staff,15,0,15,0
1681917825966,WCWP 10B,B00,201695,Staff,15,0,15,0
1681917826994,WCWP 100,A00,201716,Staff,15,0,15,0
1681917826994,WCWP 100,B00,201717,Staff,10,0,15,5
1681917829077,ANSC 105GS,A00,258289,Staff,0,0,0,0
1681917830104,ANSC 125GS,A00,258295,Staff,0,0,0,0
1681917831129,ANSC 150,A00,258267,Staff,30,0,40,10
1681917832152,ANSC 190GS,A00,258280,Staff,0,0,0,0
1681917833177,ANTH 1,A00,258264,Staff,38,0,40,2
1681917834200,ANTH 2,A01,258259,Staff,72,0,76,4
1681917835223,ANTH 23,A01,258228,Staff,36,0,40,4
1681917836247,ANTH 101,A01,258236,Staff,38,0,40,2
1681917837273,ANTH 102,A00,258272,Staff,59,0,60,1
1681917838299,ANTH 105,A00,258244,Staff,31,0,35,4
1681917839321,BENG 130,A00,253975,Staff,38,0,40,2
1681917840349,BIBC 102,A01,191866,Flagg; Matthew Paul,19,0,32,13
1681917840349,BIBC 102,A02,191867,Flagg; Matthew Paul,22,0,32,10
1681917840349,BIBC 102,A03,191868,Flagg; Matthew Paul,29,0,32,3
1681917840349,BIBC 102,A04,191936,Flagg; Matthew Paul,26,0,32,6
1681917840349,BIBC 102,A05,191937,Flagg; Matthew Paul,9,0,32,23
1681917841436,BICD 100,A01,191939,Cooper; Andrew Michael,28,0,32,4
1681917841436,BICD 100,A02,191940,Cooper; Andrew Michael,32,0,32,0
1681917841436,BICD 100,A03,191941,Cooper; Andrew Michael,32,0,32,0
1681917841436,BICD 100,A04,191942,Cooper; Andrew Michael,32,0,32,0
1681917841436,BICD 100,A05,191943,Cooper; Andrew Michael,32,0,32,0
1681917842461,BIEB 126,A01,191945,Cleland; Elsa Eleanor,0,0,32,32
1681917842461,BIEB 126,A02,191946,Cleland; Elsa Eleanor,27,0,32,5
1681917842461,BIEB 126,A03,191947,Cleland; Elsa Eleanor,29,0,32,3
1681917842461,BIEB 126,A04,191948,Cleland; Elsa Eleanor,23,0,32,9
1681917842461,BIEB 126,A05,191996,Cleland; Elsa Eleanor,28,0,32,4
1681917843484,BIEB 136GS,A00,191997,Shurin; Jonathan & Holway; David A.,0,0,0,0
1681917844510,BIEB 137GS,A01,191999,Shurin; Jonathan & Holway; David A.,0,0,0,0
1681917845534,BILD 1,A01,205385,Staff,31,0,32,1
1681917845534,BILD 1,A02,205386,Staff,30,0,32,2
1681917845534,BILD 1,A03,205387,Staff,32,0,32,0
1681917845534,BILD 1,A04,205388,Staff,28,0,32,4
1681917846561,BILD 2,A01,191774,Staff,28,0,32,4
1681917846561,BILD 2,A02,191775,Staff,30,0,32,2
1681917846561,BILD 2,A03,191777,Staff,30,0,32,2
1681917846561,BILD 2,A04,191856,Staff,31,0,32,1
1681917846561,BILD 2,A05,191857,Staff,32,0,32,0
1681917846561,BILD 2,A06,191858,Staff,32,0,32,0
1681917846561,BILD 2,A07,191859,Staff,31,0,32,1
1681917847590,BILD 3,A01,205391,Staff,29,0,32,3
1681917847590,BILD 3,A02,205393,Staff,32,0,32,0
1681917847590,BILD 3,A03,205394,Staff,28,0,32,4
1681917847590,BILD 3,A04,205395,Staff,32,0,32,0
1681917848616,BILD 20,A01,191861,Staff,32,0,32,0
1681917848616,BILD 20,A02,191862,Staff,32,0,32,0
1681917849642,BILD 30,A01,191864,Staff,31,0,32,1
1681917850664,BIMM 100,A01,192019,Staff,0,0,32,32
1681917850664,BIMM 100,A02,192020,Staff,22,0,32,10
1681917850664,BIMM 100,A03,192035,Staff,22,0,32,10
1681917851691,BIMM 110,A01,192037,Tat; John,0,0,32,32
1681917851691,BIMM 110,A02,192038,Tat; John,10,0,32,22
1681917852717,BIMM 120,A01,192040,Pickett; Brooke Elizabeth,2,0,32,30
1681917852717,BIMM 120,A02,192041,Pickett; Brooke Elizabeth,16,0,32,16
1681917852717,BIMM 120,A03,192042,Pickett; Brooke Elizabeth,15,0,32,17
1681917853740,BIPN 100,A01,192044,Armour; Jon Christopher,26,0,32,6
1681917853740,BIPN 100,A02,192059,Armour; Jon Christopher,30,0,32,2
1681917853740,BIPN 100,A03,192064,Armour; Jon Christopher,31,0,32,1
1681917853740,BIPN 100,A04,192073,Armour; Jon Christopher,28,0,32,4
1681917854763,BIPN 148,A01,205411,Leutgeb; Jill K.,16,0,32,16
1681917854763,BIPN 148,A02,205412,Leutgeb; Jill K.,31,0,32,1
1681917854763,BIPN 148,A03,205413,Leutgeb; Jill K.,30,0,32,2
1681917854763,BIPN 148,A04,205414,Leutgeb; Jill K.,30,0,32,2
1681917855786,BIPN 160,A01,192115,Marino; Marc J,18,0,32,14
1681917855786,BIPN 160,A02,192148,Marino; Marc J,27,0,32,5
1681917855786,BIPN 160,A03,192158,Marino; Marc J,31,0,32,1
1681917855786,BIPN 160,A04,192190,Marino; Marc J,32,0,32,0
1681917855786,BIPN 160,A05,192287,Marino; Marc J,32,0,32,0
1681917855786,BIPN 160,A06,192288,Marino; Marc J,32,0,32,0
1681917856812,BIPN 194,A00,206038,Staff,28,0,32,4
1681917857847,BISP 194,A00,192289,Leutgeb; Stefan,13,0,32,19
1681917857847,BISP 194,B00,245332,Nieh; James Charles,27,0,32,5
1681917858870,CAT 124,A01,202247,Staff,15,0,15,0
1681917859895,CAT 125,A00,202248,Staff,19,0,20,1
1681917859895,CAT 125,B00,202253,Staff,20,0,20,0
1681917859895,CAT 125,C00,202257,Staff,18,0,20,2
1681917860918,CAT 125GS,A01,202273,Bronstein; Phoebe Malan,20,0,20,0
1681917861953,CAT 125R,A00,202284,Staff,17,0,20,3
1681917861953,CAT 125R,C00,202286,Staff,10,0,20,10
1681917861953,CAT 125R,D00,202291,Staff,18,0,20,2
1681917861953,CAT 125R,E00,202295,Staff,13,0,20,7
1681917861953,CAT 125R,F00,202302,Staff,12,0,20,8
1681917862977,CENG 100,A00,204724,Opatkiewicz; Justin Paul,25,0,25,0
1681917864002,CGS 2A,A01,180420,Staff,31,0,36,5
1681917865029,CGS 101,A00,180421,Staff,16,0,20,4
1681917866054,CGS 112,A00,180422,Staff,9,0,16,7
1681917867077,CGS 113,A00,180423,Staff,18,0,20,2
1681917868099,CGS 137,A00,180424,Staff,12,0,12,0
1681917869125,CGS 147,A00,180425,Staff,10,0,10,0
1681917870155,CHEM 6A,A01,179556,Staff,97,0,100,3
1681917870155,CHEM 6A,A02,179558,Staff,0,0,0,0
1681917871182,CHEM 6B,A01,179560,Staff,100,0,100,0
1681917872212,CHEM 6C,A01,179565,Jazzar; Rodolphe,95,0,100,5
1681917873242,CHEM 7L,A01,179586,Schurmeier; Kimberly,12,0,24,12
1681917873242,CHEM 7L,A02,179587,Schurmeier; Kimberly,23,0,24,1
1681917873242,CHEM 7L,A03,179590,Schurmeier; Kimberly,22,0,24,2
1681917873242,CHEM 7L,A04,179591,Schurmeier; Kimberly,22,0,24,2
1681917873242,CHEM 7L,B01,179598,Schurmeier; Kimberly,17,0,24,7
1681917873242,CHEM 7L,B02,179599,Schurmeier; Kimberly,24,0,24,0
1681917873242,CHEM 7L,B03,179606,Schurmeier; Kimberly,23,0,24,1
1681917873242,CHEM 7L,B04,179607,Schurmeier; Kimberly,23,0,24,1
1681917874268,CHEM 11,A01,179609,Stallings; Dontarie M,88,0,100,12
1681917875298,CHEM 40A,A01,179621,Staff,41,0,50,9
1681917875298,CHEM 40A,A02,179622,Staff,47,0,50,3
1681917876324,CHEM 40B,A01,179630,Weizman; Haim,48,0,50,2
1681917876324,CHEM 40B,A02,179631,Weizman; Haim,45,0,50,5
1681917877351,CHEM 41A,A01,179660,Klosterman; Jeremy K,93,0,100,7
1681917878387,CHEM 43A,A01,179683,Klosterman; Jeremy K,0,0,24,24
1681917878387,CHEM 43A,A02,179688,Klosterman; Jeremy K,13,0,24,11
1681917878387,CHEM 43A,A03,179689,Klosterman; Jeremy K,20,0,24,4
1681917878387,CHEM 43A,A04,179691,Klosterman; Jeremy K,18,0,24,6
1681917879413,CHEM 114A,A01,179693,Stallings; Dontarie M,75,0,100,25
1681917880436,CHEM 143B,A01,179698,Weizman; Haim,17,0,24,7
1681917880436,CHEM 143B,A02,179700,Weizman; Haim,24,0,24,0
1681917881459,CHIN 169A,A00,179701,Wang; Xiao,20,0,20,0
1681917882480,COGS 2,A01,179750,Boyle; Mary E. T.,17,0,30,13
1681917883508,COGS 9,A01,179759,Jones; Cameron Robert,43,0,50,7
1681917884530,COGS 14A,A01,179854,Staff,18,0,50,32
1681917885557,COGS 14B,A01,179856,Staff,54,0,60,6
1681917886594,COGS 17,A01,179874,Staff,71,0,75,4
1681917887620,COGS 18,A01,179884,Staff,63,0,80,17
1681917888646,COGS 100,A01,179886,Staff,40,0,60,20
1681917889669,COGS 101B,A01,179892,Staff,1,0,30,29
1681917890692,COGS 101C,A01,179894,Staff,28,0,30,2
1681917891721,COGS 107A,A01,179896,Boyle; Mary E. T.,31,0,40,9
1681917892757,COGS 108,A01,179898,Simpkins; Charles Alexander,0,18,60,60
1681917893780,COGS 109,A01,179900,Staff,34,0,40,6
1681917894802,COGS 118A,A01,179946,Staff,8,0,40,32
1681917895827,COGS 153,A00,179978,Staff,0,0,30,30
1681917896850,COGS 156,A01,179981,Staff,27,0,30,3
1681917898896,COGS 172,A01,179987,Staff,13,0,30,17
1681917900945,COGS 186,A01,179991,Staff,12,0,30,18
1681917901969,COMM 10,A01,180001,Staff,15,0,25,10
1681917901969,COMM 10,A02,180004,Staff,20,0,25,5
1681917903000,COMM 100A,A01,180016,Staff,18,0,25,7
1681917903000,COMM 100A,A02,180020,Staff,24,0,25,1
1681917904023,COMM 101T,A00,180029,Halm; Gavin Patrick,23,0,35,12
1681917905047,COMM 106V,A00,180043,Staff,34,0,35,1
1681917906069,COMM 109P,A00,180044,Staff,31,0,35,4
1681917907093,COMM 113T,A00,180045,Havis; Allan,37,0,45,8
1681917908122,COMM 132,A00,180046,McKenna; Denise,23,0,30,7
1681917909146,COMM 143,A00,180047,Staff,19,0,30,11
1681917910171,COMM 190,A00,180048,Conner; Thomas Hartnell,20,0,23,3
1681917911199,CSE 8A,A50,180053,Cao; Yingjun,25,0,50,25
1681917911199,CSE 8A,B50,180180,Staff,50,0,50,0
1681917912225,CSE 11,A01,180190,Cao; Yingjun,30,0,50,20
1681917913248,CSE 20,A01,180192,Briones; Jor-el Thomas Caparas,23,0,30,7
1681917914269,CSE 21,A01,194538,Briones; Jor-el Thomas Caparas,50,0,60,10
1681917915300,CSE 30,A01,180324,Eldon; John,77,0,100,23
1681917916338,CSE 101,A01,201353,Staff,0,21,40,40
1681917917378,CSE 134B,A01,180326,Powell; Thomas Allan,74,0,100,26
1681917918404,CSE 140,A01,180328,Staff,45,0,75,30
1681917919430,CSE 140L,A01,180344,Eldon; John,68,0,100,32
1681917920529,CSE 150A,A01,180411,Staff,0,8,50,50
1681917921553,CSE 151A,A01,180414,Staff,0,6,50,50
1681917922581,CSE 175,A01,222521,Kumar; Rakesh,50,0,50,0
1681917923605,CSE 190,A00,201419,Staff,45,0,49,4
1681917924632,CSS 1,A01,194536,Staff,37,0,50,13
1681917925657,DSC 30,A01,202385,Staff,48,0,50,2
1681917926679,DSC 40A,A01,202387,Albuyeh; Rod,50,0,50,0
1681917927702,DSC 190,A01,202389,Silberman; Jack,21,0,21,0
1681917928727,DSGN 100,A01,179993,Staff,16,0,30,14
1681917929753,ECE 65,A50,180708,Staff,10,0,20,10
1681917929753,ECE 65,A51,180739,Staff,19,0,20,1
1681917930781,ECON 1,A01,180427,Famulari; Melissa,67,0,70,3
1681917931817,ECON 2,A01,180450,Levkoff; Steven B.,64,0,70,6
1681917932850,ECON 4,A01,203351,Anderson; John Charles,7,0,10,3
1681917933873,ECON 100A,A01,180472,Famulari; Melissa,65,0,70,5
1681917934899,ECON 120A,A01,180549,Staff,64,0,70,6
1681917935925,ECON 120B,A01,180655,Ma; Xinwei,45,0,70,25
1681917936947,ECON 129,A00,203333,Eckert; Fabian Paul,15,0,35,20
1681917937975,ECON 131,A00,180656,Staff,7,0,35,28
1681917938997,ECON 172B,A01,180672,Levkoff; Steven B.,32,0,35,3
1681917940019,ECON 178,A01,203342,Zhu; Ying,10,0,35,25
1681917941045,EDS 108GS,A00,202383,Wishard Guerra; Alison G.,20,0,20,0
1681917942069,EDS 111GS,A00,202347,Wishard Guerra; Alison G.,20,0,20,0
1681917943095,EDS 112,A01,202323,Staff,56,0,60,4
1681917944118,EDS 113,A00,202340,Staff,33,0,35,2
1681917945144,EDS 118,A00,201231,Staff,20,0,30,10
1681917946169,EDS 119,A00,204994,Staff,8,0,10,2
1681917947195,EDS 124BR,A00,202324,Eguchi; Emi,4,0,25,21
1681917948219,EDS 126,A01,203208,Jones; Makeba,26,0,30,4
1681917949242,EDS 135,A01,202333,Staff,18,0,20,2
1681917950275,EDS 180,A00,202311,Staff,47,0,50,3
1681917951298,ERC 190GS,A01,253747,Staff,28,0,28,0
1681917952321,ETHN 104,A00,180742,Staff,24,0,35,11
1681917953349,ETHN 118,A00,180745,Staff,28,0,35,7
1681917954382,ETHN 127,A00,180747,Staff,12,0,16,4
1681917955406,ETHN 137,A00,180880,Staff,12,0,12,0
1681917956429,ETHN 147,A00,180890,Staff,8,0,10,2
1681917957451,ETHN 154,A00,180891,Staff,7,0,8,1
1681917958475,ETHN 168,A00,180892,Staff,9,0,10,1
1681917959501,GLBH 20,A00,201051,Hannah; Seth Donal,0,1,0,1
1681917960523,GLBH 111,A01,209338,Burgos; Jose L.,0,0,0,0
1681917961547,GLBH 150,A00,258300,Staff,0,3,0,0
1681917962571,GLBH 181,A00,201207,Staff,15,0,40,25
1681917963595,HIEU 109,A00,180898,Staff,20,0,20,0
1681917964619,HIEU 111,A00,180899,Staff,0,0,20,20
1681917965642,HIEU 124,A00,180900,Staff,18,0,20,2
1681917966665,HILA 122,A00,180901,Staff,18,0,20,2
1681917967688,HILA 132,A00,180902,Vitz; Matthew,2,0,20,18
1681917968710,HILD 10,A01,180896,Staff,15,0,20,5
1681917969735,HILD 30GS,A00,180897,Edington; Claire Ellen,0,0,0,0
1681917970759,HISC 105,A00,180903,Staff,20,0,20,0
1681917971787,HISC 117,A00,180904,Staff,11,0,20,9
1681917972809,HIUS 108B,A00,181005,Staff,18,0,20,2
1681917973831,HIUS 113,A00,181093,Staff,3,0,20,17
1681917974857,HUM 3,A01,181190,Patterson; Patrick H.,40,0,50,10
1681917974857,HUM 3,B01,181195,Staff,46,0,50,4
1681917975881,HUM 3GS,A00,181196,Herbst; Matthew,0,0,0,0
1681917976904,HUM 4,A01,181227,West; Geoffrey Scott,34,0,50,16
1681917976904,HUM 4,B01,181282,Staff,42,0,50,8
1681917977929,HUM 4GS,A00,181377,Lyon; Antony J.,0,0,0,0
1681917978952,HUM 5,A01,181536,Zavodny; Tatiana Sophia,31,0,50,19
1681917978952,HUM 5,B01,181908,Staff,36,0,50,14
1681917979980,INTL 190,A00,181909,Segui; Alan S,0,0,0,7
1681917979980,INTL 190,B00,181961,Segui; Alan S,0,0,0,7
1681917981004,JAPN 20AR,A01,182113,Ross; Kayoko F,15,0,20,5
1681917982031,LATI 50,A01,202391,Martin-Cabrera; Luis,19,0,30,11
1681917982031,LATI 50,A02,202392,Martin-Cabrera; Luis,26,0,30,4
1681917983056,LATI 180,A00,202393,Kokinis; Troy Andreas,24,0,25,1
1681917984081,LIFR 1A,A00,182119,Staff,14,0,14,0
1681917985107,LIFR 1AX,A00,182324,Staff,14,0,14,0
1681917986132,LIFR 1B,A00,182259,Staff,14,0,14,0
1681917987155,LIFR 1BX,A00,182273,Staff,14,0,14,0
1681917988180,LIGN 8,A00,182330,Staff,136,0,150,14
1681917989204,LIGN 9GS,A00,182362,Staff,20,0,20,0
1681917990227,LIGN 119,A00,204992,Takahashi; Maho,12,0,15,3
1681917991250,LIGN 130,A01,182384,Staff,47,0,50,3
1681917992278,LIGN 149GS,A00,182390,Staff,20,0,20,0
1681917993303,LIGN 170,A00,182404,Staff,24,0,30,6
1681917994329,LISP 1D,A00,182281,Staff,7,0,14,7
1681917994329,LISP 1D,B00,182287,Staff,14,0,14,0
1681917994329,LISP 1D,C00,182295,Staff,11,0,14,3
1681917994329,LISP 1D,D00,182301,Staff,14,0,14,0
1681917995355,LISP 1DX,A00,182309,Staff,20,0,28,8
1681917995355,LISP 1DX,B00,182316,Staff,26,0,28,2
1681917996376,LTAF 120GS,A00,182412,Zhiri; Oumelbanine,20,0,20,0
1681917997402,LTCS 172GS,A00,182437,Bronstein; Phoebe Malan,20,0,20,0
1681917998429,LTEA 138,A00,182457,Staff,21,0,40,19
1681917999454,LTEN 114,A01,182490,Staff,23,0,25,2
1681918000478,LTEN 130GS,A00,182491,Lyon; Antony J.,20,0,20,0
1681918001511,LTEN 169,A00,182493,Cuong; Marisol,20,0,25,5
1681918002542,LTEN 178,A00,182501,Staff,14,0,15,1
1681918003567,LTEN 181,A00,182515,Staff,22,0,25,3
1681918004592,LTEN 185GS,A00,197655,Forbes; Camille,20,0,20,0
1681918005615,LTSP 100B,A00,202208,Bessett; Ryan Matthew,24,0,25,1
1681918006641,LTWL 100,A00,182516,Myerston Santana; Jacobo,22,0,30,8
1681918007666,LTWR 100GS,A00,182518,Forbes; Camille,20,0,20,0
1681918008692,LTWR 102,A00,182522,Staff,15,0,15,0
1681918008692,LTWR 102,B00,182525,Staff,14,0,15,1
1681918009725,LTWR 115,A00,182526,Staff,11,0,15,4
1681918010752,MAE 8,A01,182528,Pham; Hieu Tan,67,0,70,3
1681918011778,MAE 11,A00,182529,Bahadori; Mohammad Yousef,94,0,100,6
1681918012802,MAE 20,A00,182530,Evdokimenko; Ekaterina,68,0,70,2
1681918013825,MAE 30A,A00,182532,Staff,44,0,45,1
1681918014849,MAE 101A,A00,182533,Bahadori; Mohammad Yousef,97,0,100,3
1681918015874,MAE 101C,A00,182538,Staff,62,0,70,8
1681918016896,MAE 104,A00,182539,Staff,45,0,50,5
1681918017919,MAE 131A,A00,182540,Ghazinejad; Maziar,41,0,45,4
1681918018941,MAE 143A,A00,182548,Bewley; Thomas R,43,0,50,7
1681918019965,MAE 150,A00,182549,Staff,28,0,40,12
1681918020988,MAE 160,A00,182550,Evdokimenko; Ekaterina,43,0,60,17
1681918022013,MATH 3C,A01,182725,Staff,26,0,30,4
1681918023037,MATH 10A,A01,182729,Staff,25,0,30,5
1681918023037,MATH 10A,B01,182732,Staff,26,0,30,4
1681918024152,MATH 10B,A01,182737,Staff,21,0,30,9
1681918024152,MATH 10B,A02,182738,Staff,26,0,30,4
1681918024152,MATH 10B,B01,182744,Staff,27,0,30,3
1681918024152,MATH 10B,B02,182745,Staff,27,0,30,3
1681918025181,MATH 18,A01,182750,Anzaldo; Leesa B,28,0,30,2
1681918025181,MATH 18,A02,182751,Anzaldo; Leesa B,29,0,30,1
1681918025181,MATH 18,A03,182753,Anzaldo; Leesa B,28,0,30,2
1681918025181,MATH 18,A04,182757,Anzaldo; Leesa B,29,0,30,1
1681918025181,MATH 18,B01,182761,Anzaldo; Leesa B,27,0,30,3
1681918025181,MATH 18,B02,182764,Anzaldo; Leesa B,27,0,30,3
1681918025181,MATH 18,B03,182765,Anzaldo; Leesa B,30,0,30,0
1681918025181,MATH 18,B04,182766,Anzaldo; Leesa B,30,0,30,0
1681918026207,MATH 20A,A01,182771,Suk; Andrew Hoon,28,0,30,2
1681918027229,MATH 20B,A01,182775,Bach; Quang Tran,30,0,30,0
1681918027229,MATH 20B,A02,182777,Bach; Quang Tran,29,0,30,1
1681918027229,MATH 20B,B01,182780,Bach; Quang Tran,27,0,30,3
1681918027229,MATH 20B,B02,182782,Bach; Quang Tran,30,0,30,0
1681918028256,MATH 20C,A01,182787,Staff,25,0,30,5
1681918028256,MATH 20C,A02,182790,Staff,29,0,30,1
1681918028256,MATH 20C,B01,182792,Staff,25,0,30,5
1681918028256,MATH 20C,B02,182796,Staff,27,0,30,3
1681918029279,MATH 20D,A01,182799,Staff,29,0,30,1
1681918029279,MATH 20D,A02,182802,Staff,30,0,30,0
1681918029279,MATH 20D,A03,182803,Staff,30,0,30,0
1681918030302,MATH 20E,A01,182809,Verstraete; Jacques Allan,23,0,30,7
1681918030302,MATH 20E,A02,182811,Verstraete; Jacques Allan,28,0,30,2
1681918030302,MATH 20E,B01,182814,Verstraete; Jacques Allan,23,0,30,7
1681918030302,MATH 20E,B02,182815,Verstraete; Jacques Allan,30,0,30,0
1681918031335,MATH 103A,A01,182820,Staff,8,0,30,22
1681918031335,MATH 103A,A02,182821,Staff,27,0,30,3
1681918031335,MATH 103A,A03,182822,Staff,23,0,30,7
1681918031335,MATH 103A,B01,182825,Staff,23,0,30,7
1681918031335,MATH 103A,B02,182826,Staff,30,0,30,0
1681918031335,MATH 103A,B03,182830,Staff,30,0,30,0
1681918032363,MATH 109,A01,182836,Chow; Bennett,24,0,30,6
1681918032363,MATH 109,A02,182838,Chow; Bennett,29,0,30,1
1681918032363,MATH 109,A03,182894,Chow; Bennett,29,0,30,1
1681918032363,MATH 109,B01,182908,Chow; Bennett,28,0,30,2
1681918032363,MATH 109,B02,182909,Chow; Bennett,30,0,30,0
1681918032363,MATH 109,B03,182910,Chow; Bennett,27,0,30,3
1681918033390,MATH 142A,A01,182925,Staff,10,0,30,20
1681918033390,MATH 142A,A02,182935,Staff,24,0,30,6
1681918033390,MATH 142A,A03,182967,Staff,26,0,30,4
1681918033390,MATH 142A,B01,183125,Staff,23,0,30,7
1681918033390,MATH 142A,B02,183157,Staff,28,0,30,2
1681918033390,MATH 142A,B03,183158,Staff,29,0,30,1
1681918034413,MATH 183,A01,183160,Arias-Castro; Ery,23,0,30,7
1681918034413,MATH 183,A02,183161,Arias-Castro; Ery,29,0,30,1
1681918034413,MATH 183,B01,183163,Arias-Castro; Ery,28,0,30,2
1681918034413,MATH 183,B02,183164,Arias-Castro; Ery,28,0,30,2
1681918035436,MATH 193A,A01,183167,Staff,4,0,35,31
1681918035436,MATH 193A,A02,183168,Staff,28,0,35,7
1681918035436,MATH 193A,A03,183169,Staff,34,0,35,1
1681918035436,MATH 193A,A04,183170,Staff,28,0,35,7
1681918036458,MGT 4,A01,202395,Anderson; John Charles,75,0,80,5
1681918037481,MGT 5,A00,202396,Houskeeper; Robert,80,0,90,10
1681918038506,MGT 103,A00,202397,Eberhard; Craig A,53,0,90,37
1681918039530,MGT 131A,A00,202398,Houskeeper; Robert,85,0,90,5
1681918040555,MGT 135,A00,202399,Anderson; John Charles,81,0,90,9
1681918041590,MGT 162R,A00,202403,Gneezy; Uri,146,0,200,54
1681918042616,MGT 172,A00,202404,Hedges; Kathleen,49,0,90,41
1681918043638,MGT 181,A00,202405,Dunn; Louis Jean,83,0,90,7
1681918044677,MMW 14,A01,183200,Staff,13,0,28,15
1681918044677,MMW 14,A02,183201,Staff,26,0,28,2
1681918044677,MMW 14,A03,183202,Staff,24,0,28,4
1681918044677,MMW 14,A04,183203,Staff,25,0,28,3
1681918044677,MMW 14,A05,183204,Staff,26,0,28,2
1681918044677,MMW 14,A06,183205,Staff,27,0,28,1
1681918044677,MMW 14,B01,183207,Staff,26,0,28,2
1681918044677,MMW 14,B02,183208,Staff,28,0,28,0
1681918044677,MMW 14,B03,183209,Staff,28,0,28,0
1681918044677,MMW 14,B04,183210,Staff,28,0,28,0
1681918044677,MMW 14,B05,183211,Staff,28,0,28,0
1681918044677,MMW 14,B06,183212,Staff,28,0,28,0
1681918045700,MMW 14GS,A00,183213,Zhiri; Oumelbanine,28,0,28,0
1681918046724,MMW 15GS,B00,183215,Rahimi; Babak,28,0,28,0
1681918047746,MMW 121,A01,183217,Patterson; Patrick H.,14,0,28,14
1681918047746,MMW 121,A02,183218,Patterson; Patrick H.,25,0,28,3
1681918048768,MUS 1A,A01,182554,Staff,7,0,35,28
1681918049794,MUS 5,A01,182558,Staff,19,0,35,16
1681918050821,MUS 6,A01,182562,Staff,24,0,35,11
1681918051844,MUS 8GS,A00,182563,Borgo; David Garcia,25,0,25,0
1681918052870,MUS 13,A01,182567,Staff,24,0,25,1
1681918053894,MUS 15,A01,182570,Staff,32,0,35,3
1681918053894,MUS 15,B01,182575,Staff,10,0,35,25
1681918054921,MUS 80,A00,182578,Staff,23,0,25,2
1681918054921,MUS 80,B00,182581,Staff,20,0,25,5
1681918055947,MUS 113,A00,182582,Staff,25,0,25,0
1681918056970,MUS 114,A00,182583,Staff,4,0,25,21
1681918057993,MUS 150GS,A01,182588,Borgo; David Garcia,25,0,25,0
1681918059016,PHIL 1,A00,182590,Staff,35,0,40,5
1681918060043,PHIL 10,A01,182596,Grush; Rick Scott,31,0,35,4
1681918060043,PHIL 10,A02,182597,Grush; Rick Scott,34,0,35,1
1681918061066,PHIL 15,A01,182601,Staff,31,0,35,4
1681918061066,PHIL 15,A02,182602,Staff,33,0,35,2
1681918062092,PHIL 27,A01,182604,Staff,30,0,35,5
1681918062092,PHIL 27,A02,182607,Staff,35,0,35,0
1681918063115,PHIL 32,A01,182609,Staff,35,0,35,0
1681918063115,PHIL 32,A02,182612,Staff,35,0,35,0
1681918064138,PHIL 130,A00,182614,Staff,63,0,70,7
1681918065165,PHIL 136,A00,182616,Cohen; Jonathan David,66,0,70,4
1681918066188,PHIL 155,A00,182617,Vargas; Manuel Rogelio,60,0,70,10
1681918067211,PHIL 163,A01,182620,Staff,15,0,20,5
1681918067211,PHIL 163,A02,182624,Staff,10,0,20,10
1681918068234,PHIL 164,A00,182627,Staff,30,0,40,10
1681918069257,PHIL 173,A00,182628,Staff,36,0,40,4
1681918070279,PHYS 1A,A00,183221,Staff,54,0,60,6
1681918071304,PHYS 1AL,001,183222,Staff,25,0,30,5
1681918071304,PHYS 1AL,002,183223,Staff,28,0,30,2
1681918072326,PHYS 1B,A00,183231,Staff,43,0,60,17
1681918073351,PHYS 1BL,001,183232,Staff,20,0,30,10
1681918073351,PHYS 1BL,002,183233,Staff,27,0,30,3
1681918074374,PHYS 1C,A00,183240,Staff,30,0,60,30
1681918075398,PHYS 1CL,001,183241,Staff,13,0,30,17
1681918075398,PHYS 1CL,002,183242,Staff,22,0,30,8
1681918076420,PHYS 2AR,A01,183250,Staff,44,0,50,6
1681918077446,PHYS 2B,A01,183252,Staff,105,0,115,10
1681918078469,PHYS 2BL,A01,183254,Staff,21,0,24,3
1681918078469,PHYS 2BL,A02,183255,Staff,22,0,24,2
1681918079493,PHYS 2C,A01,183522,Staff,105,0,115,10
1681918080522,PHYS 4A,A01,183524,Staff,49,0,50,1
1681918081547,POLI 5,A00,183525,Staff,44,0,50,6
1681918082575,POLI 12,A00,183540,Staff,48,0,50,2
1681918083599,POLI 13R,A00,183541,Forman; Fonna,42,0,50,8
1681918084623,POLI 30,A00,183542,Mignozzetti; Umberto,47,0,50,3
1681918085652,POLI 100A,A00,183543,Staff,45,0,50,5
1681918086680,POLI 100E,A00,223598,Staff,32,0,35,3
1681918087703,POLI 103A,A00,183564,Kousser; Thad,37,0,50,13
1681918088726,POLI 104B,A00,201329,Staff,29,0,35,6
1681918089750,POLI 113BR,A00,183576,Hoston; Germaine,26,0,50,24
1681918090774,POLI 114BR,A00,183588,Staff,27,0,30,3
1681918091799,POLI 117R,A00,183595,Forman; Fonna,8,0,20,12
1681918092826,POLI 120H,A00,183596,Fisk; David Lee,13,0,20,7
1681918093855,POLI 130AA,A00,183597,Staff,14,0,20,6
1681918094877,POLI 134AA,A00,183598,Staff,19,0,20,1
1681918095902,POLI 135,A00,183599,Fisk; David Lee,20,0,25,5
1681918096927,POLI 142P,A00,183623,Staff,37,0,40,3
1681918097949,POLI 144D,A00,183624,Staff,22,0,25,3
1681918098972,POLI 151,A00,183625,Staff,15,0,20,5
1681918099996,POLI 162,A00,183626,Mignozzetti; Umberto,18,0,20,2
1681918101021,PSYC 1,A00,253748,Staff,86,0,90,4
1681918102046,PSYC 2,A00,183627,Moranton; Nirelia Melbina-,25,0,35,10
1681918103072,PSYC 3,A00,183628,Staff,43,0,45,2
1681918105124,PSYC 60,A01,183631,Lowe; Angela Beth,35,0,40,5
1681918106150,PSYC 70,A01,253757,Staff,37,0,45,8
1681918107176,PSYC 101,A00,183632,Heyman; Gail D.,48,0,60,12
1681918108198,PSYC 105,A00,183848,Lowe; Angela Beth,49,0,60,11
1681918109229,PSYC 106,A00,183849,Dobkins; Karen R.,44,0,60,16
1681918110251,PSYC 108,A00,253750,Staff,24,0,60,36
1681918111277,PSYC 114,A01,184275,Winkielman; Piotr,0,7,30,30
1681918112302,PSYC 122,A00,183856,Moranton; Nirelia Melbina-,0,10,30,30
1681918113323,PSYC 124,A00,183865,Chapman; Eddie Nathaniel,52,0,80,28
1681918114348,PSYC 137,A00,183880,Staff,19,0,25,6
1681918116399,PSYC 154,A00,183910,Lacefield; Katharine I,0,5,90,90
1681918118446,PSYC 162,A00,183946,Wixted; John T,61,0,90,29
1681918119476,PSYC 172,A00,183947,Gorman; Michael R.,13,0,30,17
1681918120499,PSYC 178,A00,183963,Glaser; Dale,20,0,40,20
1681918121521,PSYC 181GS,A00,183964,Anagnostaras; Stephan,10,0,10,0
1681918122543,PSYC 186GS,A01,257660,Staff,10,0,10,0
1681918123577,PSYC 193,B00,253749,Staff,23,0,25,2
1681918125626,PSYC 193L,A01,184122,Staff,33,0,35,2
1681918125626,PSYC 193L,C01,184167,Winkielman; Piotr,15,0,30,15
1681918126651,RELI 188GS,A00,182629,Rahimi; Babak,20,0,20,0
1681918127745,SE 101A,A00,182646,Staff,26,0,30,4
1681918128782,SE 101C,A00,182650,Staff,18,0,20,2
1681918129807,SE 110A,A00,182651,Staff,28,0,28,0
1681918130835,SE 130A,A00,182652,Staff,39,0,40,1
1681918131878,SIO 46GS,A00,182636,Cook; Geoffrey W,28,0,28,0
1681918132901,SIO 109R,A00,194459,Staff,4,0,20,16
1681918133924,SIO 121GS,A00,182639,Cook; Geoffrey W,28,0,28,0
1681918134945,SIO 132,A01,182642,Staff,32,0,40,8
1681918135971,SIO 139,A00,182644,Kacev; David,36,0,40,4
1681918136995,SOCI 2,A01,258404,Staff,34,0,36,2
1681918136995,SOCI 2,A02,258405,Staff,35,0,36,1
1681918138025,SOCI 60,A01,258408,Staff,29,0,30,1
1681918138025,SOCI 60,A02,258413,Staff,30,0,30,0
1681918139053,SOCI 100,A01,258415,Staff,29,0,30,1
1681918139053,SOCI 100,A02,258416,Staff,28,0,30,2
1681918145196,SOCI 127,A00,258421,Staff,22,0,30,8
1681918146219,SOCI 132,A00,258422,Staff,45,0,50,5
1681918147242,SOCI 133,A00,258423,Staff,26,0,30,4
1681918148264,SOCI 138GS,A00,258424,Staff,15,0,15,0
1681918149293,SOCI 145,A00,258425,Staff,25,0,30,5
1681918150319,SOCI 148,A00,258426,Staff,26,0,30,4
1681918151348,SOCI 153,A00,199217,Staff,29,0,30,1
1681918152375,SOCI 160,A00,258427,Staff,28,0,30,2
1681918153403,SOCI 160E,A00,258435,Staff,56,0,60,4
1681918154427,SOCI 189GS,A00,258436,Staff,15,0,15,0
1681918155449,SOCI 190GS,A00,258437,Staff,15,0,15,0
1681918156471,SYN 2,001,182658,Staff,9,0,16,7
1681918156471,SYN 2,002,201439,Staff,15,0,16,1
1681918156471,SYN 2,003,201443,Staff,16,0,16,0
1681918157496,SYN 100,A01,182657,Staff,17,0,20,3
1681918158518,TDAC 1,A00,184381,Salovey; Todd,16,0,20,4
1681918158518,TDAC 1,B00,184385,Harting; Carla Kelso,19,0,20,1
1681918158518,TDAC 1,C00,184394,Staff,19,0,20,1
1681918159539,TDAC 101,A00,184483,Harting; Carla Kelso,19,0,20,1
1681918160564,TDDE 111,A00,184496,Staff,14,0,15,1
1681918161587,TDDE 131,A00,184504,Staff,20,0,20,0
1681918161587,TDDE 131,B00,184505,Staff,17,0,18,1
1681918161587,TDDE 131,C00,184534,Staff,49,0,50,1
1681918161587,TDDE 131,D00,184564,Staff,15,0,15,0
1681918161587,TDDE 131,E00,204725,Staff,19,0,20,1
1681918162614,TDGE 1,A01,184414,Salovey; Todd,36,0,50,14
1681918163641,TDGE 5,A01,184419,Staff,23,0,24,1
1681918164672,TDGE 10,A00,184428,Fulton; Julia,30,0,50,20
1681918165698,TDGE 124,A00,184565,Fulton; Julia,7,0,50,43
1681918166720,TDGE 125,B00,184567,Meyer; Ursula,9,0,25,16
1681918167743,TDHT 101,A00,184568,Staff,21,0,25,4
1681918167743,TDHT 101,B00,184569,Staff,20,0,20,0
1681918168766,TDHT 114,A00,184570,Staff,49,0,50,1
1681918169789,TDMV 1,A00,184437,Arcidiacono; Kristin,22,0,30,8
1681918169789,TDMV 1,B00,184448,Caligagan; Maria T.,23,0,30,7
1681918170815,TDMV 2,A00,184449,Weinberg; Sadie,27,0,30,3
1681918170815,TDMV 2,B00,184453,Arcidiacono; Kristin,29,0,30,1
1681918171845,TDMV 110,A00,184571,Weinberg; Sadie,30,0,30,0
1681918172877,TDMV 142,A00,184572,Caligagan; Tony,27,0,30,3
1681918172877,TDMV 142,B00,184573,Caligagan; Maria T.,27,0,30,3
1681918173903,TDTR 20,A00,184482,Jun; Grace Shin Hae,25,0,25,0
1681918174929,USP 2,A01,184290,Hinds; Juli Beth,24,0,25,1
1681918175955,USP 3,A01,184295,Staff,20,0,25,5
1681918176981,USP 4,A00,184304,McTague; Sarah,15,0,25,10
1681918178008,USP 100,A00,184315,Staff,17,0,25,8
1681918179032,USP 105,A00,184326,Staff,21,0,25,4
1681918180055,USP 151,A00,184327,Staff,20,0,25,5
1681918181085,USP 170,A00,184380,Hinds; Juli Beth,14,0,25,11
1681918182107,VIS 21B,A01,182660,Staff,28,0,31,3
1681918182107,VIS 21B,A02,182662,Staff,30,0,31,1
1681918183131,VIS 103D,A00,182663,Staff,74,0,75,1
1681918184157,VIS 105D,A00,182667,Li; Huai,15,0,22,7
1681918185179,VIS 122GS,A00,182668,Herbst; Matthew,20,0,20,0
1681918186201,VIS 128C,A00,182673,Staff,69,0,75,6
1681918187226,VIS 130,A00,182675,Staff,20,0,22,2
1681918188255,VIS 160A,A00,182678,Stalbaum; Brett,4,0,10,6
1681918190300,WCWP 10B,A00,201679,Staff,15,0,15,0
1681918190300,WCWP 10B,B00,201695,Staff,15,0,15,0
1681918191321,WCWP 100,A00,201716,Staff,15,0,15,0
1681918191321,WCWP 100,B00,201717,Staff,10,0,15,5
1681918193380,ANSC 105GS,A00,258289,Staff,0,0,0,0
1681918194405,ANSC 125GS,A00,258295,Staff,0,0,0,0
1681918195428,ANSC 150,A00,258267,Staff,30,0,40,10
1681918196451,ANSC 190GS,A00,258280,Staff,0,0,0,0
1681918197473,ANTH 1,A00,258264,Staff,38,0,40,2
1681918198495,ANTH 2,A01,258259,Staff,72,0,76,4
1681918199517,ANTH 23,A01,258228,Staff,36,0,40,4
1681918200541,ANTH 101,A01,258236,Staff,38,0,40,2
1681918201582,ANTH 102,A00,258272,Staff,59,0,60,1
1681918202603,ANTH 105,A00,258244,Staff,31,0,35,4
1681918203626,BENG 130,A00,253975,Staff,38,0,40,2
1681918204654,BIBC 102,A01,191866,Flagg; Matthew Paul,19,0,32,13
1681918204654,BIBC 102,A02,191867,Flagg; Matthew Paul,22,0,32,10
1681918204654,BIBC 102,A03,191868,Flagg; Matthew Paul,29,0,32,3
1681918204654,BIBC 102,A04,191936,Flagg; Matthew Paul,26,0,32,6
1681918204654,BIBC 102,A05,191937,Flagg; Matthew Paul,9,0,32,23
1681918205687,BICD 100,A01,191939,Cooper; Andrew Michael,28,0,32,4
1681918205687,BICD 100,A02,191940,Cooper; Andrew Michael,32,0,32,0
1681918205687,BICD 100,A03,191941,Cooper; Andrew Michael,32,0,32,0
1681918205687,BICD 100,A04,191942,Cooper; Andrew Michael,32,0,32,0
1681918205687,BICD 100,A05,191943,Cooper; Andrew Michael,32,0,32,0
1681918206709,BIEB 126,A01,191945,Cleland; Elsa Eleanor,0,0,32,32
1681918206709,BIEB 126,A02,191946,Cleland; Elsa Eleanor,27,0,32,5
1681918206709,BIEB 126,A03,191947,Cleland; Elsa Eleanor,29,0,32,3
1681918206709,BIEB 126,A04,191948,Cleland; Elsa Eleanor,23,0,32,9
1681918206709,BIEB 126,A05,191996,Cleland; Elsa Eleanor,28,0,32,4
1681918207741,BIEB 136GS,A00,191997,Shurin; Jonathan & Holway; David A.,0,0,0,0
1681918208765,BIEB 137GS,A01,191999,Shurin; Jonathan & Holway; David A.,0,0,0,0
1681918209813,BILD 1,A01,205385,Staff,31,0,32,1
1681918209813,BILD 1,A02,205386,Staff,30,0,32,2
1681918209813,BILD 1,A03,205387,Staff,32,0,32,0
1681918209813,BILD 1,A04,205388,Staff,27,0,32,5
1681918210839,BILD 2,A01,191774,Staff,28,0,32,4
1681918210839,BILD 2,A02,191775,Staff,30,0,32,2
1681918210839,BILD 2,A03,191777,Staff,30,0,32,2
1681918210839,BILD 2,A04,191856,Staff,31,0,32,1
1681918210839,BILD 2,A05,191857,Staff,32,0,32,0
1681918210839,BILD 2,A06,191858,Staff,32,0,32,0
1681918210839,BILD 2,A07,191859,Staff,31,0,32,1
1681918211872,BILD 3,A01,205391,Staff,29,0,32,3
1681918211872,BILD 3,A02,205393,Staff,32,0,32,0
1681918211872,BILD 3,A03,205394,Staff,28,0,32,4
1681918211872,BILD 3,A04,205395,Staff,32,0,32,0
1681918212896,BILD 20,A01,191861,Staff,32,0,32,0
1681918212896,BILD 20,A02,191862,Staff,32,0,32,0
1681918213919,BILD 30,A01,191864,Staff,31,0,32,1
1681918214949,BIMM 100,A01,192019,Staff,0,0,32,32
1681918214949,BIMM 100,A02,192020,Staff,22,0,32,10
1681918214949,BIMM 100,A03,192035,Staff,22,0,32,10
1681918215972,BIMM 110,A01,192037,Tat; John,0,0,32,32
1681918215972,BIMM 110,A02,192038,Tat; John,10,0,32,22
1681918216994,BIMM 120,A01,192040,Pickett; Brooke Elizabeth,2,0,32,30
1681918216994,BIMM 120,A02,192041,Pickett; Brooke Elizabeth,16,0,32,16
1681918216994,BIMM 120,A03,192042,Pickett; Brooke Elizabeth,15,0,32,17
1681918218019,BIPN 100,A01,192044,Armour; Jon Christopher,26,0,32,6
1681918218019,BIPN 100,A02,192059,Armour; Jon Christopher,30,0,32,2
1681918218019,BIPN 100,A03,192064,Armour; Jon Christopher,31,0,32,1
1681918218019,BIPN 100,A04,192073,Armour; Jon Christopher,28,0,32,4
1681918219042,BIPN 148,A01,205411,Leutgeb; Jill K.,16,0,32,16
1681918219042,BIPN 148,A02,205412,Leutgeb; Jill K.,31,0,32,1
1681918219042,BIPN 148,A03,205413,Leutgeb; Jill K.,30,0,32,2
1681918219042,BIPN 148,A04,205414,Leutgeb; Jill K.,30,0,32,2
1681918220070,BIPN 160,A01,192115,Marino; Marc J,18,0,32,14
1681918220070,BIPN 160,A02,192148,Marino; Marc J,27,0,32,5
1681918220070,BIPN 160,A03,192158,Marino; Marc J,31,0,32,1
1681918220070,BIPN 160,A04,192190,Marino; Marc J,32,0,32,0
1681918220070,BIPN 160,A05,192287,Marino; Marc J,32,0,32,0
1681918220070,BIPN 160,A06,192288,Marino; Marc J,32,0,32,0
1681918221096,BIPN 194,A00,206038,Staff,28,0,32,4
1681918222119,BISP 194,A00,192289,Leutgeb; Stefan,13,0,32,19
1681918222119,BISP 194,B00,245332,Nieh; James Charles,27,0,32,5
1681918223141,CAT 124,A01,202247,Staff,15,0,15,0
1681918224164,CAT 125,A00,202248,Staff,19,0,20,1
1681918224164,CAT 125,B00,202253,Staff,20,0,20,0
1681918224164,CAT 125,C00,202257,Staff,18,0,20,2
1681918225190,CAT 125GS,A01,202273,Bronstein; Phoebe Malan,20,0,20,0
1681918226219,CAT 125R,A00,202284,Staff,17,0,20,3
1681918226219,CAT 125R,C00,202286,Staff,10,0,20,10
1681918226219,CAT 125R,D00,202291,Staff,18,0,20,2
1681918226219,CAT 125R,E00,202295,Staff,13,0,20,7
1681918226219,CAT 125R,F00,202302,Staff,12,0,20,8
1681918227253,CENG 100,A00,204724,Opatkiewicz; Justin Paul,25,0,25,0
1681918228293,CGS 2A,A01,180420,Staff,31,0,36,5
1681918229320,CGS 101,A00,180421,Staff,16,0,20,4
1681918230342,CGS 112,A00,180422,Staff,9,0,16,7
1681918231439,CGS 113,A00,180423,Staff,18,0,20,2
1681918232463,CGS 137,A00,180424,Staff,12,0,12,0
1681918233487,CGS 147,A00,180425,Staff,10,0,10,0
1681918234514,CHEM 6A,A01,179556,Staff,97,0,100,3
1681918234514,CHEM 6A,A02,179558,Staff,0,0,0,0
1681918235541,CHEM 6B,A01,179560,Staff,100,0,100,0
1681918236569,CHEM 6C,A01,179565,Jazzar; Rodolphe,95,0,100,5
1681918237598,CHEM 7L,A01,179586,Schurmeier; Kimberly,12,0,24,12
1681918237598,CHEM 7L,A02,179587,Schurmeier; Kimberly,23,0,24,1
1681918237598,CHEM 7L,A03,179590,Schurmeier; Kimberly,22,0,24,2
1681918237598,CHEM 7L,A04,179591,Schurmeier; Kimberly,22,0,24,2
1681918237598,CHEM 7L,B01,179598,Schurmeier; Kimberly,17,0,24,7
1681918237598,CHEM 7L,B02,179599,Schurmeier; Kimberly,24,0,24,0
1681918237598,CHEM 7L,B03,179606,Schurmeier; Kimberly,23,0,24,1
1681918237598,CHEM 7L,B04,179607,Schurmeier; Kimberly,23,0,24,1
1681918238621,CHEM 11,A01,179609,Stallings; Dontarie M,88,0,100,12
1681918239646,CHEM 40A,A01,179621,Staff,41,0,50,9
1681918239646,CHEM 40A,A02,179622,Staff,47,0,50,3
1681918240674,CHEM 40B,A01,179630,Weizman; Haim,48,0,50,2
1681918240674,CHEM 40B,A02,179631,Weizman; Haim,45,0,50,5
1681918241701,CHEM 41A,A01,179660,Klosterman; Jeremy K,93,0,100,7
1681918242726,CHEM 43A,A01,179683,Klosterman; Jeremy K,0,0,24,24
1681918242726,CHEM 43A,A02,179688,Klosterman; Jeremy K,13,0,24,11
1681918242726,CHEM 43A,A03,179689,Klosterman; Jeremy K,20,0,24,4
1681918242726,CHEM 43A,A04,179691,Klosterman; Jeremy K,18,0,24,6
1681918243750,CHEM 114A,A01,179693,Stallings; Dontarie M,75,0,100,25
1681918244773,CHEM 143B,A01,179698,Weizman; Haim,17,0,24,7
1681918244773,CHEM 143B,A02,179700,Weizman; Haim,24,0,24,0
1681918245797,CHIN 169A,A00,179701,Wang; Xiao,20,0,20,0
1681918246821,COGS 2,A01,179750,Boyle; Mary E. T.,17,0,30,13
1681918247848,COGS 9,A01,179759,Jones; Cameron Robert,43,0,50,7
1681918248873,COGS 14A,A01,179854,Staff,18,0,50,32
1681918249902,COGS 14B,A01,179856,Staff,54,0,60,6
1681918250929,COGS 17,A01,179874,Staff,71,0,75,4
1681918251958,COGS 18,A01,179884,Staff,63,0,80,17
1681918252992,COGS 100,A01,179886,Staff,40,0,60,20
1681918254019,COGS 101B,A01,179892,Staff,1,0,30,29
1681918255042,COGS 101C,A01,179894,Staff,28,0,30,2
1681918256079,COGS 107A,A01,179896,Boyle; Mary E. T.,31,0,40,9
1681918257106,COGS 108,A01,179898,Simpkins; Charles Alexander,0,18,60,60
1681918258128,COGS 109,A01,179900,Staff,34,0,40,6
1681918259154,COGS 118A,A01,179946,Staff,8,0,40,32
1681918260187,COGS 153,A00,179978,Staff,0,0,30,30
1681918261217,COGS 156,A01,179981,Staff,27,0,30,3
1681918263269,COGS 172,A01,179987,Staff,13,0,30,17
1681918265324,COGS 186,A01,179991,Staff,12,0,30,18
1681918266351,COMM 10,A01,180001,Staff,15,0,25,10
1681918266351,COMM 10,A02,180004,Staff,20,0,25,5
1681918267379,COMM 100A,A01,180016,Staff,17,0,25,8
1681918267379,COMM 100A,A02,180020,Staff,24,0,25,1
1681918268405,COMM 101T,A00,180029,Halm; Gavin Patrick,23,0,35,12
1681918269429,COMM 106V,A00,180043,Staff,34,0,35,1
1681918270460,COMM 109P,A00,180044,Staff,31,0,35,4
1681918271486,COMM 113T,A00,180045,Havis; Allan,37,0,45,8
1681918272574,COMM 132,A00,180046,McKenna; Denise,23,0,30,7
1681918273597,COMM 143,A00,180047,Staff,19,0,30,11
1681918274627,COMM 190,A00,180048,Conner; Thomas Hartnell,20,0,23,3
1681918275655,CSE 8A,A50,180053,Cao; Yingjun,25,0,50,25
1681918275655,CSE 8A,B50,180180,Staff,50,0,50,0
1681918276681,CSE 11,A01,180190,Cao; Yingjun,28,0,50,22
1681918277726,CSE 20,A01,180192,Briones; Jor-el Thomas Caparas,23,0,30,7
1681918278748,CSE 21,A01,194538,Briones; Jor-el Thomas Caparas,50,0,60,10
1681918279779,CSE 30,A01,180324,Eldon; John,77,0,100,23
1681918280802,CSE 101,A01,201353,Staff,0,21,40,40
1681918281835,CSE 134B,A01,180326,Powell; Thomas Allan,74,0,100,26
1681918282864,CSE 140,A01,180328,Staff,45,0,75,30
1681918283890,CSE 140L,A01,180344,Eldon; John,68,0,100,32
1681918284914,CSE 150A,A01,180411,Staff,0,8,50,50
1681918285946,CSE 151A,A01,180414,Staff,0,6,50,50
1681918286979,CSE 175,A01,222521,Kumar; Rakesh,50,0,50,0
1681918288003,CSE 190,A00,201419,Staff,45,0,49,4
1681918289025,CSS 1,A01,194536,Staff,37,0,50,13
1681918290048,DSC 30,A01,202385,Staff,48,0,50,2
1681918291078,DSC 40A,A01,202387,Albuyeh; Rod,50,0,50,0
1681918292104,DSC 190,A01,202389,Silberman; Jack,21,0,21,0
1681918293127,DSGN 100,A01,179993,Staff,16,0,30,14
1681918294152,ECE 65,A50,180708,Staff,10,0,20,10
1681918294152,ECE 65,A51,180739,Staff,19,0,20,1
1681918295181,ECON 1,A01,180427,Famulari; Melissa,67,0,70,3
1681918296204,ECON 2,A01,180450,Levkoff; Steven B.,64,0,70,6
1681918297232,ECON 4,A01,203351,Anderson; John Charles,7,0,10,3
1681918298278,ECON 100A,A01,180472,Famulari; Melissa,65,0,70,5
1681918299306,ECON 120A,A01,180549,Staff,64,0,70,6
1681918300329,ECON 120B,A01,180655,Ma; Xinwei,45,0,70,25
1681918301352,ECON 129,A00,203333,Eckert; Fabian Paul,15,0,35,20
1681918302376,ECON 131,A00,180656,Staff,7,0,35,28
1681918303407,ECON 172B,A01,180672,Levkoff; Steven B.,32,0,35,3
1681918304430,ECON 178,A01,203342,Zhu; Ying,10,0,35,25
1681918305455,EDS 108GS,A00,202383,Wishard Guerra; Alison G.,20,0,20,0
1681918306477,EDS 111GS,A00,202347,Wishard Guerra; Alison G.,20,0,20,0
1681918307508,EDS 112,A01,202323,Staff,56,0,60,4
1681918308530,EDS 113,A00,202340,Staff,33,0,35,2
1681918309553,EDS 118,A00,201231,Staff,20,0,30,10
1681918310578,EDS 119,A00,204994,Staff,8,0,10,2
1681918311601,EDS 124BR,A00,202324,Eguchi; Emi,4,0,25,21
1681918312624,EDS 126,A01,203208,Jones; Makeba,26,0,30,4
1681918313650,EDS 135,A01,202333,Staff,18,0,20,2
1681918314675,EDS 180,A00,202311,Staff,47,0,50,3
1681918315699,ERC 190GS,A01,253747,Staff,28,0,28,0
1681918316721,ETHN 104,A00,180742,Staff,24,0,35,11
1681918317746,ETHN 118,A00,180745,Staff,28,0,35,7
1681918318768,ETHN 127,A00,180747,Staff,12,0,16,4
1681918319793,ETHN 137,A00,180880,Staff,12,0,12,0
1681918320820,ETHN 147,A00,180890,Staff,8,0,10,2
1681918321843,ETHN 154,A00,180891,Staff,7,0,8,1
1681918322865,ETHN 168,A00,180892,Staff,9,0,10,1
1681918323892,GLBH 20,A00,201051,Hannah; Seth Donal,0,1,0,1
1681918324917,GLBH 111,A01,209338,Burgos; Jose L.,0,0,0,0
1681918325940,GLBH 150,A00,258300,Staff,0,3,0,0
1681918326967,GLBH 181,A00,201207,Staff,15,0,40,25
1681918327990,HIEU 109,A00,180898,Staff,20,0,20,0
1681918329017,HIEU 111,A00,180899,Staff,0,0,20,20
1681918330040,HIEU 124,A00,180900,Staff,17,0,20,3
1681918331065,HILA 122,A00,180901,Staff,18,0,20,2
1681918332087,HILA 132,A00,180902,Vitz; Matthew,2,0,20,18
1681918333109,HILD 10,A01,180896,Staff,15,0,20,5
1681918334132,HILD 30GS,A00,180897,Edington; Claire Ellen,0,0,0,0
1681918335236,HISC 105,A00,180903,Staff,20,0,20,0
1681918336260,HISC 117,A00,180904,Staff,11,0,20,9
1681918337288,HIUS 108B,A00,181005,Staff,18,0,20,2
1681918338309,HIUS 113,A00,181093,Staff,3,0,20,17
1681918339335,HUM 3,A01,181190,Patterson; Patrick H.,40,0,50,10
1681918339335,HUM 3,B01,181195,Staff,46,0,50,4
1681918340357,HUM 3GS,A00,181196,Herbst; Matthew,0,0,0,0
1681918341384,HUM 4,A01,181227,West; Geoffrey Scott,34,0,50,16
1681918341384,HUM 4,B01,181282,Staff,42,0,50,8
1681918342408,HUM 4GS,A00,181377,Lyon; Antony J.,0,0,0,0
1681918343433,HUM 5,A01,181536,Zavodny; Tatiana Sophia,31,0,50,19
1681918343433,HUM 5,B01,181908,Staff,36,0,50,14
1681918344463,INTL 190,A00,181909,Segui; Alan S,0,0,0,7
1681918344463,INTL 190,B00,181961,Segui; Alan S,0,0,0,7
1681918345498,JAPN 20AR,A01,182113,Ross; Kayoko F,15,0,20,5
1681918346522,LATI 50,A01,202391,Martin-Cabrera; Luis,19,0,30,11
1681918346522,LATI 50,A02,202392,Martin-Cabrera; Luis,26,0,30,4
1681918347547,LATI 180,A00,202393,Kokinis; Troy Andreas,24,0,25,1
1681918348569,LIFR 1A,A00,182119,Staff,14,0,14,0
1681918349591,LIFR 1AX,A00,182324,Staff,14,0,14,0
1681918350614,LIFR 1B,A00,182259,Staff,14,0,14,0
1681918351650,LIFR 1BX,A00,182273,Staff,14,0,14,0
1681918352682,LIGN 8,A00,182330,Staff,136,0,150,14
1681918353704,LIGN 9GS,A00,182362,Staff,20,0,20,0
1681918354729,LIGN 119,A00,204992,Takahashi; Maho,12,0,15,3
1681918355751,LIGN 130,A01,182384,Staff,47,0,50,3
1681918356773,LIGN 149GS,A00,182390,Staff,20,0,20,0
1681918357795,LIGN 170,A00,182404,Staff,23,0,30,7
1681918358817,LISP 1D,A00,182281,Staff,7,0,14,7
1681918358817,LISP 1D,B00,182287,Staff,14,0,14,0
1681918358817,LISP 1D,C00,182295,Staff,11,0,14,3
1681918358817,LISP 1D,D00,182301,Staff,14,0,14,0
1681918359843,LISP 1DX,A00,182309,Staff,20,0,28,8
1681918359843,LISP 1DX,B00,182316,Staff,26,0,28,2
1681918360875,LTAF 120GS,A00,182412,Zhiri; Oumelbanine,20,0,20,0
1681918361899,LTCS 172GS,A00,182437,Bronstein; Phoebe Malan,20,0,20,0
1681918362922,LTEA 138,A00,182457,Staff,21,0,40,19
1681918363944,LTEN 114,A01,182490,Staff,23,0,25,2
1681918364968,LTEN 130GS,A00,182491,Lyon; Antony J.,20,0,20,0
1681918365990,LTEN 169,A00,182493,Cuong; Marisol,19,0,25,6
1681918367015,LTEN 178,A00,182501,Staff,14,0,15,1
1681918368044,LTEN 181,A00,182515,Staff,22,0,25,3
1681918369069,LTEN 185GS,A00,197655,Forbes; Camille,20,0,20,0
1681918370094,LTSP 100B,A00,202208,Bessett; Ryan Matthew,24,0,25,1
1681918371123,LTWL 100,A00,182516,Myerston Santana; Jacobo,22,0,30,8
1681918372148,LTWR 100GS,A00,182518,Forbes; Camille,20,0,20,0
1681918373171,LTWR 102,A00,182522,Staff,15,0,15,0
1681918373171,LTWR 102,B00,182525,Staff,14,0,15,1
1681918374197,LTWR 115,A00,182526,Staff,11,0,15,4
1681918375223,MAE 8,A01,182528,Pham; Hieu Tan,67,0,70,3
1681918376246,MAE 11,A00,182529,Bahadori; Mohammad Yousef,94,0,100,6
1681918377272,MAE 20,A00,182530,Evdokimenko; Ekaterina,68,0,70,2
1681918378296,MAE 30A,A00,182532,Staff,44,0,45,1
1681918379323,MAE 101A,A00,182533,Bahadori; Mohammad Yousef,97,0,100,3
1681918380349,MAE 101C,A00,182538,Staff,62,0,70,8
1681918381377,MAE 104,A00,182539,Staff,45,0,50,5
1681918382399,MAE 131A,A00,182540,Ghazinejad; Maziar,41,0,45,4
1681918383422,MAE 143A,A00,182548,Bewley; Thomas R,43,0,50,7
1681918384447,MAE 150,A00,182549,Staff,28,0,40,12
1681918385471,MAE 160,A00,182550,Evdokimenko; Ekaterina,43,0,60,17
1681918386505,MATH 3C,A01,182725,Staff,26,0,30,4
1681918387528,MATH 10A,A01,182729,Staff,25,0,30,5
1681918387528,MATH 10A,B01,182732,Staff,26,0,30,4
1681918388558,MATH 10B,A01,182737,Staff,21,0,30,9
1681918388558,MATH 10B,A02,182738,Staff,26,0,30,4
1681918388558,MATH 10B,B01,182744,Staff,27,0,30,3
1681918388558,MATH 10B,B02,182745,Staff,27,0,30,3
1681918389587,MATH 18,A01,182750,Anzaldo; Leesa B,28,0,30,2
1681918389587,MATH 18,A02,182751,Anzaldo; Leesa B,29,0,30,1
1681918389587,MATH 18,A03,182753,Anzaldo; Leesa B,28,0,30,2
1681918389587,MATH 18,A04,182757,Anzaldo; Leesa B,29,0,30,1
1681918389587,MATH 18,B01,182761,Anzaldo; Leesa B,27,0,30,3
1681918389587,MATH 18,B02,182764,Anzaldo; Leesa B,27,0,30,3
1681918389587,MATH 18,B03,182765,Anzaldo; Leesa B,30,0,30,0
1681918389587,MATH 18,B04,182766,Anzaldo; Leesa B,30,0,30,0
1681918390610,MATH 20A,A01,182771,Suk; Andrew Hoon,28,0,30,2
1681918391633,MATH 20B,A01,182775,Bach; Quang Tran,30,0,30,0
1681918391633,MATH 20B,A02,182777,Bach; Quang Tran,29,0,30,1
1681918391633,MATH 20B,B01,182780,Bach; Quang Tran,27,0,30,3
1681918391633,MATH 20B,B02,182782,Bach; Quang Tran,30,0,30,0
1681918392656,MATH 20C,A01,182787,Staff,25,0,30,5
1681918392656,MATH 20C,A02,182790,Staff,29,0,30,1
1681918392656,MATH 20C,B01,182792,Staff,25,0,30,5
1681918392656,MATH 20C,B02,182796,Staff,27,0,30,3
1681918393679,MATH 20D,A01,182799,Staff,29,0,30,1
1681918393679,MATH 20D,A02,182802,Staff,29,0,30,1
1681918393679,MATH 20D,A03,182803,Staff,30,0,30,0
1681918394705,MATH 20E,A01,182809,Verstraete; Jacques Allan,23,0,30,7
1681918394705,MATH 20E,A02,182811,Verstraete; Jacques Allan,28,0,30,2
1681918394705,MATH 20E,B01,182814,Verstraete; Jacques Allan,23,0,30,7
1681918394705,MATH 20E,B02,182815,Verstraete; Jacques Allan,30,0,30,0
1681918395731,MATH 103A,A01,182820,Staff,8,0,30,22
1681918395731,MATH 103A,A02,182821,Staff,27,0,30,3
1681918395731,MATH 103A,A03,182822,Staff,23,0,30,7
1681918395731,MATH 103A,B01,182825,Staff,23,0,30,7
1681918395731,MATH 103A,B02,182826,Staff,30,0,30,0
1681918395731,MATH 103A,B03,182830,Staff,30,0,30,0
1681918396768,MATH 109,A01,182836,Chow; Bennett,24,0,30,6
1681918396768,MATH 109,A02,182838,Chow; Bennett,29,0,30,1
1681918396768,MATH 109,A03,182894,Chow; Bennett,29,0,30,1
1681918396768,MATH 109,B01,182908,Chow; Bennett,28,0,30,2
1681918396768,MATH 109,B02,182909,Chow; Bennett,30,0,30,0
1681918396768,MATH 109,B03,182910,Chow; Bennett,27,0,30,3
1681918397795,MATH 142A,A01,182925,Staff,10,0,30,20
1681918397795,MATH 142A,A02,182935,Staff,24,0,30,6
1681918397795,MATH 142A,A03,182967,Staff,26,0,30,4
1681918397795,MATH 142A,B01,183125,Staff,22,0,30,8
1681918397795,MATH 142A,B02,183157,Staff,28,0,30,2
1681918397795,MATH 142A,B03,183158,Staff,29,0,30,1
1681918398820,MATH 183,A01,183160,Arias-Castro; Ery,23,0,30,7
1681918398820,MATH 183,A02,183161,Arias-Castro; Ery,29,0,30,1
1681918398820,MATH 183,B01,183163,Arias-Castro; Ery,28,0,30,2
1681918398820,MATH 183,B02,183164,Arias-Castro; Ery,28,0,30,2
1681918399846,MATH 193A,A01,183167,Staff,4,0,35,31
1681918399846,MATH 193A,A02,183168,Staff,28,0,35,7
1681918399846,MATH 193A,A03,183169,Staff,34,0,35,1
1681918399846,MATH 193A,A04,183170,Staff,28,0,35,7
1681918400874,MGT 4,A01,202395,Anderson; John Charles,75,0,80,5
1681918401904,MGT 5,A00,202396,Houskeeper; Robert,80,0,90,10
1681918402927,MGT 103,A00,202397,Eberhard; Craig A,53,0,90,37
1681918403950,MGT 131A,A00,202398,Houskeeper; Robert,85,0,90,5
1681918404976,MGT 135,A00,202399,Anderson; John Charles,81,0,90,9
1681918406002,MGT 162R,A00,202403,Gneezy; Uri,146,0,200,54
1681918407025,MGT 172,A00,202404,Hedges; Kathleen,49,0,90,41
1681918408059,MGT 181,A00,202405,Dunn; Louis Jean,83,0,90,7
1681918409084,MMW 14,A01,183200,Staff,13,0,28,15
1681918409084,MMW 14,A02,183201,Staff,26,0,28,2
1681918409084,MMW 14,A03,183202,Staff,24,0,28,4
1681918409084,MMW 14,A04,183203,Staff,25,0,28,3
1681918409084,MMW 14,A05,183204,Staff,26,0,28,2
1681918409084,MMW 14,A06,183205,Staff,27,0,28,1
1681918409084,MMW 14,B01,183207,Staff,26,0,28,2
1681918409084,MMW 14,B02,183208,Staff,28,0,28,0
1681918409084,MMW 14,B03,183209,Staff,28,0,28,0
1681918409084,MMW 14,B04,183210,Staff,28,0,28,0
1681918409084,MMW 14,B05,183211,Staff,28,0,28,0
1681918409084,MMW 14,B06,183212,Staff,27,0,28,1
1681918410110,MMW 14GS,A00,183213,Zhiri; Oumelbanine,28,0,28,0
1681918411132,MMW 15GS,B00,183215,Rahimi; Babak,28,0,28,0
1681918412155,MMW 121,A01,183217,Patterson; Patrick H.,14,0,28,14
1681918412155,MMW 121,A02,183218,Patterson; Patrick H.,25,0,28,3
1681918413179,MUS 1A,A01,182554,Staff,7,0,35,28
1681918414201,MUS 5,A01,182558,Staff,19,0,35,16
1681918415237,MUS 6,A01,182562,Staff,24,0,35,11
1681918416260,MUS 8GS,A00,182563,Borgo; David Garcia,25,0,25,0
1681918417286,MUS 13,A01,182567,Staff,24,0,25,1
1681918418309,MUS 15,A01,182570,Staff,32,0,35,3
1681918418309,MUS 15,B01,182575,Staff,9,0,35,26
1681918419335,MUS 80,A00,182578,Staff,23,0,25,2
1681918419335,MUS 80,B00,182581,Staff,20,0,25,5
1681918420360,MUS 113,A00,182582,Staff,25,0,25,0
1681918421385,MUS 114,A00,182583,Staff,4,0,25,21
1681918422407,MUS 150GS,A01,182588,Borgo; David Garcia,25,0,25,0
1681918423429,PHIL 1,A00,182590,Staff,35,0,40,5
1681918424456,PHIL 10,A01,182596,Grush; Rick Scott,31,0,35,4
1681918424456,PHIL 10,A02,182597,Grush; Rick Scott,34,0,35,1
1681918425481,PHIL 15,A01,182601,Staff,31,0,35,4
1681918425481,PHIL 15,A02,182602,Staff,33,0,35,2
1681918426504,PHIL 27,A01,182604,Staff,30,0,35,5
1681918426504,PHIL 27,A02,182607,Staff,35,0,35,0
1681918427528,PHIL 32,A01,182609,Staff,35,0,35,0
1681918427528,PHIL 32,A02,182612,Staff,35,0,35,0
1681918428552,PHIL 130,A00,182614,Staff,62,0,70,8
1681918429574,PHIL 136,A00,182616,Cohen; Jonathan David,66,0,70,4
1681918430599,PHIL 155,A00,182617,Vargas; Manuel Rogelio,59,0,70,11
1681918431624,PHIL 163,A01,182620,Staff,15,0,20,5
1681918431624,PHIL 163,A02,182624,Staff,10,0,20,10
1681918432653,PHIL 164,A00,182627,Staff,30,0,40,10
1681918433683,PHIL 173,A00,182628,Staff,36,0,40,4
1681918434708,PHYS 1A,A00,183221,Staff,54,0,60,6
1681918435741,PHYS 1AL,001,183222,Staff,25,0,30,5
1681918435741,PHYS 1AL,002,183223,Staff,28,0,30,2
1681918436765,PHYS 1B,A00,183231,Staff,43,0,60,17
1681918437792,PHYS 1BL,001,183232,Staff,20,0,30,10
1681918437792,PHYS 1BL,002,183233,Staff,27,0,30,3
1681918438891,PHYS 1C,A00,183240,Staff,30,0,60,30
1681918439914,PHYS 1CL,001,183241,Staff,13,0,30,17
1681918439914,PHYS 1CL,002,183242,Staff,22,0,30,8
1681918440940,PHYS 2AR,A01,183250,Staff,44,0,50,6
1681918441963,PHYS 2B,A01,183252,Staff,105,0,115,10
1681918442988,PHYS 2BL,A01,183254,Staff,21,0,24,3
1681918442988,PHYS 2BL,A02,183255,Staff,22,0,24,2
1681918444015,PHYS 2C,A01,183522,Staff,105,0,115,10
1681918445042,PHYS 4A,A01,183524,Staff,49,0,50,1
1681918446064,POLI 5,A00,183525,Staff,44,0,50,6
1681918447086,POLI 12,A00,183540,Staff,48,0,50,2
1681918448117,POLI 13R,A00,183541,Forman; Fonna,42,0,50,8
1681918449138,POLI 30,A00,183542,Mignozzetti; Umberto,47,0,50,3
1681918450161,POLI 100A,A00,183543,Staff,45,0,50,5
1681918451188,POLI 100E,A00,223598,Staff,32,0,35,3
1681918452211,POLI 103A,A00,183564,Kousser; Thad,37,0,50,13
1681918453236,POLI 104B,A00,201329,Staff,29,0,35,6
1681918454258,POLI 113BR,A00,183576,Hoston; Germaine,26,0,50,24
1681918455283,POLI 114BR,A00,183588,Staff,27,0,30,3
1681918456305,POLI 117R,A00,183595,Forman; Fonna,8,0,20,12
1681918457326,POLI 120H,A00,183596,Fisk; David Lee,13,0,20,7
1681918458349,POLI 130AA,A00,183597,Staff,14,0,20,6
1681918459373,POLI 134AA,A00,183598,Staff,19,0,20,1
1681918460401,POLI 135,A00,183599,Fisk; David Lee,20,0,25,5
1681918461424,POLI 142P,A00,183623,Staff,37,0,40,3
1681918462449,POLI 144D,A00,183624,Staff,22,0,25,3
1681918463480,POLI 151,A00,183625,Staff,15,0,20,5
1681918464505,POLI 162,A00,183626,Mignozzetti; Umberto,18,0,20,2
1681918465526,PSYC 1,A00,253748,Staff,86,0,90,4
1681918466555,PSYC 2,A00,183627,Moranton; Nirelia Melbina-,25,0,35,10
1681918467578,PSYC 3,A00,183628,Staff,43,0,45,2
1681918469628,PSYC 60,A01,183631,Lowe; Angela Beth,35,0,40,5
1681918470651,PSYC 70,A01,253757,Staff,37,0,45,8
1681918471677,PSYC 101,A00,183632,Heyman; Gail D.,48,0,60,12
1681918472700,PSYC 105,A00,183848,Lowe; Angela Beth,48,0,60,12
1681918473724,PSYC 106,A00,183849,Dobkins; Karen R.,44,0,60,16
1681918474747,PSYC 108,A00,253750,Staff,24,0,60,36
1681918475779,PSYC 114,A01,184275,Winkielman; Piotr,0,7,30,30
1681918476812,PSYC 122,A00,183856,Moranton; Nirelia Melbina-,0,10,30,30
1681918477839,PSYC 124,A00,183865,Chapman; Eddie Nathaniel,52,0,80,28
1681918478872,PSYC 137,A00,183880,Staff,19,0,25,6
1681918480920,PSYC 154,A00,183910,Lacefield; Katharine I,0,6,90,90
1681918482971,PSYC 162,A00,183946,Wixted; John T,61,0,90,29
1681918483993,PSYC 172,A00,183947,Gorman; Michael R.,12,0,30,18
1681918485022,PSYC 178,A00,183963,Glaser; Dale,19,0,40,21
1681918486055,PSYC 181GS,A00,183964,Anagnostaras; Stephan,10,0,10,0
1681918487080,PSYC 186GS,A01,257660,Staff,10,0,10,0
1681918488105,PSYC 193,B00,253749,Staff,23,0,25,2
1681918490155,PSYC 193L,A01,184122,Staff,33,0,35,2
1681918490155,PSYC 193L,C01,184167,Winkielman; Piotr,15,0,30,15
1681918491181,RELI 188GS,A00,182629,Rahimi; Babak,20,0,20,0
1681918492205,SE 101A,A00,182646,Staff,26,0,30,4
1681918493231,SE 101C,A00,182650,Staff,18,0,20,2
1681918494259,SE 110A,A00,182651,Staff,28,0,28,0
1681918495281,SE 130A,A00,182652,Staff,39,0,40,1
1681918496305,SIO 46GS,A00,182636,Cook; Geoffrey W,28,0,28,0
1681918497329,SIO 109R,A00,194459,Staff,4,0,20,16
1681918498354,SIO 121GS,A00,182639,Cook; Geoffrey W,28,0,28,0
1681918499379,SIO 132,A01,182642,Staff,32,0,40,8
1681918500405,SIO 139,A00,182644,Kacev; David,36,0,40,4
1681918501427,SOCI 2,A01,258404,Staff,34,0,36,2
1681918501427,SOCI 2,A02,258405,Staff,35,0,36,1
1681918502450,SOCI 60,A01,258408,Staff,29,0,30,1
1681918502450,SOCI 60,A02,258413,Staff,30,0,30,0
1681918503472,SOCI 100,A01,258415,Staff,29,0,30,1
1681918503472,SOCI 100,A02,258416,Staff,28,0,30,2
1681918509621,SOCI 127,A00,258421,Staff,21,0,30,9
1681918510648,SOCI 132,A00,258422,Staff,45,0,50,5
1681918511685,SOCI 133,A00,258423,Staff,26,0,30,4
1681918512709,SOCI 138GS,A00,258424,Staff,15,0,15,0
1681918513732,SOCI 145,A00,258425,Staff,25,0,30,5
1681918514754,SOCI 148,A00,258426,Staff,26,0,30,4
1681918515788,SOCI 153,A00,199217,Staff,29,0,30,1
1681918516813,SOCI 160,A00,258427,Staff,28,0,30,2
1681918517836,SOCI 160E,A00,258435,Staff,56,0,60,4
1681918518861,SOCI 189GS,A00,258436,Staff,15,0,15,0
1681918519885,SOCI 190GS,A00,258437,Staff,15,0,15,0
1681918520908,SYN 2,001,182658,Staff,9,0,16,7
1681918520908,SYN 2,002,201439,Staff,15,0,16,1
1681918520908,SYN 2,003,201443,Staff,16,0,16,0
1681918521933,SYN 100,A01,182657,Staff,16,0,20,4
1681918522959,TDAC 1,A00,184381,Salovey; Todd,16,0,20,4
1681918522959,TDAC 1,B00,184385,Harting; Carla Kelso,19,0,20,1
1681918522959,TDAC 1,C00,184394,Staff,19,0,20,1
1681918523988,TDAC 101,A00,184483,Harting; Carla Kelso,19,0,20,1
1681918525011,TDDE 111,A00,184496,Staff,14,0,15,1
1681918526040,TDDE 131,A00,184504,Staff,20,0,20,0
1681918526040,TDDE 131,B00,184505,Staff,17,0,18,1
1681918526040,TDDE 131,C00,184534,Staff,49,0,50,1
1681918526040,TDDE 131,D00,184564,Staff,15,0,15,0
1681918526040,TDDE 131,E00,204725,Staff,19,0,20,1
1681918527066,TDGE 1,A01,184414,Salovey; Todd,36,0,50,14
1681918528088,TDGE 5,A01,184419,Staff,23,0,24,1
1681918529110,TDGE 10,A00,184428,Fulton; Julia,29,0,50,21
1681918530136,TDGE 124,A00,184565,Fulton; Julia,7,0,50,43
1681918531159,TDGE 125,B00,184567,Meyer; Ursula,9,0,25,16
1681918532182,TDHT 101,A00,184568,Staff,21,0,25,4
1681918532182,TDHT 101,B00,184569,Staff,20,0,20,0
1681918533205,TDHT 114,A00,184570,Staff,49,0,50,1
1681918534230,TDMV 1,A00,184437,Arcidiacono; Kristin,22,0,30,8
1681918534230,TDMV 1,B00,184448,Caligagan; Maria T.,23,0,30,7
1681918535256,TDMV 2,A00,184449,Weinberg; Sadie,27,0,30,3
1681918535256,TDMV 2,B00,184453,Arcidiacono; Kristin,29,0,30,1
1681918536291,TDMV 110,A00,184571,Weinberg; Sadie,30,0,30,0
1681918537322,TDMV 142,A00,184572,Caligagan; Tony,27,0,30,3
1681918537322,TDMV 142,B00,184573,Caligagan; Maria T.,27,0,30,3
1681918538346,TDTR 20,A00,184482,Jun; Grace Shin Hae,25,0,25,0
1681918539374,USP 2,A01,184290,Hinds; Juli Beth,24,0,25,1
1681918540400,USP 3,A01,184295,Staff,20,0,25,5
1681918541424,USP 4,A00,184304,McTague; Sarah,15,0,25,10
1681918542527,USP 100,A00,184315,Staff,17,0,25,8
1681918543553,USP 105,A00,184326,Staff,21,0,25,4
1681918544586,USP 151,A00,184327,Staff,20,0,25,5
1681918545610,USP 170,A00,184380,Hinds; Juli Beth,14,0,25,11
1681918546633,VIS 21B,A01,182660,Staff,28,0,31,3
1681918546633,VIS 21B,A02,182662,Staff,30,0,31,1
1681918547658,VIS 103D,A00,182663,Staff,74,0,75,1
1681918548681,VIS 105D,A00,182667,Li; Huai,15,0,22,7
1681918549703,VIS 122GS,A00,182668,Herbst; Matthew,20,0,20,0
1681918550724,VIS 128C,A00,182673,Staff,69,0,75,6
1681918551751,VIS 130,A00,182675,Staff,20,0,22,2
1681918552773,VIS 160A,A00,182678,Stalbaum; Brett,4,0,10,6
1681918554822,WCWP 10B,A00,201679,Staff,15,0,15,0
1681918554822,WCWP 10B,B00,201695,Staff,15,0,15,0
1681918555852,WCWP 100,A00,201716,Staff,15,0,15,0
1681918555852,WCWP 100,B00,201717,Staff,10,0,15,5
1681918557923,ANSC 105GS,A00,258289,Staff,0,0,0,0
1681918558948,ANSC 125GS,A00,258295,Staff,0,0,0,0
1681918559979,ANSC 150,A00,258267,Staff,30,0,40,10
1681918561005,ANSC 190GS,A00,258280,Staff,0,0,0,0
1681918562028,ANTH 1,A00,258264,Staff,38,0,40,2
1681918563054,ANTH 2,A01,258259,Staff,72,0,76,4
1681918564077,ANTH 23,A01,258228,Staff,36,0,40,4
1681918565104,ANTH 101,A01,258236,Staff,38,0,40,2
1681918566128,ANTH 102,A00,258272,Staff,59,0,60,1
1681918567152,ANTH 105,A00,258244,Staff,31,0,35,4
1681918568179,BENG 130,A00,253975,Staff,38,0,40,2
1681918569206,BIBC 102,A01,191866,Flagg; Matthew Paul,19,0,32,13
1681918569206,BIBC 102,A02,191867,Flagg; Matthew Paul,22,0,32,10
1681918569206,BIBC 102,A03,191868,Flagg; Matthew Paul,29,0,32,3
1681918569206,BIBC 102,A04,191936,Flagg; Matthew Paul,26,0,32,6
1681918569206,BIBC 102,A05,191937,Flagg; Matthew Paul,7,0,32,25
1681918570231,BICD 100,A01,191939,Cooper; Andrew Michael,28,0,32,4
1681918570231,BICD 100,A02,191940,Cooper; Andrew Michael,32,0,32,0
1681918570231,BICD 100,A03,191941,Cooper; Andrew Michael,32,0,32,0
1681918570231,BICD 100,A04,191942,Cooper; Andrew Michael,32,0,32,0
1681918570231,BICD 100,A05,191943,Cooper; Andrew Michael,32,0,32,0
1681918571255,BIEB 126,A01,191945,Cleland; Elsa Eleanor,0,0,32,32
1681918571255,BIEB 126,A02,191946,Cleland; Elsa Eleanor,27,0,32,5
1681918571255,BIEB 126,A03,191947,Cleland; Elsa Eleanor,29,0,32,3
1681918571255,BIEB 126,A04,191948,Cleland; Elsa Eleanor,23,0,32,9
1681918571255,BIEB 126,A05,191996,Cleland; Elsa Eleanor,28,0,32,4
1681918572293,BIEB 136GS,A00,191997,Shurin; Jonathan & Holway; David A.,0,0,0,0
1681918573319,BIEB 137GS,A01,191999,Shurin; Jonathan & Holway; David A.,0,0,0,0
1681918574363,BILD 1,A01,205385,Staff,31,0,32,1
1681918574363,BILD 1,A02,205386,Staff,30,0,32,2
1681918574363,BILD 1,A03,205387,Staff,32,0,32,0
1681918574363,BILD 1,A04,205388,Staff,27,0,32,5
1681918575390,BILD 2,A01,191774,Staff,28,0,32,4
1681918575390,BILD 2,A02,191775,Staff,30,0,32,2
1681918575390,BILD 2,A03,191777,Staff,30,0,32,2
1681918575390,BILD 2,A04,191856,Staff,31,0,32,1
1681918575390,BILD 2,A05,191857,Staff,32,0,32,0
1681918575390,BILD 2,A06,191858,Staff,32,0,32,0
1681918575390,BILD 2,A07,191859,Staff,31,0,32,1
1681918576423,BILD 3,A01,205391,Staff,29,0,32,3
1681918576423,BILD 3,A02,205393,Staff,32,0,32,0
1681918576423,BILD 3,A03,205394,Staff,28,0,32,4
1681918576423,BILD 3,A04,205395,Staff,32,0,32,0
1681918577446,BILD 20,A01,191861,Staff,32,0,32,0
1681918577446,BILD 20,A02,191862,Staff,32,0,32,0
1681918578468,BILD 30,A01,191864,Staff,31,0,32,1
1681918579490,BIMM 100,A01,192019,Staff,0,0,32,32
1681918579490,BIMM 100,A02,192020,Staff,22,0,32,10
1681918579490,BIMM 100,A03,192035,Staff,21,0,32,11
1681918580516,BIMM 110,A01,192037,Tat; John,0,0,32,32
1681918580516,BIMM 110,A02,192038,Tat; John,10,0,32,22
1681918581543,BIMM 120,A01,192040,Pickett; Brooke Elizabeth,2,0,32,30
1681918581543,BIMM 120,A02,192041,Pickett; Brooke Elizabeth,16,0,32,16
1681918581543,BIMM 120,A03,192042,Pickett; Brooke Elizabeth,15,0,32,17
1681918582567,BIPN 100,A01,192044,Armour; Jon Christopher,26,0,32,6
1681918582567,BIPN 100,A02,192059,Armour; Jon Christopher,30,0,32,2
1681918582567,BIPN 100,A03,192064,Armour; Jon Christopher,31,0,32,1
1681918582567,BIPN 100,A04,192073,Armour; Jon Christopher,28,0,32,4
1681918583611,BIPN 148,A01,205411,Leutgeb; Jill K.,16,0,32,16
1681918583611,BIPN 148,A02,205412,Leutgeb; Jill K.,31,0,32,1
1681918583611,BIPN 148,A03,205413,Leutgeb; Jill K.,30,0,32,2
1681918583611,BIPN 148,A04,205414,Leutgeb; Jill K.,30,0,32,2
1681918584639,BIPN 160,A01,192115,Marino; Marc J,17,0,32,15
1681918584639,BIPN 160,A02,192148,Marino; Marc J,27,0,32,5
1681918584639,BIPN 160,A03,192158,Marino; Marc J,31,0,32,1
1681918584639,BIPN 160,A04,192190,Marino; Marc J,32,0,32,0
1681918584639,BIPN 160,A05,192287,Marino; Marc J,32,0,32,0
1681918584639,BIPN 160,A06,192288,Marino; Marc J,32,0,32,0
1681918585663,BIPN 194,A00,206038,Staff,28,0,32,4
1681918586686,BISP 194,A00,192289,Leutgeb; Stefan,13,0,32,19
1681918586686,BISP 194,B00,245332,Nieh; James Charles,27,0,32,5
1681918587710,CAT 124,A01,202247,Staff,15,0,15,0
1681918588734,CAT 125,A00,202248,Staff,19,0,20,1
1681918588734,CAT 125,B00,202253,Staff,20,0,20,0
1681918588734,CAT 125,C00,202257,Staff,18,0,20,2
1681918589757,CAT 125GS,A01,202273,Bronstein; Phoebe Malan,20,0,20,0
1681918590784,CAT 125R,A00,202284,Staff,17,0,20,3
1681918590784,CAT 125R,C00,202286,Staff,10,0,20,10
1681918590784,CAT 125R,D00,202291,Staff,18,0,20,2
1681918590784,CAT 125R,E00,202295,Staff,13,0,20,7
1681918590784,CAT 125R,F00,202302,Staff,12,0,20,8
1681918591807,CENG 100,A00,204724,Opatkiewicz; Justin Paul,25,0,25,0
1681918592830,CGS 2A,A01,180420,Staff,31,0,36,5
1681918593864,CGS 101,A00,180421,Staff,16,0,20,4
1681918594889,CGS 112,A00,180422,Staff,9,0,16,7
1681918595915,CGS 113,A00,180423,Staff,18,0,20,2
1681918596942,CGS 137,A00,180424,Staff,12,0,12,0
1681918597972,CGS 147,A00,180425,Staff,10,0,10,0
1681918599009,CHEM 6A,A01,179556,Staff,97,0,100,3
1681918599009,CHEM 6A,A02,179558,Staff,0,0,0,0
1681918600036,CHEM 6B,A01,179560,Staff,100,0,100,0
1681918601071,CHEM 6C,A01,179565,Jazzar; Rodolphe,95,0,100,5
1681918602095,CHEM 7L,A01,179586,Schurmeier; Kimberly,11,0,24,13
1681918602095,CHEM 7L,A02,179587,Schurmeier; Kimberly,23,0,24,1
1681918602095,CHEM 7L,A03,179590,Schurmeier; Kimberly,22,0,24,2
1681918602095,CHEM 7L,A04,179591,Schurmeier; Kimberly,22,0,24,2
1681918602095,CHEM 7L,B01,179598,Schurmeier; Kimberly,17,0,24,7
1681918602095,CHEM 7L,B02,179599,Schurmeier; Kimberly,24,0,24,0
1681918602095,CHEM 7L,B03,179606,Schurmeier; Kimberly,23,0,24,1
1681918602095,CHEM 7L,B04,179607,Schurmeier; Kimberly,23,0,24,1
1681918603120,CHEM 11,A01,179609,Stallings; Dontarie M,88,0,100,12
1681918604145,CHEM 40A,A01,179621,Staff,41,0,50,9
1681918604145,CHEM 40A,A02,179622,Staff,47,0,50,3
1681918605174,CHEM 40B,A01,179630,Weizman; Haim,48,0,50,2
1681918605174,CHEM 40B,A02,179631,Weizman; Haim,45,0,50,5
1681918606199,CHEM 41A,A01,179660,Klosterman; Jeremy K,93,0,100,7
1681918607227,CHEM 43A,A01,179683,Klosterman; Jeremy K,0,0,24,24
1681918607227,CHEM 43A,A02,179688,Klosterman; Jeremy K,12,0,24,12
1681918607227,CHEM 43A,A03,179689,Klosterman; Jeremy K,19,0,24,5
1681918607227,CHEM 43A,A04,179691,Klosterman; Jeremy K,18,0,24,6
1681918608251,CHEM 114A,A01,179693,Stallings; Dontarie M,75,0,100,25
1681918609274,CHEM 143B,A01,179698,Weizman; Haim,17,0,24,7
1681918609274,CHEM 143B,A02,179700,Weizman; Haim,24,0,24,0
1681918610301,CHIN 169A,A00,179701,Wang; Xiao,20,0,20,0
1681918611327,COGS 2,A01,179750,Boyle; Mary E. T.,17,0,30,13
1681918612351,COGS 9,A01,179759,Jones; Cameron Robert,42,0,50,8
1681918613376,COGS 14A,A01,179854,Staff,18,0,50,32
1681918614402,COGS 14B,A01,179856,Staff,54,0,60,6
1681918615429,COGS 17,A01,179874,Staff,71,0,75,4
1681918616454,COGS 18,A01,179884,Staff,63,0,80,17
1681918617493,COGS 100,A01,179886,Staff,40,0,60,20
1681918618517,COGS 101B,A01,179892,Staff,1,0,30,29
1681918619538,COGS 101C,A01,179894,Staff,28,0,30,2
1681918620561,COGS 107A,A01,179896,Boyle; Mary E. T.,31,0,40,9
1681918621589,COGS 108,A01,179898,Simpkins; Charles Alexander,0,20,60,60
1681918622613,COGS 109,A01,179900,Staff,34,0,40,6
1681918623644,COGS 118A,A01,179946,Staff,8,0,40,32
1681918624669,COGS 153,A00,179978,Staff,0,1,30,30
1681918625692,COGS 156,A01,179981,Staff,27,0,30,3
1681918627742,COGS 172,A01,179987,Staff,13,0,30,17
1681918629789,COGS 186,A01,179991,Staff,12,0,30,18
1681918630827,COMM 10,A01,180001,Staff,15,0,25,10
1681918630827,COMM 10,A02,180004,Staff,20,0,25,5
1681918631850,COMM 100A,A01,180016,Staff,17,0,25,8
1681918631850,COMM 100A,A02,180020,Staff,24,0,25,1
1681918632872,COMM 101T,A00,180029,Halm; Gavin Patrick,23,0,35,12
1681918633894,COMM 106V,A00,180043,Staff,34,0,35,1
1681918634930,COMM 109P,A00,180044,Staff,31,0,35,4
1681918635959,COMM 113T,A00,180045,Havis; Allan,37,0,45,8
1681918636986,COMM 132,A00,180046,McKenna; Denise,23,0,30,7
1681918638008,COMM 143,A00,180047,Staff,19,0,30,11
1681918639032,COMM 190,A00,180048,Conner; Thomas Hartnell,20,0,23,3
1681918640059,CSE 8A,A50,180053,Cao; Yingjun,25,0,50,25
1681918640059,CSE 8A,B50,180180,Staff,50,0,50,0
1681918641090,CSE 11,A01,180190,Cao; Yingjun,28,0,50,22
1681918642117,CSE 20,A01,180192,Briones; Jor-el Thomas Caparas,23,0,30,7
1681918643140,CSE 21,A01,194538,Briones; Jor-el Thomas Caparas,50,0,60,10
1681918644167,CSE 30,A01,180324,Eldon; John,77,0,100,23
1681918645190,CSE 101,A01,201353,Staff,0,21,40,40
1681918646311,CSE 134B,A01,180326,Powell; Thomas Allan,74,0,100,26
1681918647335,CSE 140,A01,180328,Staff,45,0,75,30
1681918648362,CSE 140L,A01,180344,Eldon; John,68,0,100,32
1681918649385,CSE 150A,A01,180411,Staff,0,8,50,50
1681918650411,CSE 151A,A01,180414,Staff,0,6,50,50
1681918651436,CSE 175,A01,222521,Kumar; Rakesh,50,0,50,0
1681918652467,CSE 190,A00,201419,Staff,45,0,49,4
1681918653493,CSS 1,A01,194536,Staff,37,0,50,13
1681918654520,DSC 30,A01,202385,Staff,48,0,50,2
1681918655542,DSC 40A,A01,202387,Albuyeh; Rod,50,0,50,0
1681918656564,DSC 190,A01,202389,Silberman; Jack,21,0,21,0
1681918657587,DSGN 100,A01,179993,Staff,16,0,30,14
1681918658612,ECE 65,A50,180708,Staff,10,0,20,10
1681918658612,ECE 65,A51,180739,Staff,19,0,20,1
1681918659635,ECON 1,A01,180427,Famulari; Melissa,67,0,70,3
1681918660657,ECON 2,A01,180450,Levkoff; Steven B.,64,0,70,6
1681918661679,ECON 4,A01,203351,Anderson; John Charles,7,0,10,3
1681918662702,ECON 100A,A01,180472,Famulari; Melissa,64,0,70,6
1681918663724,ECON 120A,A01,180549,Staff,64,0,70,6
1681918664750,ECON 120B,A01,180655,Ma; Xinwei,45,0,70,25
1681918665776,ECON 129,A00,203333,Eckert; Fabian Paul,15,0,35,20
1681918666817,ECON 131,A00,180656,Staff,7,0,35,28
1681918667844,ECON 172B,A01,180672,Levkoff; Steven B.,31,0,35,4
1681918668872,ECON 178,A01,203342,Zhu; Ying,9,0,35,26
1681918669897,EDS 108GS,A00,202383,Wishard Guerra; Alison G.,20,0,20,0
1681918670930,EDS 111GS,A00,202347,Wishard Guerra; Alison G.,20,0,20,0
1681918671954,EDS 112,A01,202323,Staff,56,0,60,4
1681918672977,EDS 113,A00,202340,Staff,33,0,35,2
1681918674000,EDS 118,A00,201231,Staff,20,0,30,10
1681918675027,EDS 119,A00,204994,Staff,8,0,10,2
1681918676048,EDS 124BR,A00,202324,Eguchi; Emi,4,0,25,21
1681918677083,EDS 126,A01,203208,Jones; Makeba,26,0,30,4
1681918678107,EDS 135,A01,202333,Staff,18,0,20,2
1681918679131,EDS 180,A00,202311,Staff,47,0,50,3
1681918680156,ERC 190GS,A01,253747,Staff,28,0,28,0
1681918681179,ETHN 104,A00,180742,Staff,24,0,35,11
1681918682209,ETHN 118,A00,180745,Staff,28,0,35,7
1681918683232,ETHN 127,A00,180747,Staff,12,0,16,4
1681918684261,ETHN 137,A00,180880,Staff,12,0,12,0
1681918685286,ETHN 147,A00,180890,Staff,8,0,10,2
1681918686311,ETHN 154,A00,180891,Staff,7,0,8,1
1681918687332,ETHN 168,A00,180892,Staff,9,0,10,1
1681918688355,GLBH 20,A00,201051,Hannah; Seth Donal,0,1,0,1
1681918689382,GLBH 111,A01,209338,Burgos; Jose L.,0,0,0,0
1681918690405,GLBH 150,A00,258300,Staff,0,3,0,0
1681918691431,GLBH 181,A00,201207,Staff,15,0,40,25
1681918692459,HIEU 109,A00,180898,Staff,20,0,20,0
1681918693485,HIEU 111,A00,180899,Staff,0,0,20,20
1681918694538,HIEU 124,A00,180900,Staff,17,0,20,3
1681918695562,HILA 122,A00,180901,Staff,18,0,20,2
1681918696587,HILA 132,A00,180902,Vitz; Matthew,2,0,20,18
1681918697609,HILD 10,A01,180896,Staff,15,0,20,5
1681918698634,HILD 30GS,A00,180897,Edington; Claire Ellen,0,0,0,0
1681918699659,HISC 105,A00,180903,Staff,20,0,20,0
1681918700687,HISC 117,A00,180904,Staff,11,0,20,9
1681918701715,HIUS 108B,A00,181005,Staff,18,0,20,2
1681918702737,HIUS 113,A00,181093,Staff,3,0,20,17
1681918703759,HUM 3,A01,181190,Patterson; Patrick H.,40,0,50,10
1681918703759,HUM 3,B01,181195,Staff,46,0,50,4
1681918704783,HUM 3GS,A00,181196,Herbst; Matthew,0,0,0,0
1681918705806,HUM 4,A01,181227,West; Geoffrey Scott,33,0,50,17
1681918705806,HUM 4,B01,181282,Staff,42,0,50,8
1681918706837,HUM 4GS,A00,181377,Lyon; Antony J.,0,0,0,0
1681918707865,HUM 5,A01,181536,Zavodny; Tatiana Sophia,30,0,50,20
1681918707865,HUM 5,B01,181908,Staff,36,0,50,14
1681918708890,INTL 190,A00,181909,Segui; Alan S,0,0,0,7
1681918708890,INTL 190,B00,181961,Segui; Alan S,0,0,0,7
1681918709916,JAPN 20AR,A01,182113,Ross; Kayoko F,15,0,20,5
1681918710941,LATI 50,A01,202391,Martin-Cabrera; Luis,19,0,30,11
1681918710941,LATI 50,A02,202392,Martin-Cabrera; Luis,26,0,30,4
1681918711965,LATI 180,A00,202393,Kokinis; Troy Andreas,24,0,25,1
1681918712988,LIFR 1A,A00,182119,Staff,14,0,14,0
1681918714021,LIFR 1AX,A00,182324,Staff,14,0,14,0
1681918715047,LIFR 1B,A00,182259,Staff,14,0,14,0
1681918716077,LIFR 1BX,A00,182273,Staff,14,0,14,0
1681918717102,LIGN 8,A00,182330,Staff,136,0,150,14
1681918718125,LIGN 9GS,A00,182362,Staff,20,0,20,0
1681918719151,LIGN 119,A00,204992,Takahashi; Maho,12,0,15,3
1681918720175,LIGN 130,A01,182384,Staff,47,0,50,3
1681918721198,LIGN 149GS,A00,182390,Staff,20,0,20,0
1681918722224,LIGN 170,A00,182404,Staff,23,0,30,7
1681918723249,LISP 1D,A00,182281,Staff,7,0,14,7
1681918723249,LISP 1D,B00,182287,Staff,14,0,14,0
1681918723249,LISP 1D,C00,182295,Staff,11,0,14,3
1681918723249,LISP 1D,D00,182301,Staff,14,0,14,0
1681918724276,LISP 1DX,A00,182309,Staff,20,0,28,8
1681918724276,LISP 1DX,B00,182316,Staff,26,0,28,2
1681918725307,LTAF 120GS,A00,182412,Zhiri; Oumelbanine,20,0,20,0
1681918726333,LTCS 172GS,A00,182437,Bronstein; Phoebe Malan,20,0,20,0
1681918727355,LTEA 138,A00,182457,Staff,21,0,40,19
1681918728390,LTEN 114,A01,182490,Staff,23,0,25,2
1681918729415,LTEN 130GS,A00,182491,Lyon; Antony J.,20,0,20,0
1681918730438,LTEN 169,A00,182493,Cuong; Marisol,19,0,25,6
1681918731463,LTEN 178,A00,182501,Staff,14,0,15,1
1681918732489,LTEN 181,A00,182515,Staff,22,0,25,3
1681918733524,LTEN 185GS,A00,197655,Forbes; Camille,20,0,20,0
1681918734550,LTSP 100B,A00,202208,Bessett; Ryan Matthew,24,0,25,1
1681918735572,LTWL 100,A00,182516,Myerston Santana; Jacobo,22,0,30,8
1681918736597,LTWR 100GS,A00,182518,Forbes; Camille,20,0,20,0
1681918737620,LTWR 102,A00,182522,Staff,15,0,15,0
1681918737620,LTWR 102,B00,182525,Staff,14,0,15,1
1681918738646,LTWR 115,A00,182526,Staff,11,0,15,4
1681918739671,MAE 8,A01,182528,Pham; Hieu Tan,67,0,70,3
1681918740693,MAE 11,A00,182529,Bahadori; Mohammad Yousef,94,0,100,6
1681918741724,MAE 20,A00,182530,Evdokimenko; Ekaterina,68,0,70,2
1681918742749,MAE 30A,A00,182532,Staff,44,0,45,1
1681918743773,MAE 101A,A00,182533,Bahadori; Mohammad Yousef,96,0,100,4
1681918744796,MAE 101C,A00,182538,Staff,62,0,70,8
1681918745820,MAE 104,A00,182539,Staff,45,0,50,5
1681918746853,MAE 131A,A00,182540,Ghazinejad; Maziar,41,0,45,4
1681918747880,MAE 143A,A00,182548,Bewley; Thomas R,43,0,50,7
1681918748905,MAE 150,A00,182549,Staff,28,0,40,12
1681918750003,MAE 160,A00,182550,Evdokimenko; Ekaterina,42,0,60,18
1681918751028,MATH 3C,A01,182725,Staff,26,0,30,4
1681918752050,MATH 10A,A01,182729,Staff,25,0,30,5
1681918752050,MATH 10A,B01,182732,Staff,26,0,30,4
1681918753087,MATH 10B,A01,182737,Staff,21,0,30,9
1681918753087,MATH 10B,A02,182738,Staff,26,0,30,4
1681918753087,MATH 10B,B01,182744,Staff,27,0,30,3
1681918753087,MATH 10B,B02,182745,Staff,27,0,30,3
1681918754119,MATH 18,A01,182750,Anzaldo; Leesa B,28,0,30,2
1681918754119,MATH 18,A02,182751,Anzaldo; Leesa B,29,0,30,1
1681918754119,MATH 18,A03,182753,Anzaldo; Leesa B,28,0,30,2
1681918754119,MATH 18,A04,182757,Anzaldo; Leesa B,29,0,30,1
1681918754119,MATH 18,B01,182761,Anzaldo; Leesa B,27,0,30,3
1681918754119,MATH 18,B02,182764,Anzaldo; Leesa B,27,0,30,3
1681918754119,MATH 18,B03,182765,Anzaldo; Leesa B,30,0,30,0
1681918754119,MATH 18,B04,182766,Anzaldo; Leesa B,30,0,30,0
1681918755153,MATH 20A,A01,182771,Suk; Andrew Hoon,28,0,30,2
1681918756180,MATH 20B,A01,182775,Bach; Quang Tran,30,0,30,0
1681918756180,MATH 20B,A02,182777,Bach; Quang Tran,29,0,30,1
1681918756180,MATH 20B,B01,182780,Bach; Quang Tran,27,0,30,3
1681918756180,MATH 20B,B02,182782,Bach; Quang Tran,30,0,30,0
1681918757202,MATH 20C,A01,182787,Staff,25,0,30,5
1681918757202,MATH 20C,A02,182790,Staff,29,0,30,1
1681918757202,MATH 20C,B01,182792,Staff,25,0,30,5
1681918757202,MATH 20C,B02,182796,Staff,27,0,30,3
1681918758224,MATH 20D,A01,182799,Staff,29,0,30,1
1681918758224,MATH 20D,A02,182802,Staff,29,0,30,1
1681918758224,MATH 20D,A03,182803,Staff,30,0,30,0
1681918759257,MATH 20E,A01,182809,Verstraete; Jacques Allan,23,0,30,7
1681918759257,MATH 20E,A02,182811,Verstraete; Jacques Allan,28,0,30,2
1681918759257,MATH 20E,B01,182814,Verstraete; Jacques Allan,23,0,30,7
1681918759257,MATH 20E,B02,182815,Verstraete; Jacques Allan,30,0,30,0
1681918760280,MATH 103A,A01,182820,Staff,8,0,30,22
1681918760280,MATH 103A,A02,182821,Staff,27,0,30,3
1681918760280,MATH 103A,A03,182822,Staff,23,0,30,7
1681918760280,MATH 103A,B01,182825,Staff,23,0,30,7
1681918760280,MATH 103A,B02,182826,Staff,30,0,30,0
1681918760280,MATH 103A,B03,182830,Staff,30,0,30,0
1681918761308,MATH 109,A01,182836,Chow; Bennett,24,0,30,6
1681918761308,MATH 109,A02,182838,Chow; Bennett,29,0,30,1
1681918761308,MATH 109,A03,182894,Chow; Bennett,29,0,30,1
1681918761308,MATH 109,B01,182908,Chow; Bennett,28,0,30,2
1681918761308,MATH 109,B02,182909,Chow; Bennett,30,0,30,0
1681918761308,MATH 109,B03,182910,Chow; Bennett,27,0,30,3
1681918762332,MATH 142A,A01,182925,Staff,10,0,30,20
1681918762332,MATH 142A,A02,182935,Staff,24,0,30,6
1681918762332,MATH 142A,A03,182967,Staff,26,0,30,4
1681918762332,MATH 142A,B01,183125,Staff,22,0,30,8
1681918762332,MATH 142A,B02,183157,Staff,28,0,30,2
1681918762332,MATH 142A,B03,183158,Staff,29,0,30,1
1681918763357,MATH 183,A01,183160,Arias-Castro; Ery,23,0,30,7
1681918763357,MATH 183,A02,183161,Arias-Castro; Ery,29,0,30,1
1681918763357,MATH 183,B01,183163,Arias-Castro; Ery,28,0,30,2
1681918763357,MATH 183,B02,183164,Arias-Castro; Ery,28,0,30,2
1681918764380,MATH 193A,A01,183167,Staff,4,0,35,31
1681918764380,MATH 193A,A02,183168,Staff,28,0,35,7
1681918764380,MATH 193A,A03,183169,Staff,34,0,35,1
1681918764380,MATH 193A,A04,183170,Staff,28,0,35,7
1681918765402,MGT 4,A01,202395,Anderson; John Charles,75,0,80,5
1681918766429,MGT 5,A00,202396,Houskeeper; Robert,80,0,90,10
1681918767453,MGT 103,A00,202397,Eberhard; Craig A,53,0,90,37
1681918768486,MGT 131A,A00,202398,Houskeeper; Robert,85,0,90,5
1681918769512,MGT 135,A00,202399,Anderson; John Charles,81,0,90,9
1681918770537,MGT 162R,A00,202403,Gneezy; Uri,146,0,200,54
1681918771563,MGT 172,A00,202404,Hedges; Kathleen,49,0,90,41
1681918772592,MGT 181,A00,202405,Dunn; Louis Jean,83,0,90,7
1681918773618,MMW 14,A01,183200,Staff,13,0,28,15
1681918773618,MMW 14,A02,183201,Staff,26,0,28,2
1681918773618,MMW 14,A03,183202,Staff,24,0,28,4
1681918773618,MMW 14,A04,183203,Staff,25,0,28,3
1681918773618,MMW 14,A05,183204,Staff,26,0,28,2
1681918773618,MMW 14,A06,183205,Staff,27,0,28,1
1681918773618,MMW 14,B01,183207,Staff,26,0,28,2
1681918773618,MMW 14,B02,183208,Staff,28,0,28,0
1681918773618,MMW 14,B03,183209,Staff,28,0,28,0
1681918773618,MMW 14,B04,183210,Staff,28,0,28,0
1681918773618,MMW 14,B05,183211,Staff,28,0,28,0
1681918773618,MMW 14,B06,183212,Staff,27,0,28,1
1681918774652,MMW 14GS,A00,183213,Zhiri; Oumelbanine,28,0,28,0
1681918775680,MMW 15GS,B00,183215,Rahimi; Babak,28,0,28,0
1681918776703,MMW 121,A01,183217,Patterson; Patrick H.,14,0,28,14
1681918776703,MMW 121,A02,183218,Patterson; Patrick H.,25,0,28,3
1681918777726,MUS 1A,A01,182554,Staff,7,0,35,28
1681918778754,MUS 5,A01,182558,Staff,19,0,35,16
1681918779780,MUS 6,A01,182562,Staff,24,0,35,11
1681918780805,MUS 8GS,A00,182563,Borgo; David Garcia,25,0,25,0
1681918781827,MUS 13,A01,182567,Staff,24,0,25,1
1681918782850,MUS 15,A01,182570,Staff,32,0,35,3
1681918782850,MUS 15,B01,182575,Staff,9,0,35,26
1681918783875,MUS 80,A00,182578,Staff,23,0,25,2
1681918783875,MUS 80,B00,182581,Staff,20,0,25,5
1681918784901,MUS 113,A00,182582,Staff,25,0,25,0
1681918785930,MUS 114,A00,182583,Staff,4,0,25,21
1681918786956,MUS 150GS,A01,182588,Borgo; David Garcia,25,0,25,0
1681918787986,PHIL 1,A00,182590,Staff,35,0,40,5
1681918789010,PHIL 10,A01,182596,Grush; Rick Scott,31,0,35,4
1681918789010,PHIL 10,A02,182597,Grush; Rick Scott,34,0,35,1
1681918790033,PHIL 15,A01,182601,Staff,31,0,35,4
1681918790033,PHIL 15,A02,182602,Staff,33,0,35,2
1681918791059,PHIL 27,A01,182604,Staff,30,0,35,5
1681918791059,PHIL 27,A02,182607,Staff,35,0,35,0
1681918792081,PHIL 32,A01,182609,Staff,35,0,35,0
1681918792081,PHIL 32,A02,182612,Staff,35,0,35,0
1681918793112,PHIL 130,A00,182614,Staff,62,0,70,8
1681918794139,PHIL 136,A00,182616,Cohen; Jonathan David,66,0,70,4
1681918795164,PHIL 155,A00,182617,Vargas; Manuel Rogelio,59,0,70,11
1681918796191,PHIL 163,A01,182620,Staff,15,0,20,5
1681918796191,PHIL 163,A02,182624,Staff,10,0,20,10
1681918797219,PHIL 164,A00,182627,Staff,30,0,40,10
1681918798242,PHIL 173,A00,182628,Staff,36,0,40,4
1681918799265,PHYS 1A,A00,183221,Staff,54,0,60,6
1681918800289,PHYS 1AL,001,183222,Staff,25,0,30,5
1681918800289,PHYS 1AL,002,183223,Staff,28,0,30,2
1681918801317,PHYS 1B,A00,183231,Staff,43,0,60,17
1681918802345,PHYS 1BL,001,183232,Staff,20,0,30,10
1681918802345,PHYS 1BL,002,183233,Staff,27,0,30,3
1681918803373,PHYS 1C,A00,183240,Staff,30,0,60,30
1681918804401,PHYS 1CL,001,183241,Staff,13,0,30,17
1681918804401,PHYS 1CL,002,183242,Staff,22,0,30,8
1681918805423,PHYS 2AR,A01,183250,Staff,44,0,50,6
1681918806446,PHYS 2B,A01,183252,Staff,105,0,115,10
1681918807470,PHYS 2BL,A01,183254,Staff,21,0,24,3
1681918807470,PHYS 2BL,A02,183255,Staff,22,0,24,2
1681918808493,PHYS 2C,A01,183522,Staff,105,0,115,10
1681918809517,PHYS 4A,A01,183524,Staff,49,0,50,1
1681918810538,POLI 5,A00,183525,Staff,44,0,50,6
1681918811560,POLI 12,A00,183540,Staff,48,0,50,2
1681918812583,POLI 13R,A00,183541,Forman; Fonna,42,0,50,8
1681918813609,POLI 30,A00,183542,Mignozzetti; Umberto,47,0,50,3
1681918814632,POLI 100A,A00,183543,Staff,45,0,50,5
1681918815657,POLI 100E,A00,223598,Staff,32,0,35,3
1681918816685,POLI 103A,A00,183564,Kousser; Thad,37,0,50,13
1681918817716,POLI 104B,A00,201329,Staff,29,0,35,6
1681918818742,POLI 113BR,A00,183576,Hoston; Germaine,26,0,50,24
1681918819773,POLI 114BR,A00,183588,Staff,27,0,30,3
1681918820815,POLI 117R,A00,183595,Forman; Fonna,8,0,20,12
1681918821841,POLI 120H,A00,183596,Fisk; David Lee,13,0,20,7
1681918822868,POLI 130AA,A00,183597,Staff,14,0,20,6
1681918823892,POLI 134AA,A00,183598,Staff,19,0,20,1
1681918824915,POLI 135,A00,183599,Fisk; David Lee,20,0,25,5
1681918825948,POLI 142P,A00,183623,Staff,37,0,40,3
1681918826972,POLI 144D,A00,183624,Staff,22,0,25,3
1681918827993,POLI 151,A00,183625,Staff,15,0,20,5
1681918829015,POLI 162,A00,183626,Mignozzetti; Umberto,18,0,20,2
1681918830037,PSYC 1,A00,253748,Staff,86,0,90,4
1681918831061,PSYC 2,A00,183627,Moranton; Nirelia Melbina-,25,0,35,10
1681918832092,PSYC 3,A00,183628,Staff,43,0,45,2
1681918834143,PSYC 60,A01,183631,Lowe; Angela Beth,35,0,40,5
1681918835171,PSYC 70,A01,253757,Staff,37,0,45,8
1681918836194,PSYC 101,A00,183632,Heyman; Gail D.,48,0,60,12
1681918837220,PSYC 105,A00,183848,Lowe; Angela Beth,48,0,60,12
1681918838245,PSYC 106,A00,183849,Dobkins; Karen R.,44,0,60,16
1681918839274,PSYC 108,A00,253750,Staff,24,0,60,36
1681918840308,PSYC 114,A01,184275,Winkielman; Piotr,0,7,30,30
1681918841338,PSYC 122,A00,183856,Moranton; Nirelia Melbina-,0,10,30,30
1681918842363,PSYC 124,A00,183865,Chapman; Eddie Nathaniel,52,0,80,28
1681918843386,PSYC 137,A00,183880,Staff,19,0,25,6
1681918845436,PSYC 154,A00,183910,Lacefield; Katharine I,0,6,90,90
1681918847480,PSYC 162,A00,183946,Wixted; John T,61,0,90,29
1681918848505,PSYC 172,A00,183947,Gorman; Michael R.,12,0,30,18
1681918849529,PSYC 178,A00,183963,Glaser; Dale,19,0,40,21
1681918850550,PSYC 181GS,A00,183964,Anagnostaras; Stephan,10,0,10,0
1681918851574,PSYC 186GS,A01,257660,Staff,10,0,10,0
1681918852601,PSYC 193,B00,253749,Staff,23,0,25,2
1681918854729,PSYC 193L,A01,184122,Staff,33,0,35,2
1681918854729,PSYC 193L,C01,184167,Winkielman; Piotr,15,0,30,15
1681918855752,RELI 188GS,A00,182629,Rahimi; Babak,20,0,20,0
1681918856774,SE 101A,A00,182646,Staff,26,0,30,4
1681918857805,SE 101C,A00,182650,Staff,18,0,20,2
1681918858830,SE 110A,A00,182651,Staff,28,0,28,0
1681918859856,SE 130A,A00,182652,Staff,39,0,40,1
1681918860879,SIO 46GS,A00,182636,Cook; Geoffrey W,28,0,28,0
1681918861902,SIO 109R,A00,194459,Staff,4,0,20,16
1681918862935,SIO 121GS,A00,182639,Cook; Geoffrey W,28,0,28,0
1681918863960,SIO 132,A01,182642,Staff,32,0,40,8
1681918864983,SIO 139,A00,182644,Kacev; David,36,0,40,4
1681918866007,SOCI 2,A01,258404,Staff,34,0,36,2
1681918866007,SOCI 2,A02,258405,Staff,35,0,36,1
1681918867033,SOCI 60,A01,258408,Staff,29,0,30,1
1681918867033,SOCI 60,A02,258413,Staff,30,0,30,0
1681918868060,SOCI 100,A01,258415,Staff,29,0,30,1
1681918868060,SOCI 100,A02,258416,Staff,28,0,30,2
1681918874216,SOCI 127,A00,258421,Staff,21,0,30,9
1681918875238,SOCI 132,A00,258422,Staff,45,0,50,5
1681918876261,SOCI 133,A00,258423,Staff,26,0,30,4
1681918877289,SOCI 138GS,A00,258424,Staff,15,0,15,0
1681918878317,SOCI 145,A00,258425,Staff,25,0,30,5
1681918879354,SOCI 148,A00,258426,Staff,26,0,30,4
1681918880379,SOCI 153,A00,199217,Staff,29,0,30,1
1681918881407,SOCI 160,A00,258427,Staff,28,0,30,2
1681918882430,SOCI 160E,A00,258435,Staff,56,0,60,4
1681918883458,SOCI 189GS,A00,258436,Staff,15,0,15,0
1681918884480,SOCI 190GS,A00,258437,Staff,15,0,15,0
1681918885505,SYN 2,001,182658,Staff,8,0,16,8
1681918885505,SYN 2,002,201439,Staff,14,0,16,2
1681918885505,SYN 2,003,201443,Staff,16,0,16,0
1681918886527,SYN 100,A01,182657,Staff,16,0,20,4
1681918887550,TDAC 1,A00,184381,Salovey; Todd,16,0,20,4
1681918887550,TDAC 1,B00,184385,Harting; Carla Kelso,19,0,20,1
1681918887550,TDAC 1,C00,184394,Staff,19,0,20,1
1681918888573,TDAC 101,A00,184483,Harting; Carla Kelso,19,0,20,1
1681918889595,TDDE 111,A00,184496,Staff,14,0,15,1
1681918890618,TDDE 131,A00,184504,Staff,20,0,20,0
1681918890618,TDDE 131,B00,184505,Staff,17,0,18,1
1681918890618,TDDE 131,C00,184534,Staff,49,0,50,1
1681918890618,TDDE 131,D00,184564,Staff,15,0,15,0
1681918890618,TDDE 131,E00,204725,Staff,19,0,20,1
1681918891641,TDGE 1,A01,184414,Salovey; Todd,36,0,50,14
1681918892678,TDGE 5,A01,184419,Staff,23,0,24,1
1681918893707,TDGE 10,A00,184428,Fulton; Julia,29,0,50,21
1681918894729,TDGE 124,A00,184565,Fulton; Julia,7,0,50,43
1681918895754,TDGE 125,B00,184567,Meyer; Ursula,9,0,25,16
1681918896787,TDHT 101,A00,184568,Staff,21,0,25,4
1681918896787,TDHT 101,B00,184569,Staff,20,0,20,0
1681918897810,TDHT 114,A00,184570,Staff,49,0,50,1
1681918898834,TDMV 1,A00,184437,Arcidiacono; Kristin,22,0,30,8
1681918898834,TDMV 1,B00,184448,Caligagan; Maria T.,23,0,30,7
1681918899860,TDMV 2,A00,184449,Weinberg; Sadie,27,0,30,3
1681918899860,TDMV 2,B00,184453,Arcidiacono; Kristin,29,0,30,1
1681918900887,TDMV 110,A00,184571,Weinberg; Sadie,30,0,30,0
1681918901931,TDMV 142,A00,184572,Caligagan; Tony,27,0,30,3
1681918901931,TDMV 142,B00,184573,Caligagan; Maria T.,26,0,30,4
1681918902974,TDTR 20,A00,184482,Jun; Grace Shin Hae,25,0,25,0
1681918904006,USP 2,A01,184290,Hinds; Juli Beth,24,0,25,1
1681918905029,USP 3,A01,184295,Staff,20,0,25,5
1681918906052,USP 4,A00,184304,McTague; Sarah,15,0,25,10
1681918907076,USP 100,A00,184315,Staff,17,0,25,8
1681918908108,USP 105,A00,184326,Staff,21,0,25,4
1681918909131,USP 151,A00,184327,Staff,20,0,25,5
1681918910157,USP 170,A00,184380,Hinds; Juli Beth,14,0,25,11
1681918911185,VIS 21B,A01,182660,Staff,28,0,31,3
1681918911185,VIS 21B,A02,182662,Staff,30,0,31,1
1681918912211,VIS 103D,A00,182663,Staff,74,0,75,1
1681918913243,VIS 105D,A00,182667,Li; Huai,15,0,22,7
1681918914266,VIS 122GS,A00,182668,Herbst; Matthew,20,0,20,0
1681918915289,VIS 128C,A00,182673,Staff,69,0,75,6
1681918916342,VIS 130,A00,182675,Staff,20,0,22,2
1681918917368,VIS 160A,A00,182678,Stalbaum; Brett,4,0,10,6
1681918919413,WCWP 10B,A00,201679,Staff,15,0,15,0
1681918919413,WCWP 10B,B00,201695,Staff,15,0,15,0
1681918920441,WCWP 100,A00,201716,Staff,15,0,15,0
1681918920441,WCWP 100,B00,201717,Staff,10,0,15,5
1681918922508,ANSC 105GS,A00,258289,Staff,0,0,0,0
1681918923532,ANSC 125GS,A00,258295,Staff,0,0,0,0
1681918924557,ANSC 150,A00,258267,Staff,30,0,40,10
1681918925590,ANSC 190GS,A00,258280,Staff,0,0,0,0
1681918926614,ANTH 1,A00,258264,Staff,38,0,40,2
1681918927637,ANTH 2,A01,258259,Staff,72,0,76,4
1681918928667,ANTH 23,A01,258228,Staff,36,0,40,4
1681918929695,ANTH 101,A01,258236,Staff,38,0,40,2
1681918930720,ANTH 102,A00,258272,Staff,59,0,60,1
1681918931742,ANTH 105,A00,258244,Staff,31,0,35,4
1681918932776,BENG 130,A00,253975,Staff,38,0,40,2
1681918933808,BIBC 102,A01,191866,Flagg; Matthew Paul,19,0,32,13
1681918933808,BIBC 102,A02,191867,Flagg; Matthew Paul,22,0,32,10
1681918933808,BIBC 102,A03,191868,Flagg; Matthew Paul,29,0,32,3
1681918933808,BIBC 102,A04,191936,Flagg; Matthew Paul,26,0,32,6
1681918933808,BIBC 102,A05,191937,Flagg; Matthew Paul,6,0,32,26
1681918934832,BICD 100,A01,191939,Cooper; Andrew Michael,28,0,32,4
1681918934832,BICD 100,A02,191940,Cooper; Andrew Michael,32,0,32,0
1681918934832,BICD 100,A03,191941,Cooper; Andrew Michael,32,0,32,0
1681918934832,BICD 100,A04,191942,Cooper; Andrew Michael,32,0,32,0
1681918934832,BICD 100,A05,191943,Cooper; Andrew Michael,32,0,32,0
1681918935857,BIEB 126,A01,191945,Cleland; Elsa Eleanor,0,0,32,32
1681918935857,BIEB 126,A02,191946,Cleland; Elsa Eleanor,27,0,32,5
1681918935857,BIEB 126,A03,191947,Cleland; Elsa Eleanor,29,0,32,3
1681918935857,BIEB 126,A04,191948,Cleland; Elsa Eleanor,23,0,32,9
1681918935857,BIEB 126,A05,191996,Cleland; Elsa Eleanor,28,0,32,4
1681918936884,BIEB 136GS,A00,191997,Shurin; Jonathan & Holway; David A.,0,0,0,0
1681918937914,BIEB 137GS,A01,191999,Shurin; Jonathan & Holway; David A.,0,0,0,0
1681918938941,BILD 1,A01,205385,Staff,31,0,32,1
1681918938941,BILD 1,A02,205386,Staff,30,0,32,2
1681918938941,BILD 1,A03,205387,Staff,32,0,32,0
1681918938941,BILD 1,A04,205388,Staff,27,0,32,5
1681918939964,BILD 2,A01,191774,Staff,28,0,32,4
1681918939964,BILD 2,A02,191775,Staff,30,0,32,2
1681918939964,BILD 2,A03,191777,Staff,30,0,32,2
1681918939964,BILD 2,A04,191856,Staff,31,0,32,1
1681918939964,BILD 2,A05,191857,Staff,32,0,32,0
1681918939964,BILD 2,A06,191858,Staff,32,0,32,0
1681918939964,BILD 2,A07,191859,Staff,31,0,32,1
1681918940989,BILD 3,A01,205391,Staff,29,0,32,3
1681918940989,BILD 3,A02,205393,Staff,32,0,32,0
1681918940989,BILD 3,A03,205394,Staff,28,0,32,4
1681918940989,BILD 3,A04,205395,Staff,32,0,32,0
1681918942016,BILD 20,A01,191861,Staff,32,0,32,0
1681918942016,BILD 20,A02,191862,Staff,32,0,32,0
1681918943039,BILD 30,A01,191864,Staff,31,0,32,1
1681918944062,BIMM 100,A01,192019,Staff,0,0,32,32
1681918944062,BIMM 100,A02,192020,Staff,21,0,32,11
1681918944062,BIMM 100,A03,192035,Staff,21,0,32,11
1681918945089,BIMM 110,A01,192037,Tat; John,0,0,32,32
1681918945089,BIMM 110,A02,192038,Tat; John,10,0,32,22
1681918946112,BIMM 120,A01,192040,Pickett; Brooke Elizabeth,2,0,32,30
1681918946112,BIMM 120,A02,192041,Pickett; Brooke Elizabeth,16,0,32,16
1681918946112,BIMM 120,A03,192042,Pickett; Brooke Elizabeth,15,0,32,17
1681918947136,BIPN 100,A01,192044,Armour; Jon Christopher,26,0,32,6
1681918947136,BIPN 100,A02,192059,Armour; Jon Christopher,30,0,32,2
1681918947136,BIPN 100,A03,192064,Armour; Jon Christopher,31,0,32,1
1681918947136,BIPN 100,A04,192073,Armour; Jon Christopher,28,0,32,4
1681918948162,BIPN 148,A01,205411,Leutgeb; Jill K.,16,0,32,16
1681918948162,BIPN 148,A02,205412,Leutgeb; Jill K.,31,0,32,1
1681918948162,BIPN 148,A03,205413,Leutgeb; Jill K.,30,0,32,2
1681918948162,BIPN 148,A04,205414,Leutgeb; Jill K.,30,0,32,2
1681918949186,BIPN 160,A01,192115,Marino; Marc J,17,0,32,15
1681918949186,BIPN 160,A02,192148,Marino; Marc J,27,0,32,5
1681918949186,BIPN 160,A03,192158,Marino; Marc J,31,0,32,1
1681918949186,BIPN 160,A04,192190,Marino; Marc J,32,0,32,0
1681918949186,BIPN 160,A05,192287,Marino; Marc J,32,0,32,0
1681918949186,BIPN 160,A06,192288,Marino; Marc J,32,0,32,0
1681918950213,BIPN 194,A00,206038,Staff,28,0,32,4
1681918951237,BISP 194,A00,192289,Leutgeb; Stefan,13,0,32,19
1681918951237,BISP 194,B00,245332,Nieh; James Charles,26,0,32,6
1681918952280,CAT 124,A01,202247,Staff,15,0,15,0
1681918953317,CAT 125,A00,202248,Staff,19,0,20,1
1681918953317,CAT 125,B00,202253,Staff,20,0,20,0
1681918953317,CAT 125,C00,202257,Staff,18,0,20,2
1681918954343,CAT 125GS,A01,202273,Bronstein; Phoebe Malan,20,0,20,0
1681918955369,CAT 125R,A00,202284,Staff,17,0,20,3
1681918955369,CAT 125R,C00,202286,Staff,10,0,20,10
1681918955369,CAT 125R,D00,202291,Staff,18,0,20,2
1681918955369,CAT 125R,E00,202295,Staff,13,0,20,7
1681918955369,CAT 125R,F00,202302,Staff,12,0,20,8
1681918956394,CENG 100,A00,204724,Opatkiewicz; Justin Paul,25,0,25,0
1681918957495,CGS 2A,A01,180420,Staff,31,0,36,5
1681918958521,CGS 101,A00,180421,Staff,16,0,20,4
1681918959544,CGS 112,A00,180422,Staff,9,0,16,7
1681918960576,CGS 113,A00,180423,Staff,18,0,20,2
1681918961601,CGS 137,A00,180424,Staff,12,0,12,0
1681918962627,CGS 147,A00,180425,Staff,10,0,10,0
1681918963650,CHEM 6A,A01,179556,Staff,97,0,100,3
1681918963650,CHEM 6A,A02,179558,Staff,0,0,0,0
1681918964676,CHEM 6B,A01,179560,Staff,100,0,100,0
1681918965698,CHEM 6C,A01,179565,Jazzar; Rodolphe,95,0,100,5
1681918966731,CHEM 7L,A01,179586,Schurmeier; Kimberly,11,0,24,13
1681918966731,CHEM 7L,A02,179587,Schurmeier; Kimberly,23,0,24,1
1681918966731,CHEM 7L,A03,179590,Schurmeier; Kimberly,22,0,24,2
1681918966731,CHEM 7L,A04,179591,Schurmeier; Kimberly,22,0,24,2
1681918966731,CHEM 7L,B01,179598,Schurmeier; Kimberly,17,0,24,7
1681918966731,CHEM 7L,B02,179599,Schurmeier; Kimberly,24,0,24,0
1681918966731,CHEM 7L,B03,179606,Schurmeier; Kimberly,23,0,24,1
1681918966731,CHEM 7L,B04,179607,Schurmeier; Kimberly,23,0,24,1
1681918967759,CHEM 11,A01,179609,Stallings; Dontarie M,88,0,100,12
1681918968788,CHEM 40A,A01,179621,Staff,41,0,50,9
1681918968788,CHEM 40A,A02,179622,Staff,47,0,50,3
1681918969810,CHEM 40B,A01,179630,Weizman; Haim,48,0,50,2
1681918969810,CHEM 40B,A02,179631,Weizman; Haim,45,0,50,5
1681918970834,CHEM 41A,A01,179660,Klosterman; Jeremy K,93,0,100,7
1681918971862,CHEM 43A,A01,179683,Klosterman; Jeremy K,0,0,24,24
1681918971862,CHEM 43A,A02,179688,Klosterman; Jeremy K,12,0,24,12
1681918971862,CHEM 43A,A03,179689,Klosterman; Jeremy K,19,0,24,5
1681918971862,CHEM 43A,A04,179691,Klosterman; Jeremy K,18,0,24,6
1681918972888,CHEM 114A,A01,179693,Stallings; Dontarie M,75,0,100,25
1681918973920,CHEM 143B,A01,179698,Weizman; Haim,17,0,24,7
1681918973920,CHEM 143B,A02,179700,Weizman; Haim,24,0,24,0
1681918974942,CHIN 169A,A00,179701,Wang; Xiao,20,0,20,0
1681918975965,COGS 2,A01,179750,Boyle; Mary E. T.,17,0,30,13
1681918976998,COGS 9,A01,179759,Jones; Cameron Robert,42,0,50,8
1681918978027,COGS 14A,A01,179854,Staff,18,0,50,32
1681918979050,COGS 14B,A01,179856,Staff,54,0,60,6
1681918980075,COGS 17,A01,179874,Staff,71,0,75,4
1681918981098,COGS 18,A01,179884,Staff,63,0,80,17
1681918982131,COGS 100,A01,179886,Staff,40,0,60,20
1681918983156,COGS 101B,A01,179892,Staff,1,0,30,29
1681918984184,COGS 101C,A01,179894,Staff,28,0,30,2
1681918985209,COGS 107A,A01,179896,Boyle; Mary E. T.,31,0,40,9
1681918986234,COGS 108,A01,179898,Simpkins; Charles Alexander,0,21,60,60
1681918987258,COGS 109,A01,179900,Staff,34,0,40,6
1681918988283,COGS 118A,A01,179946,Staff,8,0,40,32
1681918989308,COGS 153,A00,179978,Staff,0,1,30,30
1681918990332,COGS 156,A01,179981,Staff,27,0,30,3
1681918992392,COGS 172,A01,179987,Staff,13,0,30,17
1681918994448,COGS 186,A01,179991,Staff,12,0,30,18
1681918995471,COMM 10,A01,180001,Staff,14,0,25,11
1681918995471,COMM 10,A02,180004,Staff,20,0,25,5
1681918996493,COMM 100A,A01,180016,Staff,17,0,25,8
1681918996493,COMM 100A,A02,180020,Staff,24,0,25,1
1681918997516,COMM 101T,A00,180029,Halm; Gavin Patrick,23,0,35,12
1681918998538,COMM 106V,A00,180043,Staff,34,0,35,1
1681918999569,COMM 109P,A00,180044,Staff,31,0,35,4
1681919000591,COMM 113T,A00,180045,Havis; Allan,37,0,45,8
1681919001617,COMM 132,A00,180046,McKenna; Denise,23,0,30,7
1681919002642,COMM 143,A00,180047,Staff,19,0,30,11
1681919003667,COMM 190,A00,180048,Conner; Thomas Hartnell,20,0,23,3
1681919004690,CSE 8A,A50,180053,Cao; Yingjun,25,0,50,25
1681919004690,CSE 8A,B50,180180,Staff,50,0,50,0
1681919005720,CSE 11,A01,180190,Cao; Yingjun,28,0,50,22
1681919006752,CSE 20,A01,180192,Briones; Jor-el Thomas Caparas,23,0,30,7
1681919007775,CSE 21,A01,194538,Briones; Jor-el Thomas Caparas,50,0,60,10
1681919008806,CSE 30,A01,180324,Eldon; John,76,0,100,24
1681919009829,CSE 101,A01,201353,Staff,0,21,40,40
1681919010867,CSE 134B,A01,180326,Powell; Thomas Allan,74,0,100,26
1681919011893,CSE 140,A01,180328,Staff,43,0,75,32
1681919012923,CSE 140L,A01,180344,Eldon; John,66,0,100,34
1681919013970,CSE 150A,A01,180411,Staff,0,9,50,50
1681919014997,CSE 151A,A01,180414,Staff,0,7,50,50
1681919016027,CSE 175,A01,222521,Kumar; Rakesh,50,0,50,0
1681919017064,CSE 190,A00,201419,Staff,45,0,49,4
1681919018089,CSS 1,A01,194536,Staff,37,0,50,13
1681919019124,DSC 30,A01,202385,Staff,48,0,50,2
1681919020150,DSC 40A,A01,202387,Albuyeh; Rod,50,0,50,0
1681919021174,DSC 190,A01,202389,Silberman; Jack,21,0,21,0
1681919022197,DSGN 100,A01,179993,Staff,16,0,30,14
1681919023221,ECE 65,A50,180708,Staff,10,0,20,10
1681919023221,ECE 65,A51,180739,Staff,19,0,20,1
1681919024245,ECON 1,A01,180427,Famulari; Melissa,67,0,70,3
1681919025276,ECON 2,A01,180450,Levkoff; Steven B.,64,0,70,6
1681919026309,ECON 4,A01,203351,Anderson; John Charles,7,0,10,3
1681919027336,ECON 100A,A01,180472,Famulari; Melissa,64,0,70,6
1681919028360,ECON 120A,A01,180549,Staff,64,0,70,6
1681919029387,ECON 120B,A01,180655,Ma; Xinwei,44,0,70,26
1681919030413,ECON 129,A00,203333,Eckert; Fabian Paul,15,0,35,20
1681919031437,ECON 131,A00,180656,Staff,7,0,35,28
1681919032464,ECON 172B,A01,180672,Levkoff; Steven B.,31,0,35,4
1681919033486,ECON 178,A01,203342,Zhu; Ying,9,0,35,26
1681919034511,EDS 108GS,A00,202383,Wishard Guerra; Alison G.,20,0,20,0
1681919035533,EDS 111GS,A00,202347,Wishard Guerra; Alison G.,20,0,20,0
1681919036555,EDS 112,A01,202323,Staff,56,0,60,4
1681919037579,EDS 113,A00,202340,Staff,33,0,35,2
1681919038608,EDS 118,A00,201231,Staff,20,0,30,10
1681919039637,EDS 119,A00,204994,Staff,8,0,10,2
1681919040662,EDS 124BR,A00,202324,Eguchi; Emi,4,0,25,21
1681919041689,EDS 126,A01,203208,Jones; Makeba,26,0,30,4
1681919042713,EDS 135,A01,202333,Staff,18,0,20,2
1681919043736,EDS 180,A00,202311,Staff,47,0,50,3
1681919044762,ERC 190GS,A01,253747,Staff,28,0,28,0
1681919045789,ETHN 104,A00,180742,Staff,24,0,35,11
1681919046813,ETHN 118,A00,180745,Staff,28,0,35,7
1681919047836,ETHN 127,A00,180747,Staff,12,0,16,4
1681919048859,ETHN 137,A00,180880,Staff,11,0,12,1
1681919049882,ETHN 147,A00,180890,Staff,8,0,10,2
1681919050908,ETHN 154,A00,180891,Staff,7,0,8,1
1681919051932,ETHN 168,A00,180892,Staff,9,0,10,1
1681919052957,GLBH 20,A00,201051,Hannah; Seth Donal,0,2,0,1
1681919053983,GLBH 111,A01,209338,Burgos; Jose L.,0,0,0,0
1681919055011,GLBH 150,A00,258300,Staff,0,3,0,0
1681919056035,GLBH 181,A00,201207,Staff,15,0,40,25
1681919057058,HIEU 109,A00,180898,Staff,20,0,20,0
1681919058082,HIEU 111,A00,180899,Staff,0,0,20,20
1681919059109,HIEU 124,A00,180900,Staff,17,0,20,3
1681919060133,HILA 122,A00,180901,Staff,18,0,20,2
1681919061233,HILA 132,A00,180902,Vitz; Matthew,2,0,20,18
1681919062258,HILD 10,A01,180896,Staff,15,0,20,5
1681919063285,HILD 30GS,A00,180897,Edington; Claire Ellen,0,0,0,0
1681919064306,HISC 105,A00,180903,Staff,20,0,20,0
1681919065329,HISC 117,A00,180904,Staff,11,0,20,9
1681919066352,HIUS 108B,A00,181005,Staff,18,0,20,2
1681919067375,HIUS 113,A00,181093,Staff,3,0,20,17
1681919068401,HUM 3,A01,181190,Patterson; Patrick H.,39,0,50,11
1681919068401,HUM 3,B01,181195,Staff,46,0,50,4
1681919069424,HUM 3GS,A00,181196,Herbst; Matthew,0,0,0,0
1681919070451,HUM 4,A01,181227,West; Geoffrey Scott,33,0,50,17
1681919070451,HUM 4,B01,181282,Staff,42,0,50,8
1681919071477,HUM 4GS,A00,181377,Lyon; Antony J.,0,0,0,0
1681919072500,HUM 5,A01,181536,Zavodny; Tatiana Sophia,29,0,50,21
1681919072500,HUM 5,B01,181908,Staff,36,0,50,14
1681919073526,INTL 190,A00,181909,Segui; Alan S,0,0,0,7
1681919073526,INTL 190,B00,181961,Segui; Alan S,0,0,0,7
1681919074555,JAPN 20AR,A01,182113,Ross; Kayoko F,15,0,20,5
1681919075577,LATI 50,A01,202391,Martin-Cabrera; Luis,18,0,30,12
1681919075577,LATI 50,A02,202392,Martin-Cabrera; Luis,26,0,30,4
1681919076601,LATI 180,A00,202393,Kokinis; Troy Andreas,24,0,25,1
1681919077626,LIFR 1A,A00,182119,Staff,14,0,14,0
1681919078650,LIFR 1AX,A00,182324,Staff,14,0,14,0
1681919079673,LIFR 1B,A00,182259,Staff,14,0,14,0
1681919080696,LIFR 1BX,A00,182273,Staff,14,0,14,0
1681919081722,LIGN 8,A00,182330,Staff,136,0,150,14
1681919082745,LIGN 9GS,A00,182362,Staff,20,0,20,0
1681919083769,LIGN 119,A00,204992,Takahashi; Maho,12,0,15,3
1681919084796,LIGN 130,A01,182384,Staff,47,0,50,3
1681919085828,LIGN 149GS,A00,182390,Staff,20,0,20,0
1681919086853,LIGN 170,A00,182404,Staff,23,0,30,7
1681919087881,LISP 1D,A00,182281,Staff,7,0,14,7
1681919087881,LISP 1D,B00,182287,Staff,14,0,14,0
1681919087881,LISP 1D,C00,182295,Staff,11,0,14,3
1681919087881,LISP 1D,D00,182301,Staff,14,0,14,0
1681919088913,LISP 1DX,A00,182309,Staff,20,0,28,8
1681919088913,LISP 1DX,B00,182316,Staff,26,0,28,2
1681919089935,LTAF 120GS,A00,182412,Zhiri; Oumelbanine,20,0,20,0
1681919090966,LTCS 172GS,A00,182437,Bronstein; Phoebe Malan,20,0,20,0
1681919091990,LTEA 138,A00,182457,Staff,21,0,40,19
1681919093016,LTEN 114,A01,182490,Staff,23,0,25,2
1681919094038,LTEN 130GS,A00,182491,Lyon; Antony J.,20,0,20,0
1681919095061,LTEN 169,A00,182493,Cuong; Marisol,19,0,25,6
1681919096106,LTEN 178,A00,182501,Staff,14,0,15,1
1681919097128,LTEN 181,A00,182515,Staff,22,0,25,3
1681919098154,LTEN 185GS,A00,197655,Forbes; Camille,20,0,20,0
1681919099179,LTSP 100B,A00,202208,Bessett; Ryan Matthew,24,0,25,1
1681919100203,LTWL 100,A00,182516,Myerston Santana; Jacobo,22,0,30,8
1681919101242,LTWR 100GS,A00,182518,Forbes; Camille,20,0,20,0
1681919102264,LTWR 102,A00,182522,Staff,15,0,15,0
1681919102264,LTWR 102,B00,182525,Staff,14,0,15,1
1681919103288,LTWR 115,A00,182526,Staff,11,0,15,4
1681919104312,MAE 8,A01,182528,Pham; Hieu Tan,67,0,70,3
1681919105335,MAE 11,A00,182529,Bahadori; Mohammad Yousef,94,0,100,6
1681919106364,MAE 20,A00,182530,Evdokimenko; Ekaterina,68,0,70,2
1681919107386,MAE 30A,A00,182532,Staff,44,0,45,1
1681919108417,MAE 101A,A00,182533,Bahadori; Mohammad Yousef,96,0,100,4
1681919109440,MAE 101C,A00,182538,Staff,62,0,70,8
1681919110462,MAE 104,A00,182539,Staff,44,0,50,6
1681919111484,MAE 131A,A00,182540,Ghazinejad; Maziar,40,0,45,5
1681919112509,MAE 143A,A00,182548,Bewley; Thomas R,43,0,50,7
1681919113533,MAE 150,A00,182549,Staff,28,0,40,12
1681919114560,MAE 160,A00,182550,Evdokimenko; Ekaterina,42,0,60,18
1681919115582,MATH 3C,A01,182725,Staff,26,0,30,4
1681919116609,MATH 10A,A01,182729,Staff,25,0,30,5
1681919116609,MATH 10A,B01,182732,Staff,26,0,30,4
1681919117631,MATH 10B,A01,182737,Staff,21,0,30,9
1681919117631,MATH 10B,A02,182738,Staff,26,0,30,4
1681919117631,MATH 10B,B01,182744,Staff,27,0,30,3
1681919117631,MATH 10B,B02,182745,Staff,27,0,30,3
1681919118655,MATH 18,A01,182750,Anzaldo; Leesa B,28,0,30,2
1681919118655,MATH 18,A02,182751,Anzaldo; Leesa B,29,0,30,1
1681919118655,MATH 18,A03,182753,Anzaldo; Leesa B,28,0,30,2
1681919118655,MATH 18,A04,182757,Anzaldo; Leesa B,29,0,30,1
1681919118655,MATH 18,B01,182761,Anzaldo; Leesa B,27,0,30,3
1681919118655,MATH 18,B02,182764,Anzaldo; Leesa B,27,0,30,3
1681919118655,MATH 18,B03,182765,Anzaldo; Leesa B,30,0,30,0
1681919118655,MATH 18,B04,182766,Anzaldo; Leesa B,30,0,30,0
1681919119687,MATH 20A,A01,182771,Suk; Andrew Hoon,28,0,30,2
1681919120721,MATH 20B,A01,182775,Bach; Quang Tran,30,0,30,0
1681919120721,MATH 20B,A02,182777,Bach; Quang Tran,29,0,30,1
1681919120721,MATH 20B,B01,182780,Bach; Quang Tran,27,0,30,3
1681919120721,MATH 20B,B02,182782,Bach; Quang Tran,30,0,30,0
1681919121747,MATH 20C,A01,182787,Staff,25,0,30,5
1681919121747,MATH 20C,A02,182790,Staff,29,0,30,1
1681919121747,MATH 20C,B01,182792,Staff,25,0,30,5
1681919121747,MATH 20C,B02,182796,Staff,27,0,30,3
1681919122772,MATH 20D,A01,182799,Staff,29,0,30,1
1681919122772,MATH 20D,A02,182802,Staff,29,0,30,1
1681919122772,MATH 20D,A03,182803,Staff,30,0,30,0
1681919123801,MATH 20E,A01,182809,Verstraete; Jacques Allan,23,0,30,7
1681919123801,MATH 20E,A02,182811,Verstraete; Jacques Allan,28,0,30,2
1681919123801,MATH 20E,B01,182814,Verstraete; Jacques Allan,23,0,30,7
1681919123801,MATH 20E,B02,182815,Verstraete; Jacques Allan,30,0,30,0
1681919124829,MATH 103A,A01,182820,Staff,8,0,30,22
1681919124829,MATH 103A,A02,182821,Staff,27,0,30,3
1681919124829,MATH 103A,A03,182822,Staff,23,0,30,7
1681919124829,MATH 103A,B01,182825,Staff,23,0,30,7
1681919124829,MATH 103A,B02,182826,Staff,30,0,30,0
1681919124829,MATH 103A,B03,182830,Staff,30,0,30,0
1681919125862,MATH 109,A01,182836,Chow; Bennett,24,0,30,6
1681919125862,MATH 109,A02,182838,Chow; Bennett,29,0,30,1
1681919125862,MATH 109,A03,182894,Chow; Bennett,29,0,30,1
1681919125862,MATH 109,B01,182908,Chow; Bennett,28,0,30,2
1681919125862,MATH 109,B02,182909,Chow; Bennett,30,0,30,0
1681919125862,MATH 109,B03,182910,Chow; Bennett,27,0,30,3
1681919126886,MATH 142A,A01,182925,Staff,10,0,30,20
1681919126886,MATH 142A,A02,182935,Staff,24,0,30,6
1681919126886,MATH 142A,A03,182967,Staff,26,0,30,4
1681919126886,MATH 142A,B01,183125,Staff,22,0,30,8
1681919126886,MATH 142A,B02,183157,Staff,28,0,30,2
1681919126886,MATH 142A,B03,183158,Staff,29,0,30,1
1681919127914,MATH 183,A01,183160,Arias-Castro; Ery,23,0,30,7
1681919127914,MATH 183,A02,183161,Arias-Castro; Ery,29,0,30,1
1681919127914,MATH 183,B01,183163,Arias-Castro; Ery,28,0,30,2
1681919127914,MATH 183,B02,183164,Arias-Castro; Ery,28,0,30,2
1681919128937,MATH 193A,A01,183167,Staff,4,0,35,31
1681919128937,MATH 193A,A02,183168,Staff,28,0,35,7
1681919128937,MATH 193A,A03,183169,Staff,34,0,35,1
1681919128937,MATH 193A,A04,183170,Staff,28,0,35,7
1681919129960,MGT 4,A01,202395,Anderson; John Charles,75,0,80,5
1681919130986,MGT 5,A00,202396,Houskeeper; Robert,80,0,90,10
1681919132008,MGT 103,A00,202397,Eberhard; Craig A,53,0,90,37
1681919133031,MGT 131A,A00,202398,Houskeeper; Robert,85,0,90,5
1681919134053,MGT 135,A00,202399,Anderson; John Charles,81,0,90,9
1681919135076,MGT 162R,A00,202403,Gneezy; Uri,144,0,200,56
1681919136098,MGT 172,A00,202404,Hedges; Kathleen,49,0,90,41
1681919137125,MGT 181,A00,202405,Dunn; Louis Jean,83,0,90,7
1681919138152,MMW 14,A01,183200,Staff,13,0,28,15
1681919138152,MMW 14,A02,183201,Staff,26,0,28,2
1681919138152,MMW 14,A03,183202,Staff,24,0,28,4
1681919138152,MMW 14,A04,183203,Staff,25,0,28,3
1681919138152,MMW 14,A05,183204,Staff,26,0,28,2
1681919138152,MMW 14,A06,183205,Staff,27,0,28,1
1681919138152,MMW 14,B01,183207,Staff,26,0,28,2
1681919138152,MMW 14,B02,183208,Staff,28,0,28,0
1681919138152,MMW 14,B03,183209,Staff,28,0,28,0
1681919138152,MMW 14,B04,183210,Staff,28,0,28,0
1681919138152,MMW 14,B05,183211,Staff,28,0,28,0
1681919138152,MMW 14,B06,183212,Staff,27,0,28,1
1681919139175,MMW 14GS,A00,183213,Zhiri; Oumelbanine,28,0,28,0
1681919140201,MMW 15GS,B00,183215,Rahimi; Babak,28,0,28,0
1681919141226,MMW 121,A01,183217,Patterson; Patrick H.,14,0,28,14
1681919141226,MMW 121,A02,183218,Patterson; Patrick H.,25,0,28,3
1681919142250,MUS 1A,A01,182554,Staff,7,0,35,28
1681919143277,MUS 5,A01,182558,Staff,19,0,35,16
1681919144300,MUS 6,A01,182562,Staff,24,0,35,11
1681919145322,MUS 8GS,A00,182563,Borgo; David Garcia,25,0,25,0
1681919146349,MUS 13,A01,182567,Staff,24,0,25,1
1681919147375,MUS 15,A01,182570,Staff,32,0,35,3
1681919147375,MUS 15,B01,182575,Staff,9,0,35,26
1681919148405,MUS 80,A00,182578,Staff,23,0,25,2
1681919148405,MUS 80,B00,182581,Staff,20,0,25,5
1681919149428,MUS 113,A00,182582,Staff,25,0,25,0
1681919150451,MUS 114,A00,182583,Staff,4,0,25,21
1681919151474,MUS 150GS,A01,182588,Borgo; David Garcia,25,0,25,0
1681919152497,PHIL 1,A00,182590,Staff,35,0,40,5
1681919153518,PHIL 10,A01,182596,Grush; Rick Scott,31,0,35,4
1681919153518,PHIL 10,A02,182597,Grush; Rick Scott,34,0,35,1
1681919154540,PHIL 15,A01,182601,Staff,31,0,35,4
1681919154540,PHIL 15,A02,182602,Staff,33,0,35,2
1681919155566,PHIL 27,A01,182604,Staff,30,0,35,5
1681919155566,PHIL 27,A02,182607,Staff,35,0,35,0
1681919156601,PHIL 32,A01,182609,Staff,35,0,35,0
1681919156601,PHIL 32,A02,182612,Staff,35,0,35,0
1681919157624,PHIL 130,A00,182614,Staff,62,0,70,8
1681919158646,PHIL 136,A00,182616,Cohen; Jonathan David,66,0,70,4
1681919159671,PHIL 155,A00,182617,Vargas; Manuel Rogelio,59,0,70,11
1681919160696,PHIL 163,A01,182620,Staff,15,0,20,5
1681919160696,PHIL 163,A02,182624,Staff,10,0,20,10
1681919161732,PHIL 164,A00,182627,Staff,30,0,40,10
1681919162754,PHIL 173,A00,182628,Staff,36,0,40,4
1681919163779,PHYS 1A,A00,183221,Staff,54,0,60,6
1681919164879,PHYS 1AL,001,183222,Staff,25,0,30,5
1681919164879,PHYS 1AL,002,183223,Staff,28,0,30,2
1681919165903,PHYS 1B,A00,183231,Staff,43,0,60,17
1681919166934,PHYS 1BL,001,183232,Staff,20,0,30,10
1681919166934,PHYS 1BL,002,183233,Staff,27,0,30,3
1681919167956,PHYS 1C,A00,183240,Staff,30,0,60,30
1681919168983,PHYS 1CL,001,183241,Staff,13,0,30,17
1681919168983,PHYS 1CL,002,183242,Staff,22,0,30,8
1681919170013,PHYS 2AR,A01,183250,Staff,44,0,50,6
1681919171035,PHYS 2B,A01,183252,Staff,104,0,115,11
1681919172062,PHYS 2BL,A01,183254,Staff,21,0,24,3
1681919172062,PHYS 2BL,A02,183255,Staff,22,0,24,2
1681919173086,PHYS 2C,A01,183522,Staff,105,0,115,10
1681919174111,PHYS 4A,A01,183524,Staff,49,0,50,1
1681919175145,POLI 5,A00,183525,Staff,44,0,50,6
1681919176169,POLI 12,A00,183540,Staff,48,0,50,2
1681919177191,POLI 13R,A00,183541,Forman; Fonna,42,0,50,8
1681919178214,POLI 30,A00,183542,Mignozzetti; Umberto,47,0,50,3
1681919179239,POLI 100A,A00,183543,Staff,45,0,50,5
1681919180261,POLI 100E,A00,223598,Staff,32,0,35,3
1681919181284,POLI 103A,A00,183564,Kousser; Thad,37,0,50,13
1681919182310,POLI 104B,A00,201329,Staff,28,0,35,7
1681919183338,POLI 113BR,A00,183576,Hoston; Germaine,26,0,50,24
1681919184361,POLI 114BR,A00,183588,Staff,27,0,30,3
1681919185389,POLI 117R,A00,183595,Forman; Fonna,8,0,20,12
1681919186417,POLI 120H,A00,183596,Fisk; David Lee,13,0,20,7
1681919187440,POLI 130AA,A00,183597,Staff,14,0,20,6
1681919188466,POLI 134AA,A00,183598,Staff,19,0,20,1
1681919189490,POLI 135,A00,183599,Fisk; David Lee,20,0,25,5
1681919190513,POLI 142P,A00,183623,Staff,37,0,40,3
1681919191539,POLI 144D,A00,183624,Staff,22,0,25,3
1681919192561,POLI 151,A00,183625,Staff,15,0,20,5
1681919193583,POLI 162,A00,183626,Mignozzetti; Umberto,18,0,20,2
1681919194612,PSYC 1,A00,253748,Staff,86,0,90,4
1681919195638,PSYC 2,A00,183627,Moranton; Nirelia Melbina-,25,0,35,10
1681919196664,PSYC 3,A00,183628,Staff,43,0,45,2
1681919198713,PSYC 60,A01,183631,Lowe; Angela Beth,35,0,40,5
1681919199736,PSYC 70,A01,253757,Staff,37,0,45,8
1681919200763,PSYC 101,A00,183632,Heyman; Gail D.,48,0,60,12
1681919201794,PSYC 105,A00,183848,Lowe; Angela Beth,48,0,60,12
1681919202816,PSYC 106,A00,183849,Dobkins; Karen R.,44,0,60,16
1681919203839,PSYC 108,A00,253750,Staff,24,0,60,36
1681919204867,PSYC 114,A01,184275,Winkielman; Piotr,0,7,30,30
1681919205890,PSYC 122,A00,183856,Moranton; Nirelia Melbina-,0,11,30,30
1681919206913,PSYC 124,A00,183865,Chapman; Eddie Nathaniel,51,0,80,29
1681919207935,PSYC 137,A00,183880,Staff,19,0,25,6
1681919209982,PSYC 154,A00,183910,Lacefield; Katharine I,0,8,90,90
1681919212033,PSYC 162,A00,183946,Wixted; John T,60,0,90,30
1681919213060,PSYC 172,A00,183947,Gorman; Michael R.,12,0,30,18
1681919214083,PSYC 178,A00,183963,Glaser; Dale,19,0,40,21
1681919215123,PSYC 181GS,A00,183964,Anagnostaras; Stephan,10,0,10,0
1681919216147,PSYC 186GS,A01,257660,Staff,10,0,10,0
1681919217170,PSYC 193,B00,253749,Staff,23,0,25,2
1681919219231,PSYC 193L,A01,184122,Staff,33,0,35,2
1681919219231,PSYC 193L,C01,184167,Winkielman; Piotr,15,0,30,15
1681919220257,RELI 188GS,A00,182629,Rahimi; Babak,20,0,20,0
1681919221280,SE 101A,A00,182646,Staff,26,0,30,4
1681919222302,SE 101C,A00,182650,Staff,18,0,20,2
1681919223326,SE 110A,A00,182651,Staff,28,0,28,0
1681919224349,SE 130A,A00,182652,Staff,39,0,40,1
1681919225375,SIO 46GS,A00,182636,Cook; Geoffrey W,27,0,28,1
1681919226397,SIO 109R,A00,194459,Staff,4,0,20,16
1681919227420,SIO 121GS,A00,182639,Cook; Geoffrey W,27,0,28,1
1681919228446,SIO 132,A01,182642,Staff,32,0,40,8
1681919229482,SIO 139,A00,182644,Kacev; David,36,0,40,4
1681919230505,SOCI 2,A01,258404,Staff,34,0,36,2
1681919230505,SOCI 2,A02,258405,Staff,35,0,36,1
1681919231540,SOCI 60,A01,258408,Staff,29,0,30,1
1681919231540,SOCI 60,A02,258413,Staff,30,0,30,0
1681919232566,SOCI 100,A01,258415,Staff,29,0,30,1
1681919232566,SOCI 100,A02,258416,Staff,28,0,30,2
1681919238722,SOCI 127,A00,258421,Staff,21,0,30,9
1681919239748,SOCI 132,A00,258422,Staff,45,0,50,5
1681919240769,SOCI 133,A00,258423,Staff,26,0,30,4
1681919241795,SOCI 138GS,A00,258424,Staff,15,0,15,0
1681919242820,SOCI 145,A00,258425,Staff,25,0,30,5
1681919243846,SOCI 148,A00,258426,Staff,26,0,30,4
1681919244882,SOCI 153,A00,199217,Staff,29,0,30,1
1681919245914,SOCI 160,A00,258427,Staff,28,0,30,2
1681919246937,SOCI 160E,A00,258435,Staff,56,0,60,4
1681919247976,SOCI 189GS,A00,258436,Staff,15,0,15,0
1681919249011,SOCI 190GS,A00,258437,Staff,15,0,15,0
1681919250038,SYN 2,001,182658,Staff,8,0,16,8
1681919250038,SYN 2,002,201439,Staff,14,0,16,2
1681919250038,SYN 2,003,201443,Staff,16,0,16,0
1681919251060,SYN 100,A01,182657,Staff,16,0,20,4
1681919252083,TDAC 1,A00,184381,Salovey; Todd,16,0,20,4
1681919252083,TDAC 1,B00,184385,Harting; Carla Kelso,19,0,20,1
1681919252083,TDAC 1,C00,184394,Staff,19,0,20,1
1681919253108,TDAC 101,A00,184483,Harting; Carla Kelso,19,0,20,1
1681919254131,TDDE 111,A00,184496,Staff,14,0,15,1
1681919255154,TDDE 131,A00,184504,Staff,20,0,20,0
1681919255154,TDDE 131,B00,184505,Staff,17,0,18,1
1681919255154,TDDE 131,C00,184534,Staff,49,0,50,1
1681919255154,TDDE 131,D00,184564,Staff,15,0,15,0
1681919255154,TDDE 131,E00,204725,Staff,19,0,20,1
1681919256178,TDGE 1,A01,184414,Salovey; Todd,36,0,50,14
1681919257203,TDGE 5,A01,184419,Staff,23,0,24,1
1681919258228,TDGE 10,A00,184428,Fulton; Julia,29,0,50,21
1681919259251,TDGE 124,A00,184565,Fulton; Julia,7,0,50,43
1681919260277,TDGE 125,B00,184567,Meyer; Ursula,9,0,25,16
1681919261300,TDHT 101,A00,184568,Staff,21,0,25,4
1681919261300,TDHT 101,B00,184569,Staff,20,0,20,0
1681919262331,TDHT 114,A00,184570,Staff,49,0,50,1
1681919263361,TDMV 1,A00,184437,Arcidiacono; Kristin,22,0,30,8
1681919263361,TDMV 1,B00,184448,Caligagan; Maria T.,23,0,30,7
1681919264390,TDMV 2,A00,184449,Weinberg; Sadie,27,0,30,3
1681919264390,TDMV 2,B00,184453,Arcidiacono; Kristin,29,0,30,1
1681919265412,TDMV 110,A00,184571,Weinberg; Sadie,30,0,30,0
1681919266439,TDMV 142,A00,184572,Caligagan; Tony,27,0,30,3
1681919266439,TDMV 142,B00,184573,Caligagan; Maria T.,26,0,30,4
1681919267464,TDTR 20,A00,184482,Jun; Grace Shin Hae,25,0,25,0
1681919268559,USP 2,A01,184290,Hinds; Juli Beth,24,0,25,1
1681919269581,USP 3,A01,184295,Staff,20,0,25,5
1681919270604,USP 4,A00,184304,McTague; Sarah,15,0,25,10
1681919271629,USP 100,A00,184315,Staff,17,0,25,8
1681919272652,USP 105,A00,184326,Staff,21,0,25,4
1681919273675,USP 151,A00,184327,Staff,20,0,25,5
1681919274698,USP 170,A00,184380,Hinds; Juli Beth,14,0,25,11
1681919275724,VIS 21B,A01,182660,Staff,28,0,31,3
1681919275724,VIS 21B,A02,182662,Staff,30,0,31,1
1681919276747,VIS 103D,A00,182663,Staff,74,0,75,1
1681919277770,VIS 105D,A00,182667,Li; Huai,15,0,22,7
1681919278795,VIS 122GS,A00,182668,Herbst; Matthew,20,0,20,0
1681919279818,VIS 128C,A00,182673,Staff,69,0,75,6
1681919280853,VIS 130,A00,182675,Staff,20,0,22,2
1681919281877,VIS 160A,A00,182678,Stalbaum; Brett,4,0,10,6
1681919283922,WCWP 10B,A00,201679,Staff,15,0,15,0
1681919283922,WCWP 10B,B00,201695,Staff,15,0,15,0
1681919284948,WCWP 100,A00,201716,Staff,15,0,15,0
1681919284948,WCWP 100,B00,201717,Staff,10,0,15,5
1681919287056,ANSC 105GS,A00,258289,Staff,0,0,0,0
1681919288081,ANSC 125GS,A00,258295,Staff,0,0,0,0
1681919289104,ANSC 150,A00,258267,Staff,30,0,40,10
1681919290126,ANSC 190GS,A00,258280,Staff,0,0,0,0
1681919291164,ANTH 1,A00,258264,Staff,38,0,40,2
1681919292189,ANTH 2,A01,258259,Staff,72,0,76,4
1681919293211,ANTH 23,A01,258228,Staff,36,0,40,4
1681919294238,ANTH 101,A01,258236,Staff,38,0,40,2
1681919295267,ANTH 102,A00,258272,Staff,59,0,60,1
1681919296288,ANTH 105,A00,258244,Staff,31,0,35,4
1681919297319,BENG 130,A00,253975,Staff,38,0,40,2
1681919298341,BIBC 102,A01,191866,Flagg; Matthew Paul,19,0,32,13
1681919298341,BIBC 102,A02,191867,Flagg; Matthew Paul,22,0,32,10
1681919298341,BIBC 102,A03,191868,Flagg; Matthew Paul,29,0,32,3
1681919298341,BIBC 102,A04,191936,Flagg; Matthew Paul,26,0,32,6
1681919298341,BIBC 102,A05,191937,Flagg; Matthew Paul,6,0,32,26
1681919299373,BICD 100,A01,191939,Cooper; Andrew Michael,28,0,32,4
1681919299373,BICD 100,A02,191940,Cooper; Andrew Michael,32,0,32,0
1681919299373,BICD 100,A03,191941,Cooper; Andrew Michael,32,0,32,0
1681919299373,BICD 100,A04,191942,Cooper; Andrew Michael,32,0,32,0
1681919299373,BICD 100,A05,191943,Cooper; Andrew Michael,32,0,32,0
1681919300402,BIEB 126,A01,191945,Cleland; Elsa Eleanor,0,0,32,32
1681919300402,BIEB 126,A02,191946,Cleland; Elsa Eleanor,27,0,32,5
1681919300402,BIEB 126,A03,191947,Cleland; Elsa Eleanor,29,0,32,3
1681919300402,BIEB 126,A04,191948,Cleland; Elsa Eleanor,23,0,32,9
1681919300402,BIEB 126,A05,191996,Cleland; Elsa Eleanor,28,0,32,4
1681919301425,BIEB 136GS,A00,191997,Shurin; Jonathan & Holway; David A.,0,0,0,2
1681919302451,BIEB 137GS,A01,191999,Shurin; Jonathan & Holway; David A.,0,0,0,1
1681919303476,BILD 1,A01,205385,Staff,31,0,32,1
1681919303476,BILD 1,A02,205386,Staff,30,0,32,2
1681919303476,BILD 1,A03,205387,Staff,32,0,32,0
1681919303476,BILD 1,A04,205388,Staff,27,0,32,5
1681919304500,BILD 2,A01,191774,Staff,28,0,32,4
1681919304500,BILD 2,A02,191775,Staff,30,0,32,2
1681919304500,BILD 2,A03,191777,Staff,30,0,32,2
1681919304500,BILD 2,A04,191856,Staff,31,0,32,1
1681919304500,BILD 2,A05,191857,Staff,32,0,32,0
1681919304500,BILD 2,A06,191858,Staff,32,0,32,0
1681919304500,BILD 2,A07,191859,Staff,31,0,32,1
1681919305534,BILD 3,A01,205391,Staff,29,0,32,3
1681919305534,BILD 3,A02,205393,Staff,32,0,32,0
1681919305534,BILD 3,A03,205394,Staff,28,0,32,4
1681919305534,BILD 3,A04,205395,Staff,32,0,32,0
1681919306559,BILD 20,A01,191861,Staff,32,0,32,0
1681919306559,BILD 20,A02,191862,Staff,32,0,32,0
1681919307584,BILD 30,A01,191864,Staff,31,0,32,1
1681919308610,BIMM 100,A01,192019,Staff,0,0,32,32
1681919308610,BIMM 100,A02,192020,Staff,21,0,32,11
1681919308610,BIMM 100,A03,192035,Staff,21,0,32,11
1681919309632,BIMM 110,A01,192037,Tat; John,0,0,32,32
1681919309632,BIMM 110,A02,192038,Tat; John,10,0,32,22
1681919310653,BIMM 120,A01,192040,Pickett; Brooke Elizabeth,2,0,32,30
1681919310653,BIMM 120,A02,192041,Pickett; Brooke Elizabeth,16,0,32,16
1681919310653,BIMM 120,A03,192042,Pickett; Brooke Elizabeth,15,0,32,17
1681919311678,BIPN 100,A01,192044,Armour; Jon Christopher,26,0,32,6
1681919311678,BIPN 100,A02,192059,Armour; Jon Christopher,30,0,32,2
1681919311678,BIPN 100,A03,192064,Armour; Jon Christopher,31,0,32,1
1681919311678,BIPN 100,A04,192073,Armour; Jon Christopher,28,0,32,4
1681919312701,BIPN 148,A01,205411,Leutgeb; Jill K.,16,0,32,16
1681919312701,BIPN 148,A02,205412,Leutgeb; Jill K.,31,0,32,1
1681919312701,BIPN 148,A03,205413,Leutgeb; Jill K.,30,0,32,2
1681919312701,BIPN 148,A04,205414,Leutgeb; Jill K.,30,0,32,2
1681919313726,BIPN 160,A01,192115,Marino; Marc J,17,0,32,15
1681919313726,BIPN 160,A02,192148,Marino; Marc J,27,0,32,5
1681919313726,BIPN 160,A03,192158,Marino; Marc J,31,0,32,1
1681919313726,BIPN 160,A04,192190,Marino; Marc J,32,0,32,0
1681919313726,BIPN 160,A05,192287,Marino; Marc J,32,0,32,0
1681919313726,BIPN 160,A06,192288,Marino; Marc J,32,0,32,0
1681919314752,BIPN 194,A00,206038,Staff,28,0,32,4
1681919315777,BISP 194,A00,192289,Leutgeb; Stefan,13,0,32,19
1681919315777,BISP 194,B00,245332,Nieh; James Charles,26,0,32,6
1681919316801,CAT 124,A01,202247,Staff,15,0,15,0
1681919317825,CAT 125,A00,202248,Staff,19,0,20,1
1681919317825,CAT 125,B00,202253,Staff,20,0,20,0
1681919317825,CAT 125,C00,202257,Staff,18,0,20,2
1681919318849,CAT 125GS,A01,202273,Bronstein; Phoebe Malan,20,0,20,0
1681919319881,CAT 125R,A00,202284,Staff,17,0,20,3
1681919319881,CAT 125R,C00,202286,Staff,10,0,20,10
1681919319881,CAT 125R,D00,202291,Staff,18,0,20,2
1681919319881,CAT 125R,E00,202295,Staff,13,0,20,7
1681919319881,CAT 125R,F00,202302,Staff,12,0,20,8
1681919320904,CENG 100,A00,204724,Opatkiewicz; Justin Paul,25,0,25,0
1681919321929,CGS 2A,A01,180420,Staff,31,0,36,5
1681919322952,CGS 101,A00,180421,Staff,16,0,20,4
1681919323977,CGS 112,A00,180422,Staff,9,0,16,7
1681919325001,CGS 113,A00,180423,Staff,18,0,20,2
1681919326028,CGS 137,A00,180424,Staff,12,0,12,0
1681919327050,CGS 147,A00,180425,Staff,10,0,10,0
1681919328077,CHEM 6A,A01,179556,Staff,97,0,100,3
1681919328077,CHEM 6A,A02,179558,Staff,0,0,0,0
1681919329100,CHEM 6B,A01,179560,Staff,100,0,100,0
1681919330127,CHEM 6C,A01,179565,Jazzar; Rodolphe,95,0,100,5
1681919331151,CHEM 7L,A01,179586,Schurmeier; Kimberly,11,0,24,13
1681919331151,CHEM 7L,A02,179587,Schurmeier; Kimberly,23,0,24,1
1681919331151,CHEM 7L,A03,179590,Schurmeier; Kimberly,22,0,24,2
1681919331151,CHEM 7L,A04,179591,Schurmeier; Kimberly,22,0,24,2
1681919331151,CHEM 7L,B01,179598,Schurmeier; Kimberly,17,0,24,7
1681919331151,CHEM 7L,B02,179599,Schurmeier; Kimberly,24,0,24,0
1681919331151,CHEM 7L,B03,179606,Schurmeier; Kimberly,23,0,24,1
1681919331151,CHEM 7L,B04,179607,Schurmeier; Kimberly,23,0,24,1
1681919332175,CHEM 11,A01,179609,Stallings; Dontarie M,88,0,100,12
1681919333202,CHEM 40A,A01,179621,Staff,41,0,50,9
1681919333202,CHEM 40A,A02,179622,Staff,47,0,50,3
1681919334243,CHEM 40B,A01,179630,Weizman; Haim,48,0,50,2
1681919334243,CHEM 40B,A02,179631,Weizman; Haim,45,0,50,5
1681919335267,CHEM 41A,A01,179660,Klosterman; Jeremy K,93,0,100,7
1681919336295,CHEM 43A,A01,179683,Klosterman; Jeremy K,0,0,24,24
1681919336295,CHEM 43A,A02,179688,Klosterman; Jeremy K,12,0,24,12
1681919336295,CHEM 43A,A03,179689,Klosterman; Jeremy K,19,0,24,5
1681919336295,CHEM 43A,A04,179691,Klosterman; Jeremy K,18,0,24,6
1681919337317,CHEM 114A,A01,179693,Stallings; Dontarie M,75,0,100,25
1681919338340,CHEM 143B,A01,179698,Weizman; Haim,17,0,24,7
1681919338340,CHEM 143B,A02,179700,Weizman; Haim,24,0,24,0
1681919339363,CHIN 169A,A00,179701,Wang; Xiao,20,0,20,0
1681919340389,COGS 2,A01,179750,Boyle; Mary E. T.,17,0,30,13
1681919341419,COGS 9,A01,179759,Jones; Cameron Robert,42,0,50,8
1681919342440,COGS 14A,A01,179854,Staff,18,0,50,32
1681919343463,COGS 14B,A01,179856,Staff,54,0,60,6
1681919344490,COGS 17,A01,179874,Staff,71,0,75,4
1681919345514,COGS 18,A01,179884,Staff,63,0,80,17
1681919346543,COGS 100,A01,179886,Staff,40,0,60,20
1681919347566,COGS 101B,A01,179892,Staff,1,0,30,29
1681919348600,COGS 101C,A01,179894,Staff,28,0,30,2
1681919349624,COGS 107A,A01,179896,Boyle; Mary E. T.,31,0,40,9
1681919350649,COGS 108,A01,179898,Simpkins; Charles Alexander,0,21,60,60
1681919351678,COGS 109,A01,179900,Staff,34,0,40,6
1681919352701,COGS 118A,A01,179946,Staff,8,0,40,32
1681919353729,COGS 153,A00,179978,Staff,0,1,30,30
1681919354755,COGS 156,A01,179981,Staff,27,0,30,3
1681919356818,COGS 172,A01,179987,Staff,13,0,30,17
1681919358869,COGS 186,A01,179991,Staff,12,0,30,18
1681919359894,COMM 10,A01,180001,Staff,14,0,25,11
1681919359894,COMM 10,A02,180004,Staff,20,0,25,5
1681919360920,COMM 100A,A01,180016,Staff,17,0,25,8
1681919360920,COMM 100A,A02,180020,Staff,24,0,25,1
1681919361945,COMM 101T,A00,180029,Halm; Gavin Patrick,23,0,35,12
1681919362970,COMM 106V,A00,180043,Staff,34,0,35,1
1681919363999,COMM 109P,A00,180044,Staff,31,0,35,4
1681919365030,COMM 113T,A00,180045,Havis; Allan,37,0,45,8
1681919366055,COMM 132,A00,180046,McKenna; Denise,23,0,30,7
1681919367077,COMM 143,A00,180047,Staff,19,0,30,11
1681919368100,COMM 190,A00,180048,Conner; Thomas Hartnell,20,0,23,3
1681919369124,CSE 8A,A50,180053,Cao; Yingjun,25,0,50,25
1681919369124,CSE 8A,B50,180180,Staff,50,0,50,0
1681919370147,CSE 11,A01,180190,Cao; Yingjun,28,0,50,22
1681919371173,CSE 20,A01,180192,Briones; Jor-el Thomas Caparas,23,0,30,7
1681919372288,CSE 21,A01,194538,Briones; Jor-el Thomas Caparas,50,0,60,10
1681919373311,CSE 30,A01,180324,Eldon; John,76,0,100,24
1681919374333,CSE 101,A01,201353,Staff,0,21,40,40
1681919375356,CSE 134B,A01,180326,Powell; Thomas Allan,74,0,100,26
1681919376388,CSE 140,A01,180328,Staff,42,0,75,33
1681919377410,CSE 140L,A01,180344,Eldon; John,65,0,100,35
1681919378431,CSE 150A,A01,180411,Staff,0,9,50,50
1681919379454,CSE 151A,A01,180414,Staff,0,7,50,50
1681919380477,CSE 175,A01,222521,Kumar; Rakesh,50,0,50,0
1681919381502,CSE 190,A00,201419,Staff,45,0,49,4
1681919382528,CSS 1,A01,194536,Staff,37,0,50,13
1681919383550,DSC 30,A01,202385,Staff,48,0,50,2
1681919384576,DSC 40A,A01,202387,Albuyeh; Rod,50,0,50,0
1681919385602,DSC 190,A01,202389,Silberman; Jack,21,0,21,0
1681919386624,DSGN 100,A01,179993,Staff,16,0,30,14
1681919387649,ECE 65,A50,180708,Staff,10,0,20,10
1681919387649,ECE 65,A51,180739,Staff,19,0,20,1
1681919388675,ECON 1,A01,180427,Famulari; Melissa,67,0,70,3
1681919389697,ECON 2,A01,180450,Levkoff; Steven B.,64,0,70,6
1681919390722,ECON 4,A01,203351,Anderson; John Charles,7,0,10,3
1681919391744,ECON 100A,A01,180472,Famulari; Melissa,64,0,70,6
1681919392766,ECON 120A,A01,180549,Staff,64,0,70,6
1681919393789,ECON 120B,A01,180655,Ma; Xinwei,43,0,70,27
1681919394814,ECON 129,A00,203333,Eckert; Fabian Paul,15,0,35,20
1681919395838,ECON 131,A00,180656,Staff,7,0,35,28
1681919396860,ECON 172B,A01,180672,Levkoff; Steven B.,31,0,35,4
1681919397883,ECON 178,A01,203342,Zhu; Ying,9,0,35,26
1681919398912,EDS 108GS,A00,202383,Wishard Guerra; Alison G.,20,0,20,0
1681919399945,EDS 111GS,A00,202347,Wishard Guerra; Alison G.,20,0,20,0
1681919400971,EDS 112,A01,202323,Staff,56,0,60,4
1681919401996,EDS 113,A00,202340,Staff,33,0,35,2
1681919403017,EDS 118,A00,201231,Staff,20,0,30,10
1681919404041,EDS 119,A00,204994,Staff,8,0,10,2
1681919405068,EDS 124BR,A00,202324,Eguchi; Emi,4,0,25,21
1681919406092,EDS 126,A01,203208,Jones; Makeba,26,0,30,4
1681919407114,EDS 135,A01,202333,Staff,18,0,20,2
1681919408138,EDS 180,A00,202311,Staff,47,0,50,3
1681919409160,ERC 190GS,A01,253747,Staff,28,0,28,0
1681919410192,ETHN 104,A00,180742,Staff,24,0,35,11
1681919411218,ETHN 118,A00,180745,Staff,28,0,35,7
1681919412244,ETHN 127,A00,180747,Staff,12,0,16,4
1681919413268,ETHN 137,A00,180880,Staff,11,0,12,1
1681919414292,ETHN 147,A00,180890,Staff,8,0,10,2
1681919415314,ETHN 154,A00,180891,Staff,7,0,8,1
1681919416339,ETHN 168,A00,180892,Staff,9,0,10,1
1681919417362,GLBH 20,A00,201051,Hannah; Seth Donal,0,2,0,1
1681919418393,GLBH 111,A01,209338,Burgos; Jose L.,0,0,0,0
1681919419419,GLBH 150,A00,258300,Staff,0,3,0,0
1681919420444,GLBH 181,A00,201207,Staff,15,0,40,25
1681919421475,HIEU 109,A00,180898,Staff,20,0,20,0
1681919422500,HIEU 111,A00,180899,Staff,0,0,20,20
1681919423523,HIEU 124,A00,180900,Staff,17,0,20,3
1681919424548,HILA 122,A00,180901,Staff,18,0,20,2
1681919425574,HILA 132,A00,180902,Vitz; Matthew,2,0,20,18
1681919426603,HILD 10,A01,180896,Staff,15,0,20,5
1681919427625,HILD 30GS,A00,180897,Edington; Claire Ellen,0,0,0,0
1681919428655,HISC 105,A00,180903,Staff,20,0,20,0
1681919429676,HISC 117,A00,180904,Staff,11,0,20,9
1681919430699,HIUS 108B,A00,181005,Staff,18,0,20,2
1681919431721,HIUS 113,A00,181093,Staff,3,0,20,17
1681919432742,HUM 3,A01,181190,Patterson; Patrick H.,39,0,50,11
1681919432742,HUM 3,B01,181195,Staff,46,0,50,4
1681919433765,HUM 3GS,A00,181196,Herbst; Matthew,0,0,0,0
1681919434788,HUM 4,A01,181227,West; Geoffrey Scott,33,0,50,17
1681919434788,HUM 4,B01,181282,Staff,42,0,50,8
1681919435821,HUM 4GS,A00,181377,Lyon; Antony J.,0,0,0,0
1681919436853,HUM 5,A01,181536,Zavodny; Tatiana Sophia,29,0,50,21
1681919436853,HUM 5,B01,181908,Staff,36,0,50,14
1681919437878,INTL 190,A00,181909,Segui; Alan S,0,0,0,7
1681919437878,INTL 190,B00,181961,Segui; Alan S,0,0,0,7
1681919438902,JAPN 20AR,A01,182113,Ross; Kayoko F,15,0,20,5
1681919439929,LATI 50,A01,202391,Martin-Cabrera; Luis,18,0,30,12
1681919439929,LATI 50,A02,202392,Martin-Cabrera; Luis,26,0,30,4
1681919440962,LATI 180,A00,202393,Kokinis; Troy Andreas,24,0,25,1
1681919441986,LIFR 1A,A00,182119,Staff,14,0,14,0
1681919443013,LIFR 1AX,A00,182324,Staff,14,0,14,0
1681919444042,LIFR 1B,A00,182259,Staff,14,0,14,0
1681919445066,LIFR 1BX,A00,182273,Staff,14,0,14,0
1681919446100,LIGN 8,A00,182330,Staff,136,0,150,14
1681919447122,LIGN 9GS,A00,182362,Staff,20,0,20,0
1681919448144,LIGN 119,A00,204992,Takahashi; Maho,12,0,15,3
1681919449169,LIGN 130,A01,182384,Staff,47,0,50,3
1681919450193,LIGN 149GS,A00,182390,Staff,20,0,20,0
1681919451222,LIGN 170,A00,182404,Staff,23,0,30,7
1681919452253,LISP 1D,A00,182281,Staff,7,0,14,7
1681919452253,LISP 1D,B00,182287,Staff,14,0,14,0
1681919452253,LISP 1D,C00,182295,Staff,11,0,14,3
1681919452253,LISP 1D,D00,182301,Staff,14,0,14,0
1681919453278,LISP 1DX,A00,182309,Staff,20,0,28,8
1681919453278,LISP 1DX,B00,182316,Staff,26,0,28,2
1681919454304,LTAF 120GS,A00,182412,Zhiri; Oumelbanine,20,0,20,0
1681919455341,LTCS 172GS,A00,182437,Bronstein; Phoebe Malan,20,0,20,0
1681919456363,LTEA 138,A00,182457,Staff,21,0,40,19
1681919457389,LTEN 114,A01,182490,Staff,23,0,25,2
1681919458411,LTEN 130GS,A00,182491,Lyon; Antony J.,20,0,20,0
1681919459439,LTEN 169,A00,182493,Cuong; Marisol,19,0,25,6
1681919460465,LTEN 178,A00,182501,Staff,14,0,15,1
1681919461487,LTEN 181,A00,182515,Staff,22,0,25,3
1681919462518,LTEN 185GS,A00,197655,Forbes; Camille,20,0,20,0
1681919463542,LTSP 100B,A00,202208,Bessett; Ryan Matthew,24,0,25,1
1681919464567,LTWL 100,A00,182516,Myerston Santana; Jacobo,22,0,30,8
1681919465591,LTWR 100GS,A00,182518,Forbes; Camille,20,0,20,0
1681919466618,LTWR 102,A00,182522,Staff,15,0,15,0
1681919466618,LTWR 102,B00,182525,Staff,14,0,15,1
1681919467643,LTWR 115,A00,182526,Staff,11,0,15,4
1681919468666,MAE 8,A01,182528,Pham; Hieu Tan,67,0,70,3
1681919469689,MAE 11,A00,182529,Bahadori; Mohammad Yousef,94,0,100,6
1681919470713,MAE 20,A00,182530,Evdokimenko; Ekaterina,68,0,70,2
1681919471735,MAE 30A,A00,182532,Staff,44,0,45,1
1681919472757,MAE 101A,A00,182533,Bahadori; Mohammad Yousef,96,0,100,4
1681919473789,MAE 101C,A00,182538,Staff,62,0,70,8
1681919474811,MAE 104,A00,182539,Staff,44,0,50,6
1681919475913,MAE 131A,A00,182540,Ghazinejad; Maziar,40,0,45,5
1681919476941,MAE 143A,A00,182548,Bewley; Thomas R,43,0,50,7
1681919477965,MAE 150,A00,182549,Staff,28,0,40,12
1681919478990,MAE 160,A00,182550,Evdokimenko; Ekaterina,42,0,60,18
1681919480017,MATH 3C,A01,182725,Staff,26,0,30,4
1681919481040,MATH 10A,A01,182729,Staff,25,0,30,5
1681919481040,MATH 10A,B01,182732,Staff,26,0,30,4
1681919482068,MATH 10B,A01,182737,Staff,21,0,30,9
1681919482068,MATH 10B,A02,182738,Staff,26,0,30,4
1681919482068,MATH 10B,B01,182744,Staff,27,0,30,3
1681919482068,MATH 10B,B02,182745,Staff,27,0,30,3
1681919483102,MATH 18,A01,182750,Anzaldo; Leesa B,28,0,30,2
1681919483102,MATH 18,A02,182751,Anzaldo; Leesa B,29,0,30,1
1681919483102,MATH 18,A03,182753,Anzaldo; Leesa B,28,0,30,2
1681919483102,MATH 18,A04,182757,Anzaldo; Leesa B,29,0,30,1
1681919483102,MATH 18,B01,182761,Anzaldo; Leesa B,27,0,30,3
1681919483102,MATH 18,B02,182764,Anzaldo; Leesa B,27,0,30,3
1681919483102,MATH 18,B03,182765,Anzaldo; Leesa B,30,0,30,0
1681919483102,MATH 18,B04,182766,Anzaldo; Leesa B,30,0,30,0
1681919484124,MATH 20A,A01,182771,Suk; Andrew Hoon,28,0,30,2
1681919485150,MATH 20B,A01,182775,Bach; Quang Tran,30,0,30,0
1681919485150,MATH 20B,A02,182777,Bach; Quang Tran,29,0,30,1
1681919485150,MATH 20B,B01,182780,Bach; Quang Tran,27,0,30,3
1681919485150,MATH 20B,B02,182782,Bach; Quang Tran,30,0,30,0
1681919486177,MATH 20C,A01,182787,Staff,25,0,30,5
1681919486177,MATH 20C,A02,182790,Staff,29,0,30,1
1681919486177,MATH 20C,B01,182792,Staff,25,0,30,5
1681919486177,MATH 20C,B02,182796,Staff,27,0,30,3
1681919487203,MATH 20D,A01,182799,Staff,28,0,30,2
1681919487203,MATH 20D,A02,182802,Staff,29,0,30,1
1681919487203,MATH 20D,A03,182803,Staff,30,0,30,0
1681919488227,MATH 20E,A01,182809,Verstraete; Jacques Allan,23,0,30,7
1681919488227,MATH 20E,A02,182811,Verstraete; Jacques Allan,28,0,30,2
1681919488227,MATH 20E,B01,182814,Verstraete; Jacques Allan,23,0,30,7
1681919488227,MATH 20E,B02,182815,Verstraete; Jacques Allan,30,0,30,0
1681919489253,MATH 103A,A01,182820,Staff,8,0,30,22
1681919489253,MATH 103A,A02,182821,Staff,27,0,30,3
1681919489253,MATH 103A,A03,182822,Staff,23,0,30,7
1681919489253,MATH 103A,B01,182825,Staff,23,0,30,7
1681919489253,MATH 103A,B02,182826,Staff,30,0,30,0
1681919489253,MATH 103A,B03,182830,Staff,30,0,30,0
1681919490281,MATH 109,A01,182836,Chow; Bennett,24,0,30,6
1681919490281,MATH 109,A02,182838,Chow; Bennett,29,0,30,1
1681919490281,MATH 109,A03,182894,Chow; Bennett,29,0,30,1
1681919490281,MATH 109,B01,182908,Chow; Bennett,27,0,30,3
1681919490281,MATH 109,B02,182909,Chow; Bennett,30,0,30,0
1681919490281,MATH 109,B03,182910,Chow; Bennett,27,0,30,3
1681919491304,MATH 142A,A01,182925,Staff,10,0,30,20
1681919491304,MATH 142A,A02,182935,Staff,24,0,30,6
1681919491304,MATH 142A,A03,182967,Staff,26,0,30,4
1681919491304,MATH 142A,B01,183125,Staff,22,0,30,8
1681919491304,MATH 142A,B02,183157,Staff,28,0,30,2
1681919491304,MATH 142A,B03,183158,Staff,29,0,30,1
1681919492337,MATH 183,A01,183160,Arias-Castro; Ery,23,0,30,7
1681919492337,MATH 183,A02,183161,Arias-Castro; Ery,29,0,30,1
1681919492337,MATH 183,B01,183163,Arias-Castro; Ery,28,0,30,2
1681919492337,MATH 183,B02,183164,Arias-Castro; Ery,28,0,30,2
1681919493365,MATH 193A,A01,183167,Staff,4,0,35,31
1681919493365,MATH 193A,A02,183168,Staff,28,0,35,7
1681919493365,MATH 193A,A03,183169,Staff,34,0,35,1
1681919493365,MATH 193A,A04,183170,Staff,28,0,35,7
1681919494388,MGT 4,A01,202395,Anderson; John Charles,75,0,80,5
1681919495411,MGT 5,A00,202396,Houskeeper; Robert,80,0,90,10
1681919496434,MGT 103,A00,202397,Eberhard; Craig A,53,0,90,37
1681919497461,MGT 131A,A00,202398,Houskeeper; Robert,85,0,90,5
1681919498484,MGT 135,A00,202399,Anderson; John Charles,81,0,90,9
1681919499509,MGT 162R,A00,202403,Gneezy; Uri,144,0,200,56
1681919500536,MGT 172,A00,202404,Hedges; Kathleen,49,0,90,41
1681919501561,MGT 181,A00,202405,Dunn; Louis Jean,83,0,90,7
1681919502585,MMW 14,A01,183200,Staff,12,0,28,16
1681919502585,MMW 14,A02,183201,Staff,26,0,28,2
1681919502585,MMW 14,A03,183202,Staff,24,0,28,4
1681919502585,MMW 14,A04,183203,Staff,25,0,28,3
1681919502585,MMW 14,A05,183204,Staff,26,0,28,2
1681919502585,MMW 14,A06,183205,Staff,27,0,28,1
1681919502585,MMW 14,B01,183207,Staff,26,0,28,2
1681919502585,MMW 14,B02,183208,Staff,28,0,28,0
1681919502585,MMW 14,B03,183209,Staff,28,0,28,0
1681919502585,MMW 14,B04,183210,Staff,28,0,28,0
1681919502585,MMW 14,B05,183211,Staff,28,0,28,0
1681919502585,MMW 14,B06,183212,Staff,27,0,28,1
1681919503610,MMW 14GS,A00,183213,Zhiri; Oumelbanine,28,0,28,0
1681919504631,MMW 15GS,B00,183215,Rahimi; Babak,28,0,28,0
1681919505656,MMW 121,A01,183217,Patterson; Patrick H.,14,0,28,14
1681919505656,MMW 121,A02,183218,Patterson; Patrick H.,25,0,28,3
1681919506682,MUS 1A,A01,182554,Staff,7,0,35,28
1681919507704,MUS 5,A01,182558,Staff,19,0,35,16
1681919508726,MUS 6,A01,182562,Staff,24,0,35,11
1681919509752,MUS 8GS,A00,182563,Borgo; David Garcia,25,0,25,0
1681919510784,MUS 13,A01,182567,Staff,24,0,25,1
1681919511812,MUS 15,A01,182570,Staff,32,0,35,3
1681919511812,MUS 15,B01,182575,Staff,9,0,35,26
1681919512836,MUS 80,A00,182578,Staff,23,0,25,2
1681919512836,MUS 80,B00,182581,Staff,20,0,25,5
1681919513859,MUS 113,A00,182582,Staff,25,0,25,0
1681919514885,MUS 114,A00,182583,Staff,4,0,25,21
1681919515915,MUS 150GS,A01,182588,Borgo; David Garcia,25,0,25,0
1681919516940,PHIL 1,A00,182590,Staff,35,0,40,5
1681919517970,PHIL 10,A01,182596,Grush; Rick Scott,31,0,35,4
1681919517970,PHIL 10,A02,182597,Grush; Rick Scott,34,0,35,1
1681919518993,PHIL 15,A01,182601,Staff,31,0,35,4
1681919518993,PHIL 15,A02,182602,Staff,33,0,35,2
1681919520016,PHIL 27,A01,182604,Staff,30,0,35,5
1681919520016,PHIL 27,A02,182607,Staff,35,0,35,0
1681919521038,PHIL 32,A01,182609,Staff,35,0,35,0
1681919521038,PHIL 32,A02,182612,Staff,35,0,35,0
1681919522061,PHIL 130,A00,182614,Staff,62,0,70,8
1681919523084,PHIL 136,A00,182616,Cohen; Jonathan David,66,0,70,4
1681919524107,PHIL 155,A00,182617,Vargas; Manuel Rogelio,58,0,70,12
1681919525130,PHIL 163,A01,182620,Staff,15,0,20,5
1681919525130,PHIL 163,A02,182624,Staff,10,0,20,10
1681919526155,PHIL 164,A00,182627,Staff,30,0,40,10
1681919527177,PHIL 173,A00,182628,Staff,36,0,40,4
1681919528206,PHYS 1A,A00,183221,Staff,54,0,60,6
1681919529240,PHYS 1AL,001,183222,Staff,25,0,30,5
1681919529240,PHYS 1AL,002,183223,Staff,28,0,30,2
1681919530265,PHYS 1B,A00,183231,Staff,43,0,60,17
1681919531292,PHYS 1BL,001,183232,Staff,20,0,30,10
1681919531292,PHYS 1BL,002,183233,Staff,27,0,30,3
1681919532318,PHYS 1C,A00,183240,Staff,29,0,60,31
1681919533343,PHYS 1CL,001,183241,Staff,12,0,30,18
1681919533343,PHYS 1CL,002,183242,Staff,22,0,30,8
1681919534366,PHYS 2AR,A01,183250,Staff,44,0,50,6
1681919535390,PHYS 2B,A01,183252,Staff,104,0,115,11
1681919536418,PHYS 2BL,A01,183254,Staff,21,0,24,3
1681919536418,PHYS 2BL,A02,183255,Staff,22,0,24,2
1681919537443,PHYS 2C,A01,183522,Staff,103,0,115,12
1681919538473,PHYS 4A,A01,183524,Staff,49,0,50,1
1681919539496,POLI 5,A00,183525,Staff,44,0,50,6
1681919540520,POLI 12,A00,183540,Staff,46,0,50,4
1681919541545,POLI 13R,A00,183541,Forman; Fonna,42,0,50,8
1681919542577,POLI 30,A00,183542,Mignozzetti; Umberto,47,0,50,3
1681919543599,POLI 100A,A00,183543,Staff,45,0,50,5
1681919544625,POLI 100E,A00,223598,Staff,32,0,35,3
1681919545649,POLI 103A,A00,183564,Kousser; Thad,37,0,50,13
1681919546673,POLI 104B,A00,201329,Staff,28,0,35,7
1681919547698,POLI 113BR,A00,183576,Hoston; Germaine,26,0,50,24
1681919548724,POLI 114BR,A00,183588,Staff,27,0,30,3
1681919549747,POLI 117R,A00,183595,Forman; Fonna,8,0,20,12
1681919550770,POLI 120H,A00,183596,Fisk; David Lee,13,0,20,7
1681919551792,POLI 130AA,A00,183597,Staff,14,0,20,6
1681919552815,POLI 134AA,A00,183598,Staff,19,0,20,1
1681919553847,POLI 135,A00,183599,Fisk; David Lee,20,0,25,5
1681919554884,POLI 142P,A00,183623,Staff,37,0,40,3
1681919555910,POLI 144D,A00,183624,Staff,22,0,25,3
1681919556938,POLI 151,A00,183625,Staff,15,0,20,5
1681919557960,POLI 162,A00,183626,Mignozzetti; Umberto,18,0,20,2
1681919558984,PSYC 1,A00,253748,Staff,86,0,90,4
1681919571807,PSYC 2,A00,183627,Moranton; Nirelia Melbina-,25,0,35,10
1681919572830,PSYC 3,A00,183628,Staff,43,0,45,2
1681919574880,PSYC 60,A01,183631,Lowe; Angela Beth,35,0,40,5
1681919575912,PSYC 70,A01,253757,Staff,37,0,45,8
1681919576938,PSYC 101,A00,183632,Heyman; Gail D.,48,0,60,12
1681919577962,PSYC 105,A00,183848,Lowe; Angela Beth,48,0,60,12
1681919578987,PSYC 106,A00,183849,Dobkins; Karen R.,44,0,60,16
1681919580011,PSYC 108,A00,253750,Staff,24,0,60,36
1681919581036,PSYC 114,A01,184275,Winkielman; Piotr,0,7,30,30
1681919582062,PSYC 122,A00,183856,Moranton; Nirelia Melbina-,0,11,30,30
1681919583088,PSYC 124,A00,183865,Chapman; Eddie Nathaniel,51,0,80,29
1681919584111,PSYC 137,A00,183880,Staff,19,0,25,6
1681919586172,PSYC 154,A00,183910,Lacefield; Katharine I,0,8,90,90
1681919588216,PSYC 162,A00,183946,Wixted; John T,60,0,90,30
1681919589244,PSYC 172,A00,183947,Gorman; Michael R.,12,0,30,18
1681919590282,PSYC 178,A00,183963,Glaser; Dale,19,0,40,21
1681919591392,PSYC 181GS,A00,183964,Anagnostaras; Stephan,10,0,10,0
1681919592422,PSYC 186GS,A01,257660,Staff,10,0,10,0
1681919593448,PSYC 193,B00,253749,Staff,23,0,25,2
1681919595494,PSYC 193L,A01,184122,Staff,33,0,35,2
1681919595494,PSYC 193L,C01,184167,Winkielman; Piotr,15,0,30,15
1681919596517,RELI 188GS,A00,182629,Rahimi; Babak,20,0,20,0
1681919597540,SE 101A,A00,182646,Staff,26,0,30,4
1681919598564,SE 101C,A00,182650,Staff,18,0,20,2
1681919599586,SE 110A,A00,182651,Staff,28,0,28,0
1681919600612,SE 130A,A00,182652,Staff,39,0,40,1
1681919601638,SIO 46GS,A00,182636,Cook; Geoffrey W,27,0,28,1
1681919602668,SIO 109R,A00,194459,Staff,4,0,20,16
1681919603690,SIO 121GS,A00,182639,Cook; Geoffrey W,27,0,28,1
1681919604715,SIO 132,A01,182642,Staff,32,0,40,8
1681919605741,SIO 139,A00,182644,Kacev; David,36,0,40,4
1681919606771,SOCI 2,A01,258404,Staff,34,0,36,2
1681919606771,SOCI 2,A02,258405,Staff,35,0,36,1
1681919607795,SOCI 60,A01,258408,Staff,29,0,30,1
1681919607795,SOCI 60,A02,258413,Staff,30,0,30,0
1681919608826,SOCI 100,A01,258415,Staff,29,0,30,1
1681919608826,SOCI 100,A02,258416,Staff,28,0,30,2
1681919614973,SOCI 127,A00,258421,Staff,21,0,30,9
1681919615998,SOCI 132,A00,258422,Staff,45,0,50,5
1681919617024,SOCI 133,A00,258423,Staff,26,0,30,4
1681919618046,SOCI 138GS,A00,258424,Staff,15,0,15,0
1681919619069,SOCI 145,A00,258425,Staff,25,0,30,5
1681919620097,SOCI 148,A00,258426,Staff,26,0,30,4
1681919621123,SOCI 153,A00,199217,Staff,29,0,30,1
1681919622148,SOCI 160,A00,258427,Staff,28,0,30,2
1681919623172,SOCI 160E,A00,258435,Staff,56,0,60,4
1681919624195,SOCI 189GS,A00,258436,Staff,15,0,15,0
1681919625218,SOCI 190GS,A00,258437,Staff,15,0,15,0
1681919626241,SYN 2,001,182658,Staff,8,0,16,8
1681919626241,SYN 2,002,201439,Staff,14,0,16,2
1681919626241,SYN 2,003,201443,Staff,16,0,16,0
1681919627264,SYN 100,A01,182657,Staff,16,0,20,4
1681919628291,TDAC 1,A00,184381,Salovey; Todd,16,0,20,4
1681919628291,TDAC 1,B00,184385,Harting; Carla Kelso,19,0,20,1
1681919628291,TDAC 1,C00,184394,Staff,19,0,20,1
1681919629328,TDAC 101,A00,184483,Harting; Carla Kelso,19,0,20,1
1681919630360,TDDE 111,A00,184496,Staff,14,0,15,1
1681919631384,TDDE 131,A00,184504,Staff,20,0,20,0
1681919631384,TDDE 131,B00,184505,Staff,17,0,18,1
1681919631384,TDDE 131,C00,184534,Staff,49,0,50,1
1681919631384,TDDE 131,D00,184564,Staff,15,0,15,0
1681919631384,TDDE 131,E00,204725,Staff,19,0,20,1
1681919632410,TDGE 1,A01,184414,Salovey; Todd,36,0,50,14
1681919633433,TDGE 5,A01,184419,Staff,23,0,24,1
1681919634464,TDGE 10,A00,184428,Fulton; Julia,29,0,50,21
1681919635486,TDGE 124,A00,184565,Fulton; Julia,7,0,50,43
1681919636518,TDGE 125,B00,184567,Meyer; Ursula,9,0,25,16
1681919637544,TDHT 101,A00,184568,Staff,21,0,25,4
1681919637544,TDHT 101,B00,184569,Staff,20,0,20,0
1681919638578,TDHT 114,A00,184570,Staff,49,0,50,1
1681919639605,TDMV 1,A00,184437,Arcidiacono; Kristin,22,0,30,8
1681919639605,TDMV 1,B00,184448,Caligagan; Maria T.,23,0,30,7
1681919640628,TDMV 2,A00,184449,Weinberg; Sadie,27,0,30,3
1681919640628,TDMV 2,B00,184453,Arcidiacono; Kristin,29,0,30,1
1681919641660,TDMV 110,A00,184571,Weinberg; Sadie,30,0,30,0
1681919642705,TDMV 142,A00,184572,Caligagan; Tony,27,0,30,3
1681919642705,TDMV 142,B00,184573,Caligagan; Maria T.,26,0,30,4
1681919643728,TDTR 20,A00,184482,Jun; Grace Shin Hae,25,0,25,0
1681919644755,USP 2,A01,184290,Hinds; Juli Beth,24,0,25,1
1681919645779,USP 3,A01,184295,Staff,20,0,25,5
1681919646802,USP 4,A00,184304,McTague; Sarah,15,0,25,10
1681919647828,USP 100,A00,184315,Staff,17,0,25,8
1681919648854,USP 105,A00,184326,Staff,21,0,25,4
1681919649878,USP 151,A00,184327,Staff,20,0,25,5
1681919650902,USP 170,A00,184380,Hinds; Juli Beth,14,0,25,11
1681919651925,VIS 21B,A01,182660,Staff,28,0,31,3
1681919651925,VIS 21B,A02,182662,Staff,30,0,31,1
1681919652949,VIS 103D,A00,182663,Staff,74,0,75,1
1681919653973,VIS 105D,A00,182667,Li; Huai,15,0,22,7
1681919654999,VIS 122GS,A00,182668,Herbst; Matthew,20,0,20,0
1681919656025,VIS 128C,A00,182673,Staff,69,0,75,6
1681919657057,VIS 130,A00,182675,Staff,20,0,22,2
1681919658080,VIS 160A,A00,182678,Stalbaum; Brett,4,0,10,6
1681919660132,WCWP 10B,A00,201679,Staff,15,0,15,0
1681919660132,WCWP 10B,B00,201695,Staff,15,0,15,0
1681919661156,WCWP 100,A00,201716,Staff,15,0,15,0
1681919661156,WCWP 100,B00,201717,Staff,10,0,15,5
1681919663253,ANSC 105GS,A00,258289,Staff,0,0,0,0
1681919664275,ANSC 125GS,A00,258295,Staff,0,0,0,0
1681919665308,ANSC 150,A00,258267,Staff,30,0,40,10
1681919666330,ANSC 190GS,A00,258280,Staff,0,0,0,0
1681919667363,ANTH 1,A00,258264,Staff,38,0,40,2
1681919668391,ANTH 2,A01,258259,Staff,72,0,76,4
1681919669413,ANTH 23,A01,258228,Staff,36,0,40,4
1681919670444,ANTH 101,A01,258236,Staff,38,0,40,2
1681919671470,ANTH 102,A00,258272,Staff,59,0,60,1
1681919672494,ANTH 105,A00,258244,Staff,31,0,35,4
1681919673519,BENG 130,A00,253975,Staff,38,0,40,2
1681919674542,BIBC 102,A01,191866,Flagg; Matthew Paul,19,0,32,13
1681919674542,BIBC 102,A02,191867,Flagg; Matthew Paul,22,0,32,10
1681919674542,BIBC 102,A03,191868,Flagg; Matthew Paul,29,0,32,3
1681919674542,BIBC 102,A04,191936,Flagg; Matthew Paul,26,0,32,6
1681919674542,BIBC 102,A05,191937,Flagg; Matthew Paul,6,0,32,26
1681919675564,BICD 100,A01,191939,Cooper; Andrew Michael,28,0,32,4
1681919675564,BICD 100,A02,191940,Cooper; Andrew Michael,32,0,32,0
1681919675564,BICD 100,A03,191941,Cooper; Andrew Michael,32,0,32,0
1681919675564,BICD 100,A04,191942,Cooper; Andrew Michael,32,0,32,0
1681919675564,BICD 100,A05,191943,Cooper; Andrew Michael,32,0,32,0
1681919676590,BIEB 126,A01,191945,Cleland; Elsa Eleanor,0,0,32,32
1681919676590,BIEB 126,A02,191946,Cleland; Elsa Eleanor,27,0,32,5
1681919676590,BIEB 126,A03,191947,Cleland; Elsa Eleanor,29,0,32,3
1681919676590,BIEB 126,A04,191948,Cleland; Elsa Eleanor,23,0,32,9
1681919676590,BIEB 126,A05,191996,Cleland; Elsa Eleanor,28,0,32,4
1681919677614,BIEB 136GS,A00,191997,Shurin; Jonathan & Holway; David A.,0,0,0,3
1681919678649,BIEB 137GS,A01,191999,Shurin; Jonathan & Holway; David A.,0,0,0,2
1681919679671,BILD 1,A01,205385,Staff,31,0,32,1
1681919679671,BILD 1,A02,205386,Staff,30,0,32,2
1681919679671,BILD 1,A03,205387,Staff,32,0,32,0
1681919679671,BILD 1,A04,205388,Staff,27,0,32,5
1681919680698,BILD 2,A01,191774,Staff,28,0,32,4
1681919680698,BILD 2,A02,191775,Staff,30,0,32,2
1681919680698,BILD 2,A03,191777,Staff,30,0,32,2
1681919680698,BILD 2,A04,191856,Staff,31,0,32,1
1681919680698,BILD 2,A05,191857,Staff,32,0,32,0
1681919680698,BILD 2,A06,191858,Staff,32,0,32,0
1681919680698,BILD 2,A07,191859,Staff,31,0,32,1
1681919681724,BILD 3,A01,205391,Staff,29,0,32,3
1681919681724,BILD 3,A02,205393,Staff,32,0,32,0
1681919681724,BILD 3,A03,205394,Staff,28,0,32,4
1681919681724,BILD 3,A04,205395,Staff,32,0,32,0
1681919682746,BILD 20,A01,191861,Staff,32,0,32,0
1681919682746,BILD 20,A02,191862,Staff,32,0,32,0
1681919683773,BILD 30,A01,191864,Staff,31,0,32,1
1681919684798,BIMM 100,A01,192019,Staff,0,0,32,32
1681919684798,BIMM 100,A02,192020,Staff,21,0,32,11
1681919684798,BIMM 100,A03,192035,Staff,21,0,32,11
1681919685820,BIMM 110,A01,192037,Tat; John,0,0,32,32
1681919685820,BIMM 110,A02,192038,Tat; John,9,0,32,23
1681919686846,BIMM 120,A01,192040,Pickett; Brooke Elizabeth,1,0,32,31
1681919686846,BIMM 120,A02,192041,Pickett; Brooke Elizabeth,16,0,32,16
1681919686846,BIMM 120,A03,192042,Pickett; Brooke Elizabeth,15,0,32,17
1681919687869,BIPN 100,A01,192044,Armour; Jon Christopher,26,0,32,6
1681919687869,BIPN 100,A02,192059,Armour; Jon Christopher,30,0,32,2
1681919687869,BIPN 100,A03,192064,Armour; Jon Christopher,31,0,32,1
1681919687869,BIPN 100,A04,192073,Armour; Jon Christopher,28,0,32,4
1681919688892,BIPN 148,A01,205411,Leutgeb; Jill K.,16,0,32,16
1681919688892,BIPN 148,A02,205412,Leutgeb; Jill K.,31,0,32,1
1681919688892,BIPN 148,A03,205413,Leutgeb; Jill K.,30,0,32,2
1681919688892,BIPN 148,A04,205414,Leutgeb; Jill K.,30,0,32,2
1681919689919,BIPN 160,A01,192115,Marino; Marc J,17,0,32,15
1681919689919,BIPN 160,A02,192148,Marino; Marc J,27,0,32,5
1681919689919,BIPN 160,A03,192158,Marino; Marc J,31,0,32,1
1681919689919,BIPN 160,A04,192190,Marino; Marc J,32,0,32,0
1681919689919,BIPN 160,A05,192287,Marino; Marc J,32,0,32,0
1681919689919,BIPN 160,A06,192288,Marino; Marc J,32,0,32,0
1681919690945,BIPN 194,A00,206038,Staff,28,0,32,4
1681919691975,BISP 194,A00,192289,Leutgeb; Stefan,13,0,32,19
1681919691975,BISP 194,B00,245332,Nieh; James Charles,26,0,32,6
1681919693003,CAT 124,A01,202247,Staff,15,0,15,0
1681919694030,CAT 125,A00,202248,Staff,19,0,20,1
1681919694030,CAT 125,B00,202253,Staff,20,0,20,0
1681919694030,CAT 125,C00,202257,Staff,18,0,20,2
1681919695126,CAT 125GS,A01,202273,Bronstein; Phoebe Malan,20,0,20,0
1681919696150,CAT 125R,A00,202284,Staff,17,0,20,3
1681919696150,CAT 125R,C00,202286,Staff,10,0,20,10
1681919696150,CAT 125R,D00,202291,Staff,18,0,20,2
1681919696150,CAT 125R,E00,202295,Staff,13,0,20,7
1681919696150,CAT 125R,F00,202302,Staff,11,0,20,9
1681919697180,CENG 100,A00,204724,Opatkiewicz; Justin Paul,25,0,25,0
1681919698205,CGS 2A,A01,180420,Staff,31,0,36,5
1681919699230,CGS 101,A00,180421,Staff,16,0,20,4
1681919700253,CGS 112,A00,180422,Staff,9,0,16,7
1681919701275,CGS 113,A00,180423,Staff,18,0,20,2
1681919702297,CGS 137,A00,180424,Staff,12,0,12,0
1681919703320,CGS 147,A00,180425,Staff,10,0,10,0
1681919704345,CHEM 6A,A01,179556,Staff,97,0,100,3
1681919704345,CHEM 6A,A02,179558,Staff,0,0,0,0
1681919705373,CHEM 6B,A01,179560,Staff,100,0,100,0
1681919706404,CHEM 6C,A01,179565,Jazzar; Rodolphe,95,0,100,5
1681919707433,CHEM 7L,A01,179586,Schurmeier; Kimberly,11,0,24,13
1681919707433,CHEM 7L,A02,179587,Schurmeier; Kimberly,23,0,24,1
1681919707433,CHEM 7L,A03,179590,Schurmeier; Kimberly,22,0,24,2
1681919707433,CHEM 7L,A04,179591,Schurmeier; Kimberly,22,0,24,2
1681919707433,CHEM 7L,B01,179598,Schurmeier; Kimberly,17,0,24,7
1681919707433,CHEM 7L,B02,179599,Schurmeier; Kimberly,24,0,24,0
1681919707433,CHEM 7L,B03,179606,Schurmeier; Kimberly,23,0,24,1
1681919707433,CHEM 7L,B04,179607,Schurmeier; Kimberly,23,0,24,1
1681919708464,CHEM 11,A01,179609,Stallings; Dontarie M,88,0,100,12
1681919709487,CHEM 40A,A01,179621,Staff,41,0,50,9
1681919709487,CHEM 40A,A02,179622,Staff,47,0,50,3
1681919710515,CHEM 40B,A01,179630,Weizman; Haim,48,0,50,2
1681919710515,CHEM 40B,A02,179631,Weizman; Haim,45,0,50,5
1681919711540,CHEM 41A,A01,179660,Klosterman; Jeremy K,93,0,100,7
1681919712562,CHEM 43A,A01,179683,Klosterman; Jeremy K,0,0,24,24
1681919712562,CHEM 43A,A02,179688,Klosterman; Jeremy K,11,0,24,13
1681919712562,CHEM 43A,A03,179689,Klosterman; Jeremy K,19,0,24,5
1681919712562,CHEM 43A,A04,179691,Klosterman; Jeremy K,18,0,24,6
1681919713586,CHEM 114A,A01,179693,Stallings; Dontarie M,74,0,100,26
1681919714611,CHEM 143B,A01,179698,Weizman; Haim,17,0,24,7
1681919714611,CHEM 143B,A02,179700,Weizman; Haim,24,0,24,0
1681919715635,CHIN 169A,A00,179701,Wang; Xiao,20,0,20,0
1681919716657,COGS 2,A01,179750,Boyle; Mary E. T.,17,0,30,13
1681919717680,COGS 9,A01,179759,Jones; Cameron Robert,42,0,50,8
1681919718706,COGS 14A,A01,179854,Staff,17,0,50,33
1681919719728,COGS 14B,A01,179856,Staff,53,0,60,7
1681919720760,COGS 17,A01,179874,Staff,71,0,75,4
1681919721785,COGS 18,A01,179884,Staff,63,0,80,17
1681919722811,COGS 100,A01,179886,Staff,39,0,60,21
1681919723834,COGS 101B,A01,179892,Staff,1,0,30,29
1681919724864,COGS 101C,A01,179894,Staff,28,0,30,2
1681919725891,COGS 107A,A01,179896,Boyle; Mary E. T.,31,0,40,9
1681919726920,COGS 108,A01,179898,Simpkins; Charles Alexander,0,23,60,60
1681919727943,COGS 109,A01,179900,Staff,34,0,40,6
1681919728966,COGS 118A,A01,179946,Staff,8,0,40,32
1681919730014,COGS 153,A00,179978,Staff,0,1,30,30
1681919731039,COGS 156,A01,179981,Staff,27,0,30,3
1681919733089,COGS 172,A01,179987,Staff,13,0,30,17
1681919735137,COGS 186,A01,179991,Staff,12,0,30,18
1681919736162,COMM 10,A01,180001,Staff,14,0,25,11
1681919736162,COMM 10,A02,180004,Staff,20,0,25,5
1681919737187,COMM 100A,A01,180016,Staff,17,0,25,8
1681919737187,COMM 100A,A02,180020,Staff,24,0,25,1
1681919738213,COMM 101T,A00,180029,Halm; Gavin Patrick,23,0,35,12
1681919739260,COMM 106V,A00,180043,Staff,34,0,35,1
1681919740285,COMM 109P,A00,180044,Staff,31,0,35,4
1681919741308,COMM 113T,A00,180045,Havis; Allan,37,0,45,8
1681919742334,COMM 132,A00,180046,McKenna; Denise,23,0,30,7
1681919743357,COMM 143,A00,180047,Staff,19,0,30,11
1681919744380,COMM 190,A00,180048,Conner; Thomas Hartnell,20,0,23,3
1681919745410,CSE 8A,A50,180053,Cao; Yingjun,25,0,50,25
1681919745410,CSE 8A,B50,180180,Staff,50,0,50,0
1681919746442,CSE 11,A01,180190,Cao; Yingjun,28,0,50,22
1681919747464,CSE 20,A01,180192,Briones; Jor-el Thomas Caparas,23,0,30,7
1681919748486,CSE 21,A01,194538,Briones; Jor-el Thomas Caparas,50,0,60,10
1681919749513,CSE 30,A01,180324,Eldon; John,76,0,100,24
1681919750538,CSE 101,A01,201353,Staff,0,22,40,40
1681919751565,CSE 134B,A01,180326,Powell; Thomas Allan,74,0,100,26
1681919752587,CSE 140,A01,180328,Staff,42,0,75,33
1681919753613,CSE 140L,A01,180344,Eldon; John,65,0,100,35
1681919754635,CSE 150A,A01,180411,Staff,0,10,50,50
1681919755662,CSE 151A,A01,180414,Staff,0,8,50,50
1681919756688,CSE 175,A01,222521,Kumar; Rakesh,50,0,50,0
1681919757729,CSE 190,A00,201419,Staff,45,0,49,4
1681919758760,CSS 1,A01,194536,Staff,37,0,50,13
1681919759782,DSC 30,A01,202385,Staff,48,0,50,2
1681919760806,DSC 40A,A01,202387,Albuyeh; Rod,50,0,50,0
1681919761843,DSC 190,A01,202389,Silberman; Jack,21,0,21,0
1681919762868,DSGN 100,A01,179993,Staff,16,0,30,14
1681919763895,ECE 65,A50,180708,Staff,10,0,20,10
1681919763895,ECE 65,A51,180739,Staff,19,0,20,1
1681919764924,ECON 1,A01,180427,Famulari; Melissa,67,0,70,3
1681919765949,ECON 2,A01,180450,Levkoff; Steven B.,64,0,70,6
1681919766982,ECON 4,A01,203351,Anderson; John Charles,7,0,10,3
1681919768013,ECON 100A,A01,180472,Famulari; Melissa,64,0,70,6
1681919769039,ECON 120A,A01,180549,Staff,63,0,70,7
1681919770070,ECON 120B,A01,180655,Ma; Xinwei,44,0,70,26
1681919771095,ECON 129,A00,203333,Eckert; Fabian Paul,13,0,35,22
1681919772118,ECON 131,A00,180656,Staff,7,0,35,28
1681919773141,ECON 172B,A01,180672,Levkoff; Steven B.,31,0,35,4
1681919774166,ECON 178,A01,203342,Zhu; Ying,9,0,35,26
1681919775189,EDS 108GS,A00,202383,Wishard Guerra; Alison G.,20,0,20,0
1681919776212,EDS 111GS,A00,202347,Wishard Guerra; Alison G.,20,0,20,0
1681919777234,EDS 112,A01,202323,Staff,56,0,60,4
1681919778259,EDS 113,A00,202340,Staff,33,0,35,2
1681919779299,EDS 118,A00,201231,Staff,20,0,30,10
1681919780322,EDS 119,A00,204994,Staff,8,0,10,2
1681919781347,EDS 124BR,A00,202324,Eguchi; Emi,4,0,25,21
1681919782371,EDS 126,A01,203208,Jones; Makeba,26,0,30,4
1681919783403,EDS 135,A01,202333,Staff,18,0,20,2
1681919784428,EDS 180,A00,202311,Staff,47,0,50,3
1681919785455,ERC 190GS,A01,253747,Staff,28,0,28,0
1681919786477,ETHN 104,A00,180742,Staff,23,0,35,12
1681919787503,ETHN 118,A00,180745,Staff,27,0,35,8
1681919788537,ETHN 127,A00,180747,Staff,12,0,16,4
1681919789562,ETHN 137,A00,180880,Staff,11,0,12,1
1681919790588,ETHN 147,A00,180890,Staff,8,0,10,2
1681919791620,ETHN 154,A00,180891,Staff,7,0,8,1
1681919792653,ETHN 168,A00,180892,Staff,9,0,10,1
1681919793681,GLBH 20,A00,201051,Hannah; Seth Donal,0,2,0,1
1681919794704,GLBH 111,A01,209338,Burgos; Jose L.,0,0,0,0
1681919795726,GLBH 150,A00,258300,Staff,0,3,0,0
1681919796749,GLBH 181,A00,201207,Staff,15,0,40,25
1681919797784,HIEU 109,A00,180898,Staff,20,0,20,0
1681919798883,HIEU 111,A00,180899,Staff,0,0,20,20
1681919799905,HIEU 124,A00,180900,Staff,17,0,20,3
1681919800929,HILA 122,A00,180901,Staff,18,0,20,2
1681919801954,HILA 132,A00,180902,Vitz; Matthew,2,0,20,18
1681919802977,HILD 10,A01,180896,Staff,15,0,20,5
1681919804034,HILD 30GS,A00,180897,Edington; Claire Ellen,0,0,0,0
1681919805058,HISC 105,A00,180903,Staff,20,0,20,0
1681919806084,HISC 117,A00,180904,Staff,11,0,20,9
1681919807109,HIUS 108B,A00,181005,Staff,18,0,20,2
1681919808134,HIUS 113,A00,181093,Staff,3,0,20,17
1681919809156,HUM 3,A01,181190,Patterson; Patrick H.,39,0,50,11
1681919809156,HUM 3,B01,181195,Staff,46,0,50,4
1681919810181,HUM 3GS,A00,181196,Herbst; Matthew,0,0,0,0
1681919811206,HUM 4,A01,181227,West; Geoffrey Scott,33,0,50,17
1681919811206,HUM 4,B01,181282,Staff,42,0,50,8
1681919812231,HUM 4GS,A00,181377,Lyon; Antony J.,0,0,0,0
1681919813260,HUM 5,A01,181536,Zavodny; Tatiana Sophia,29,0,50,21
1681919813260,HUM 5,B01,181908,Staff,36,0,50,14
1681919814286,INTL 190,A00,181909,Segui; Alan S,0,0,0,7
1681919814286,INTL 190,B00,181961,Segui; Alan S,0,0,0,7
1681919815311,JAPN 20AR,A01,182113,Ross; Kayoko F,15,0,20,5
1681919816336,LATI 50,A01,202391,Martin-Cabrera; Luis,18,0,30,12
1681919816336,LATI 50,A02,202392,Martin-Cabrera; Luis,26,0,30,4
1681919817359,LATI 180,A00,202393,Kokinis; Troy Andreas,24,0,25,1
1681919818382,LIFR 1A,A00,182119,Staff,14,0,14,0
1681919819408,LIFR 1AX,A00,182324,Staff,14,0,14,0
1681919820434,LIFR 1B,A00,182259,Staff,14,0,14,0
1681919821456,LIFR 1BX,A00,182273,Staff,14,0,14,0
1681919822479,LIGN 8,A00,182330,Staff,135,0,150,15
1681919823504,LIGN 9GS,A00,182362,Staff,20,0,20,0
1681919824531,LIGN 119,A00,204992,Takahashi; Maho,12,0,15,3
1681919825562,LIGN 130,A01,182384,Staff,47,0,50,3
1681919826588,LIGN 149GS,A00,182390,Staff,20,0,20,0
1681919827611,LIGN 170,A00,182404,Staff,23,0,30,7
1681919828634,LISP 1D,A00,182281,Staff,7,0,14,7
1681919828634,LISP 1D,B00,182287,Staff,14,0,14,0
1681919828634,LISP 1D,C00,182295,Staff,11,0,14,3
1681919828634,LISP 1D,D00,182301,Staff,14,0,14,0
1681919829660,LISP 1DX,A00,182309,Staff,20,0,28,8
1681919829660,LISP 1DX,B00,182316,Staff,26,0,28,2
1681919830686,LTAF 120GS,A00,182412,Zhiri; Oumelbanine,20,0,20,0
1681919831710,LTCS 172GS,A00,182437,Bronstein; Phoebe Malan,20,0,20,0
1681919832736,LTEA 138,A00,182457,Staff,21,0,40,19
1681919833762,LTEN 114,A01,182490,Staff,23,0,25,2
1681919834783,LTEN 130GS,A00,182491,Lyon; Antony J.,20,0,20,0
1681919835820,LTEN 169,A00,182493,Cuong; Marisol,19,0,25,6
1681919836842,LTEN 178,A00,182501,Staff,14,0,15,1
1681919837871,LTEN 181,A00,182515,Staff,22,0,25,3
1681919838894,LTEN 185GS,A00,197655,Forbes; Camille,20,0,20,0
1681919839917,LTSP 100B,A00,202208,Bessett; Ryan Matthew,24,0,25,1
1681919840939,LTWL 100,A00,182516,Myerston Santana; Jacobo,21,0,30,9
1681919841968,LTWR 100GS,A00,182518,Forbes; Camille,20,0,20,0
1681919843015,LTWR 102,A00,182522,Staff,15,0,15,0
1681919843015,LTWR 102,B00,182525,Staff,14,0,15,1
1681919844042,LTWR 115,A00,182526,Staff,11,0,15,4
1681919845069,MAE 8,A01,182528,Pham; Hieu Tan,67,0,70,3
1681919846092,MAE 11,A00,182529,Bahadori; Mohammad Yousef,94,0,100,6
1681919847115,MAE 20,A00,182530,Evdokimenko; Ekaterina,68,0,70,2
1681919848144,MAE 30A,A00,182532,Staff,44,0,45,1
1681919849167,MAE 101A,A00,182533,Bahadori; Mohammad Yousef,95,0,100,5
1681919850189,MAE 101C,A00,182538,Staff,62,0,70,8
1681919851213,MAE 104,A00,182539,Staff,44,0,50,6
1681919852239,MAE 131A,A00,182540,Ghazinejad; Maziar,40,0,45,5
1681919853262,MAE 143A,A00,182548,Bewley; Thomas R,43,0,50,7
1681919854288,MAE 150,A00,182549,Staff,28,0,40,12
1681919855314,MAE 160,A00,182550,Evdokimenko; Ekaterina,42,0,60,18
1681919856372,MATH 3C,A01,182725,Staff,26,0,30,4
1681919857404,MATH 10A,A01,182729,Staff,25,0,30,5
1681919857404,MATH 10A,B01,182732,Staff,26,0,30,4
1681919858426,MATH 10B,A01,182737,Staff,21,0,30,9
1681919858426,MATH 10B,A02,182738,Staff,26,0,30,4
1681919858426,MATH 10B,B01,182744,Staff,27,0,30,3
1681919858426,MATH 10B,B02,182745,Staff,27,0,30,3
1681919859450,MATH 18,A01,182750,Anzaldo; Leesa B,28,0,30,2
1681919859450,MATH 18,A02,182751,Anzaldo; Leesa B,29,0,30,1
1681919859450,MATH 18,A03,182753,Anzaldo; Leesa B,28,0,30,2
1681919859450,MATH 18,A04,182757,Anzaldo; Leesa B,29,0,30,1
1681919859450,MATH 18,B01,182761,Anzaldo; Leesa B,27,0,30,3
1681919859450,MATH 18,B02,182764,Anzaldo; Leesa B,27,0,30,3
1681919859450,MATH 18,B03,182765,Anzaldo; Leesa B,30,0,30,0
1681919859450,MATH 18,B04,182766,Anzaldo; Leesa B,30,0,30,0
1681919860473,MATH 20A,A01,182771,Suk; Andrew Hoon,28,0,30,2
1681919861498,MATH 20B,A01,182775,Bach; Quang Tran,30,0,30,0
1681919861498,MATH 20B,A02,182777,Bach; Quang Tran,29,0,30,1
1681919861498,MATH 20B,B01,182780,Bach; Quang Tran,26,0,30,4
1681919861498,MATH 20B,B02,182782,Bach; Quang Tran,30,0,30,0
1681919862533,MATH 20C,A01,182787,Staff,25,0,30,5
1681919862533,MATH 20C,A02,182790,Staff,29,0,30,1
1681919862533,MATH 20C,B01,182792,Staff,25,0,30,5
1681919862533,MATH 20C,B02,182796,Staff,27,0,30,3
1681919863554,MATH 20D,A01,182799,Staff,28,0,30,2
1681919863554,MATH 20D,A02,182802,Staff,29,0,30,1
1681919863554,MATH 20D,A03,182803,Staff,30,0,30,0
1681919864575,MATH 20E,A01,182809,Verstraete; Jacques Allan,23,0,30,7
1681919864575,MATH 20E,A02,182811,Verstraete; Jacques Allan,28,0,30,2
1681919864575,MATH 20E,B01,182814,Verstraete; Jacques Allan,23,0,30,7
1681919864575,MATH 20E,B02,182815,Verstraete; Jacques Allan,30,0,30,0
1681919865598,MATH 103A,A01,182820,Staff,8,0,30,22
1681919865598,MATH 103A,A02,182821,Staff,27,0,30,3
1681919865598,MATH 103A,A03,182822,Staff,23,0,30,7
1681919865598,MATH 103A,B01,182825,Staff,23,0,30,7
1681919865598,MATH 103A,B02,182826,Staff,30,0,30,0
1681919865598,MATH 103A,B03,182830,Staff,30,0,30,0
1681919866625,MATH 109,A01,182836,Chow; Bennett,24,0,30,6
1681919866625,MATH 109,A02,182838,Chow; Bennett,29,0,30,1
1681919866625,MATH 109,A03,182894,Chow; Bennett,29,0,30,1
1681919866625,MATH 109,B01,182908,Chow; Bennett,27,0,30,3
1681919866625,MATH 109,B02,182909,Chow; Bennett,30,0,30,0
1681919866625,MATH 109,B03,182910,Chow; Bennett,27,0,30,3
1681919867648,MATH 142A,A01,182925,Staff,10,0,30,20
1681919867648,MATH 142A,A02,182935,Staff,24,0,30,6
1681919867648,MATH 142A,A03,182967,Staff,26,0,30,4
1681919867648,MATH 142A,B01,183125,Staff,22,0,30,8
1681919867648,MATH 142A,B02,183157,Staff,28,0,30,2
1681919867648,MATH 142A,B03,183158,Staff,29,0,30,1
1681919868671,MATH 183,A01,183160,Arias-Castro; Ery,23,0,30,7
1681919868671,MATH 183,A02,183161,Arias-Castro; Ery,29,0,30,1
1681919868671,MATH 183,B01,183163,Arias-Castro; Ery,28,0,30,2
1681919868671,MATH 183,B02,183164,Arias-Castro; Ery,28,0,30,2
1681919869697,MATH 193A,A01,183167,Staff,4,0,35,31
1681919869697,MATH 193A,A02,183168,Staff,28,0,35,7
1681919869697,MATH 193A,A03,183169,Staff,34,0,35,1
1681919869697,MATH 193A,A04,183170,Staff,28,0,35,7
1681919870720,MGT 4,A01,202395,Anderson; John Charles,75,0,80,5
1681919871746,MGT 5,A00,202396,Houskeeper; Robert,80,0,90,10
1681919872770,MGT 103,A00,202397,Eberhard; Craig A,53,0,90,37
1681919873805,MGT 131A,A00,202398,Houskeeper; Robert,85,0,90,5
1681919874829,MGT 135,A00,202399,Anderson; John Charles,81,0,90,9
1681919875855,MGT 162R,A00,202403,Gneezy; Uri,144,0,200,56
1681919876883,MGT 172,A00,202404,Hedges; Kathleen,48,0,90,42
1681919877906,MGT 181,A00,202405,Dunn; Louis Jean,83,0,90,7
1681919878932,MMW 14,A01,183200,Staff,12,0,28,16
1681919878932,MMW 14,A02,183201,Staff,26,0,28,2
1681919878932,MMW 14,A03,183202,Staff,24,0,28,4
1681919878932,MMW 14,A04,183203,Staff,25,0,28,3
1681919878932,MMW 14,A05,183204,Staff,26,0,28,2
1681919878932,MMW 14,A06,183205,Staff,27,0,28,1
1681919878932,MMW 14,B01,183207,Staff,26,0,28,2
1681919878932,MMW 14,B02,183208,Staff,28,0,28,0
1681919878932,MMW 14,B03,183209,Staff,28,0,28,0
1681919878932,MMW 14,B04,183210,Staff,28,0,28,0
1681919878932,MMW 14,B05,183211,Staff,28,0,28,0
1681919878932,MMW 14,B06,183212,Staff,27,0,28,1
1681919879960,MMW 14GS,A00,183213,Zhiri; Oumelbanine,28,0,28,0
1681919880994,MMW 15GS,B00,183215,Rahimi; Babak,28,0,28,0
1681919882021,MMW 121,A01,183217,Patterson; Patrick H.,14,0,28,14
1681919882021,MMW 121,A02,183218,Patterson; Patrick H.,25,0,28,3
1681919883056,MUS 1A,A01,182554,Staff,7,0,35,28
1681919884079,MUS 5,A01,182558,Staff,19,0,35,16
1681919885114,MUS 6,A01,182562,Staff,22,0,35,13
1681919886142,MUS 8GS,A00,182563,Borgo; David Garcia,25,0,25,0
1681919887165,MUS 13,A01,182567,Staff,24,0,25,1
1681919888191,MUS 15,A01,182570,Staff,32,0,35,3
1681919888191,MUS 15,B01,182575,Staff,9,0,35,26
1681919889216,MUS 80,A00,182578,Staff,23,0,25,2
1681919889216,MUS 80,B00,182581,Staff,20,0,25,5
1681919890240,MUS 113,A00,182582,Staff,25,0,25,0
1681919891275,MUS 114,A00,182583,Staff,4,0,25,21
1681919892302,MUS 150GS,A01,182588,Borgo; David Garcia,25,0,25,0
1681919893327,PHIL 1,A00,182590,Staff,35,0,40,5
1681919894353,PHIL 10,A01,182596,Grush; Rick Scott,31,0,35,4
1681919894353,PHIL 10,A02,182597,Grush; Rick Scott,34,0,35,1
1681919895384,PHIL 15,A01,182601,Staff,31,0,35,4
1681919895384,PHIL 15,A02,182602,Staff,33,0,35,2
1681919896410,PHIL 27,A01,182604,Staff,30,0,35,5
1681919896410,PHIL 27,A02,182607,Staff,35,0,35,0
1681919897437,PHIL 32,A01,182609,Staff,35,0,35,0
1681919897437,PHIL 32,A02,182612,Staff,35,0,35,0
1681919898460,PHIL 130,A00,182614,Staff,62,0,70,8
1681919899485,PHIL 136,A00,182616,Cohen; Jonathan David,66,0,70,4
1681919900509,PHIL 155,A00,182617,Vargas; Manuel Rogelio,59,0,70,11
1681919901532,PHIL 163,A01,182620,Staff,15,0,20,5
1681919901532,PHIL 163,A02,182624,Staff,10,0,20,10
1681919902630,PHIL 164,A00,182627,Staff,30,0,40,10
1681919903652,PHIL 173,A00,182628,Staff,36,0,40,4
1681919904674,PHYS 1A,A00,183221,Staff,54,0,60,6
1681919905699,PHYS 1AL,001,183222,Staff,25,0,30,5
1681919905699,PHYS 1AL,002,183223,Staff,28,0,30,2
1681919906723,PHYS 1B,A00,183231,Staff,43,0,60,17
1681919907745,PHYS 1BL,001,183232,Staff,20,0,30,10
1681919907745,PHYS 1BL,002,183233,Staff,27,0,30,3
1681919908770,PHYS 1C,A00,183240,Staff,29,0,60,31
1681919909801,PHYS 1CL,001,183241,Staff,12,0,30,18
1681919909801,PHYS 1CL,002,183242,Staff,22,0,30,8
1681919910824,PHYS 2AR,A01,183250,Staff,44,0,50,6
1681919911849,PHYS 2B,A01,183252,Staff,104,0,115,11
1681919912875,PHYS 2BL,A01,183254,Staff,21,0,24,3
1681919912875,PHYS 2BL,A02,183255,Staff,22,0,24,2
1681919913899,PHYS 2C,A01,183522,Staff,103,0,115,12
1681919914925,PHYS 4A,A01,183524,Staff,49,0,50,1
1681919915948,POLI 5,A00,183525,Staff,44,0,50,6
1681919916973,POLI 12,A00,183540,Staff,46,0,50,4
1681919917998,POLI 13R,A00,183541,Forman; Fonna,42,0,50,8
1681919919024,POLI 30,A00,183542,Mignozzetti; Umberto,47,0,50,3
1681919920056,POLI 100A,A00,183543,Staff,45,0,50,5
1681919921094,POLI 100E,A00,223598,Staff,32,0,35,3
1681919922121,POLI 103A,A00,183564,Kousser; Thad,37,0,50,13
1681919923152,POLI 104B,A00,201329,Staff,28,0,35,7
1681919924175,POLI 113BR,A00,183576,Hoston; Germaine,26,0,50,24
1681919925200,POLI 114BR,A00,183588,Staff,27,0,30,3
1681919926231,POLI 117R,A00,183595,Forman; Fonna,7,0,20,13
1681919927256,POLI 120H,A00,183596,Fisk; David Lee,13,0,20,7
1681919928285,POLI 130AA,A00,183597,Staff,14,0,20,6
1681919929309,POLI 134AA,A00,183598,Staff,19,0,20,1
1681919930337,POLI 135,A00,183599,Fisk; David Lee,20,0,25,5
1681919931368,POLI 142P,A00,183623,Staff,37,0,40,3
1681919932391,POLI 144D,A00,183624,Staff,22,0,25,3
1681919933413,POLI 151,A00,183625,Staff,15,0,20,5
1681919934439,POLI 162,A00,183626,Mignozzetti; Umberto,18,0,20,2
1681919935462,PSYC 1,A00,253748,Staff,86,0,90,4
1681919936488,PSYC 2,A00,183627,Moranton; Nirelia Melbina-,25,0,35,10
1681919937511,PSYC 3,A00,183628,Staff,43,0,45,2
1681919939562,PSYC 60,A01,183631,Lowe; Angela Beth,35,0,40,5
1681919940600,PSYC 70,A01,253757,Staff,37,0,45,8
1681919941663,PSYC 101,A00,183632,Heyman; Gail D.,48,0,60,12
1681919942685,PSYC 105,A00,183848,Lowe; Angela Beth,48,0,60,12
1681919943716,PSYC 106,A00,183849,Dobkins; Karen R.,44,0,60,16
1681919944738,PSYC 108,A00,253750,Staff,24,0,60,36
1681919945763,PSYC 114,A01,184275,Winkielman; Piotr,0,7,30,30
1681919946786,PSYC 122,A00,183856,Moranton; Nirelia Melbina-,0,11,30,30
1681919947810,PSYC 124,A00,183865,Chapman; Eddie Nathaniel,51,0,80,29
1681919948833,PSYC 137,A00,183880,Staff,19,0,25,6
1681919950883,PSYC 154,A00,183910,Lacefield; Katharine I,0,8,90,90
1681919952930,PSYC 162,A00,183946,Wixted; John T,60,0,90,30
1681919953953,PSYC 172,A00,183947,Gorman; Michael R.,12,0,30,18
1681919954975,PSYC 178,A00,183963,Glaser; Dale,19,0,40,21
1681919956000,PSYC 181GS,A00,183964,Anagnostaras; Stephan,10,0,10,0
1681919957025,PSYC 186GS,A01,257660,Staff,10,0,10,0
1681919958051,PSYC 193,B00,253749,Staff,23,0,25,2
1681919960099,PSYC 193L,A01,184122,Staff,33,0,35,2
1681919960099,PSYC 193L,C01,184167,Winkielman; Piotr,15,0,30,15
1681919961122,RELI 188GS,A00,182629,Rahimi; Babak,20,0,20,0
1681919962145,SE 101A,A00,182646,Staff,26,0,30,4
1681919963193,SE 101C,A00,182650,Staff,17,0,20,3
1681919964216,SE 110A,A00,182651,Staff,28,0,28,0
1681919965238,SE 130A,A00,182652,Staff,39,0,40,1
1681919966273,SIO 46GS,A00,182636,Cook; Geoffrey W,27,0,28,1
1681919967296,SIO 109R,A00,194459,Staff,5,0,20,15
1681919968321,SIO 121GS,A00,182639,Cook; Geoffrey W,27,0,28,1
1681919969348,SIO 132,A01,182642,Staff,32,0,40,8
1681919970374,SIO 139,A00,182644,Kacev; David,36,0,40,4
1681919971396,SOCI 2,A01,258404,Staff,34,0,36,2
1681919971396,SOCI 2,A02,258405,Staff,35,0,36,1
1681919972425,SOCI 60,A01,258408,Staff,29,0,30,1
1681919972425,SOCI 60,A02,258413,Staff,30,0,30,0
1681919973448,SOCI 100,A01,258415,Staff,29,0,30,1
1681919973448,SOCI 100,A02,258416,Staff,28,0,30,2
1681919979610,SOCI 127,A00,258421,Staff,21,0,30,9
1681919980634,SOCI 132,A00,258422,Staff,45,0,50,5
1681919981656,SOCI 133,A00,258423,Staff,26,0,30,4
1681919982725,SOCI 138GS,A00,258424,Staff,15,0,15,0
1681919983750,SOCI 145,A00,258425,Staff,25,0,30,5
1681919984774,SOCI 148,A00,258426,Staff,26,0,30,4
1681919985799,SOCI 153,A00,199217,Staff,29,0,30,1
1681919986824,SOCI 160,A00,258427,Staff,28,0,30,2
1681919987847,SOCI 160E,A00,258435,Staff,56,0,60,4
1681919988873,SOCI 189GS,A00,258436,Staff,15,0,15,0
1681919989895,SOCI 190GS,A00,258437,Staff,15,0,15,0
1681919990921,SYN 2,001,182658,Staff,8,0,16,8
1681919990921,SYN 2,002,201439,Staff,14,0,16,2
1681919990921,SYN 2,003,201443,Staff,16,0,16,0
1681919991946,SYN 100,A01,182657,Staff,16,0,20,4
1681919992972,TDAC 1,A00,184381,Salovey; Todd,16,0,20,4
1681919992972,TDAC 1,B00,184385,Harting; Carla Kelso,19,0,20,1
1681919992972,TDAC 1,C00,184394,Staff,19,0,20,1
1681919993994,TDAC 101,A00,184483,Harting; Carla Kelso,19,0,20,1
1681919995019,TDDE 111,A00,184496,Staff,14,0,15,1
1681919996043,TDDE 131,A00,184504,Staff,20,0,20,0
1681919996043,TDDE 131,B00,184505,Staff,17,0,18,1
1681919996043,TDDE 131,C00,184534,Staff,49,0,50,1
1681919996043,TDDE 131,D00,184564,Staff,15,0,15,0
1681919996043,TDDE 131,E00,204725,Staff,19,0,20,1
1681919997065,TDGE 1,A01,184414,Salovey; Todd,36,0,50,14
1681919998097,TDGE 5,A01,184419,Staff,23,0,24,1
1681919999124,TDGE 10,A00,184428,Fulton; Julia,29,0,50,21
1681920000155,TDGE 124,A00,184565,Fulton; Julia,7,0,50,43
1681920001178,TDGE 125,B00,184567,Meyer; Ursula,9,0,25,16
1681920002201,TDHT 101,A00,184568,Staff,21,0,25,4
1681920002201,TDHT 101,B00,184569,Staff,20,0,20,0
1681920003231,TDHT 114,A00,184570,Staff,49,0,50,1
1681920004259,TDMV 1,A00,184437,Arcidiacono; Kristin,22,0,30,8
1681920004259,TDMV 1,B00,184448,Caligagan; Maria T.,23,0,30,7
1681920005293,TDMV 2,A00,184449,Weinberg; Sadie,27,0,30,3
1681920005293,TDMV 2,B00,184453,Arcidiacono; Kristin,29,0,30,1
1681920006393,TDMV 110,A00,184571,Weinberg; Sadie,30,0,30,0
1681920007416,TDMV 142,A00,184572,Caligagan; Tony,27,0,30,3
1681920007416,TDMV 142,B00,184573,Caligagan; Maria T.,26,0,30,4
1681920008438,TDTR 20,A00,184482,Jun; Grace Shin Hae,25,0,25,0
1681920009464,USP 2,A01,184290,Hinds; Juli Beth,24,0,25,1
1681920010490,USP 3,A01,184295,Staff,20,0,25,5
1681920011522,USP 4,A00,184304,McTague; Sarah,15,0,25,10
1681920012548,USP 100,A00,184315,Staff,17,0,25,8
1681920013572,USP 105,A00,184326,Staff,21,0,25,4
1681920014606,USP 151,A00,184327,Staff,20,0,25,5
1681920015629,USP 170,A00,184380,Hinds; Juli Beth,14,0,25,11
1681920016655,VIS 21B,A01,182660,Staff,28,0,31,3
1681920016655,VIS 21B,A02,182662,Staff,30,0,31,1
1681920017684,VIS 103D,A00,182663,Staff,74,0,75,1
1681920018715,VIS 105D,A00,182667,Li; Huai,15,0,22,7
1681920019743,VIS 122GS,A00,182668,Herbst; Matthew,20,0,20,0
1681920020771,VIS 128C,A00,182673,Staff,69,0,75,6
1681920021797,VIS 130,A00,182675,Staff,20,0,22,2
1681920022821,VIS 160A,A00,182678,Stalbaum; Brett,4,0,10,6
1681920024869,WCWP 10B,A00,201679,Staff,15,0,15,0
1681920024869,WCWP 10B,B00,201695,Staff,15,0,15,0
1681920025894,WCWP 100,A00,201716,Staff,14,0,15,1
1681920025894,WCWP 100,B00,201717,Staff,10,0,15,5
1681920027957,ANSC 105GS,A00,258289,Staff,0,0,0,0
1681920028986,ANSC 125GS,A00,258295,Staff,0,0,0,0
1681920030021,ANSC 150,A00,258267,Staff,30,0,40,10
1681920031043,ANSC 190GS,A00,258280,Staff,0,0,0,0
1681920032082,ANTH 1,A00,258264,Staff,38,0,40,2
1681920033109,ANTH 2,A01,258259,Staff,72,0,76,4
1681920034133,ANTH 23,A01,258228,Staff,36,0,40,4
1681920035155,ANTH 101,A01,258236,Staff,38,0,40,2
1681920036178,ANTH 102,A00,258272,Staff,59,0,60,1
1681920037209,ANTH 105,A00,258244,Staff,31,0,35,4
1681920038236,BENG 130,A00,253975,Staff,38,0,40,2
1681920039269,BIBC 102,A01,191866,Flagg; Matthew Paul,19,0,32,13
1681920039269,BIBC 102,A02,191867,Flagg; Matthew Paul,22,0,32,10
1681920039269,BIBC 102,A03,191868,Flagg; Matthew Paul,29,0,32,3
1681920039269,BIBC 102,A04,191936,Flagg; Matthew Paul,26,0,32,6
1681920039269,BIBC 102,A05,191937,Flagg; Matthew Paul,6,0,32,26
1681920040300,BICD 100,A01,191939,Cooper; Andrew Michael,28,0,32,4
1681920040300,BICD 100,A02,191940,Cooper; Andrew Michael,32,0,32,0
1681920040300,BICD 100,A03,191941,Cooper; Andrew Michael,32,0,32,0
1681920040300,BICD 100,A04,191942,Cooper; Andrew Michael,32,0,32,0
1681920040300,BICD 100,A05,191943,Cooper; Andrew Michael,32,0,32,0
1681920041322,BIEB 126,A01,191945,Cleland; Elsa Eleanor,0,0,32,32
1681920041322,BIEB 126,A02,191946,Cleland; Elsa Eleanor,27,0,32,5
1681920041322,BIEB 126,A03,191947,Cleland; Elsa Eleanor,29,0,32,3
1681920041322,BIEB 126,A04,191948,Cleland; Elsa Eleanor,23,0,32,9
1681920041322,BIEB 126,A05,191996,Cleland; Elsa Eleanor,28,0,32,4
1681920042345,BIEB 136GS,A00,191997,Shurin; Jonathan & Holway; David A.,0,0,0,3
1681920043370,BIEB 137GS,A01,191999,Shurin; Jonathan & Holway; David A.,0,0,0,2
1681920044394,BILD 1,A01,205385,Staff,31,0,32,1
1681920044394,BILD 1,A02,205386,Staff,30,0,32,2
1681920044394,BILD 1,A03,205387,Staff,32,0,32,0
1681920044394,BILD 1,A04,205388,Staff,27,0,32,5
1681920045425,BILD 2,A01,191774,Staff,28,0,32,4
1681920045425,BILD 2,A02,191775,Staff,30,0,32,2
1681920045425,BILD 2,A03,191777,Staff,30,0,32,2
1681920045425,BILD 2,A04,191856,Staff,31,0,32,1
1681920045425,BILD 2,A05,191857,Staff,32,0,32,0
1681920045425,BILD 2,A06,191858,Staff,32,0,32,0
1681920045425,BILD 2,A07,191859,Staff,31,0,32,1
1681920046454,BILD 3,A01,205391,Staff,29,0,32,3
1681920046454,BILD 3,A02,205393,Staff,32,0,32,0
1681920046454,BILD 3,A03,205394,Staff,28,0,32,4
1681920046454,BILD 3,A04,205395,Staff,32,0,32,0
1681920047480,BILD 20,A01,191861,Staff,32,0,32,0
1681920047480,BILD 20,A02,191862,Staff,32,0,32,0
1681920048503,BILD 30,A01,191864,Staff,31,0,32,1
1681920049536,BIMM 100,A01,192019,Staff,0,0,32,32
1681920049536,BIMM 100,A02,192020,Staff,22,0,32,10
1681920049536,BIMM 100,A03,192035,Staff,21,0,32,11
1681920050561,BIMM 110,A01,192037,Tat; John,0,0,32,32
1681920050561,BIMM 110,A02,192038,Tat; John,9,0,32,23
1681920051584,BIMM 120,A01,192040,Pickett; Brooke Elizabeth,1,0,32,31
1681920051584,BIMM 120,A02,192041,Pickett; Brooke Elizabeth,16,0,32,16
1681920051584,BIMM 120,A03,192042,Pickett; Brooke Elizabeth,15,0,32,17
1681920052611,BIPN 100,A01,192044,Armour; Jon Christopher,26,0,32,6
1681920052611,BIPN 100,A02,192059,Armour; Jon Christopher,30,0,32,2
1681920052611,BIPN 100,A03,192064,Armour; Jon Christopher,31,0,32,1
1681920052611,BIPN 100,A04,192073,Armour; Jon Christopher,28,0,32,4
1681920053633,BIPN 148,A01,205411,Leutgeb; Jill K.,16,0,32,16
1681920053633,BIPN 148,A02,205412,Leutgeb; Jill K.,31,0,32,1
1681920053633,BIPN 148,A03,205413,Leutgeb; Jill K.,30,0,32,2
1681920053633,BIPN 148,A04,205414,Leutgeb; Jill K.,30,0,32,2
1681920054656,BIPN 160,A01,192115,Marino; Marc J,17,0,32,15
1681920054656,BIPN 160,A02,192148,Marino; Marc J,27,0,32,5
1681920054656,BIPN 160,A03,192158,Marino; Marc J,31,0,32,1
1681920054656,BIPN 160,A04,192190,Marino; Marc J,32,0,32,0
1681920054656,BIPN 160,A05,192287,Marino; Marc J,32,0,32,0
1681920054656,BIPN 160,A06,192288,Marino; Marc J,32,0,32,0
1681920055682,BIPN 194,A00,206038,Staff,28,0,32,4
1681920056711,BISP 194,A00,192289,Leutgeb; Stefan,13,0,32,19
1681920056711,BISP 194,B00,245332,Nieh; James Charles,26,0,32,6
1681920057744,CAT 124,A01,202247,Staff,15,0,15,0
1681920058767,CAT 125,A00,202248,Staff,19,0,20,1
1681920058767,CAT 125,B00,202253,Staff,20,0,20,0
1681920058767,CAT 125,C00,202257,Staff,18,0,20,2
1681920059796,CAT 125GS,A01,202273,Bronstein; Phoebe Malan,20,0,20,0
1681920060819,CAT 125R,A00,202284,Staff,17,0,20,3
1681920060819,CAT 125R,C00,202286,Staff,10,0,20,10
1681920060819,CAT 125R,D00,202291,Staff,18,0,20,2
1681920060819,CAT 125R,E00,202295,Staff,13,0,20,7
1681920060819,CAT 125R,F00,202302,Staff,11,0,20,9
1681920061846,CENG 100,A00,204724,Opatkiewicz; Justin Paul,25,0,25,0
1681920062874,CGS 2A,A01,180420,Staff,31,0,36,5
1681920063897,CGS 101,A00,180421,Staff,16,0,20,4
1681920064920,CGS 112,A00,180422,Staff,9,0,16,7
1681920065949,CGS 113,A00,180423,Staff,18,0,20,2
1681920066975,CGS 137,A00,180424,Staff,12,0,12,0
1681920067998,CGS 147,A00,180425,Staff,10,0,10,0
1681920069025,CHEM 6A,A01,179556,Staff,97,0,100,3
1681920069025,CHEM 6A,A02,179558,Staff,0,0,0,0
1681920070051,CHEM 6B,A01,179560,Staff,100,0,100,0
1681920071075,CHEM 6C,A01,179565,Jazzar; Rodolphe,95,0,100,5
1681920072103,CHEM 7L,A01,179586,Schurmeier; Kimberly,11,0,24,13
1681920072103,CHEM 7L,A02,179587,Schurmeier; Kimberly,23,0,24,1
1681920072103,CHEM 7L,A03,179590,Schurmeier; Kimberly,22,0,24,2
1681920072103,CHEM 7L,A04,179591,Schurmeier; Kimberly,22,0,24,2
1681920072103,CHEM 7L,B01,179598,Schurmeier; Kimberly,17,0,24,7
1681920072103,CHEM 7L,B02,179599,Schurmeier; Kimberly,24,0,24,0
1681920072103,CHEM 7L,B03,179606,Schurmeier; Kimberly,23,0,24,1
1681920072103,CHEM 7L,B04,179607,Schurmeier; Kimberly,23,0,24,1
1681920073129,CHEM 11,A01,179609,Stallings; Dontarie M,88,0,100,12
1681920074170,CHEM 40A,A01,179621,Staff,41,0,50,9
1681920074170,CHEM 40A,A02,179622,Staff,47,0,50,3
1681920075197,CHEM 40B,A01,179630,Weizman; Haim,48,0,50,2
1681920075197,CHEM 40B,A02,179631,Weizman; Haim,45,0,50,5
1681920076221,CHEM 41A,A01,179660,Klosterman; Jeremy K,93,0,100,7
1681920077248,CHEM 43A,A01,179683,Klosterman; Jeremy K,0,0,24,24
1681920077248,CHEM 43A,A02,179688,Klosterman; Jeremy K,11,0,24,13
1681920077248,CHEM 43A,A03,179689,Klosterman; Jeremy K,19,0,24,5
1681920077248,CHEM 43A,A04,179691,Klosterman; Jeremy K,18,0,24,6
1681920078273,CHEM 114A,A01,179693,Stallings; Dontarie M,73,0,100,27
1681920079299,CHEM 143B,A01,179698,Weizman; Haim,17,0,24,7
1681920079299,CHEM 143B,A02,179700,Weizman; Haim,24,0,24,0
1681920080325,CHIN 169A,A00,179701,Wang; Xiao,20,0,20,0
1681920081348,COGS 2,A01,179750,Boyle; Mary E. T.,17,0,30,13
1681920082371,COGS 9,A01,179759,Jones; Cameron Robert,42,0,50,8
1681920083397,COGS 14A,A01,179854,Staff,17,0,50,33
1681920084426,COGS 14B,A01,179856,Staff,53,0,60,7
1681920085449,COGS 17,A01,179874,Staff,71,0,75,4
1681920086474,COGS 18,A01,179884,Staff,63,0,80,17
1681920087505,COGS 100,A01,179886,Staff,38,0,60,22
1681920088529,COGS 101B,A01,179892,Staff,1,0,30,29
1681920089552,COGS 101C,A01,179894,Staff,28,0,30,2
1681920090582,COGS 107A,A01,179896,Boyle; Mary E. T.,31,0,40,9
1681920091604,COGS 108,A01,179898,Simpkins; Charles Alexander,0,23,60,60
1681920092629,COGS 109,A01,179900,Staff,34,0,40,6
1681920093651,COGS 118A,A01,179946,Staff,8,0,40,32
1681920094683,COGS 153,A00,179978,Staff,0,2,30,30
1681920095709,COGS 156,A01,179981,Staff,25,0,30,5
1681920097758,COGS 172,A01,179987,Staff,13,0,30,17
1681920099803,COGS 186,A01,179991,Staff,12,0,30,18
1681920100827,COMM 10,A01,180001,Staff,14,0,25,11
1681920100827,COMM 10,A02,180004,Staff,20,0,25,5
1681920101854,COMM 100A,A01,180016,Staff,17,0,25,8
1681920101854,COMM 100A,A02,180020,Staff,24,0,25,1
1681920102879,COMM 101T,A00,180029,Halm; Gavin Patrick,23,0,35,12
1681920103905,COMM 106V,A00,180043,Staff,34,0,35,1
1681920104928,COMM 109P,A00,180044,Staff,31,0,35,4
1681920105953,COMM 113T,A00,180045,Havis; Allan,37,0,45,8
1681920106977,COMM 132,A00,180046,McKenna; Denise,23,0,30,7
1681920108010,COMM 143,A00,180047,Staff,19,0,30,11
1681920109036,COMM 190,A00,180048,Conner; Thomas Hartnell,20,0,23,3
1681920110133,CSE 8A,A50,180053,Cao; Yingjun,25,0,50,25
1681920110133,CSE 8A,B50,180180,Staff,50,0,50,0
1681920111167,CSE 11,A01,180190,Cao; Yingjun,27,0,50,23
1681920112191,CSE 20,A01,180192,Briones; Jor-el Thomas Caparas,23,0,30,7
1681920113214,CSE 21,A01,194538,Briones; Jor-el Thomas Caparas,50,0,60,10
1681920114237,CSE 30,A01,180324,Eldon; John,76,0,100,24
1681920115262,CSE 101,A01,201353,Staff,0,23,40,40
1681920116298,CSE 134B,A01,180326,Powell; Thomas Allan,74,0,100,26
1681920117321,CSE 140,A01,180328,Staff,42,0,75,33
1681920118344,CSE 140L,A01,180344,Eldon; John,65,0,100,35
1681920119381,CSE 150A,A01,180411,Staff,0,11,50,50
1681920120405,CSE 151A,A01,180414,Staff,0,8,50,50
1681920121427,CSE 175,A01,222521,Kumar; Rakesh,50,0,50,0
1681920122465,CSE 190,A00,201419,Staff,45,0,49,4
1681920123489,CSS 1,A01,194536,Staff,37,0,50,13
1681920124513,DSC 30,A01,202385,Staff,48,0,50,2
1681920125538,DSC 40A,A01,202387,Albuyeh; Rod,50,0,50,0
1681920126564,DSC 190,A01,202389,Silberman; Jack,21,0,21,0
1681920127587,DSGN 100,A01,179993,Staff,16,0,30,14
1681920128609,ECE 65,A50,180708,Staff,10,0,20,10
1681920128609,ECE 65,A51,180739,Staff,19,0,20,1
1681920129635,ECON 1,A01,180427,Famulari; Melissa,67,0,70,3
1681920130661,ECON 2,A01,180450,Levkoff; Steven B.,64,0,70,6
1681920131685,ECON 4,A01,203351,Anderson; John Charles,7,0,10,3
1681920132710,ECON 100A,A01,180472,Famulari; Melissa,64,0,70,6
1681920133738,ECON 120A,A01,180549,Staff,63,0,70,7
1681920134761,ECON 120B,A01,180655,Ma; Xinwei,43,0,70,27
1681920135787,ECON 129,A00,203333,Eckert; Fabian Paul,13,0,35,22
1681920136814,ECON 131,A00,180656,Staff,7,0,35,28
1681920137843,ECON 172B,A01,180672,Levkoff; Steven B.,31,0,35,4
1681920138869,ECON 178,A01,203342,Zhu; Ying,9,0,35,26
1681920139892,EDS 108GS,A00,202383,Wishard Guerra; Alison G.,20,0,20,0
1681920140914,EDS 111GS,A00,202347,Wishard Guerra; Alison G.,20,0,20,0
1681920141944,EDS 112,A01,202323,Staff,56,0,60,4
1681920142972,EDS 113,A00,202340,Staff,33,0,35,2
1681920143999,EDS 118,A00,201231,Staff,20,0,30,10
1681920145027,EDS 119,A00,204994,Staff,8,0,10,2
1681920146058,EDS 124BR,A00,202324,Eguchi; Emi,4,0,25,21
1681920147082,EDS 126,A01,203208,Jones; Makeba,26,0,30,4
1681920148108,EDS 135,A01,202333,Staff,18,0,20,2
1681920149138,EDS 180,A00,202311,Staff,47,0,50,3
1681920150167,ERC 190GS,A01,253747,Staff,28,0,28,0
1681920151192,ETHN 104,A00,180742,Staff,23,0,35,12
1681920152221,ETHN 118,A00,180745,Staff,27,0,35,8
1681920153250,ETHN 127,A00,180747,Staff,12,0,16,4
1681920154282,ETHN 137,A00,180880,Staff,11,0,12,1
1681920155305,ETHN 147,A00,180890,Staff,8,0,10,2
1681920156337,ETHN 154,A00,180891,Staff,7,0,8,1
1681920157367,ETHN 168,A00,180892,Staff,9,0,10,1
1681920158393,GLBH 20,A00,201051,Hannah; Seth Donal,0,2,0,1
1681920159416,GLBH 111,A01,209338,Burgos; Jose L.,0,0,0,0
1681920160442,GLBH 150,A00,258300,Staff,0,3,0,0
1681920161467,GLBH 181,A00,201207,Staff,15,0,40,25
1681920162490,HIEU 109,A00,180898,Staff,20,0,20,0
1681920163512,HIEU 111,A00,180899,Staff,0,0,20,20
1681920164540,HIEU 124,A00,180900,Staff,17,0,20,3
1681920165563,HILA 122,A00,180901,Staff,18,0,20,2
1681920166599,HILA 132,A00,180902,Vitz; Matthew,2,0,20,18
1681920167625,HILD 10,A01,180896,Staff,15,0,20,5
1681920168648,HILD 30GS,A00,180897,Edington; Claire Ellen,0,0,0,0
1681920169671,HISC 105,A00,180903,Staff,20,0,20,0
1681920170693,HISC 117,A00,180904,Staff,11,0,20,9
1681920171715,HIUS 108B,A00,181005,Staff,18,0,20,2
1681920172738,HIUS 113,A00,181093,Staff,3,0,20,17
1681920173761,HUM 3,A01,181190,Patterson; Patrick H.,39,0,50,11
1681920173761,HUM 3,B01,181195,Staff,46,0,50,4
1681920174783,HUM 3GS,A00,181196,Herbst; Matthew,0,0,0,0
1681920175809,HUM 4,A01,181227,West; Geoffrey Scott,33,0,50,17
1681920175809,HUM 4,B01,181282,Staff,42,0,50,8
1681920176835,HUM 4GS,A00,181377,Lyon; Antony J.,0,0,0,0
1681920177857,HUM 5,A01,181536,Zavodny; Tatiana Sophia,28,0,50,22
1681920177857,HUM 5,B01,181908,Staff,36,0,50,14
1681920178880,INTL 190,A00,181909,Segui; Alan S,0,0,0,7
1681920178880,INTL 190,B00,181961,Segui; Alan S,0,0,0,7
1681920179904,JAPN 20AR,A01,182113,Ross; Kayoko F,15,0,20,5
1681920180935,LATI 50,A01,202391,Martin-Cabrera; Luis,18,0,30,12
1681920180935,LATI 50,A02,202392,Martin-Cabrera; Luis,26,0,30,4
1681920181964,LATI 180,A00,202393,Kokinis; Troy Andreas,24,0,25,1
1681920182990,LIFR 1A,A00,182119,Staff,14,0,14,0
1681920184012,LIFR 1AX,A00,182324,Staff,14,0,14,0
1681920185038,LIFR 1B,A00,182259,Staff,14,0,14,0
1681920186061,LIFR 1BX,A00,182273,Staff,14,0,14,0
1681920187087,LIGN 8,A00,182330,Staff,135,0,150,15
1681920188118,LIGN 9GS,A00,182362,Staff,20,0,20,0
1681920189145,LIGN 119,A00,204992,Takahashi; Maho,12,0,15,3
1681920190168,LIGN 130,A01,182384,Staff,47,0,50,3
1681920191192,LIGN 149GS,A00,182390,Staff,20,0,20,0
1681920192215,LIGN 170,A00,182404,Staff,23,0,30,7
1681920193238,LISP 1D,A00,182281,Staff,7,0,14,7
1681920193238,LISP 1D,B00,182287,Staff,14,0,14,0
1681920193238,LISP 1D,C00,182295,Staff,11,0,14,3
1681920193238,LISP 1D,D00,182301,Staff,14,0,14,0
1681920194263,LISP 1DX,A00,182309,Staff,20,0,28,8
1681920194263,LISP 1DX,B00,182316,Staff,26,0,28,2
1681920195288,LTAF 120GS,A00,182412,Zhiri; Oumelbanine,20,0,20,0
1681920196313,LTCS 172GS,A00,182437,Bronstein; Phoebe Malan,20,0,20,0
1681920197336,LTEA 138,A00,182457,Staff,20,0,40,20
1681920198365,LTEN 114,A01,182490,Staff,23,0,25,2
1681920199387,LTEN 130GS,A00,182491,Lyon; Antony J.,20,0,20,0
1681920200417,LTEN 169,A00,182493,Cuong; Marisol,19,0,25,6
1681920201442,LTEN 178,A00,182501,Staff,14,0,15,1
1681920202474,LTEN 181,A00,182515,Staff,22,0,25,3
1681920203496,LTEN 185GS,A00,197655,Forbes; Camille,20,0,20,0
1681920204517,LTSP 100B,A00,202208,Bessett; Ryan Matthew,24,0,25,1
1681920205544,LTWL 100,A00,182516,Myerston Santana; Jacobo,21,0,30,9
1681920206574,LTWR 100GS,A00,182518,Forbes; Camille,20,0,20,0
1681920207601,LTWR 102,A00,182522,Staff,15,0,15,0
1681920207601,LTWR 102,B00,182525,Staff,14,0,15,1
1681920208625,LTWR 115,A00,182526,Staff,11,0,15,4
1681920209661,MAE 8,A01,182528,Pham; Hieu Tan,67,0,70,3
1681920210687,MAE 11,A00,182529,Bahadori; Mohammad Yousef,94,0,100,6
1681920211718,MAE 20,A00,182530,Evdokimenko; Ekaterina,68,0,70,2
1681920212741,MAE 30A,A00,182532,Staff,44,0,45,1
1681920213839,MAE 101A,A00,182533,Bahadori; Mohammad Yousef,95,0,100,5
1681920214864,MAE 101C,A00,182538,Staff,62,0,70,8
1681920215890,MAE 104,A00,182539,Staff,44,0,50,6
1681920216919,MAE 131A,A00,182540,Ghazinejad; Maziar,40,0,45,5
1681920217946,MAE 143A,A00,182548,Bewley; Thomas R,43,0,50,7
1681920218969,MAE 150,A00,182549,Staff,28,0,40,12
1681920219991,MAE 160,A00,182550,Evdokimenko; Ekaterina,42,0,60,18
1681920221013,MATH 3C,A01,182725,Staff,26,0,30,4
1681920222041,MATH 10A,A01,182729,Staff,25,0,30,5
1681920222041,MATH 10A,B01,182732,Staff,26,0,30,4
1681920223070,MATH 10B,A01,182737,Staff,21,0,30,9
1681920223070,MATH 10B,A02,182738,Staff,26,0,30,4
1681920223070,MATH 10B,B01,182744,Staff,27,0,30,3
1681920223070,MATH 10B,B02,182745,Staff,27,0,30,3
1681920224094,MATH 18,A01,182750,Anzaldo; Leesa B,28,0,30,2
1681920224094,MATH 18,A02,182751,Anzaldo; Leesa B,29,0,30,1
1681920224094,MATH 18,A03,182753,Anzaldo; Leesa B,27,0,30,3
1681920224094,MATH 18,A04,182757,Anzaldo; Leesa B,29,0,30,1
1681920224094,MATH 18,B01,182761,Anzaldo; Leesa B,27,0,30,3
1681920224094,MATH 18,B02,182764,Anzaldo; Leesa B,27,0,30,3
1681920224094,MATH 18,B03,182765,Anzaldo; Leesa B,29,0,30,1
1681920224094,MATH 18,B04,182766,Anzaldo; Leesa B,30,0,30,0
1681920225118,MATH 20A,A01,182771,Suk; Andrew Hoon,28,0,30,2
1681920226145,MATH 20B,A01,182775,Bach; Quang Tran,30,0,30,0
1681920226145,MATH 20B,A02,182777,Bach; Quang Tran,29,0,30,1
1681920226145,MATH 20B,B01,182780,Bach; Quang Tran,26,0,30,4
1681920226145,MATH 20B,B02,182782,Bach; Quang Tran,30,0,30,0
1681920227178,MATH 20C,A01,182787,Staff,25,0,30,5
1681920227178,MATH 20C,A02,182790,Staff,29,0,30,1
1681920227178,MATH 20C,B01,182792,Staff,25,0,30,5
1681920227178,MATH 20C,B02,182796,Staff,27,0,30,3
1681920228204,MATH 20D,A01,182799,Staff,28,0,30,2
1681920228204,MATH 20D,A02,182802,Staff,29,0,30,1
1681920228204,MATH 20D,A03,182803,Staff,30,0,30,0
1681920229245,MATH 20E,A01,182809,Verstraete; Jacques Allan,23,0,30,7
1681920229245,MATH 20E,A02,182811,Verstraete; Jacques Allan,28,0,30,2
1681920229245,MATH 20E,B01,182814,Verstraete; Jacques Allan,23,0,30,7
1681920229245,MATH 20E,B02,182815,Verstraete; Jacques Allan,30,0,30,0
1681920230269,MATH 103A,A01,182820,Staff,8,0,30,22
1681920230269,MATH 103A,A02,182821,Staff,27,0,30,3
1681920230269,MATH 103A,A03,182822,Staff,23,0,30,7
1681920230269,MATH 103A,B01,182825,Staff,23,0,30,7
1681920230269,MATH 103A,B02,182826,Staff,30,0,30,0
1681920230269,MATH 103A,B03,182830,Staff,30,0,30,0
1681920231293,MATH 109,A01,182836,Chow; Bennett,24,0,30,6
1681920231293,MATH 109,A02,182838,Chow; Bennett,29,0,30,1
1681920231293,MATH 109,A03,182894,Chow; Bennett,29,0,30,1
1681920231293,MATH 109,B01,182908,Chow; Bennett,27,0,30,3
1681920231293,MATH 109,B02,182909,Chow; Bennett,30,0,30,0
1681920231293,MATH 109,B03,182910,Chow; Bennett,27,0,30,3
1681920232321,MATH 142A,A01,182925,Staff,10,0,30,20
1681920232321,MATH 142A,A02,182935,Staff,24,0,30,6
1681920232321,MATH 142A,A03,182967,Staff,26,0,30,4
1681920232321,MATH 142A,B01,183125,Staff,22,0,30,8
1681920232321,MATH 142A,B02,183157,Staff,28,0,30,2
1681920232321,MATH 142A,B03,183158,Staff,29,0,30,1
1681920233350,MATH 183,A01,183160,Arias-Castro; Ery,23,0,30,7
1681920233350,MATH 183,A02,183161,Arias-Castro; Ery,29,0,30,1
1681920233350,MATH 183,B01,183163,Arias-Castro; Ery,28,0,30,2
1681920233350,MATH 183,B02,183164,Arias-Castro; Ery,28,0,30,2
1681920234377,MATH 193A,A01,183167,Staff,4,0,35,31
1681920234377,MATH 193A,A02,183168,Staff,28,0,35,7
1681920234377,MATH 193A,A03,183169,Staff,34,0,35,1
1681920234377,MATH 193A,A04,183170,Staff,28,0,35,7
1681920235400,MGT 4,A01,202395,Anderson; John Charles,75,0,80,5
1681920236427,MGT 5,A00,202396,Houskeeper; Robert,79,0,90,11
1681920237453,MGT 103,A00,202397,Eberhard; Craig A,52,0,90,38
1681920238478,MGT 131A,A00,202398,Houskeeper; Robert,85,0,90,5
1681920239502,MGT 135,A00,202399,Anderson; John Charles,81,0,90,9
1681920240527,MGT 162R,A00,202403,Gneezy; Uri,143,0,200,57
1681920241549,MGT 172,A00,202404,Hedges; Kathleen,48,0,90,42
1681920242573,MGT 181,A00,202405,Dunn; Louis Jean,83,0,90,7
1681920243596,MMW 14,A01,183200,Staff,11,0,28,17
1681920243596,MMW 14,A02,183201,Staff,26,0,28,2
1681920243596,MMW 14,A03,183202,Staff,24,0,28,4
1681920243596,MMW 14,A04,183203,Staff,25,0,28,3
1681920243596,MMW 14,A05,183204,Staff,26,0,28,2
1681920243596,MMW 14,A06,183205,Staff,27,0,28,1
1681920243596,MMW 14,B01,183207,Staff,26,0,28,2
1681920243596,MMW 14,B02,183208,Staff,28,0,28,0
1681920243596,MMW 14,B03,183209,Staff,28,0,28,0
1681920243596,MMW 14,B04,183210,Staff,28,0,28,0
1681920243596,MMW 14,B05,183211,Staff,28,0,28,0
1681920243596,MMW 14,B06,183212,Staff,27,0,28,1
1681920244622,MMW 14GS,A00,183213,Zhiri; Oumelbanine,28,0,28,0
1681920245644,MMW 15GS,B00,183215,Rahimi; Babak,28,0,28,0
1681920246669,MMW 121,A01,183217,Patterson; Patrick H.,14,0,28,14
1681920246669,MMW 121,A02,183218,Patterson; Patrick H.,25,0,28,3
1681920247693,MUS 1A,A01,182554,Staff,7,0,35,28
1681920248718,MUS 5,A01,182558,Staff,19,0,35,16
1681920249740,MUS 6,A01,182562,Staff,22,0,35,13
1681920250764,MUS 8GS,A00,182563,Borgo; David Garcia,25,0,25,0
1681920251786,MUS 13,A01,182567,Staff,24,0,25,1
1681920252809,MUS 15,A01,182570,Staff,32,0,35,3
1681920252809,MUS 15,B01,182575,Staff,9,0,35,26
1681920253835,MUS 80,A00,182578,Staff,23,0,25,2
1681920253835,MUS 80,B00,182581,Staff,20,0,25,5
1681920254858,MUS 113,A00,182582,Staff,25,0,25,0
1681920255881,MUS 114,A00,182583,Staff,4,0,25,21
1681920256906,MUS 150GS,A01,182588,Borgo; David Garcia,25,0,25,0
1681920257949,PHIL 1,A00,182590,Staff,35,0,40,5
1681920258977,PHIL 10,A01,182596,Grush; Rick Scott,31,0,35,4
1681920258977,PHIL 10,A02,182597,Grush; Rick Scott,34,0,35,1
1681920260002,PHIL 15,A01,182601,Staff,31,0,35,4
1681920260002,PHIL 15,A02,182602,Staff,33,0,35,2
1681920261026,PHIL 27,A01,182604,Staff,30,0,35,5
1681920261026,PHIL 27,A02,182607,Staff,35,0,35,0
1681920262048,PHIL 32,A01,182609,Staff,35,0,35,0
1681920262048,PHIL 32,A02,182612,Staff,35,0,35,0
1681920263073,PHIL 130,A00,182614,Staff,62,0,70,8
1681920264097,PHIL 136,A00,182616,Cohen; Jonathan David,66,0,70,4
1681920265123,PHIL 155,A00,182617,Vargas; Manuel Rogelio,59,0,70,11
1681920266146,PHIL 163,A01,182620,Staff,15,0,20,5
1681920266146,PHIL 163,A02,182624,Staff,10,0,20,10
1681920267169,PHIL 164,A00,182627,Staff,30,0,40,10
1681920268196,PHIL 173,A00,182628,Staff,36,0,40,4
1681920269222,PHYS 1A,A00,183221,Staff,54,0,60,6
1681920270263,PHYS 1AL,001,183222,Staff,25,0,30,5
1681920270263,PHYS 1AL,002,183223,Staff,28,0,30,2
1681920271286,PHYS 1B,A00,183231,Staff,43,0,60,17
1681920272314,PHYS 1BL,001,183232,Staff,20,0,30,10
1681920272314,PHYS 1BL,002,183233,Staff,27,0,30,3
1681920273340,PHYS 1C,A00,183240,Staff,28,0,60,32
1681920274362,PHYS 1CL,001,183241,Staff,11,0,30,19
1681920274362,PHYS 1CL,002,183242,Staff,22,0,30,8
1681920275395,PHYS 2AR,A01,183250,Staff,43,0,50,7
1681920276432,PHYS 2B,A01,183252,Staff,104,0,115,11
1681920277456,PHYS 2BL,A01,183254,Staff,21,0,24,3
1681920277456,PHYS 2BL,A02,183255,Staff,22,0,24,2
1681920278480,PHYS 2C,A01,183522,Staff,103,0,115,12
1681920279506,PHYS 4A,A01,183524,Staff,49,0,50,1
1681920280531,POLI 5,A00,183525,Staff,44,0,50,6
1681920281570,POLI 12,A00,183540,Staff,46,0,50,4
1681920282595,POLI 13R,A00,183541,Forman; Fonna,42,0,50,8
1681920283620,POLI 30,A00,183542,Mignozzetti; Umberto,47,0,50,3
1681920284643,POLI 100A,A00,183543,Staff,45,0,50,5
1681920285666,POLI 100E,A00,223598,Staff,32,0,35,3
1681920286689,POLI 103A,A00,183564,Kousser; Thad,37,0,50,13
1681920287712,POLI 104B,A00,201329,Staff,28,0,35,7
1681920288736,POLI 113BR,A00,183576,Hoston; Germaine,26,0,50,24
1681920289761,POLI 114BR,A00,183588,Staff,27,0,30,3
1681920290786,POLI 117R,A00,183595,Forman; Fonna,7,0,20,13
1681920291815,POLI 120H,A00,183596,Fisk; David Lee,13,0,20,7
1681920292837,POLI 130AA,A00,183597,Staff,14,0,20,6
1681920293880,POLI 134AA,A00,183598,Staff,19,0,20,1
1681920294908,POLI 135,A00,183599,Fisk; David Lee,20,0,25,5
1681920295933,POLI 142P,A00,183623,Staff,37,0,40,3
1681920296958,POLI 144D,A00,183624,Staff,22,0,25,3
1681920297980,POLI 151,A00,183625,Staff,15,0,20,5
1681920299018,POLI 162,A00,183626,Mignozzetti; Umberto,18,0,20,2
1681920300041,PSYC 1,A00,253748,Staff,86,0,90,4
1681920301063,PSYC 2,A00,183627,Moranton; Nirelia Melbina-,25,0,35,10
1681920302088,PSYC 3,A00,183628,Staff,43,0,45,2
1681920304144,PSYC 60,A01,183631,Lowe; Angela Beth,35,0,40,5
1681920305171,PSYC 70,A01,253757,Staff,37,0,45,8
1681920306198,PSYC 101,A00,183632,Heyman; Gail D.,48,0,60,12
1681920307234,PSYC 105,A00,183848,Lowe; Angela Beth,48,0,60,12
1681920308260,PSYC 106,A00,183849,Dobkins; Karen R.,44,0,60,16
1681920309287,PSYC 108,A00,253750,Staff,24,0,60,36
1681920310317,PSYC 114,A01,184275,Winkielman; Piotr,0,7,30,30
1681920311345,PSYC 122,A00,183856,Moranton; Nirelia Melbina-,0,12,30,30
1681920312369,PSYC 124,A00,183865,Chapman; Eddie Nathaniel,49,0,80,31
1681920313393,PSYC 137,A00,183880,Staff,19,0,25,6
1681920315441,PSYC 154,A00,183910,Lacefield; Katharine I,0,10,90,90
1681920317562,PSYC 162,A00,183946,Wixted; John T,59,0,90,31
1681920318588,PSYC 172,A00,183947,Gorman; Michael R.,12,0,30,18
1681920319613,PSYC 178,A00,183963,Glaser; Dale,19,0,40,21
1681920320637,PSYC 181GS,A00,183964,Anagnostaras; Stephan,10,0,10,0
1681920321662,PSYC 186GS,A01,257660,Staff,10,0,10,0
1681920322687,PSYC 193,B00,253749,Staff,23,0,25,2
1681920324739,PSYC 193L,A01,184122,Staff,33,0,35,2
1681920324739,PSYC 193L,C01,184167,Winkielman; Piotr,15,0,30,15
1681920325762,RELI 188GS,A00,182629,Rahimi; Babak,20,0,20,0
1681920326788,SE 101A,A00,182646,Staff,26,0,30,4
1681920327812,SE 101C,A00,182650,Staff,17,0,20,3
1681920328836,SE 110A,A00,182651,Staff,28,0,28,0
1681920329867,SE 130A,A00,182652,Staff,39,0,40,1
1681920330890,SIO 46GS,A00,182636,Cook; Geoffrey W,27,0,28,1
1681920331919,SIO 109R,A00,194459,Staff,5,0,20,15
1681920332942,SIO 121GS,A00,182639,Cook; Geoffrey W,27,0,28,1
1681920333966,SIO 132,A01,182642,Staff,32,0,40,8
1681920334989,SIO 139,A00,182644,Kacev; David,36,0,40,4
1681920336020,SOCI 2,A01,258404,Staff,34,0,36,2
1681920336020,SOCI 2,A02,258405,Staff,35,0,36,1
1681920337047,SOCI 60,A01,258408,Staff,29,0,30,1
1681920337047,SOCI 60,A02,258413,Staff,30,0,30,0
1681920338077,SOCI 100,A01,258415,Staff,29,0,30,1
1681920338077,SOCI 100,A02,258416,Staff,28,0,30,2
1681920344252,SOCI 127,A00,258421,Staff,21,0,30,9
1681920345285,SOCI 132,A00,258422,Staff,45,0,50,5
1681920346307,SOCI 133,A00,258423,Staff,26,0,30,4
1681920347329,SOCI 138GS,A00,258424,Staff,15,0,15,0
1681920348363,SOCI 145,A00,258425,Staff,25,0,30,5
1681920349393,SOCI 148,A00,258426,Staff,26,0,30,4
1681920350417,SOCI 153,A00,199217,Staff,29,0,30,1
1681920351442,SOCI 160,A00,258427,Staff,28,0,30,2
1681920352464,SOCI 160E,A00,258435,Staff,56,0,60,4
1681920353486,SOCI 189GS,A00,258436,Staff,15,0,15,0
1681920354509,SOCI 190GS,A00,258437,Staff,15,0,15,0
1681920355537,SYN 2,001,182658,Staff,8,0,16,8
1681920355537,SYN 2,002,201439,Staff,14,0,16,2
1681920355537,SYN 2,003,201443,Staff,16,0,16,0
1681920356567,SYN 100,A01,182657,Staff,16,0,20,4
1681920357594,TDAC 1,A00,184381,Salovey; Todd,16,0,20,4
1681920357594,TDAC 1,B00,184385,Harting; Carla Kelso,19,0,20,1
1681920357594,TDAC 1,C00,184394,Staff,19,0,20,1
1681920358642,TDAC 101,A00,184483,Harting; Carla Kelso,19,0,20,1
1681920359664,TDDE 111,A00,184496,Staff,14,0,15,1
1681920360690,TDDE 131,A00,184504,Staff,20,0,20,0
1681920360690,TDDE 131,B00,184505,Staff,17,0,18,1
1681920360690,TDDE 131,C00,184534,Staff,49,0,50,1
1681920360690,TDDE 131,D00,184564,Staff,15,0,15,0
1681920360690,TDDE 131,E00,204725,Staff,19,0,20,1
1681920361717,TDGE 1,A01,184414,Salovey; Todd,36,0,50,14
1681920362742,TDGE 5,A01,184419,Staff,23,0,24,1
1681920363773,TDGE 10,A00,184428,Fulton; Julia,29,0,50,21
1681920364797,TDGE 124,A00,184565,Fulton; Julia,7,0,50,43
1681920365822,TDGE 125,B00,184567,Meyer; Ursula,9,0,25,16
1681920366848,TDHT 101,A00,184568,Staff,21,0,25,4
1681920366848,TDHT 101,B00,184569,Staff,20,0,20,0
1681920367874,TDHT 114,A00,184570,Staff,49,0,50,1
1681920368897,TDMV 1,A00,184437,Arcidiacono; Kristin,22,0,30,8
1681920368897,TDMV 1,B00,184448,Caligagan; Maria T.,23,0,30,7
1681920369924,TDMV 2,A00,184449,Weinberg; Sadie,27,0,30,3
1681920369924,TDMV 2,B00,184453,Arcidiacono; Kristin,29,0,30,1
1681920370947,TDMV 110,A00,184571,Weinberg; Sadie,30,0,30,0
1681920371971,TDMV 142,A00,184572,Caligagan; Tony,27,0,30,3
1681920371971,TDMV 142,B00,184573,Caligagan; Maria T.,26,0,30,4
1681920372999,TDTR 20,A00,184482,Jun; Grace Shin Hae,25,0,25,0
1681920374027,USP 2,A01,184290,Hinds; Juli Beth,24,0,25,1
1681920375053,USP 3,A01,184295,Staff,20,0,25,5
1681920376084,USP 4,A00,184304,McTague; Sarah,14,0,25,11
1681920377108,USP 100,A00,184315,Staff,17,0,25,8
1681920378130,USP 105,A00,184326,Staff,21,0,25,4
1681920379155,USP 151,A00,184327,Staff,20,0,25,5
1681920380177,USP 170,A00,184380,Hinds; Juli Beth,14,0,25,11
1681920381207,VIS 21B,A01,182660,Staff,28,0,31,3
1681920381207,VIS 21B,A02,182662,Staff,30,0,31,1
1681920382248,VIS 103D,A00,182663,Staff,74,0,75,1
1681920383273,VIS 105D,A00,182667,Li; Huai,15,0,22,7
1681920384302,VIS 122GS,A00,182668,Herbst; Matthew,20,0,20,0
1681920385329,VIS 128C,A00,182673,Staff,69,0,75,6
1681920386354,VIS 130,A00,182675,Staff,20,0,22,2
1681920387376,VIS 160A,A00,182678,Stalbaum; Brett,4,0,10,6
1681920389426,WCWP 10B,A00,201679,Staff,15,0,15,0
1681920389426,WCWP 10B,B00,201695,Staff,15,0,15,0
1681920390451,WCWP 100,A00,201716,Staff,13,0,15,2
1681920390451,WCWP 100,B00,201717,Staff,10,0,15,5
1681920392561,ANSC 105GS,A00,258289,Staff,0,0,0,0
1681920393585,ANSC 125GS,A00,258295,Staff,0,0,0,0
1681920394611,ANSC 150,A00,258267,Staff,30,0,40,10
1681920395635,ANSC 190GS,A00,258280,Staff,0,0,0,0
1681920396658,ANTH 1,A00,258264,Staff,38,0,40,2
1681920397684,ANTH 2,A01,258259,Staff,72,0,76,4
1681920398709,ANTH 23,A01,258228,Staff,36,0,40,4
1681920399735,ANTH 101,A01,258236,Staff,38,0,40,2
1681920400764,ANTH 102,A00,258272,Staff,59,0,60,1
1681920401787,ANTH 105,A00,258244,Staff,31,0,35,4
1681920402811,BENG 130,A00,253975,Staff,38,0,40,2
1681920403839,BIBC 102,A01,191866,Flagg; Matthew Paul,19,0,32,13
1681920403839,BIBC 102,A02,191867,Flagg; Matthew Paul,22,0,32,10
1681920403839,BIBC 102,A03,191868,Flagg; Matthew Paul,29,0,32,3
1681920403839,BIBC 102,A04,191936,Flagg; Matthew Paul,26,0,32,6
1681920403839,BIBC 102,A05,191937,Flagg; Matthew Paul,5,0,32,27
1681920404870,BICD 100,A01,191939,Cooper; Andrew Michael,28,0,32,4
1681920404870,BICD 100,A02,191940,Cooper; Andrew Michael,32,0,32,0
1681920404870,BICD 100,A03,191941,Cooper; Andrew Michael,32,0,32,0
1681920404870,BICD 100,A04,191942,Cooper; Andrew Michael,32,0,32,0
1681920404870,BICD 100,A05,191943,Cooper; Andrew Michael,32,0,32,0
1681920405894,BIEB 126,A01,191945,Cleland; Elsa Eleanor,0,0,32,32
1681920405894,BIEB 126,A02,191946,Cleland; Elsa Eleanor,27,0,32,5
1681920405894,BIEB 126,A03,191947,Cleland; Elsa Eleanor,29,0,32,3
1681920405894,BIEB 126,A04,191948,Cleland; Elsa Eleanor,23,0,32,9
1681920405894,BIEB 126,A05,191996,Cleland; Elsa Eleanor,28,0,32,4
1681920406916,BIEB 136GS,A00,191997,Shurin; Jonathan & Holway; David A.,0,0,0,3
1681920407940,BIEB 137GS,A01,191999,Shurin; Jonathan & Holway; David A.,0,0,0,2
1681920408963,BILD 1,A01,205385,Staff,31,0,32,1
1681920408963,BILD 1,A02,205386,Staff,30,0,32,2
1681920408963,BILD 1,A03,205387,Staff,32,0,32,0
1681920408963,BILD 1,A04,205388,Staff,27,0,32,5
1681920409987,BILD 2,A01,191774,Staff,28,0,32,4
1681920409987,BILD 2,A02,191775,Staff,30,0,32,2
1681920409987,BILD 2,A03,191777,Staff,30,0,32,2
1681920409987,BILD 2,A04,191856,Staff,31,0,32,1
1681920409987,BILD 2,A05,191857,Staff,32,0,32,0
1681920409987,BILD 2,A06,191858,Staff,32,0,32,0
1681920409987,BILD 2,A07,191859,Staff,31,0,32,1
1681920411022,BILD 3,A01,205391,Staff,29,0,32,3
1681920411022,BILD 3,A02,205393,Staff,32,0,32,0
1681920411022,BILD 3,A03,205394,Staff,28,0,32,4
1681920411022,BILD 3,A04,205395,Staff,32,0,32,0
1681920412049,BILD 20,A01,191861,Staff,32,0,32,0
1681920412049,BILD 20,A02,191862,Staff,32,0,32,0
1681920413075,BILD 30,A01,191864,Staff,31,0,32,1
1681920414101,BIMM 100,A01,192019,Staff,0,0,32,32
1681920414101,BIMM 100,A02,192020,Staff,21,0,32,11
1681920414101,BIMM 100,A03,192035,Staff,21,0,32,11
1681920415125,BIMM 110,A01,192037,Tat; John,0,0,32,32
1681920415125,BIMM 110,A02,192038,Tat; John,9,0,32,23
1681920416149,BIMM 120,A01,192040,Pickett; Brooke Elizabeth,1,0,32,31
1681920416149,BIMM 120,A02,192041,Pickett; Brooke Elizabeth,16,0,32,16
1681920416149,BIMM 120,A03,192042,Pickett; Brooke Elizabeth,15,0,32,17
1681920417175,BIPN 100,A01,192044,Armour; Jon Christopher,25,0,32,7
1681920417175,BIPN 100,A02,192059,Armour; Jon Christopher,30,0,32,2
1681920417175,BIPN 100,A03,192064,Armour; Jon Christopher,31,0,32,1
1681920417175,BIPN 100,A04,192073,Armour; Jon Christopher,28,0,32,4
1681920418212,BIPN 148,A01,205411,Leutgeb; Jill K.,16,0,32,16
1681920418212,BIPN 148,A02,205412,Leutgeb; Jill K.,31,0,32,1
1681920418212,BIPN 148,A03,205413,Leutgeb; Jill K.,30,0,32,2
1681920418212,BIPN 148,A04,205414,Leutgeb; Jill K.,30,0,32,2
1681920419236,BIPN 160,A01,192115,Marino; Marc J,17,0,32,15
1681920419236,BIPN 160,A02,192148,Marino; Marc J,27,0,32,5
1681920419236,BIPN 160,A03,192158,Marino; Marc J,31,0,32,1
1681920419236,BIPN 160,A04,192190,Marino; Marc J,32,0,32,0
1681920419236,BIPN 160,A05,192287,Marino; Marc J,32,0,32,0
1681920419236,BIPN 160,A06,192288,Marino; Marc J,32,0,32,0
1681920420263,BIPN 194,A00,206038,Staff,28,0,32,4
1681920421367,BISP 194,A00,192289,Leutgeb; Stefan,13,0,32,19
1681920421367,BISP 194,B00,245332,Nieh; James Charles,26,0,32,6
1681920422390,CAT 124,A01,202247,Staff,15,0,15,0
1681920423416,CAT 125,A00,202248,Staff,19,0,20,1
1681920423416,CAT 125,B00,202253,Staff,20,0,20,0
1681920423416,CAT 125,C00,202257,Staff,18,0,20,2
1681920424443,CAT 125GS,A01,202273,Bronstein; Phoebe Malan,20,0,20,0
1681920425471,CAT 125R,A00,202284,Staff,17,0,20,3
1681920425471,CAT 125R,C00,202286,Staff,10,0,20,10
1681920425471,CAT 125R,D00,202291,Staff,18,0,20,2
1681920425471,CAT 125R,E00,202295,Staff,13,0,20,7
1681920425471,CAT 125R,F00,202302,Staff,11,0,20,9
1681920426502,CENG 100,A00,204724,Opatkiewicz; Justin Paul,25,0,25,0
1681920427524,CGS 2A,A01,180420,Staff,31,0,36,5
1681920428550,CGS 101,A00,180421,Staff,16,0,20,4
1681920429575,CGS 112,A00,180422,Staff,9,0,16,7
1681920430601,CGS 113,A00,180423,Staff,18,0,20,2
1681920431626,CGS 137,A00,180424,Staff,12,0,12,0
1681920432656,CGS 147,A00,180425,Staff,10,0,10,0
1681920433678,CHEM 6A,A01,179556,Staff,96,0,100,4
1681920433678,CHEM 6A,A02,179558,Staff,0,0,0,0
1681920434702,CHEM 6B,A01,179560,Staff,100,0,100,0
1681920435729,CHEM 6C,A01,179565,Jazzar; Rodolphe,95,0,100,5
1681920436754,CHEM 7L,A01,179586,Schurmeier; Kimberly,11,0,24,13
1681920436754,CHEM 7L,A02,179587,Schurmeier; Kimberly,23,0,24,1
1681920436754,CHEM 7L,A03,179590,Schurmeier; Kimberly,22,0,24,2
1681920436754,CHEM 7L,A04,179591,Schurmeier; Kimberly,22,0,24,2
1681920436754,CHEM 7L,B01,179598,Schurmeier; Kimberly,17,0,24,7
1681920436754,CHEM 7L,B02,179599,Schurmeier; Kimberly,24,0,24,0
1681920436754,CHEM 7L,B03,179606,Schurmeier; Kimberly,23,0,24,1
1681920436754,CHEM 7L,B04,179607,Schurmeier; Kimberly,23,0,24,1
1681920437779,CHEM 11,A01,179609,Stallings; Dontarie M,88,0,100,12
1681920438804,CHEM 40A,A01,179621,Staff,41,0,50,9
1681920438804,CHEM 40A,A02,179622,Staff,47,0,50,3
1681920439831,CHEM 40B,A01,179630,Weizman; Haim,48,0,50,2
1681920439831,CHEM 40B,A02,179631,Weizman; Haim,45,0,50,5
1681920440858,CHEM 41A,A01,179660,Klosterman; Jeremy K,93,0,100,7
1681920441884,CHEM 43A,A01,179683,Klosterman; Jeremy K,0,0,24,24
1681920441884,CHEM 43A,A02,179688,Klosterman; Jeremy K,11,0,24,13
1681920441884,CHEM 43A,A03,179689,Klosterman; Jeremy K,19,0,24,5
1681920441884,CHEM 43A,A04,179691,Klosterman; Jeremy K,18,0,24,6
1681920442910,CHEM 114A,A01,179693,Stallings; Dontarie M,73,0,100,27
1681920443933,CHEM 143B,A01,179698,Weizman; Haim,17,0,24,7
1681920443933,CHEM 143B,A02,179700,Weizman; Haim,24,0,24,0
1681920444956,CHIN 169A,A00,179701,Wang; Xiao,20,0,20,0
1681920445978,COGS 2,A01,179750,Boyle; Mary E. T.,17,0,30,13
1681920447004,COGS 9,A01,179759,Jones; Cameron Robert,42,0,50,8
1681920448030,COGS 14A,A01,179854,Staff,16,0,50,34
1681920449060,COGS 14B,A01,179856,Staff,53,0,60,7
1681920450083,COGS 17,A01,179874,Staff,71,0,75,4
1681920451108,COGS 18,A01,179884,Staff,63,0,80,17
1681920452134,COGS 100,A01,179886,Staff,37,0,60,23
1681920453160,COGS 101B,A01,179892,Staff,1,0,30,29
1681920454182,COGS 101C,A01,179894,Staff,28,0,30,2
1681920455240,COGS 107A,A01,179896,Boyle; Mary E. T.,31,0,40,9
1681920456267,COGS 108,A01,179898,Simpkins; Charles Alexander,0,23,60,60
1681920457294,COGS 109,A01,179900,Staff,34,0,40,6
1681920458317,COGS 118A,A01,179946,Staff,8,0,40,32
1681920459340,COGS 153,A00,179978,Staff,0,2,30,30
1681920460363,COGS 156,A01,179981,Staff,25,0,30,5
1681920462409,COGS 172,A01,179987,Staff,13,0,30,17
1681920464457,COGS 186,A01,179991,Staff,12,0,30,18
1681920465481,COMM 10,A01,180001,Staff,14,0,25,11
1681920465481,COMM 10,A02,180004,Staff,20,0,25,5
1681920466504,COMM 100A,A01,180016,Staff,16,0,25,9
1681920466504,COMM 100A,A02,180020,Staff,24,0,25,1
1681920467530,COMM 101T,A00,180029,Halm; Gavin Patrick,23,0,35,12
1681920468558,COMM 106V,A00,180043,Staff,34,0,35,1
1681920469581,COMM 109P,A00,180044,Staff,31,0,35,4
1681920470603,COMM 113T,A00,180045,Havis; Allan,37,0,45,8
1681920471633,COMM 132,A00,180046,McKenna; Denise,23,0,30,7
1681920472658,COMM 143,A00,180047,Staff,18,0,30,12
1681920473683,COMM 190,A00,180048,Conner; Thomas Hartnell,20,0,23,3
1681920474707,CSE 8A,A50,180053,Cao; Yingjun,25,0,50,25
1681920474707,CSE 8A,B50,180180,Staff,50,0,50,0
1681920475730,CSE 11,A01,180190,Cao; Yingjun,27,0,50,23
1681920476756,CSE 20,A01,180192,Briones; Jor-el Thomas Caparas,23,0,30,7
1681920477781,CSE 21,A01,194538,Briones; Jor-el Thomas Caparas,50,0,60,10
1681920478813,CSE 30,A01,180324,Eldon; John,76,0,100,24
1681920479841,CSE 101,A01,201353,Staff,0,23,40,40
1681920480863,CSE 134B,A01,180326,Powell; Thomas Allan,74,0,100,26
1681920481899,CSE 140,A01,180328,Staff,42,0,75,33
1681920482940,CSE 140L,A01,180344,Eldon; John,65,0,100,35
1681920483963,CSE 150A,A01,180411,Staff,0,11,50,50
1681920484989,CSE 151A,A01,180414,Staff,0,8,50,50
1681920486021,CSE 175,A01,222521,Kumar; Rakesh,50,0,50,0
1681920487046,CSE 190,A00,201419,Staff,45,0,49,4
1681920488076,CSS 1,A01,194536,Staff,37,0,50,13
1681920489100,DSC 30,A01,202385,Staff,48,0,50,2
1681920490126,DSC 40A,A01,202387,Albuyeh; Rod,50,0,50,0
1681920491155,DSC 190,A01,202389,Silberman; Jack,21,0,21,0
1681920492181,DSGN 100,A01,179993,Staff,16,0,30,14
1681920493206,ECE 65,A50,180708,Staff,10,0,20,10
1681920493206,ECE 65,A51,180739,Staff,19,0,20,1
1681920494234,ECON 1,A01,180427,Famulari; Melissa,67,0,70,3
1681920495257,ECON 2,A01,180450,Levkoff; Steven B.,64,0,70,6
1681920496283,ECON 4,A01,203351,Anderson; John Charles,6,0,10,4
1681920497313,ECON 100A,A01,180472,Famulari; Melissa,64,0,70,6
1681920498337,ECON 120A,A01,180549,Staff,64,0,70,6
1681920499359,ECON 120B,A01,180655,Ma; Xinwei,43,0,70,27
1681920500382,ECON 129,A00,203333,Eckert; Fabian Paul,13,0,35,22
1681920501408,ECON 131,A00,180656,Staff,7,0,35,28
1681920502438,ECON 172B,A01,180672,Levkoff; Steven B.,31,0,35,4
1681920503465,ECON 178,A01,203342,Zhu; Ying,9,0,35,26
1681920504487,EDS 108GS,A00,202383,Wishard Guerra; Alison G.,20,0,20,0
1681920505513,EDS 111GS,A00,202347,Wishard Guerra; Alison G.,20,0,20,0
1681920506536,EDS 112,A01,202323,Staff,55,0,60,5
1681920507561,EDS 113,A00,202340,Staff,33,0,35,2
1681920508587,EDS 118,A00,201231,Staff,20,0,30,10
1681920509612,EDS 119,A00,204994,Staff,8,0,10,2
1681920510635,EDS 124BR,A00,202324,Eguchi; Emi,4,0,25,21
1681920511660,EDS 126,A01,203208,Jones; Makeba,26,0,30,4
1681920512682,EDS 135,A01,202333,Staff,18,0,20,2
1681920513706,EDS 180,A00,202311,Staff,47,0,50,3
1681920514740,ERC 190GS,A01,253747,Staff,28,0,28,0
1681920515763,ETHN 104,A00,180742,Staff,23,0,35,12
1681920516788,ETHN 118,A00,180745,Staff,27,0,35,8
1681920517817,ETHN 127,A00,180747,Staff,12,0,16,4
1681920518841,ETHN 137,A00,180880,Staff,11,0,12,1
1681920519870,ETHN 147,A00,180890,Staff,8,0,10,2
1681920520901,ETHN 154,A00,180891,Staff,7,0,8,1
1681920521936,ETHN 168,A00,180892,Staff,9,0,10,1
1681920522962,GLBH 20,A00,201051,Hannah; Seth Donal,0,2,0,1
1681920523997,GLBH 111,A01,209338,Burgos; Jose L.,0,0,0,0
1681920525093,GLBH 150,A00,258300,Staff,0,3,0,0
1681920526119,GLBH 181,A00,201207,Staff,15,0,40,25
1681920527146,HIEU 109,A00,180898,Staff,20,0,20,0
1681920528181,HIEU 111,A00,180899,Staff,0,0,20,20
1681920529211,HIEU 124,A00,180900,Staff,17,0,20,3
1681920530236,HILA 122,A00,180901,Staff,18,0,20,2
1681920531261,HILA 132,A00,180902,Vitz; Matthew,2,0,20,18
1681920532285,HILD 10,A01,180896,Staff,15,0,20,5
1681920533310,HILD 30GS,A00,180897,Edington; Claire Ellen,0,0,0,0
1681920534335,HISC 105,A00,180903,Staff,20,0,20,0
1681920535358,HISC 117,A00,180904,Staff,11,0,20,9
1681920536384,HIUS 108B,A00,181005,Staff,18,0,20,2
1681920537406,HIUS 113,A00,181093,Staff,3,0,20,17
1681920538432,HUM 3,A01,181190,Patterson; Patrick H.,39,0,50,11
1681920538432,HUM 3,B01,181195,Staff,46,0,50,4
1681920539459,HUM 3GS,A00,181196,Herbst; Matthew,0,0,0,0
1681920540485,HUM 4,A01,181227,West; Geoffrey Scott,33,0,50,17
1681920540485,HUM 4,B01,181282,Staff,42,0,50,8
1681920541516,HUM 4GS,A00,181377,Lyon; Antony J.,0,0,0,0
1681920542539,HUM 5,A01,181536,Zavodny; Tatiana Sophia,28,0,50,22
1681920542539,HUM 5,B01,181908,Staff,36,0,50,14
1681920543565,INTL 190,A00,181909,Segui; Alan S,0,0,0,7
1681920543565,INTL 190,B00,181961,Segui; Alan S,0,0,0,7
1681920544589,JAPN 20AR,A01,182113,Ross; Kayoko F,15,0,20,5
1681920545611,LATI 50,A01,202391,Martin-Cabrera; Luis,18,0,30,12
1681920545611,LATI 50,A02,202392,Martin-Cabrera; Luis,26,0,30,4
1681920546647,LATI 180,A00,202393,Kokinis; Troy Andreas,24,0,25,1
1681920547684,LIFR 1A,A00,182119,Staff,14,0,14,0
1681920548715,LIFR 1AX,A00,182324,Staff,14,0,14,0
1681920549738,LIFR 1B,A00,182259,Staff,14,0,14,0
1681920550761,LIFR 1BX,A00,182273,Staff,14,0,14,0
1681920551787,LIGN 8,A00,182330,Staff,135,0,150,15
1681920552810,LIGN 9GS,A00,182362,Staff,20,0,20,0
1681920553833,LIGN 119,A00,204992,Takahashi; Maho,12,0,15,3
1681920554856,LIGN 130,A01,182384,Staff,47,0,50,3
1681920555882,LIGN 149GS,A00,182390,Staff,20,0,20,0
1681920556904,LIGN 170,A00,182404,Staff,23,0,30,7
1681920557932,LISP 1D,A00,182281,Staff,7,0,14,7
1681920557932,LISP 1D,B00,182287,Staff,14,0,14,0
1681920557932,LISP 1D,C00,182295,Staff,11,0,14,3
1681920557932,LISP 1D,D00,182301,Staff,14,0,14,0
1681920558962,LISP 1DX,A00,182309,Staff,20,0,28,8
1681920558962,LISP 1DX,B00,182316,Staff,26,0,28,2
1681920559985,LTAF 120GS,A00,182412,Zhiri; Oumelbanine,20,0,20,0
1681920561007,LTCS 172GS,A00,182437,Bronstein; Phoebe Malan,20,0,20,0
1681920562033,LTEA 138,A00,182457,Staff,20,0,40,20
1681920563056,LTEN 114,A01,182490,Staff,23,0,25,2
1681920564083,LTEN 130GS,A00,182491,Lyon; Antony J.,20,0,20,0
1681920565106,LTEN 169,A00,182493,Cuong; Marisol,19,0,25,6
1681920566133,LTEN 178,A00,182501,Staff,14,0,15,1
1681920567158,LTEN 181,A00,182515,Staff,22,0,25,3
1681920568181,LTEN 185GS,A00,197655,Forbes; Camille,20,0,20,0
1681920569204,LTSP 100B,A00,202208,Bessett; Ryan Matthew,24,0,25,1
1681920570230,LTWL 100,A00,182516,Myerston Santana; Jacobo,21,0,30,9
1681920571252,LTWR 100GS,A00,182518,Forbes; Camille,20,0,20,0
1681920572277,LTWR 102,A00,182522,Staff,15,0,15,0
1681920572277,LTWR 102,B00,182525,Staff,14,0,15,1
1681920573302,LTWR 115,A00,182526,Staff,11,0,15,4
1681920574327,MAE 8,A01,182528,Pham; Hieu Tan,67,0,70,3
1681920575352,MAE 11,A00,182529,Bahadori; Mohammad Yousef,94,0,100,6
1681920576378,MAE 20,A00,182530,Evdokimenko; Ekaterina,68,0,70,2
1681920577401,MAE 30A,A00,182532,Staff,44,0,45,1
1681920578428,MAE 101A,A00,182533,Bahadori; Mohammad Yousef,95,0,100,5
1681920579453,MAE 101C,A00,182538,Staff,62,0,70,8
1681920580479,MAE 104,A00,182539,Staff,44,0,50,6
1681920581503,MAE 131A,A00,182540,Ghazinejad; Maziar,40,0,45,5
1681920582531,MAE 143A,A00,182548,Bewley; Thomas R,43,0,50,7
1681920583556,MAE 150,A00,182549,Staff,28,0,40,12
1681920584578,MAE 160,A00,182550,Evdokimenko; Ekaterina,42,0,60,18
1681920585605,MATH 3C,A01,182725,Staff,26,0,30,4
1681920586633,MATH 10A,A01,182729,Staff,25,0,30,5
1681920586633,MATH 10A,B01,182732,Staff,26,0,30,4
1681920587656,MATH 10B,A01,182737,Staff,21,0,30,9
1681920587656,MATH 10B,A02,182738,Staff,26,0,30,4
1681920587656,MATH 10B,B01,182744,Staff,27,0,30,3
1681920587656,MATH 10B,B02,182745,Staff,27,0,30,3
1681920588680,MATH 18,A01,182750,Anzaldo; Leesa B,28,0,30,2
1681920588680,MATH 18,A02,182751,Anzaldo; Leesa B,29,0,30,1
1681920588680,MATH 18,A03,182753,Anzaldo; Leesa B,27,0,30,3
1681920588680,MATH 18,A04,182757,Anzaldo; Leesa B,29,0,30,1
1681920588680,MATH 18,B01,182761,Anzaldo; Leesa B,27,0,30,3
1681920588680,MATH 18,B02,182764,Anzaldo; Leesa B,27,0,30,3
1681920588680,MATH 18,B03,182765,Anzaldo; Leesa B,29,0,30,1
1681920588680,MATH 18,B04,182766,Anzaldo; Leesa B,30,0,30,0
1681920589707,MATH 20A,A01,182771,Suk; Andrew Hoon,28,0,30,2
1681920590736,MATH 20B,A01,182775,Bach; Quang Tran,30,0,30,0
1681920590736,MATH 20B,A02,182777,Bach; Quang Tran,29,0,30,1
1681920590736,MATH 20B,B01,182780,Bach; Quang Tran,26,0,30,4
1681920590736,MATH 20B,B02,182782,Bach; Quang Tran,30,0,30,0
1681920591762,MATH 20C,A01,182787,Staff,25,0,30,5
1681920591762,MATH 20C,A02,182790,Staff,29,0,30,1
1681920591762,MATH 20C,B01,182792,Staff,25,0,30,5
1681920591762,MATH 20C,B02,182796,Staff,27,0,30,3
1681920592785,MATH 20D,A01,182799,Staff,28,0,30,2
1681920592785,MATH 20D,A02,182802,Staff,29,0,30,1
1681920592785,MATH 20D,A03,182803,Staff,30,0,30,0
1681920593807,MATH 20E,A01,182809,Verstraete; Jacques Allan,23,0,30,7
1681920593807,MATH 20E,A02,182811,Verstraete; Jacques Allan,28,0,30,2
1681920593807,MATH 20E,B01,182814,Verstraete; Jacques Allan,23,0,30,7
1681920593807,MATH 20E,B02,182815,Verstraete; Jacques Allan,30,0,30,0
1681920594831,MATH 103A,A01,182820,Staff,8,0,30,22
1681920594831,MATH 103A,A02,182821,Staff,27,0,30,3
1681920594831,MATH 103A,A03,182822,Staff,23,0,30,7
1681920594831,MATH 103A,B01,182825,Staff,23,0,30,7
1681920594831,MATH 103A,B02,182826,Staff,30,0,30,0
1681920594831,MATH 103A,B03,182830,Staff,30,0,30,0
1681920595855,MATH 109,A01,182836,Chow; Bennett,24,0,30,6
1681920595855,MATH 109,A02,182838,Chow; Bennett,29,0,30,1
1681920595855,MATH 109,A03,182894,Chow; Bennett,29,0,30,1
1681920595855,MATH 109,B01,182908,Chow; Bennett,27,0,30,3
1681920595855,MATH 109,B02,182909,Chow; Bennett,30,0,30,0
1681920595855,MATH 109,B03,182910,Chow; Bennett,27,0,30,3
1681920596882,MATH 142A,A01,182925,Staff,10,0,30,20
1681920596882,MATH 142A,A02,182935,Staff,24,0,30,6
1681920596882,MATH 142A,A03,182967,Staff,26,0,30,4
1681920596882,MATH 142A,B01,183125,Staff,22,0,30,8
1681920596882,MATH 142A,B02,183157,Staff,28,0,30,2
1681920596882,MATH 142A,B03,183158,Staff,29,0,30,1
1681920597909,MATH 183,A01,183160,Arias-Castro; Ery,23,0,30,7
1681920597909,MATH 183,A02,183161,Arias-Castro; Ery,29,0,30,1
1681920597909,MATH 183,B01,183163,Arias-Castro; Ery,28,0,30,2
1681920597909,MATH 183,B02,183164,Arias-Castro; Ery,28,0,30,2
1681920598937,MATH 193A,A01,183167,Staff,4,0,35,31
1681920598937,MATH 193A,A02,183168,Staff,28,0,35,7
1681920598937,MATH 193A,A03,183169,Staff,34,0,35,1
1681920598937,MATH 193A,A04,183170,Staff,28,0,35,7
1681920599967,MGT 4,A01,202395,Anderson; John Charles,75,0,80,5
1681920600998,MGT 5,A00,202396,Houskeeper; Robert,79,0,90,11
1681920602035,MGT 103,A00,202397,Eberhard; Craig A,52,0,90,38
1681920603062,MGT 131A,A00,202398,Houskeeper; Robert,85,0,90,5
1681920604094,MGT 135,A00,202399,Anderson; John Charles,81,0,90,9
1681920605130,MGT 162R,A00,202403,Gneezy; Uri,143,0,200,57
1681920606163,MGT 172,A00,202404,Hedges; Kathleen,48,0,90,42
1681920607185,MGT 181,A00,202405,Dunn; Louis Jean,82,0,90,8
1681920608210,MMW 14,A01,183200,Staff,11,0,28,17
1681920608210,MMW 14,A02,183201,Staff,26,0,28,2
1681920608210,MMW 14,A03,183202,Staff,24,0,28,4
1681920608210,MMW 14,A04,183203,Staff,25,0,28,3
1681920608210,MMW 14,A05,183204,Staff,26,0,28,2
1681920608210,MMW 14,A06,183205,Staff,27,0,28,1
1681920608210,MMW 14,B01,183207,Staff,26,0,28,2
1681920608210,MMW 14,B02,183208,Staff,28,0,28,0
1681920608210,MMW 14,B03,183209,Staff,28,0,28,0
1681920608210,MMW 14,B04,183210,Staff,28,0,28,0
1681920608210,MMW 14,B05,183211,Staff,28,0,28,0
1681920608210,MMW 14,B06,183212,Staff,27,0,28,1
1681920609237,MMW 14GS,A00,183213,Zhiri; Oumelbanine,28,0,28,0
1681920610271,MMW 15GS,B00,183215,Rahimi; Babak,28,0,28,0
1681920611299,MMW 121,A01,183217,Patterson; Patrick H.,14,0,28,14
1681920611299,MMW 121,A02,183218,Patterson; Patrick H.,25,0,28,3
1681920612326,MUS 1A,A01,182554,Staff,7,0,35,28
1681920613348,MUS 5,A01,182558,Staff,19,0,35,16
1681920614372,MUS 6,A01,182562,Staff,22,0,35,13
1681920615397,MUS 8GS,A00,182563,Borgo; David Garcia,25,0,25,0
1681920616423,MUS 13,A01,182567,Staff,24,0,25,1
1681920617445,MUS 15,A01,182570,Staff,32,0,35,3
1681920617445,MUS 15,B01,182575,Staff,9,0,35,26
1681920618468,MUS 80,A00,182578,Staff,23,0,25,2
1681920618468,MUS 80,B00,182581,Staff,20,0,25,5
1681920619493,MUS 113,A00,182582,Staff,25,0,25,0
1681920620529,MUS 114,A00,182583,Staff,4,0,25,21
1681920621552,MUS 150GS,A01,182588,Borgo; David Garcia,25,0,25,0
1681920622577,PHIL 1,A00,182590,Staff,35,0,40,5
1681920623603,PHIL 10,A01,182596,Grush; Rick Scott,31,0,35,4
1681920623603,PHIL 10,A02,182597,Grush; Rick Scott,34,0,35,1
1681920624636,PHIL 15,A01,182601,Staff,31,0,35,4
1681920624636,PHIL 15,A02,182602,Staff,33,0,35,2
1681920625661,PHIL 27,A01,182604,Staff,30,0,35,5
1681920625661,PHIL 27,A02,182607,Staff,35,0,35,0
1681920626683,PHIL 32,A01,182609,Staff,35,0,35,0
1681920626683,PHIL 32,A02,182612,Staff,35,0,35,0
1681920627716,PHIL 130,A00,182614,Staff,62,0,70,8
1681920628832,PHIL 136,A00,182616,Cohen; Jonathan David,66,0,70,4
1681920629858,PHIL 155,A00,182617,Vargas; Manuel Rogelio,59,0,70,11
1681920630882,PHIL 163,A01,182620,Staff,15,0,20,5
1681920630882,PHIL 163,A02,182624,Staff,10,0,20,10
1681920631907,PHIL 164,A00,182627,Staff,30,0,40,10
1681920632939,PHIL 173,A00,182628,Staff,36,0,40,4
1681920633972,PHYS 1A,A00,183221,Staff,54,0,60,6
1681920634994,PHYS 1AL,001,183222,Staff,25,0,30,5
1681920634994,PHYS 1AL,002,183223,Staff,28,0,30,2
1681920636016,PHYS 1B,A00,183231,Staff,43,0,60,17
1681920637046,PHYS 1BL,001,183232,Staff,20,0,30,10
1681920637046,PHYS 1BL,002,183233,Staff,27,0,30,3
1681920638071,PHYS 1C,A00,183240,Staff,28,0,60,32
1681920639093,PHYS 1CL,001,183241,Staff,11,0,30,19
1681920639093,PHYS 1CL,002,183242,Staff,22,0,30,8
1681920640118,PHYS 2AR,A01,183250,Staff,43,0,50,7
1681920641140,PHYS 2B,A01,183252,Staff,104,0,115,11
1681920642164,PHYS 2BL,A01,183254,Staff,21,0,24,3
1681920642164,PHYS 2BL,A02,183255,Staff,22,0,24,2
1681920643201,PHYS 2C,A01,183522,Staff,103,0,115,12
1681920644226,PHYS 4A,A01,183524,Staff,49,0,50,1
1681920645252,POLI 5,A00,183525,Staff,44,0,50,6
1681920646274,POLI 12,A00,183540,Staff,46,0,50,4
1681920647297,POLI 13R,A00,183541,Forman; Fonna,42,0,50,8
1681920648319,POLI 30,A00,183542,Mignozzetti; Umberto,47,0,50,3
1681920649341,POLI 100A,A00,183543,Staff,45,0,50,5
1681920650367,POLI 100E,A00,223598,Staff,32,0,35,3
1681920651393,POLI 103A,A00,183564,Kousser; Thad,37,0,50,13
1681920652416,POLI 104B,A00,201329,Staff,28,0,35,7
1681920653438,POLI 113BR,A00,183576,Hoston; Germaine,26,0,50,24
1681920654468,POLI 114BR,A00,183588,Staff,27,0,30,3
1681920655491,POLI 117R,A00,183595,Forman; Fonna,7,0,20,13
1681920656514,POLI 120H,A00,183596,Fisk; David Lee,13,0,20,7
1681920657535,POLI 130AA,A00,183597,Staff,14,0,20,6
1681920658562,POLI 134AA,A00,183598,Staff,19,0,20,1
1681920659584,POLI 135,A00,183599,Fisk; David Lee,20,0,25,5
1681920660609,POLI 142P,A00,183623,Staff,37,0,40,3
1681920661634,POLI 144D,A00,183624,Staff,22,0,25,3
1681920662658,POLI 151,A00,183625,Staff,15,0,20,5
1681920663681,POLI 162,A00,183626,Mignozzetti; Umberto,18,0,20,2
1681920664707,PSYC 1,A00,253748,Staff,86,0,90,4
1681920665744,PSYC 2,A00,183627,Moranton; Nirelia Melbina-,25,0,35,10
1681920666770,PSYC 3,A00,183628,Staff,43,0,45,2
1681920668830,PSYC 60,A01,183631,Lowe; Angela Beth,35,0,40,5
1681920669853,PSYC 70,A01,253757,Staff,37,0,45,8
1681920670875,PSYC 101,A00,183632,Heyman; Gail D.,47,0,60,13
1681920671897,PSYC 105,A00,183848,Lowe; Angela Beth,48,0,60,12
1681920672922,PSYC 106,A00,183849,Dobkins; Karen R.,43,0,60,17
1681920673954,PSYC 108,A00,253750,Staff,24,0,60,36
1681920674983,PSYC 114,A01,184275,Winkielman; Piotr,0,7,30,30
1681920676009,PSYC 122,A00,183856,Moranton; Nirelia Melbina-,0,12,30,30
1681920677040,PSYC 124,A00,183865,Chapman; Eddie Nathaniel,49,0,80,31
1681920678064,PSYC 137,A00,183880,Staff,19,0,25,6
1681920680113,PSYC 154,A00,183910,Lacefield; Katharine I,0,10,90,90
1681920682171,PSYC 162,A00,183946,Wixted; John T,59,0,90,31
1681920683197,PSYC 172,A00,183947,Gorman; Michael R.,11,0,30,19
1681920684223,PSYC 178,A00,183963,Glaser; Dale,19,0,40,21
1681920685254,PSYC 181GS,A00,183964,Anagnostaras; Stephan,10,0,10,0
1681920686279,PSYC 186GS,A01,257660,Staff,10,0,10,0
1681920687303,PSYC 193,B00,253749,Staff,23,0,25,2
1681920689356,PSYC 193L,A01,184122,Staff,33,0,35,2
1681920689356,PSYC 193L,C01,184167,Winkielman; Piotr,15,0,30,15
1681920690383,RELI 188GS,A00,182629,Rahimi; Babak,20,0,20,0
1681920691409,SE 101A,A00,182646,Staff,26,0,30,4
1681920692434,SE 101C,A00,182650,Staff,17,0,20,3
1681920693460,SE 110A,A00,182651,Staff,28,0,28,0
1681920694483,SE 130A,A00,182652,Staff,39,0,40,1
1681920695509,SIO 46GS,A00,182636,Cook; Geoffrey W,27,0,28,1
1681920696540,SIO 109R,A00,194459,Staff,5,0,20,15
1681920697562,SIO 121GS,A00,182639,Cook; Geoffrey W,27,0,28,1
1681920698590,SIO 132,A01,182642,Staff,32,0,40,8
1681920699623,SIO 139,A00,182644,Kacev; David,36,0,40,4
1681920700650,SOCI 2,A01,258404,Staff,33,0,36,3
1681920700650,SOCI 2,A02,258405,Staff,35,0,36,1
1681920701686,SOCI 60,A01,258408,Staff,29,0,30,1
1681920701686,SOCI 60,A02,258413,Staff,30,0,30,0
1681920702711,SOCI 100,A01,258415,Staff,29,0,30,1
1681920702711,SOCI 100,A02,258416,Staff,28,0,30,2
1681920708879,SOCI 127,A00,258421,Staff,21,0,30,9
1681920709905,SOCI 132,A00,258422,Staff,45,0,50,5
1681920710930,SOCI 133,A00,258423,Staff,26,0,30,4
1681920711952,SOCI 138GS,A00,258424,Staff,15,0,15,0
1681920712978,SOCI 145,A00,258425,Staff,25,0,30,5
1681920714000,SOCI 148,A00,258426,Staff,26,0,30,4
1681920715025,SOCI 153,A00,199217,Staff,29,0,30,1
1681920716047,SOCI 160,A00,258427,Staff,28,0,30,2
1681920717070,SOCI 160E,A00,258435,Staff,56,0,60,4
1681920718102,SOCI 189GS,A00,258436,Staff,15,0,15,0
1681920719125,SOCI 190GS,A00,258437,Staff,15,0,15,0
1681920720148,SYN 2,001,182658,Staff,8,0,16,8
1681920720148,SYN 2,002,201439,Staff,14,0,16,2
1681920720148,SYN 2,003,201443,Staff,16,0,16,0
1681920721177,SYN 100,A01,182657,Staff,16,0,20,4
1681920722199,TDAC 1,A00,184381,Salovey; Todd,16,0,20,4
1681920722199,TDAC 1,B00,184385,Harting; Carla Kelso,19,0,20,1
1681920722199,TDAC 1,C00,184394,Staff,19,0,20,1
1681920723220,TDAC 101,A00,184483,Harting; Carla Kelso,19,0,20,1
1681920724245,TDDE 111,A00,184496,Staff,14,0,15,1
1681920725272,TDDE 131,A00,184504,Staff,20,0,20,0
1681920725272,TDDE 131,B00,184505,Staff,17,0,18,1
1681920725272,TDDE 131,C00,184534,Staff,49,0,50,1
1681920725272,TDDE 131,D00,184564,Staff,15,0,15,0
1681920725272,TDDE 131,E00,204725,Staff,19,0,20,1
1681920726295,TDGE 1,A01,184414,Salovey; Todd,36,0,50,14
1681920727319,TDGE 5,A01,184419,Staff,23,0,24,1
1681920728344,TDGE 10,A00,184428,Fulton; Julia,29,0,50,21
1681920729367,TDGE 124,A00,184565,Fulton; Julia,7,0,50,43
1681920730390,TDGE 125,B00,184567,Meyer; Ursula,9,0,25,16
1681920731422,TDHT 101,A00,184568,Staff,21,0,25,4
1681920731422,TDHT 101,B00,184569,Staff,20,0,20,0
1681920732526,TDHT 114,A00,184570,Staff,49,0,50,1
1681920733550,TDMV 1,A00,184437,Arcidiacono; Kristin,22,0,30,8
1681920733550,TDMV 1,B00,184448,Caligagan; Maria T.,23,0,30,7
1681920734572,TDMV 2,A00,184449,Weinberg; Sadie,27,0,30,3
1681920734572,TDMV 2,B00,184453,Arcidiacono; Kristin,29,0,30,1
1681920735599,TDMV 110,A00,184571,Weinberg; Sadie,30,0,30,0
1681920736624,TDMV 142,A00,184572,Caligagan; Tony,27,0,30,3
1681920736624,TDMV 142,B00,184573,Caligagan; Maria T.,26,0,30,4
1681920737646,TDTR 20,A00,184482,Jun; Grace Shin Hae,25,0,25,0
1681920738670,USP 2,A01,184290,Hinds; Juli Beth,24,0,25,1
1681920739695,USP 3,A01,184295,Staff,20,0,25,5
1681920740721,USP 4,A00,184304,McTague; Sarah,14,0,25,11
1681920741747,USP 100,A00,184315,Staff,17,0,25,8
1681920742774,USP 105,A00,184326,Staff,21,0,25,4
1681920743802,USP 151,A00,184327,Staff,20,0,25,5
1681920744825,USP 170,A00,184380,Hinds; Juli Beth,14,0,25,11
1681920745848,VIS 21B,A01,182660,Staff,28,0,31,3
1681920745848,VIS 21B,A02,182662,Staff,30,0,31,1
1681920746874,VIS 103D,A00,182663,Staff,74,0,75,1
1681920747908,VIS 105D,A00,182667,Li; Huai,15,0,22,7
1681920748933,VIS 122GS,A00,182668,Herbst; Matthew,20,0,20,0
1681920749956,VIS 128C,A00,182673,Staff,69,0,75,6
1681920750982,VIS 130,A00,182675,Staff,20,0,22,2
1681920752011,VIS 160A,A00,182678,Stalbaum; Brett,4,0,10,6
1681920754069,WCWP 10B,A00,201679,Staff,15,0,15,0
1681920754069,WCWP 10B,B00,201695,Staff,15,0,15,0
1681920755097,WCWP 100,A00,201716,Staff,13,0,15,2
1681920755097,WCWP 100,B00,201717,Staff,8,0,15,7
1681920757167,ANSC 105GS,A00,258289,Staff,0,0,0,0
1681920758189,ANSC 125GS,A00,258295,Staff,0,0,0,0
1681920759221,ANSC 150,A00,258267,Staff,30,0,40,10
1681920760249,ANSC 190GS,A00,258280,Staff,0,0,0,0
1681920761275,ANTH 1,A00,258264,Staff,38,0,40,2
1681920762300,ANTH 2,A01,258259,Staff,72,0,76,4
1681920763328,ANTH 23,A01,258228,Staff,36,0,40,4
1681920764354,ANTH 101,A01,258236,Staff,38,0,40,2
1681920765386,ANTH 102,A00,258272,Staff,59,0,60,1
1681920766411,ANTH 105,A00,258244,Staff,31,0,35,4
1681920767437,BENG 130,A00,253975,Staff,38,0,40,2
1681920768463,BIBC 102,A01,191866,Flagg; Matthew Paul,19,0,32,13
1681920768463,BIBC 102,A02,191867,Flagg; Matthew Paul,22,0,32,10
1681920768463,BIBC 102,A03,191868,Flagg; Matthew Paul,29,0,32,3
1681920768463,BIBC 102,A04,191936,Flagg; Matthew Paul,26,0,32,6
1681920768463,BIBC 102,A05,191937,Flagg; Matthew Paul,5,0,32,27
1681920769486,BICD 100,A01,191939,Cooper; Andrew Michael,28,0,32,4
1681920769486,BICD 100,A02,191940,Cooper; Andrew Michael,32,0,32,0
1681920769486,BICD 100,A03,191941,Cooper; Andrew Michael,32,0,32,0
1681920769486,BICD 100,A04,191942,Cooper; Andrew Michael,32,0,32,0
1681920769486,BICD 100,A05,191943,Cooper; Andrew Michael,32,0,32,0
1681920770512,BIEB 126,A01,191945,Cleland; Elsa Eleanor,0,0,32,32
1681920770512,BIEB 126,A02,191946,Cleland; Elsa Eleanor,27,0,32,5
1681920770512,BIEB 126,A03,191947,Cleland; Elsa Eleanor,29,0,32,3
1681920770512,BIEB 126,A04,191948,Cleland; Elsa Eleanor,23,0,32,9
1681920770512,BIEB 126,A05,191996,Cleland; Elsa Eleanor,28,0,32,4
1681920771535,BIEB 136GS,A00,191997,Shurin; Jonathan & Holway; David A.,0,0,0,3
1681920772557,BIEB 137GS,A01,191999,Shurin; Jonathan & Holway; David A.,0,0,0,2
1681920773582,BILD 1,A01,205385,Staff,31,0,32,1
1681920773582,BILD 1,A02,205386,Staff,30,0,32,2
1681920773582,BILD 1,A03,205387,Staff,32,0,32,0
1681920773582,BILD 1,A04,205388,Staff,27,0,32,5
1681920774605,BILD 2,A01,191774,Staff,28,0,32,4
1681920774605,BILD 2,A02,191775,Staff,30,0,32,2
1681920774605,BILD 2,A03,191777,Staff,30,0,32,2
1681920774605,BILD 2,A04,191856,Staff,31,0,32,1
1681920774605,BILD 2,A05,191857,Staff,32,0,32,0
1681920774605,BILD 2,A06,191858,Staff,32,0,32,0
1681920774605,BILD 2,A07,191859,Staff,31,0,32,1
1681920775632,BILD 3,A01,205391,Staff,29,0,32,3
1681920775632,BILD 3,A02,205393,Staff,32,0,32,0
1681920775632,BILD 3,A03,205394,Staff,28,0,32,4
1681920775632,BILD 3,A04,205395,Staff,32,0,32,0
1681920776655,BILD 20,A01,191861,Staff,32,0,32,0
1681920776655,BILD 20,A02,191862,Staff,32,0,32,0
1681920777680,BILD 30,A01,191864,Staff,31,0,32,1
1681920778707,BIMM 100,A01,192019,Staff,0,0,32,32
1681920778707,BIMM 100,A02,192020,Staff,21,0,32,11
1681920778707,BIMM 100,A03,192035,Staff,21,0,32,11
1681920779729,BIMM 110,A01,192037,Tat; John,0,0,32,32
1681920779729,BIMM 110,A02,192038,Tat; John,9,0,32,23
1681920780756,BIMM 120,A01,192040,Pickett; Brooke Elizabeth,1,0,32,31
1681920780756,BIMM 120,A02,192041,Pickett; Brooke Elizabeth,15,0,32,17
1681920780756,BIMM 120,A03,192042,Pickett; Brooke Elizabeth,15,0,32,17
1681920781781,BIPN 100,A01,192044,Armour; Jon Christopher,25,0,32,7
1681920781781,BIPN 100,A02,192059,Armour; Jon Christopher,30,0,32,2
1681920781781,BIPN 100,A03,192064,Armour; Jon Christopher,30,0,32,2
1681920781781,BIPN 100,A04,192073,Armour; Jon Christopher,28,0,32,4
1681920782805,BIPN 148,A01,205411,Leutgeb; Jill K.,16,0,32,16
1681920782805,BIPN 148,A02,205412,Leutgeb; Jill K.,31,0,32,1
1681920782805,BIPN 148,A03,205413,Leutgeb; Jill K.,30,0,32,2
1681920782805,BIPN 148,A04,205414,Leutgeb; Jill K.,30,0,32,2
1681920783833,BIPN 160,A01,192115,Marino; Marc J,17,0,32,15
1681920783833,BIPN 160,A02,192148,Marino; Marc J,27,0,32,5
1681920783833,BIPN 160,A03,192158,Marino; Marc J,31,0,32,1
1681920783833,BIPN 160,A04,192190,Marino; Marc J,32,0,32,0
1681920783833,BIPN 160,A05,192287,Marino; Marc J,32,0,32,0
1681920783833,BIPN 160,A06,192288,Marino; Marc J,32,0,32,0
1681920784859,BIPN 194,A00,206038,Staff,28,0,32,4
1681920785892,BISP 194,A00,192289,Leutgeb; Stefan,13,0,32,19
1681920785892,BISP 194,B00,245332,Nieh; James Charles,26,0,32,6
1681920786915,CAT 124,A01,202247,Staff,15,0,15,0
1681920787941,CAT 125,A00,202248,Staff,19,0,20,1
1681920787941,CAT 125,B00,202253,Staff,20,0,20,0
1681920787941,CAT 125,C00,202257,Staff,18,0,20,2
1681920788963,CAT 125GS,A01,202273,Bronstein; Phoebe Malan,20,0,20,0
1681920790028,CAT 125R,A00,202284,Staff,17,0,20,3
1681920790028,CAT 125R,C00,202286,Staff,10,0,20,10
1681920790028,CAT 125R,D00,202291,Staff,18,0,20,2
1681920790028,CAT 125R,E00,202295,Staff,13,0,20,7
1681920790028,CAT 125R,F00,202302,Staff,9,0,20,11
1681920791051,CENG 100,A00,204724,Opatkiewicz; Justin Paul,25,0,25,0
1681920792073,CGS 2A,A01,180420,Staff,31,0,36,5
1681920793098,CGS 101,A00,180421,Staff,16,0,20,4
1681920794121,CGS 112,A00,180422,Staff,9,0,16,7
1681920795146,CGS 113,A00,180423,Staff,18,0,20,2
1681920796168,CGS 137,A00,180424,Staff,12,0,12,0
1681920797193,CGS 147,A00,180425,Staff,10,0,10,0
1681920798215,CHEM 6A,A01,179556,Staff,96,0,100,4
1681920798215,CHEM 6A,A02,179558,Staff,0,0,0,0
1681920799241,CHEM 6B,A01,179560,Staff,100,0,100,0
1681920800266,CHEM 6C,A01,179565,Jazzar; Rodolphe,95,0,100,5
1681920801291,CHEM 7L,A01,179586,Schurmeier; Kimberly,11,0,24,13
1681920801291,CHEM 7L,A02,179587,Schurmeier; Kimberly,23,0,24,1
1681920801291,CHEM 7L,A03,179590,Schurmeier; Kimberly,22,0,24,2
1681920801291,CHEM 7L,A04,179591,Schurmeier; Kimberly,22,0,24,2
1681920801291,CHEM 7L,B01,179598,Schurmeier; Kimberly,17,0,24,7
1681920801291,CHEM 7L,B02,179599,Schurmeier; Kimberly,24,0,24,0
1681920801291,CHEM 7L,B03,179606,Schurmeier; Kimberly,23,0,24,1
1681920801291,CHEM 7L,B04,179607,Schurmeier; Kimberly,23,0,24,1
1681920802322,CHEM 11,A01,179609,Stallings; Dontarie M,88,0,100,12
1681920803354,CHEM 40A,A01,179621,Staff,41,0,50,9
1681920803354,CHEM 40A,A02,179622,Staff,47,0,50,3
1681920804378,CHEM 40B,A01,179630,Weizman; Haim,48,0,50,2
1681920804378,CHEM 40B,A02,179631,Weizman; Haim,45,0,50,5
1681920805413,CHEM 41A,A01,179660,Klosterman; Jeremy K,93,0,100,7
1681920806440,CHEM 43A,A01,179683,Klosterman; Jeremy K,0,0,24,24
1681920806440,CHEM 43A,A02,179688,Klosterman; Jeremy K,11,0,24,13
1681920806440,CHEM 43A,A03,179689,Klosterman; Jeremy K,19,0,24,5
1681920806440,CHEM 43A,A04,179691,Klosterman; Jeremy K,18,0,24,6
1681920807464,CHEM 114A,A01,179693,Stallings; Dontarie M,73,0,100,27
1681920808487,CHEM 143B,A01,179698,Weizman; Haim,17,0,24,7
1681920808487,CHEM 143B,A02,179700,Weizman; Haim,24,0,24,0
1681920809511,CHIN 169A,A00,179701,Wang; Xiao,20,0,20,0
1681920810537,COGS 2,A01,179750,Boyle; Mary E. T.,17,0,30,13
1681920811562,COGS 9,A01,179759,Jones; Cameron Robert,42,0,50,8
1681920812584,COGS 14A,A01,179854,Staff,16,0,50,34
1681920813619,COGS 14B,A01,179856,Staff,53,0,60,7
1681920814645,COGS 17,A01,179874,Staff,71,0,75,4
1681920815667,COGS 18,A01,179884,Staff,63,0,80,17
1681920816690,COGS 100,A01,179886,Staff,37,0,60,23
1681920817713,COGS 101B,A01,179892,Staff,1,0,30,29
1681920818739,COGS 101C,A01,179894,Staff,28,0,30,2
1681920819769,COGS 107A,A01,179896,Boyle; Mary E. T.,31,0,40,9
1681920820801,COGS 108,A01,179898,Simpkins; Charles Alexander,0,23,60,60
1681920821828,COGS 109,A01,179900,Staff,34,0,40,6
1681920822862,COGS 118A,A01,179946,Staff,8,0,40,32
1681920823888,COGS 153,A00,179978,Staff,0,2,30,30
1681920824911,COGS 156,A01,179981,Staff,25,0,30,5
1681920826975,COGS 172,A01,179987,Staff,13,0,30,17
1681920829021,COGS 186,A01,179991,Staff,12,0,30,18
1681920830043,COMM 10,A01,180001,Staff,14,0,25,11
1681920830043,COMM 10,A02,180004,Staff,20,0,25,5
1681920831067,COMM 100A,A01,180016,Staff,15,0,25,10
1681920831067,COMM 100A,A02,180020,Staff,24,0,25,1
1681920832091,COMM 101T,A00,180029,Halm; Gavin Patrick,23,0,35,12
1681920833117,COMM 106V,A00,180043,Staff,34,0,35,1
1681920834139,COMM 109P,A00,180044,Staff,30,0,35,5
1681920835177,COMM 113T,A00,180045,Havis; Allan,37,0,45,8
1681920836273,COMM 132,A00,180046,McKenna; Denise,23,0,30,7
1681920837297,COMM 143,A00,180047,Staff,18,0,30,12
1681920838320,COMM 190,A00,180048,Conner; Thomas Hartnell,19,0,23,4
1681920839349,CSE 8A,A50,180053,Cao; Yingjun,25,0,50,25
1681920839349,CSE 8A,B50,180180,Staff,50,0,50,0
1681920840372,CSE 11,A01,180190,Cao; Yingjun,26,0,50,24
1681920841398,CSE 20,A01,180192,Briones; Jor-el Thomas Caparas,23,0,30,7
1681920842422,CSE 21,A01,194538,Briones; Jor-el Thomas Caparas,50,0,60,10
1681920843444,CSE 30,A01,180324,Eldon; John,76,0,100,24
1681920844467,CSE 101,A01,201353,Staff,0,23,40,40
1681920845493,CSE 134B,A01,180326,Powell; Thomas Allan,74,0,100,26
1681920846520,CSE 140,A01,180328,Staff,42,0,75,33
1681920847548,CSE 140L,A01,180344,Eldon; John,65,0,100,35
1681920848580,CSE 150A,A01,180411,Staff,0,11,50,50
1681920849602,CSE 151A,A01,180414,Staff,0,8,50,50
1681920850624,CSE 175,A01,222521,Kumar; Rakesh,50,0,50,0
1681920851647,CSE 190,A00,201419,Staff,45,0,49,4
1681920852673,CSS 1,A01,194536,Staff,37,0,50,13
1681920853696,DSC 30,A01,202385,Staff,48,0,50,2
1681920854730,DSC 40A,A01,202387,Albuyeh; Rod,50,0,50,0
1681920855754,DSC 190,A01,202389,Silberman; Jack,21,0,21,0
1681920856779,DSGN 100,A01,179993,Staff,16,0,30,14
1681920857804,ECE 65,A50,180708,Staff,10,0,20,10
1681920857804,ECE 65,A51,180739,Staff,19,0,20,1
1681920858833,ECON 1,A01,180427,Famulari; Melissa,67,0,70,3
1681920859856,ECON 2,A01,180450,Levkoff; Steven B.,64,0,70,6
1681920860878,ECON 4,A01,203351,Anderson; John Charles,6,0,10,4
1681920861912,ECON 100A,A01,180472,Famulari; Melissa,64,0,70,6
1681920862935,ECON 120A,A01,180549,Staff,64,0,70,6
1681920863961,ECON 120B,A01,180655,Ma; Xinwei,43,0,70,27
1681920864987,ECON 129,A00,203333,Eckert; Fabian Paul,13,0,35,22
1681920866013,ECON 131,A00,180656,Staff,6,0,35,29
1681920867039,ECON 172B,A01,180672,Levkoff; Steven B.,31,0,35,4
1681920868062,ECON 178,A01,203342,Zhu; Ying,9,0,35,26
1681920869085,EDS 108GS,A00,202383,Wishard Guerra; Alison G.,20,0,20,0
1681920870118,EDS 111GS,A00,202347,Wishard Guerra; Alison G.,20,0,20,0
1681920871142,EDS 112,A01,202323,Staff,55,0,60,5
1681920872168,EDS 113,A00,202340,Staff,33,0,35,2
1681920873190,EDS 118,A00,201231,Staff,20,0,30,10
1681920874216,EDS 119,A00,204994,Staff,8,0,10,2
1681920875239,EDS 124BR,A00,202324,Eguchi; Emi,4,0,25,21
1681920876263,EDS 126,A01,203208,Jones; Makeba,26,0,30,4
1681920877292,EDS 135,A01,202333,Staff,18,0,20,2
1681920878318,EDS 180,A00,202311,Staff,47,0,50,3
1681920879351,ERC 190GS,A01,253747,Staff,28,0,28,0
1681920880393,ETHN 104,A00,180742,Staff,23,0,35,12
1681920881421,ETHN 118,A00,180745,Staff,27,0,35,8
1681920882450,ETHN 127,A00,180747,Staff,12,0,16,4
1681920883474,ETHN 137,A00,180880,Staff,11,0,12,1
1681920884509,ETHN 147,A00,180890,Staff,8,0,10,2
1681920885532,ETHN 154,A00,180891,Staff,7,0,8,1
1681920886555,ETHN 168,A00,180892,Staff,9,0,10,1
1681920887577,GLBH 20,A00,201051,Hannah; Seth Donal,0,2,0,1
1681920888603,GLBH 111,A01,209338,Burgos; Jose L.,0,0,0,0
1681920889626,GLBH 150,A00,258300,Staff,0,3,0,0
1681920890660,GLBH 181,A00,201207,Staff,13,0,40,27
1681920891689,HIEU 109,A00,180898,Staff,20,0,20,0
1681920892712,HIEU 111,A00,180899,Staff,0,0,20,20
1681920893735,HIEU 124,A00,180900,Staff,17,0,20,3
1681920894758,HILA 122,A00,180901,Staff,18,0,20,2
1681920895788,HILA 132,A00,180902,Vitz; Matthew,2,0,20,18
1681920896812,HILD 10,A01,180896,Staff,15,0,20,5
1681920897835,HILD 30GS,A00,180897,Edington; Claire Ellen,0,0,0,0
1681920898864,HISC 105,A00,180903,Staff,20,0,20,0
1681920899888,HISC 117,A00,180904,Staff,11,0,20,9
1681920900911,HIUS 108B,A00,181005,Staff,18,0,20,2
1681920901934,HIUS 113,A00,181093,Staff,3,0,20,17
1681920902960,HUM 3,A01,181190,Patterson; Patrick H.,39,0,50,11
1681920902960,HUM 3,B01,181195,Staff,46,0,50,4
1681920903982,HUM 3GS,A00,181196,Herbst; Matthew,0,0,0,0
1681920905006,HUM 4,A01,181227,West; Geoffrey Scott,33,0,50,17
1681920905006,HUM 4,B01,181282,Staff,42,0,50,8
1681920906031,HUM 4GS,A00,181377,Lyon; Antony J.,0,0,0,0
1681920907061,HUM 5,A01,181536,Zavodny; Tatiana Sophia,28,0,50,22
1681920907061,HUM 5,B01,181908,Staff,36,0,50,14
1681920908091,INTL 190,A00,181909,Segui; Alan S,0,0,0,8
1681920908091,INTL 190,B00,181961,Segui; Alan S,0,0,0,7
1681920909120,JAPN 20AR,A01,182113,Ross; Kayoko F,15,0,20,5
1681920910151,LATI 50,A01,202391,Martin-Cabrera; Luis,18,0,30,12
1681920910151,LATI 50,A02,202392,Martin-Cabrera; Luis,26,0,30,4
1681920911178,LATI 180,A00,202393,Kokinis; Troy Andreas,24,0,25,1
1681920912207,LIFR 1A,A00,182119,Staff,14,0,14,0
1681920913232,LIFR 1AX,A00,182324,Staff,14,0,14,0
1681920914256,LIFR 1B,A00,182259,Staff,13,0,14,1
1681920915280,LIFR 1BX,A00,182273,Staff,13,0,14,1
1681920916878,LIGN 8,A00,182330,Staff,135,0,150,15
1681920917902,LIGN 9GS,A00,182362,Staff,20,0,20,0
1681920918929,LIGN 119,A00,204992,Takahashi; Maho,12,0,15,3
1681920919955,LIGN 130,A01,182384,Staff,47,0,50,3
1681920920978,LIGN 149GS,A00,182390,Staff,20,0,20,0
1681920922011,LIGN 170,A00,182404,Staff,23,0,30,7
1681920923034,LISP 1D,A00,182281,Staff,7,0,14,7
1681920923034,LISP 1D,B00,182287,Staff,14,0,14,0
1681920923034,LISP 1D,C00,182295,Staff,11,0,14,3
1681920923034,LISP 1D,D00,182301,Staff,14,0,14,0
1681920924059,LISP 1DX,A00,182309,Staff,20,0,28,8
1681920924059,LISP 1DX,B00,182316,Staff,26,0,28,2
1681920925090,LTAF 120GS,A00,182412,Zhiri; Oumelbanine,20,0,20,0
1681920926114,LTCS 172GS,A00,182437,Bronstein; Phoebe Malan,20,0,20,0
1681920927142,LTEA 138,A00,182457,Staff,20,0,40,20
1681920928168,LTEN 114,A01,182490,Staff,23,0,25,2
1681920929197,LTEN 130GS,A00,182491,Lyon; Antony J.,20,0,20,0
1681920930219,LTEN 169,A00,182493,Cuong; Marisol,19,0,25,6
1681920931248,LTEN 178,A00,182501,Staff,14,0,15,1
1681920932279,LTEN 181,A00,182515,Staff,22,0,25,3
1681920933311,LTEN 185GS,A00,197655,Forbes; Camille,20,0,20,0
1681920934337,LTSP 100B,A00,202208,Bessett; Ryan Matthew,24,0,25,1
1681920935359,LTWL 100,A00,182516,Myerston Santana; Jacobo,21,0,30,9
1681920936386,LTWR 100GS,A00,182518,Forbes; Camille,20,0,20,0
1681920937409,LTWR 102,A00,182522,Staff,15,0,15,0
1681920937409,LTWR 102,B00,182525,Staff,14,0,15,1
1681920938432,LTWR 115,A00,182526,Staff,11,0,15,4
1681920939455,MAE 8,A01,182528,Pham; Hieu Tan,67,0,70,3
1681920940550,MAE 11,A00,182529,Bahadori; Mohammad Yousef,94,0,100,6
1681920941576,MAE 20,A00,182530,Evdokimenko; Ekaterina,68,0,70,2
1681920942598,MAE 30A,A00,182532,Staff,44,0,45,1
1681920943624,MAE 101A,A00,182533,Bahadori; Mohammad Yousef,95,0,100,5
1681920944646,MAE 101C,A00,182538,Staff,62,0,70,8
1681920945677,MAE 104,A00,182539,Staff,44,0,50,6
1681920946701,MAE 131A,A00,182540,Ghazinejad; Maziar,40,0,45,5
1681920947734,MAE 143A,A00,182548,Bewley; Thomas R,43,0,50,7
1681920948761,MAE 150,A00,182549,Staff,28,0,40,12
1681920949797,MAE 160,A00,182550,Evdokimenko; Ekaterina,42,0,60,18
1681920950827,MATH 3C,A01,182725,Staff,26,0,30,4
1681920951850,MATH 10A,A01,182729,Staff,25,0,30,5
1681920951850,MATH 10A,B01,182732,Staff,26,0,30,4
1681920952882,MATH 10B,A01,182737,Staff,21,0,30,9
1681920952882,MATH 10B,A02,182738,Staff,26,0,30,4
1681920952882,MATH 10B,B01,182744,Staff,27,0,30,3
1681920952882,MATH 10B,B02,182745,Staff,27,0,30,3
1681920953905,MATH 18,A01,182750,Anzaldo; Leesa B,28,0,30,2
1681920953905,MATH 18,A02,182751,Anzaldo; Leesa B,29,0,30,1
1681920953905,MATH 18,A03,182753,Anzaldo; Leesa B,27,0,30,3
1681920953905,MATH 18,A04,182757,Anzaldo; Leesa B,29,0,30,1
1681920953905,MATH 18,B01,182761,Anzaldo; Leesa B,27,0,30,3
1681920953905,MATH 18,B02,182764,Anzaldo; Leesa B,26,0,30,4
1681920953905,MATH 18,B03,182765,Anzaldo; Leesa B,29,0,30,1
1681920953905,MATH 18,B04,182766,Anzaldo; Leesa B,30,0,30,0
1681920954931,MATH 20A,A01,182771,Suk; Andrew Hoon,28,0,30,2
1681920955955,MATH 20B,A01,182775,Bach; Quang Tran,30,0,30,0
1681920955955,MATH 20B,A02,182777,Bach; Quang Tran,29,0,30,1
1681920955955,MATH 20B,B01,182780,Bach; Quang Tran,26,0,30,4
1681920955955,MATH 20B,B02,182782,Bach; Quang Tran,30,0,30,0
1681920956991,MATH 20C,A01,182787,Staff,25,0,30,5
1681920956991,MATH 20C,A02,182790,Staff,29,0,30,1
1681920956991,MATH 20C,B01,182792,Staff,25,0,30,5
1681920956991,MATH 20C,B02,182796,Staff,26,0,30,4
1681920958016,MATH 20D,A01,182799,Staff,28,0,30,2
1681920958016,MATH 20D,A02,182802,Staff,29,0,30,1
1681920958016,MATH 20D,A03,182803,Staff,30,0,30,0
1681920959045,MATH 20E,A01,182809,Verstraete; Jacques Allan,23,0,30,7
1681920959045,MATH 20E,A02,182811,Verstraete; Jacques Allan,28,0,30,2
1681920959045,MATH 20E,B01,182814,Verstraete; Jacques Allan,23,0,30,7
1681920959045,MATH 20E,B02,182815,Verstraete; Jacques Allan,30,0,30,0
1681920960067,MATH 103A,A01,182820,Staff,8,0,30,22
1681920960067,MATH 103A,A02,182821,Staff,27,0,30,3
1681920960067,MATH 103A,A03,182822,Staff,23,0,30,7
1681920960067,MATH 103A,B01,182825,Staff,23,0,30,7
1681920960067,MATH 103A,B02,182826,Staff,30,0,30,0
1681920960067,MATH 103A,B03,182830,Staff,30,0,30,0
1681920961104,MATH 109,A01,182836,Chow; Bennett,24,0,30,6
1681920961104,MATH 109,A02,182838,Chow; Bennett,29,0,30,1
1681920961104,MATH 109,A03,182894,Chow; Bennett,29,0,30,1
1681920961104,MATH 109,B01,182908,Chow; Bennett,27,0,30,3
1681920961104,MATH 109,B02,182909,Chow; Bennett,30,0,30,0
1681920961104,MATH 109,B03,182910,Chow; Bennett,27,0,30,3
1681920962127,MATH 142A,A01,182925,Staff,9,0,30,21
1681920962127,MATH 142A,A02,182935,Staff,24,0,30,6
1681920962127,MATH 142A,A03,182967,Staff,26,0,30,4
1681920962127,MATH 142A,B01,183125,Staff,22,0,30,8
1681920962127,MATH 142A,B02,183157,Staff,28,0,30,2
1681920962127,MATH 142A,B03,183158,Staff,29,0,30,1
1681920963157,MATH 183,A01,183160,Arias-Castro; Ery,23,0,30,7
1681920963157,MATH 183,A02,183161,Arias-Castro; Ery,29,0,30,1
1681920963157,MATH 183,B01,183163,Arias-Castro; Ery,28,0,30,2
1681920963157,MATH 183,B02,183164,Arias-Castro; Ery,28,0,30,2
1681920964186,MATH 193A,A01,183167,Staff,4,0,35,31
1681920964186,MATH 193A,A02,183168,Staff,28,0,35,7
1681920964186,MATH 193A,A03,183169,Staff,34,0,35,1
1681920964186,MATH 193A,A04,183170,Staff,28,0,35,7
1681920965212,MGT 4,A01,202395,Anderson; John Charles,75,0,80,5
1681920966234,MGT 5,A00,202396,Houskeeper; Robert,79,0,90,11
1681920967260,MGT 103,A00,202397,Eberhard; Craig A,51,0,90,39
1681920968286,MGT 131A,A00,202398,Houskeeper; Robert,85,0,90,5
1681920969310,MGT 135,A00,202399,Anderson; John Charles,81,0,90,9
1681920970337,MGT 162R,A00,202403,Gneezy; Uri,140,0,200,60
1681920971361,MGT 172,A00,202404,Hedges; Kathleen,47,0,90,43
1681920972387,MGT 181,A00,202405,Dunn; Louis Jean,81,0,90,9
1681920973411,MMW 14,A01,183200,Staff,11,0,28,17
1681920973411,MMW 14,A02,183201,Staff,26,0,28,2
1681920973411,MMW 14,A03,183202,Staff,24,0,28,4
1681920973411,MMW 14,A04,183203,Staff,25,0,28,3
1681920973411,MMW 14,A05,183204,Staff,26,0,28,2
1681920973411,MMW 14,A06,183205,Staff,27,0,28,1
1681920973411,MMW 14,B01,183207,Staff,26,0,28,2
1681920973411,MMW 14,B02,183208,Staff,28,0,28,0
1681920973411,MMW 14,B03,183209,Staff,28,0,28,0
1681920973411,MMW 14,B04,183210,Staff,28,0,28,0
1681920973411,MMW 14,B05,183211,Staff,28,0,28,0
1681920973411,MMW 14,B06,183212,Staff,27,0,28,1
1681920974433,MMW 14GS,A00,183213,Zhiri; Oumelbanine,28,0,28,0
1681920975459,MMW 15GS,B00,183215,Rahimi; Babak,28,0,28,0
1681920976493,MMW 121,A01,183217,Patterson; Patrick H.,13,0,28,15
1681920976493,MMW 121,A02,183218,Patterson; Patrick H.,25,0,28,3
1681920977518,MUS 1A,A01,182554,Staff,7,0,35,28
1681920978544,MUS 5,A01,182558,Staff,19,0,35,16
1681920979566,MUS 6,A01,182562,Staff,22,0,35,13
1681920980595,MUS 8GS,A00,182563,Borgo; David Garcia,25,0,25,0
1681920981617,MUS 13,A01,182567,Staff,24,0,25,1
1681920982639,MUS 15,A01,182570,Staff,32,0,35,3
1681920982639,MUS 15,B01,182575,Staff,9,0,35,26
1681920983665,MUS 80,A00,182578,Staff,23,0,25,2
1681920983665,MUS 80,B00,182581,Staff,20,0,25,5
1681920984690,MUS 113,A00,182582,Staff,25,0,25,0
1681920985714,MUS 114,A00,182583,Staff,4,0,25,21
1681920986736,MUS 150GS,A01,182588,Borgo; David Garcia,25,0,25,0
1681920987761,PHIL 1,A00,182590,Staff,35,0,40,5
1681920988788,PHIL 10,A01,182596,Grush; Rick Scott,31,0,35,4
1681920988788,PHIL 10,A02,182597,Grush; Rick Scott,34,0,35,1
1681920989814,PHIL 15,A01,182601,Staff,31,0,35,4
1681920989814,PHIL 15,A02,182602,Staff,33,0,35,2
1681920990840,PHIL 27,A01,182604,Staff,30,0,35,5
1681920990840,PHIL 27,A02,182607,Staff,35,0,35,0
1681920991869,PHIL 32,A01,182609,Staff,35,0,35,0
1681920991869,PHIL 32,A02,182612,Staff,35,0,35,0
1681920992893,PHIL 130,A00,182614,Staff,62,0,70,8
1681920993917,PHIL 136,A00,182616,Cohen; Jonathan David,66,0,70,4
1681920994941,PHIL 155,A00,182617,Vargas; Manuel Rogelio,58,0,70,12
1681920995966,PHIL 163,A01,182620,Staff,15,0,20,5
1681920995966,PHIL 163,A02,182624,Staff,10,0,20,10
1681920996989,PHIL 164,A00,182627,Staff,30,0,40,10
1681920998016,PHIL 173,A00,182628,Staff,36,0,40,4
1681920999044,PHYS 1A,A00,183221,Staff,54,0,60,6
1681921000068,PHYS 1AL,001,183222,Staff,25,0,30,5
1681921000068,PHYS 1AL,002,183223,Staff,28,0,30,2
1681921001091,PHYS 1B,A00,183231,Staff,43,0,60,17
1681921002128,PHYS 1BL,001,183232,Staff,20,0,30,10
1681921002128,PHYS 1BL,002,183233,Staff,27,0,30,3
1681921003156,PHYS 1C,A00,183240,Staff,28,0,60,32
1681921004183,PHYS 1CL,001,183241,Staff,11,0,30,19
1681921004183,PHYS 1CL,002,183242,Staff,22,0,30,8
1681921005211,PHYS 2AR,A01,183250,Staff,43,0,50,7
1681921006241,PHYS 2B,A01,183252,Staff,104,0,115,11
1681921007265,PHYS 2BL,A01,183254,Staff,21,0,24,3
1681921007265,PHYS 2BL,A02,183255,Staff,22,0,24,2
1681921008297,PHYS 2C,A01,183522,Staff,103,0,115,12
1681921009322,PHYS 4A,A01,183524,Staff,49,0,50,1
1681921010358,POLI 5,A00,183525,Staff,44,0,50,6
1681921011387,POLI 12,A00,183540,Staff,46,0,50,4
1681921012412,POLI 13R,A00,183541,Forman; Fonna,42,0,50,8
1681921013434,POLI 30,A00,183542,Mignozzetti; Umberto,47,0,50,3
1681921014462,POLI 100A,A00,183543,Staff,45,0,50,5
1681921015483,POLI 100E,A00,223598,Staff,32,0,35,3
1681921016507,POLI 103A,A00,183564,Kousser; Thad,37,0,50,13
1681921017533,POLI 104B,A00,201329,Staff,28,0,35,7
1681921018562,POLI 113BR,A00,183576,Hoston; Germaine,25,0,50,25
1681921019589,POLI 114BR,A00,183588,Staff,27,0,30,3
1681921020612,POLI 117R,A00,183595,Forman; Fonna,7,0,20,13
1681921021642,POLI 120H,A00,183596,Fisk; David Lee,13,0,20,7
1681921022665,POLI 130AA,A00,183597,Staff,14,0,20,6
1681921023687,POLI 134AA,A00,183598,Staff,19,0,20,1
1681921024711,POLI 135,A00,183599,Fisk; David Lee,20,0,25,5
1681921025734,POLI 142P,A00,183623,Staff,37,0,40,3
1681921026761,POLI 144D,A00,183624,Staff,22,0,25,3
1681921027787,POLI 151,A00,183625,Staff,15,0,20,5
1681921028816,POLI 162,A00,183626,Mignozzetti; Umberto,18,0,20,2
1681921029842,PSYC 1,A00,253748,Staff,86,0,90,4
1681921030865,PSYC 2,A00,183627,Moranton; Nirelia Melbina-,25,0,35,10
1681921031888,PSYC 3,A00,183628,Staff,43,0,45,2
1681921033938,PSYC 60,A01,183631,Lowe; Angela Beth,35,0,40,5
1681921034962,PSYC 70,A01,253757,Staff,37,0,45,8
1681921035984,PSYC 101,A00,183632,Heyman; Gail D.,47,0,60,13
1681921037006,PSYC 105,A00,183848,Lowe; Angela Beth,48,0,60,12
1681921038029,PSYC 106,A00,183849,Dobkins; Karen R.,43,0,60,17
1681921039053,PSYC 108,A00,253750,Staff,23,0,60,37
1681921040076,PSYC 114,A01,184275,Winkielman; Piotr,0,7,30,30
1681921041099,PSYC 122,A00,183856,Moranton; Nirelia Melbina-,0,12,30,30
1681921042122,PSYC 124,A00,183865,Chapman; Eddie Nathaniel,50,0,80,30
1681921043147,PSYC 137,A00,183880,Staff,19,0,25,6
1681921045280,PSYC 154,A00,183910,Lacefield; Katharine I,0,12,90,90
1681921047325,PSYC 162,A00,183946,Wixted; John T,58,0,90,32
1681921048348,PSYC 172,A00,183947,Gorman; Michael R.,11,0,30,19
1681921049372,PSYC 178,A00,183963,Glaser; Dale,19,0,40,21
1681921050395,PSYC 181GS,A00,183964,Anagnostaras; Stephan,10,0,10,0
1681921051417,PSYC 186GS,A01,257660,Staff,10,0,10,0
1681921052440,PSYC 193,B00,253749,Staff,23,0,25,2
1681921054489,PSYC 193L,A01,184122,Staff,33,0,35,2
1681921054489,PSYC 193L,C01,184167,Winkielman; Piotr,15,0,30,15
1681921055518,RELI 188GS,A00,182629,Rahimi; Babak,20,0,20,0
1681921056544,SE 101A,A00,182646,Staff,26,0,30,4
1681921057573,SE 101C,A00,182650,Staff,17,0,20,3
1681921058596,SE 110A,A00,182651,Staff,28,0,28,0
1681921059619,SE 130A,A00,182652,Staff,39,0,40,1
1681921060656,SIO 46GS,A00,182636,Cook; Geoffrey W,27,0,28,1
1681921061679,SIO 109R,A00,194459,Staff,5,0,20,15
1681921062701,SIO 121GS,A00,182639,Cook; Geoffrey W,27,0,28,1
1681921063723,SIO 132,A01,182642,Staff,32,0,40,8
1681921064752,SIO 139,A00,182644,Kacev; David,36,0,40,4
1681921065774,SOCI 2,A01,258404,Staff,33,0,36,3
1681921065774,SOCI 2,A02,258405,Staff,35,0,36,1
1681921066797,SOCI 60,A01,258408,Staff,29,0,30,1
1681921066797,SOCI 60,A02,258413,Staff,30,0,30,0
1681921067829,SOCI 100,A01,258415,Staff,29,0,30,1
1681921067829,SOCI 100,A02,258416,Staff,28,0,30,2
1681921073990,SOCI 127,A00,258421,Staff,21,0,30,9
1681921075016,SOCI 132,A00,258422,Staff,45,0,50,5
1681921076045,SOCI 133,A00,258423,Staff,26,0,30,4
1681921077078,SOCI 138GS,A00,258424,Staff,15,0,15,0
1681921078115,SOCI 145,A00,258425,Staff,25,0,30,5
1681921079145,SOCI 148,A00,258426,Staff,26,0,30,4
1681921080168,SOCI 153,A00,199217,Staff,29,0,30,1
1681921081193,SOCI 160,A00,258427,Staff,28,0,30,2
1681921082229,SOCI 160E,A00,258435,Staff,56,0,60,4
1681921083251,SOCI 189GS,A00,258436,Staff,15,0,15,0
1681921084274,SOCI 190GS,A00,258437,Staff,15,0,15,0
1681921085307,SYN 2,001,182658,Staff,8,0,16,8
1681921085307,SYN 2,002,201439,Staff,14,0,16,2
1681921085307,SYN 2,003,201443,Staff,16,0,16,0
1681921086330,SYN 100,A01,182657,Staff,16,0,20,4
1681921087353,TDAC 1,A00,184381,Salovey; Todd,16,0,20,4
1681921087353,TDAC 1,B00,184385,Harting; Carla Kelso,19,0,20,1
1681921087353,TDAC 1,C00,184394,Staff,19,0,20,1
1681921088391,TDAC 101,A00,184483,Harting; Carla Kelso,19,0,20,1
1681921089421,TDDE 111,A00,184496,Staff,14,0,15,1
1681921090444,TDDE 131,A00,184504,Staff,20,0,20,0
1681921090444,TDDE 131,B00,184505,Staff,17,0,18,1
1681921090444,TDDE 131,C00,184534,Staff,49,0,50,1
1681921090444,TDDE 131,D00,184564,Staff,15,0,15,0
1681921090444,TDDE 131,E00,204725,Staff,19,0,20,1
1681921091473,TDGE 1,A01,184414,Salovey; Todd,36,0,50,14
1681921092500,TDGE 5,A01,184419,Staff,23,0,24,1
1681921093524,TDGE 10,A00,184428,Fulton; Julia,29,0,50,21
1681921094563,TDGE 124,A00,184565,Fulton; Julia,7,0,50,43
1681921095585,TDGE 125,B00,184567,Meyer; Ursula,9,0,25,16
1681921096619,TDHT 101,A00,184568,Staff,21,0,25,4
1681921096619,TDHT 101,B00,184569,Staff,20,0,20,0
1681921097645,TDHT 114,A00,184570,Staff,49,0,50,1
1681921098668,TDMV 1,A00,184437,Arcidiacono; Kristin,22,0,30,8
1681921098668,TDMV 1,B00,184448,Caligagan; Maria T.,23,0,30,7
1681921099693,TDMV 2,A00,184449,Weinberg; Sadie,27,0,30,3
1681921099693,TDMV 2,B00,184453,Arcidiacono; Kristin,29,0,30,1
1681921100716,TDMV 110,A00,184571,Weinberg; Sadie,30,0,30,0
1681921101738,TDMV 142,A00,184572,Caligagan; Tony,27,0,30,3
1681921101738,TDMV 142,B00,184573,Caligagan; Maria T.,26,0,30,4
1681921102769,TDTR 20,A00,184482,Jun; Grace Shin Hae,25,0,25,0
1681921103805,USP 2,A01,184290,Hinds; Juli Beth,24,0,25,1
1681921104849,USP 3,A01,184295,Staff,20,0,25,5
1681921105873,USP 4,A00,184304,McTague; Sarah,13,0,25,12
1681921106900,USP 100,A00,184315,Staff,16,0,25,9
1681921107927,USP 105,A00,184326,Staff,21,0,25,4
1681921108949,USP 151,A00,184327,Staff,20,0,25,5
1681921109973,USP 170,A00,184380,Hinds; Juli Beth,14,0,25,11
1681921111002,VIS 21B,A01,182660,Staff,28,0,31,3
1681921111002,VIS 21B,A02,182662,Staff,30,0,31,1
1681921112024,VIS 103D,A00,182663,Staff,74,0,75,1
1681921113047,VIS 105D,A00,182667,Li; Huai,15,0,22,7
1681921114070,VIS 122GS,A00,182668,Herbst; Matthew,20,0,20,0
1681921115097,VIS 128C,A00,182673,Staff,69,0,75,6
1681921116121,VIS 130,A00,182675,Staff,20,0,22,2
1681921117143,VIS 160A,A00,182678,Stalbaum; Brett,4,0,10,6
1681921119196,WCWP 10B,A00,201679,Staff,15,0,15,0
1681921119196,WCWP 10B,B00,201695,Staff,15,0,15,0
1681921120237,WCWP 100,A00,201716,Staff,13,0,15,2
1681921120237,WCWP 100,B00,201717,Staff,8,0,15,7
1681921122295,ANSC 105GS,A00,258289,Staff,0,0,0,0
1681921123320,ANSC 125GS,A00,258295,Staff,0,0,0,0
1681921124346,ANSC 150,A00,258267,Staff,30,0,40,10
1681921125369,ANSC 190GS,A00,258280,Staff,0,0,0,0
1681921126391,ANTH 1,A00,258264,Staff,38,0,40,2
1681921127412,ANTH 2,A01,258259,Staff,72,0,76,4
1681921128436,ANTH 23,A01,258228,Staff,36,0,40,4
1681921129465,ANTH 101,A01,258236,Staff,38,0,40,2
1681921130505,ANTH 102,A00,258272,Staff,59,0,60,1
1681921131533,ANTH 105,A00,258244,Staff,31,0,35,4
1681921132560,BENG 130,A00,253975,Staff,38,0,40,2
1681921133582,BIBC 102,A01,191866,Flagg; Matthew Paul,19,0,32,13
1681921133582,BIBC 102,A02,191867,Flagg; Matthew Paul,22,0,32,10
1681921133582,BIBC 102,A03,191868,Flagg; Matthew Paul,29,0,32,3
1681921133582,BIBC 102,A04,191936,Flagg; Matthew Paul,26,0,32,6
1681921133582,BIBC 102,A05,191937,Flagg; Matthew Paul,5,0,32,27
1681921134608,BICD 100,A01,191939,Cooper; Andrew Michael,28,0,32,4
1681921134608,BICD 100,A02,191940,Cooper; Andrew Michael,32,0,32,0
1681921134608,BICD 100,A03,191941,Cooper; Andrew Michael,32,0,32,0
1681921134608,BICD 100,A04,191942,Cooper; Andrew Michael,32,0,32,0
1681921134608,BICD 100,A05,191943,Cooper; Andrew Michael,32,0,32,0
1681921135633,BIEB 126,A01,191945,Cleland; Elsa Eleanor,0,0,32,32
1681921135633,BIEB 126,A02,191946,Cleland; Elsa Eleanor,27,0,32,5
1681921135633,BIEB 126,A03,191947,Cleland; Elsa Eleanor,29,0,32,3
1681921135633,BIEB 126,A04,191948,Cleland; Elsa Eleanor,23,0,32,9
1681921135633,BIEB 126,A05,191996,Cleland; Elsa Eleanor,28,0,32,4
1681921136656,BIEB 136GS,A00,191997,Shurin; Jonathan & Holway; David A.,0,0,0,3
1681921137679,BIEB 137GS,A01,191999,Shurin; Jonathan & Holway; David A.,0,0,0,2
1681921138701,BILD 1,A01,205385,Staff,31,0,32,1
1681921138701,BILD 1,A02,205386,Staff,30,0,32,2
1681921138701,BILD 1,A03,205387,Staff,32,0,32,0
1681921138701,BILD 1,A04,205388,Staff,27,0,32,5
1681921139729,BILD 2,A01,191774,Staff,28,0,32,4
1681921139729,BILD 2,A02,191775,Staff,30,0,32,2
1681921139729,BILD 2,A03,191777,Staff,30,0,32,2
1681921139729,BILD 2,A04,191856,Staff,31,0,32,1
1681921139729,BILD 2,A05,191857,Staff,32,0,32,0
1681921139729,BILD 2,A06,191858,Staff,32,0,32,0
1681921139729,BILD 2,A07,191859,Staff,31,0,32,1
1681921140752,BILD 3,A01,205391,Staff,29,0,32,3
1681921140752,BILD 3,A02,205393,Staff,32,0,32,0
1681921140752,BILD 3,A03,205394,Staff,28,0,32,4
1681921140752,BILD 3,A04,205395,Staff,32,0,32,0
1681921141779,BILD 20,A01,191861,Staff,32,0,32,0
1681921141779,BILD 20,A02,191862,Staff,32,0,32,0
1681921142812,BILD 30,A01,191864,Staff,31,0,32,1
1681921143843,BIMM 100,A01,192019,Staff,0,0,32,32
1681921143843,BIMM 100,A02,192020,Staff,21,0,32,11
1681921143843,BIMM 100,A03,192035,Staff,21,0,32,11
1681921144868,BIMM 110,A01,192037,Tat; John,0,0,32,32
1681921144868,BIMM 110,A02,192038,Tat; John,9,0,32,23
1681921145891,BIMM 120,A01,192040,Pickett; Brooke Elizabeth,1,0,32,31
1681921145891,BIMM 120,A02,192041,Pickett; Brooke Elizabeth,15,0,32,17
1681921145891,BIMM 120,A03,192042,Pickett; Brooke Elizabeth,15,0,32,17
1681921146917,BIPN 100,A01,192044,Armour; Jon Christopher,25,0,32,7
1681921146917,BIPN 100,A02,192059,Armour; Jon Christopher,30,0,32,2
1681921146917,BIPN 100,A03,192064,Armour; Jon Christopher,30,0,32,2
1681921146917,BIPN 100,A04,192073,Armour; Jon Christopher,28,0,32,4
1681921148029,BIPN 148,A01,205411,Leutgeb; Jill K.,16,0,32,16
1681921148029,BIPN 148,A02,205412,Leutgeb; Jill K.,31,0,32,1
1681921148029,BIPN 148,A03,205413,Leutgeb; Jill K.,30,0,32,2
1681921148029,BIPN 148,A04,205414,Leutgeb; Jill K.,30,0,32,2
1681921149060,BIPN 160,A01,192115,Marino; Marc J,17,0,32,15
1681921149060,BIPN 160,A02,192148,Marino; Marc J,27,0,32,5
1681921149060,BIPN 160,A03,192158,Marino; Marc J,31,0,32,1
1681921149060,BIPN 160,A04,192190,Marino; Marc J,32,0,32,0
1681921149060,BIPN 160,A05,192287,Marino; Marc J,32,0,32,0
1681921149060,BIPN 160,A06,192288,Marino; Marc J,32,0,32,0
1681921150087,BIPN 194,A00,206038,Staff,28,0,32,4
1681921151120,BISP 194,A00,192289,Leutgeb; Stefan,13,0,32,19
1681921151120,BISP 194,B00,245332,Nieh; James Charles,26,0,32,6
1681921152146,CAT 124,A01,202247,Staff,15,0,15,0
1681921153174,CAT 125,A00,202248,Staff,19,0,20,1
1681921153174,CAT 125,B00,202253,Staff,20,0,20,0
1681921153174,CAT 125,C00,202257,Staff,18,0,20,2
1681921154200,CAT 125GS,A01,202273,Bronstein; Phoebe Malan,20,0,20,0
1681921155228,CAT 125R,A00,202284,Staff,17,0,20,3
1681921155228,CAT 125R,C00,202286,Staff,10,0,20,10
1681921155228,CAT 125R,D00,202291,Staff,18,0,20,2
1681921155228,CAT 125R,E00,202295,Staff,13,0,20,7
1681921155228,CAT 125R,F00,202302,Staff,9,0,20,11
1681921156252,CENG 100,A00,204724,Opatkiewicz; Justin Paul,25,0,25,0
1681921157274,CGS 2A,A01,180420,Staff,31,0,36,5
1681921158299,CGS 101,A00,180421,Staff,16,0,20,4
1681921159322,CGS 112,A00,180422,Staff,9,0,16,7
1681921160347,CGS 113,A00,180423,Staff,18,0,20,2
1681921161368,CGS 137,A00,180424,Staff,12,0,12,0
1681921162391,CGS 147,A00,180425,Staff,10,0,10,0
1681921163419,CHEM 6A,A01,179556,Staff,96,0,100,4
1681921163419,CHEM 6A,A02,179558,Staff,0,0,0,0
1681921164442,CHEM 6B,A01,179560,Staff,100,0,100,0
1681921165472,CHEM 6C,A01,179565,Jazzar; Rodolphe,95,0,100,5
1681921166495,CHEM 7L,A01,179586,Schurmeier; Kimberly,11,0,24,13
1681921166495,CHEM 7L,A02,179587,Schurmeier; Kimberly,23,0,24,1
1681921166495,CHEM 7L,A03,179590,Schurmeier; Kimberly,22,0,24,2
1681921166495,CHEM 7L,A04,179591,Schurmeier; Kimberly,22,0,24,2
1681921166495,CHEM 7L,B01,179598,Schurmeier; Kimberly,17,0,24,7
1681921166495,CHEM 7L,B02,179599,Schurmeier; Kimberly,24,0,24,0
1681921166495,CHEM 7L,B03,179606,Schurmeier; Kimberly,23,0,24,1
1681921166495,CHEM 7L,B04,179607,Schurmeier; Kimberly,23,0,24,1
1681921167518,CHEM 11,A01,179609,Stallings; Dontarie M,88,0,100,12
1681921168542,CHEM 40A,A01,179621,Staff,41,0,50,9
1681921168542,CHEM 40A,A02,179622,Staff,47,0,50,3
1681921169565,CHEM 40B,A01,179630,Weizman; Haim,48,0,50,2
1681921169565,CHEM 40B,A02,179631,Weizman; Haim,45,0,50,5
1681921170591,CHEM 41A,A01,179660,Klosterman; Jeremy K,93,0,100,7
1681921171614,CHEM 43A,A01,179683,Klosterman; Jeremy K,0,0,24,24
1681921171614,CHEM 43A,A02,179688,Klosterman; Jeremy K,11,0,24,13
1681921171614,CHEM 43A,A03,179689,Klosterman; Jeremy K,19,0,24,5
1681921171614,CHEM 43A,A04,179691,Klosterman; Jeremy K,18,0,24,6
1681921172640,CHEM 114A,A01,179693,Stallings; Dontarie M,73,0,100,27
1681921173666,CHEM 143B,A01,179698,Weizman; Haim,16,0,24,8
1681921173666,CHEM 143B,A02,179700,Weizman; Haim,24,0,24,0
1681921174710,CHIN 169A,A00,179701,Wang; Xiao,20,0,20,0
1681921175736,COGS 2,A01,179750,Boyle; Mary E. T.,17,0,30,13
1681921176764,COGS 9,A01,179759,Jones; Cameron Robert,42,0,50,8
1681921177789,COGS 14A,A01,179854,Staff,16,0,50,34
1681921178815,COGS 14B,A01,179856,Staff,53,0,60,7
1681921179850,COGS 17,A01,179874,Staff,71,0,75,4
1681921180874,COGS 18,A01,179884,Staff,63,0,80,17
1681921181897,COGS 100,A01,179886,Staff,36,0,60,24
1681921182925,COGS 101B,A01,179892,Staff,1,0,30,29
1681921183953,COGS 101C,A01,179894,Staff,28,0,30,2
1681921184977,COGS 107A,A01,179896,Boyle; Mary E. T.,31,0,40,9
1681921186004,COGS 108,A01,179898,Simpkins; Charles Alexander,0,23,60,60
1681921187028,COGS 109,A01,179900,Staff,34,0,40,6
1681921188064,COGS 118A,A01,179946,Staff,8,0,40,32
1681921189090,COGS 153,A00,179978,Staff,0,2,30,30
1681921190114,COGS 156,A01,179981,Staff,25,0,30,5
1681921192159,COGS 172,A01,179987,Staff,13,0,30,17
1681921194210,COGS 186,A01,179991,Staff,12,0,30,18
1681921195235,COMM 10,A01,180001,Staff,14,0,25,11
1681921195235,COMM 10,A02,180004,Staff,20,0,25,5
1681921196261,COMM 100A,A01,180016,Staff,15,0,25,10
1681921196261,COMM 100A,A02,180020,Staff,24,0,25,1
1681921197293,COMM 101T,A00,180029,Halm; Gavin Patrick,23,0,35,12
1681921198316,COMM 106V,A00,180043,Staff,34,0,35,1
1681921199340,COMM 109P,A00,180044,Staff,30,0,35,5
1681921200363,COMM 113T,A00,180045,Havis; Allan,37,0,45,8
1681921201393,COMM 132,A00,180046,McKenna; Denise,23,0,30,7
1681921202419,COMM 143,A00,180047,Staff,18,0,30,12
1681921203442,COMM 190,A00,180048,Conner; Thomas Hartnell,19,0,23,4
1681921204469,CSE 8A,A50,180053,Cao; Yingjun,25,0,50,25
1681921204469,CSE 8A,B50,180180,Staff,50,0,50,0
1681921205499,CSE 11,A01,180190,Cao; Yingjun,26,0,50,24
1681921206532,CSE 20,A01,180192,Briones; Jor-el Thomas Caparas,23,0,30,7
1681921207559,CSE 21,A01,194538,Briones; Jor-el Thomas Caparas,50,0,60,10
1681921208585,CSE 30,A01,180324,Eldon; John,76,0,100,24
1681921209615,CSE 101,A01,201353,Staff,0,24,40,40
1681921210638,CSE 134B,A01,180326,Powell; Thomas Allan,74,0,100,26
1681921211663,CSE 140,A01,180328,Staff,41,0,75,34
1681921212689,CSE 140L,A01,180344,Eldon; John,64,0,100,36
1681921213713,CSE 150A,A01,180411,Staff,0,11,50,50
1681921214737,CSE 151A,A01,180414,Staff,0,8,50,50
1681921215759,CSE 175,A01,222521,Kumar; Rakesh,50,0,50,0
1681921216784,CSE 190,A00,201419,Staff,44,0,49,5
1681921217808,CSS 1,A01,194536,Staff,37,0,50,13
1681921218836,DSC 30,A01,202385,Staff,48,0,50,2
1681921219860,DSC 40A,A01,202387,Albuyeh; Rod,50,0,50,0
1681921220887,DSC 190,A01,202389,Silberman; Jack,21,0,21,0
1681921221912,DSGN 100,A01,179993,Staff,16,0,30,14
1681921222942,ECE 65,A50,180708,Staff,10,0,20,10
1681921222942,ECE 65,A51,180739,Staff,19,0,20,1
1681921223969,ECON 1,A01,180427,Famulari; Melissa,67,0,70,3
1681921224998,ECON 2,A01,180450,Levkoff; Steven B.,64,0,70,6
1681921226021,ECON 4,A01,203351,Anderson; John Charles,6,0,10,4
1681921227049,ECON 100A,A01,180472,Famulari; Melissa,64,0,70,6
1681921228073,ECON 120A,A01,180549,Staff,64,0,70,6
1681921229106,ECON 120B,A01,180655,Ma; Xinwei,43,0,70,27
1681921230129,ECON 129,A00,203333,Eckert; Fabian Paul,13,0,35,22
1681921231154,ECON 131,A00,180656,Staff,6,0,35,29
1681921232177,ECON 172B,A01,180672,Levkoff; Steven B.,31,0,35,4
1681921233202,ECON 178,A01,203342,Zhu; Ying,9,0,35,26
1681921234224,EDS 108GS,A00,202383,Wishard Guerra; Alison G.,20,0,20,0
1681921235248,EDS 111GS,A00,202347,Wishard Guerra; Alison G.,20,0,20,0
1681921236270,EDS 112,A01,202323,Staff,55,0,60,5
1681921237293,EDS 113,A00,202340,Staff,32,0,35,3
1681921238315,EDS 118,A00,201231,Staff,20,0,30,10
1681921239341,EDS 119,A00,204994,Staff,8,0,10,2
1681921240366,EDS 124BR,A00,202324,Eguchi; Emi,4,0,25,21
1681921241389,EDS 126,A01,203208,Jones; Makeba,26,0,30,4
1681921242414,EDS 135,A01,202333,Staff,18,0,20,2
1681921243453,EDS 180,A00,202311,Staff,47,0,50,3
1681921244487,ERC 190GS,A01,253747,Staff,28,0,28,0
1681921245509,ETHN 104,A00,180742,Staff,23,0,35,12
1681921246535,ETHN 118,A00,180745,Staff,27,0,35,8
1681921247561,ETHN 127,A00,180747,Staff,12,0,16,4
1681921248587,ETHN 137,A00,180880,Staff,11,0,12,1
1681921249612,ETHN 147,A00,180890,Staff,8,0,10,2
1681921250639,ETHN 154,A00,180891,Staff,7,0,8,1
1681921251746,ETHN 168,A00,180892,Staff,9,0,10,1
1681921252772,GLBH 20,A00,201051,Hannah; Seth Donal,0,2,0,1
1681921253799,GLBH 111,A01,209338,Burgos; Jose L.,0,0,0,0
1681921254827,GLBH 150,A00,258300,Staff,0,3,0,0
1681921255850,GLBH 181,A00,201207,Staff,13,0,40,27
1681921256874,HIEU 109,A00,180898,Staff,20,0,20,0
1681921257899,HIEU 111,A00,180899,Staff,0,0,20,20
1681921258928,HIEU 124,A00,180900,Staff,17,0,20,3
1681921259955,HILA 122,A00,180901,Staff,18,0,20,2
1681921260981,HILA 132,A00,180902,Vitz; Matthew,2,0,20,18
1681921262010,HILD 10,A01,180896,Staff,15,0,20,5
1681921263038,HILD 30GS,A00,180897,Edington; Claire Ellen,0,0,0,0
1681921264065,HISC 105,A00,180903,Staff,20,0,20,0
1681921265090,HISC 117,A00,180904,Staff,11,0,20,9
1681921266113,HIUS 108B,A00,181005,Staff,18,0,20,2
1681921267139,HIUS 113,A00,181093,Staff,3,0,20,17
1681921268163,HUM 3,A01,181190,Patterson; Patrick H.,39,0,50,11
1681921268163,HUM 3,B01,181195,Staff,46,0,50,4
1681921269193,HUM 3GS,A00,181196,Herbst; Matthew,0,0,0,0
1681921270220,HUM 4,A01,181227,West; Geoffrey Scott,33,0,50,17
1681921270220,HUM 4,B01,181282,Staff,42,0,50,8
1681921271244,HUM 4GS,A00,181377,Lyon; Antony J.,0,0,0,0
1681921272270,HUM 5,A01,181536,Zavodny; Tatiana Sophia,28,0,50,22
1681921272270,HUM 5,B01,181908,Staff,36,0,50,14
1681921273299,INTL 190,A00,181909,Segui; Alan S,0,0,0,8
1681921273299,INTL 190,B00,181961,Segui; Alan S,0,0,0,7
1681921274329,JAPN 20AR,A01,182113,Ross; Kayoko F,15,0,20,5
1681921275352,LATI 50,A01,202391,Martin-Cabrera; Luis,18,0,30,12
1681921275352,LATI 50,A02,202392,Martin-Cabrera; Luis,26,0,30,4
1681921276375,LATI 180,A00,202393,Kokinis; Troy Andreas,24,0,25,1
1681921277399,LIFR 1A,A00,182119,Staff,14,0,14,0
1681921278426,LIFR 1AX,A00,182324,Staff,14,0,14,0
1681921279461,LIFR 1B,A00,182259,Staff,13,0,14,1
1681921280487,LIFR 1BX,A00,182273,Staff,13,0,14,1
1681921281513,LIGN 8,A00,182330,Staff,135,0,150,15
1681921282538,LIGN 9GS,A00,182362,Staff,20,0,20,0
1681921283560,LIGN 119,A00,204992,Takahashi; Maho,12,0,15,3
1681921284583,LIGN 130,A01,182384,Staff,47,0,50,3
1681921285608,LIGN 149GS,A00,182390,Staff,20,0,20,0
1681921286644,LIGN 170,A00,182404,Staff,23,0,30,7
1681921287666,LISP 1D,A00,182281,Staff,7,0,14,7
1681921287666,LISP 1D,B00,182287,Staff,14,0,14,0
1681921287666,LISP 1D,C00,182295,Staff,11,0,14,3
1681921287666,LISP 1D,D00,182301,Staff,14,0,14,0
1681921288691,LISP 1DX,A00,182309,Staff,20,0,28,8
1681921288691,LISP 1DX,B00,182316,Staff,26,0,28,2
1681921289712,LTAF 120GS,A00,182412,Zhiri; Oumelbanine,20,0,20,0
1681921290735,LTCS 172GS,A00,182437,Bronstein; Phoebe Malan,20,0,20,0
1681921291758,LTEA 138,A00,182457,Staff,20,0,40,20
1681921292782,LTEN 114,A01,182490,Staff,23,0,25,2
1681921293806,LTEN 130GS,A00,182491,Lyon; Antony J.,20,0,20,0
1681921294828,LTEN 169,A00,182493,Cuong; Marisol,19,0,25,6
1681921295852,LTEN 178,A00,182501,Staff,14,0,15,1
1681921296875,LTEN 181,A00,182515,Staff,22,0,25,3
1681921297899,LTEN 185GS,A00,197655,Forbes; Camille,20,0,20,0
1681921298922,LTSP 100B,A00,202208,Bessett; Ryan Matthew,24,0,25,1
1681921299947,LTWL 100,A00,182516,Myerston Santana; Jacobo,21,0,30,9
1681921300969,LTWR 100GS,A00,182518,Forbes; Camille,20,0,20,0
1681921301994,LTWR 102,A00,182522,Staff,15,0,15,0
1681921301994,LTWR 102,B00,182525,Staff,14,0,15,1
1681921303027,LTWR 115,A00,182526,Staff,11,0,15,4
1681921304050,MAE 8,A01,182528,Pham; Hieu Tan,67,0,70,3
1681921305076,MAE 11,A00,182529,Bahadori; Mohammad Yousef,93,0,100,7
1681921306099,MAE 20,A00,182530,Evdokimenko; Ekaterina,68,0,70,2
1681921307124,MAE 30A,A00,182532,Staff,44,0,45,1
1681921308150,MAE 101A,A00,182533,Bahadori; Mohammad Yousef,95,0,100,5
1681921309177,MAE 101C,A00,182538,Staff,62,0,70,8
1681921310199,MAE 104,A00,182539,Staff,44,0,50,6
1681921311223,MAE 131A,A00,182540,Ghazinejad; Maziar,40,0,45,5
1681921312247,MAE 143A,A00,182548,Bewley; Thomas R,43,0,50,7
1681921313269,MAE 150,A00,182549,Staff,28,0,40,12
1681921314291,MAE 160,A00,182550,Evdokimenko; Ekaterina,42,0,60,18
1681921315313,MATH 3C,A01,182725,Staff,26,0,30,4
1681921316335,MATH 10A,A01,182729,Staff,25,0,30,5
1681921316335,MATH 10A,B01,182732,Staff,26,0,30,4
1681921317358,MATH 10B,A01,182737,Staff,21,0,30,9
1681921317358,MATH 10B,A02,182738,Staff,26,0,30,4
1681921317358,MATH 10B,B01,182744,Staff,27,0,30,3
1681921317358,MATH 10B,B02,182745,Staff,27,0,30,3
1681921318389,MATH 18,A01,182750,Anzaldo; Leesa B,28,0,30,2
1681921318389,MATH 18,A02,182751,Anzaldo; Leesa B,29,0,30,1
1681921318389,MATH 18,A03,182753,Anzaldo; Leesa B,27,0,30,3
1681921318389,MATH 18,A04,182757,Anzaldo; Leesa B,29,0,30,1
1681921318389,MATH 18,B01,182761,Anzaldo; Leesa B,27,0,30,3
1681921318389,MATH 18,B02,182764,Anzaldo; Leesa B,26,0,30,4
1681921318389,MATH 18,B03,182765,Anzaldo; Leesa B,29,0,30,1
1681921318389,MATH 18,B04,182766,Anzaldo; Leesa B,30,0,30,0
1681921319411,MATH 20A,A01,182771,Suk; Andrew Hoon,28,0,30,2
1681921320437,MATH 20B,A01,182775,Bach; Quang Tran,30,0,30,0
1681921320437,MATH 20B,A02,182777,Bach; Quang Tran,29,0,30,1
1681921320437,MATH 20B,B01,182780,Bach; Quang Tran,26,0,30,4
1681921320437,MATH 20B,B02,182782,Bach; Quang Tran,30,0,30,0
1681921321473,MATH 20C,A01,182787,Staff,25,0,30,5
1681921321473,MATH 20C,A02,182790,Staff,29,0,30,1
1681921321473,MATH 20C,B01,182792,Staff,25,0,30,5
1681921321473,MATH 20C,B02,182796,Staff,26,0,30,4
1681921322498,MATH 20D,A01,182799,Staff,28,0,30,2
1681921322498,MATH 20D,A02,182802,Staff,29,0,30,1
1681921322498,MATH 20D,A03,182803,Staff,30,0,30,0
1681921323522,MATH 20E,A01,182809,Verstraete; Jacques Allan,23,0,30,7
1681921323522,MATH 20E,A02,182811,Verstraete; Jacques Allan,28,0,30,2
1681921323522,MATH 20E,B01,182814,Verstraete; Jacques Allan,23,0,30,7
1681921323522,MATH 20E,B02,182815,Verstraete; Jacques Allan,30,0,30,0
1681921324550,MATH 103A,A01,182820,Staff,8,0,30,22
1681921324550,MATH 103A,A02,182821,Staff,27,0,30,3
1681921324550,MATH 103A,A03,182822,Staff,23,0,30,7
1681921324550,MATH 103A,B01,182825,Staff,23,0,30,7
1681921324550,MATH 103A,B02,182826,Staff,30,0,30,0
1681921324550,MATH 103A,B03,182830,Staff,30,0,30,0
1681921325573,MATH 109,A01,182836,Chow; Bennett,24,0,30,6
1681921325573,MATH 109,A02,182838,Chow; Bennett,29,0,30,1
1681921325573,MATH 109,A03,182894,Chow; Bennett,29,0,30,1
1681921325573,MATH 109,B01,182908,Chow; Bennett,27,0,30,3
1681921325573,MATH 109,B02,182909,Chow; Bennett,30,0,30,0
1681921325573,MATH 109,B03,182910,Chow; Bennett,27,0,30,3
1681921326599,MATH 142A,A01,182925,Staff,9,0,30,21
1681921326599,MATH 142A,A02,182935,Staff,24,0,30,6
1681921326599,MATH 142A,A03,182967,Staff,26,0,30,4
1681921326599,MATH 142A,B01,183125,Staff,22,0,30,8
1681921326599,MATH 142A,B02,183157,Staff,28,0,30,2
1681921326599,MATH 142A,B03,183158,Staff,29,0,30,1
1681921327634,MATH 183,A01,183160,Arias-Castro; Ery,23,0,30,7
1681921327634,MATH 183,A02,183161,Arias-Castro; Ery,29,0,30,1
1681921327634,MATH 183,B01,183163,Arias-Castro; Ery,28,0,30,2
1681921327634,MATH 183,B02,183164,Arias-Castro; Ery,28,0,30,2
1681921328668,MATH 193A,A01,183167,Staff,3,0,35,32
1681921328668,MATH 193A,A02,183168,Staff,28,0,35,7
1681921328668,MATH 193A,A03,183169,Staff,34,0,35,1
1681921328668,MATH 193A,A04,183170,Staff,28,0,35,7
1681921329694,MGT 4,A01,202395,Anderson; John Charles,75,0,80,5
1681921330719,MGT 5,A00,202396,Houskeeper; Robert,79,0,90,11
1681921331742,MGT 103,A00,202397,Eberhard; Craig A,50,0,90,40
1681921332768,MGT 131A,A00,202398,Houskeeper; Robert,84,0,90,6
1681921333796,MGT 135,A00,202399,Anderson; John Charles,81,0,90,9
1681921334822,MGT 162R,A00,202403,Gneezy; Uri,140,0,200,60
1681921335848,MGT 172,A00,202404,Hedges; Kathleen,45,0,90,45
1681921336871,MGT 181,A00,202405,Dunn; Louis Jean,81,0,90,9
1681921337899,MMW 14,A01,183200,Staff,11,0,28,17
1681921337899,MMW 14,A02,183201,Staff,26,0,28,2
1681921337899,MMW 14,A03,183202,Staff,24,0,28,4
1681921337899,MMW 14,A04,183203,Staff,25,0,28,3
1681921337899,MMW 14,A05,183204,Staff,26,0,28,2
1681921337899,MMW 14,A06,183205,Staff,27,0,28,1
1681921337899,MMW 14,B01,183207,Staff,26,0,28,2
1681921337899,MMW 14,B02,183208,Staff,28,0,28,0
1681921337899,MMW 14,B03,183209,Staff,28,0,28,0
1681921337899,MMW 14,B04,183210,Staff,28,0,28,0
1681921337899,MMW 14,B05,183211,Staff,28,0,28,0
1681921337899,MMW 14,B06,183212,Staff,27,0,28,1
1681921338922,MMW 14GS,A00,183213,Zhiri; Oumelbanine,28,0,28,0
1681921339950,MMW 15GS,B00,183215,Rahimi; Babak,28,0,28,0
1681921340977,MMW 121,A01,183217,Patterson; Patrick H.,13,0,28,15
1681921340977,MMW 121,A02,183218,Patterson; Patrick H.,25,0,28,3
1681921342002,MUS 1A,A01,182554,Staff,7,0,35,28
1681921343034,MUS 5,A01,182558,Staff,19,0,35,16
1681921344057,MUS 6,A01,182562,Staff,22,0,35,13
1681921345081,MUS 8GS,A00,182563,Borgo; David Garcia,25,0,25,0
1681921346107,MUS 13,A01,182567,Staff,24,0,25,1
1681921347141,MUS 15,A01,182570,Staff,32,0,35,3
1681921347141,MUS 15,B01,182575,Staff,9,0,35,26
1681921348168,MUS 80,A00,182578,Staff,23,0,25,2
1681921348168,MUS 80,B00,182581,Staff,20,0,25,5
1681921349195,MUS 113,A00,182582,Staff,25,0,25,0
1681921350223,MUS 114,A00,182583,Staff,3,0,25,22
1681921351249,MUS 150GS,A01,182588,Borgo; David Garcia,25,0,25,0
1681921352272,PHIL 1,A00,182590,Staff,35,0,40,5
1681921353295,PHIL 10,A01,182596,Grush; Rick Scott,31,0,35,4
1681921353295,PHIL 10,A02,182597,Grush; Rick Scott,34,0,35,1
1681921354323,PHIL 15,A01,182601,Staff,31,0,35,4
1681921354323,PHIL 15,A02,182602,Staff,33,0,35,2
1681921355419,PHIL 27,A01,182604,Staff,30,0,35,5
1681921355419,PHIL 27,A02,182607,Staff,35,0,35,0
1681921356444,PHIL 32,A01,182609,Staff,35,0,35,0
1681921356444,PHIL 32,A02,182612,Staff,35,0,35,0
1681921357466,PHIL 130,A00,182614,Staff,62,0,70,8
1681921358487,PHIL 136,A00,182616,Cohen; Jonathan David,66,0,70,4
1681921359512,PHIL 155,A00,182617,Vargas; Manuel Rogelio,58,0,70,12
1681921360544,PHIL 163,A01,182620,Staff,15,0,20,5
1681921360544,PHIL 163,A02,182624,Staff,10,0,20,10
1681921361567,PHIL 164,A00,182627,Staff,30,0,40,10
1681921362590,PHIL 173,A00,182628,Staff,36,0,40,4
1681921363618,PHYS 1A,A00,183221,Staff,54,0,60,6
1681921364652,PHYS 1AL,001,183222,Staff,25,0,30,5
1681921364652,PHYS 1AL,002,183223,Staff,28,0,30,2
1681921365686,PHYS 1B,A00,183231,Staff,43,0,60,17
1681921366714,PHYS 1BL,001,183232,Staff,20,0,30,10
1681921366714,PHYS 1BL,002,183233,Staff,27,0,30,3
1681921367737,PHYS 1C,A00,183240,Staff,28,0,60,32
1681921368763,PHYS 1CL,001,183241,Staff,11,0,30,19
1681921368763,PHYS 1CL,002,183242,Staff,22,0,30,8
1681921369788,PHYS 2AR,A01,183250,Staff,43,0,50,7
1681921370813,PHYS 2B,A01,183252,Staff,104,0,115,11
1681921371842,PHYS 2BL,A01,183254,Staff,21,0,24,3
1681921371842,PHYS 2BL,A02,183255,Staff,22,0,24,2
1681921372874,PHYS 2C,A01,183522,Staff,103,0,115,12
1681921373909,PHYS 4A,A01,183524,Staff,49,0,50,1
1681921374933,POLI 5,A00,183525,Staff,44,0,50,6
1681921375964,POLI 12,A00,183540,Staff,46,0,50,4
1681921376990,POLI 13R,A00,183541,Forman; Fonna,42,0,50,8
1681921378017,POLI 30,A00,183542,Mignozzetti; Umberto,47,0,50,3
1681921379043,POLI 100A,A00,183543,Staff,45,0,50,5
1681921380069,POLI 100E,A00,223598,Staff,32,0,35,3
1681921381095,POLI 103A,A00,183564,Kousser; Thad,37,0,50,13
1681921382121,POLI 104B,A00,201329,Staff,28,0,35,7
1681921383149,POLI 113BR,A00,183576,Hoston; Germaine,25,0,50,25
1681921384177,POLI 114BR,A00,183588,Staff,27,0,30,3
1681921385199,POLI 117R,A00,183595,Forman; Fonna,7,0,20,13
1681921386226,POLI 120H,A00,183596,Fisk; David Lee,13,0,20,7
1681921387253,POLI 130AA,A00,183597,Staff,14,0,20,6
1681921388290,POLI 134AA,A00,183598,Staff,19,0,20,1
1681921389321,POLI 135,A00,183599,Fisk; David Lee,20,0,25,5
1681921390350,POLI 142P,A00,183623,Staff,37,0,40,3
1681921391373,POLI 144D,A00,183624,Staff,22,0,25,3
1681921392396,POLI 151,A00,183625,Staff,15,0,20,5
1681921393419,POLI 162,A00,183626,Mignozzetti; Umberto,18,0,20,2
1681921394443,PSYC 1,A00,253748,Staff,86,0,90,4
1681921395475,PSYC 2,A00,183627,Moranton; Nirelia Melbina-,25,0,35,10
1681921396500,PSYC 3,A00,183628,Staff,43,0,45,2
1681921398565,PSYC 60,A01,183631,Lowe; Angela Beth,35,0,40,5
1681921399593,PSYC 70,A01,253757,Staff,37,0,45,8
1681921400621,PSYC 101,A00,183632,Heyman; Gail D.,47,0,60,13
1681921401647,PSYC 105,A00,183848,Lowe; Angela Beth,48,0,60,12
1681921402672,PSYC 106,A00,183849,Dobkins; Karen R.,43,0,60,17
1681921403698,PSYC 108,A00,253750,Staff,23,0,60,37
1681921404726,PSYC 114,A01,184275,Winkielman; Piotr,0,7,30,30
1681921405754,PSYC 122,A00,183856,Moranton; Nirelia Melbina-,0,13,30,30
1681921406780,PSYC 124,A00,183865,Chapman; Eddie Nathaniel,49,0,80,31
1681921407805,PSYC 137,A00,183880,Staff,19,0,25,6
1681921409865,PSYC 154,A00,183910,Lacefield; Katharine I,0,12,90,90
1681921411925,PSYC 162,A00,183946,Wixted; John T,56,0,90,34
1681921412948,PSYC 172,A00,183947,Gorman; Michael R.,10,0,30,20
1681921413973,PSYC 178,A00,183963,Glaser; Dale,18,0,40,22
1681921414995,PSYC 181GS,A00,183964,Anagnostaras; Stephan,10,0,10,0
1681921416016,PSYC 186GS,A01,257660,Staff,10,0,10,0
1681921417042,PSYC 193,B00,253749,Staff,23,0,25,2
1681921419094,PSYC 193L,A01,184122,Staff,33,0,35,2
1681921419094,PSYC 193L,C01,184167,Winkielman; Piotr,15,0,30,15
1681921420120,RELI 188GS,A00,182629,Rahimi; Babak,20,0,20,0
1681921421147,SE 101A,A00,182646,Staff,26,0,30,4
1681921422170,SE 101C,A00,182650,Staff,17,0,20,3
1681921423201,SE 110A,A00,182651,Staff,28,0,28,0
1681921424225,SE 130A,A00,182652,Staff,39,0,40,1
1681921425253,SIO 46GS,A00,182636,Cook; Geoffrey W,27,0,28,1
1681921426278,SIO 109R,A00,194459,Staff,5,0,20,15
1681921427305,SIO 121GS,A00,182639,Cook; Geoffrey W,27,0,28,1
1681921428335,SIO 132,A01,182642,Staff,32,0,40,8
1681921429359,SIO 139,A00,182644,Kacev; David,36,0,40,4
1681921430384,SOCI 2,A01,258404,Staff,33,0,36,3
1681921430384,SOCI 2,A02,258405,Staff,35,0,36,1
1681921431416,SOCI 60,A01,258408,Staff,29,0,30,1
1681921431416,SOCI 60,A02,258413,Staff,30,0,30,0
1681921432441,SOCI 100,A01,258415,Staff,29,0,30,1
1681921432441,SOCI 100,A02,258416,Staff,28,0,30,2
1681921438594,SOCI 127,A00,258421,Staff,21,0,30,9
1681921439623,SOCI 132,A00,258422,Staff,45,0,50,5
1681921440646,SOCI 133,A00,258423,Staff,26,0,30,4
1681921441694,SOCI 138GS,A00,258424,Staff,15,0,15,0
1681921442721,SOCI 145,A00,258425,Staff,25,0,30,5
1681921443747,SOCI 148,A00,258426,Staff,25,0,30,5
1681921444771,SOCI 153,A00,199217,Staff,29,0,30,1
1681921445794,SOCI 160,A00,258427,Staff,28,0,30,2
1681921446824,SOCI 160E,A00,258435,Staff,56,0,60,4
1681921447849,SOCI 189GS,A00,258436,Staff,15,0,15,0
1681921448882,SOCI 190GS,A00,258437,Staff,15,0,15,0
1681921449906,SYN 2,001,182658,Staff,8,0,16,8
1681921449906,SYN 2,002,201439,Staff,14,0,16,2
1681921449906,SYN 2,003,201443,Staff,16,0,16,0
1681921450934,SYN 100,A01,182657,Staff,16,0,20,4
1681921451961,TDAC 1,A00,184381,Salovey; Todd,16,0,20,4
1681921451961,TDAC 1,B00,184385,Harting; Carla Kelso,19,0,20,1
1681921451961,TDAC 1,C00,184394,Staff,19,0,20,1
1681921452983,TDAC 101,A00,184483,Harting; Carla Kelso,19,0,20,1
1681921454004,TDDE 111,A00,184496,Staff,14,0,15,1
1681921455040,TDDE 131,A00,184504,Staff,20,0,20,0
1681921455040,TDDE 131,B00,184505,Staff,17,0,18,1
1681921455040,TDDE 131,C00,184534,Staff,49,0,50,1
1681921455040,TDDE 131,D00,184564,Staff,15,0,15,0
1681921455040,TDDE 131,E00,204725,Staff,19,0,20,1
1681921456065,TDGE 1,A01,184414,Salovey; Todd,36,0,50,14
1681921457091,TDGE 5,A01,184419,Staff,23,0,24,1
1681921458115,TDGE 10,A00,184428,Fulton; Julia,29,0,50,21
1681921459226,TDGE 124,A00,184565,Fulton; Julia,7,0,50,43
1681921460249,TDGE 125,B00,184567,Meyer; Ursula,9,0,25,16
1681921461276,TDHT 101,A00,184568,Staff,21,0,25,4
1681921461276,TDHT 101,B00,184569,Staff,20,0,20,0
1681921462300,TDHT 114,A00,184570,Staff,49,0,50,1
1681921463327,TDMV 1,A00,184437,Arcidiacono; Kristin,22,0,30,8
1681921463327,TDMV 1,B00,184448,Caligagan; Maria T.,23,0,30,7
1681921464354,TDMV 2,A00,184449,Weinberg; Sadie,27,0,30,3
1681921464354,TDMV 2,B00,184453,Arcidiacono; Kristin,29,0,30,1
1681921465380,TDMV 110,A00,184571,Weinberg; Sadie,30,0,30,0
1681921466419,TDMV 142,A00,184572,Caligagan; Tony,27,0,30,3
1681921466419,TDMV 142,B00,184573,Caligagan; Maria T.,26,0,30,4
1681921467444,TDTR 20,A00,184482,Jun; Grace Shin Hae,25,0,25,0
1681921468466,USP 2,A01,184290,Hinds; Juli Beth,24,0,25,1
1681921469499,USP 3,A01,184295,Staff,20,0,25,5
1681921470525,USP 4,A00,184304,McTague; Sarah,13,0,25,12
1681921471546,USP 100,A00,184315,Staff,16,0,25,9
1681921472569,USP 105,A00,184326,Staff,21,0,25,4
1681921473591,USP 151,A00,184327,Staff,20,0,25,5
1681921474617,USP 170,A00,184380,Hinds; Juli Beth,13,0,25,12
1681921475647,VIS 21B,A01,182660,Staff,28,0,31,3
1681921475647,VIS 21B,A02,182662,Staff,30,0,31,1
1681921476670,VIS 103D,A00,182663,Staff,74,0,75,1
1681921477697,VIS 105D,A00,182667,Li; Huai,14,0,22,8
1681921478722,VIS 122GS,A00,182668,Herbst; Matthew,20,0,20,0
1681921479745,VIS 128C,A00,182673,Staff,69,0,75,6
1681921480770,VIS 130,A00,182675,Staff,20,0,22,2
1681921481797,VIS 160A,A00,182678,Stalbaum; Brett,4,0,10,6
1681921483847,WCWP 10B,A00,201679,Staff,15,0,15,0
1681921483847,WCWP 10B,B00,201695,Staff,15,0,15,0
1681921484880,WCWP 100,A00,201716,Staff,13,0,15,2
1681921484880,WCWP 100,B00,201717,Staff,6,0,15,9
1681921486934,ANSC 105GS,A00,258289,Staff,0,0,0,0
1681921487957,ANSC 125GS,A00,258295,Staff,0,0,0,0
1681921488984,ANSC 150,A00,258267,Staff,30,0,40,10
1681921490007,ANSC 190GS,A00,258280,Staff,0,0,0,0
1681921491033,ANTH 1,A00,258264,Staff,38,0,40,2
1681921492058,ANTH 2,A01,258259,Staff,72,0,76,4
1681921493081,ANTH 23,A01,258228,Staff,36,0,40,4
1681921494106,ANTH 101,A01,258236,Staff,38,0,40,2
1681921495129,ANTH 102,A00,258272,Staff,59,0,60,1
1681921496164,ANTH 105,A00,258244,Staff,31,0,35,4
1681921497190,BENG 130,A00,253975,Staff,38,0,40,2
1681921498221,BIBC 102,A01,191866,Flagg; Matthew Paul,19,0,32,13
1681921498221,BIBC 102,A02,191867,Flagg; Matthew Paul,22,0,32,10
1681921498221,BIBC 102,A03,191868,Flagg; Matthew Paul,29,0,32,3
1681921498221,BIBC 102,A04,191936,Flagg; Matthew Paul,26,0,32,6
1681921498221,BIBC 102,A05,191937,Flagg; Matthew Paul,5,0,32,27
1681921499248,BICD 100,A01,191939,Cooper; Andrew Michael,28,0,32,4
1681921499248,BICD 100,A02,191940,Cooper; Andrew Michael,32,0,32,0
1681921499248,BICD 100,A03,191941,Cooper; Andrew Michael,32,0,32,0
1681921499248,BICD 100,A04,191942,Cooper; Andrew Michael,32,0,32,0
1681921499248,BICD 100,A05,191943,Cooper; Andrew Michael,32,0,32,0
1681921500274,BIEB 126,A01,191945,Cleland; Elsa Eleanor,0,0,32,32
1681921500274,BIEB 126,A02,191946,Cleland; Elsa Eleanor,27,0,32,5
1681921500274,BIEB 126,A03,191947,Cleland; Elsa Eleanor,29,0,32,3
1681921500274,BIEB 126,A04,191948,Cleland; Elsa Eleanor,23,0,32,9
1681921500274,BIEB 126,A05,191996,Cleland; Elsa Eleanor,28,0,32,4
1681921501426,BIEB 136GS,A00,191997,Shurin; Jonathan & Holway; David A.,0,0,0,3
1681921502462,BIEB 137GS,A01,191999,Shurin; Jonathan & Holway; David A.,0,0,0,2
1681921503488,BILD 1,A01,205385,Staff,31,0,32,1
1681921503488,BILD 1,A02,205386,Staff,30,0,32,2
1681921503488,BILD 1,A03,205387,Staff,32,0,32,0
1681921503488,BILD 1,A04,205388,Staff,27,0,32,5
1681921504515,BILD 2,A01,191774,Staff,28,0,32,4
1681921504515,BILD 2,A02,191775,Staff,30,0,32,2
1681921504515,BILD 2,A03,191777,Staff,30,0,32,2
1681921504515,BILD 2,A04,191856,Staff,31,0,32,1
1681921504515,BILD 2,A05,191857,Staff,32,0,32,0
1681921504515,BILD 2,A06,191858,Staff,32,0,32,0
1681921504515,BILD 2,A07,191859,Staff,31,0,32,1
1681921505542,BILD 3,A01,205391,Staff,29,0,32,3
1681921505542,BILD 3,A02,205393,Staff,32,0,32,0
1681921505542,BILD 3,A03,205394,Staff,28,0,32,4
1681921505542,BILD 3,A04,205395,Staff,32,0,32,0
1681921506581,BILD 20,A01,191861,Staff,32,0,32,0
1681921506581,BILD 20,A02,191862,Staff,32,0,32,0
1681921507604,BILD 30,A01,191864,Staff,31,0,32,1
1681921508630,BIMM 100,A01,192019,Staff,0,0,32,32
1681921508630,BIMM 100,A02,192020,Staff,21,0,32,11
1681921508630,BIMM 100,A03,192035,Staff,21,0,32,11
1681921509655,BIMM 110,A01,192037,Tat; John,0,0,32,32
1681921509655,BIMM 110,A02,192038,Tat; John,9,0,32,23
1681921510685,BIMM 120,A01,192040,Pickett; Brooke Elizabeth,1,0,32,31
1681921510685,BIMM 120,A02,192041,Pickett; Brooke Elizabeth,15,0,32,17
1681921510685,BIMM 120,A03,192042,Pickett; Brooke Elizabeth,15,0,32,17
1681921511711,BIPN 100,A01,192044,Armour; Jon Christopher,24,0,32,8
1681921511711,BIPN 100,A02,192059,Armour; Jon Christopher,30,0,32,2
1681921511711,BIPN 100,A03,192064,Armour; Jon Christopher,30,0,32,2
1681921511711,BIPN 100,A04,192073,Armour; Jon Christopher,28,0,32,4
1681921512748,BIPN 148,A01,205411,Leutgeb; Jill K.,16,0,32,16
1681921512748,BIPN 148,A02,205412,Leutgeb; Jill K.,31,0,32,1
1681921512748,BIPN 148,A03,205413,Leutgeb; Jill K.,30,0,32,2
1681921512748,BIPN 148,A04,205414,Leutgeb; Jill K.,30,0,32,2
1681921513770,BIPN 160,A01,192115,Marino; Marc J,17,0,32,15
1681921513770,BIPN 160,A02,192148,Marino; Marc J,27,0,32,5
1681921513770,BIPN 160,A03,192158,Marino; Marc J,31,0,32,1
1681921513770,BIPN 160,A04,192190,Marino; Marc J,32,0,32,0
1681921513770,BIPN 160,A05,192287,Marino; Marc J,32,0,32,0
1681921513770,BIPN 160,A06,192288,Marino; Marc J,32,0,32,0
1681921514796,BIPN 194,A00,206038,Staff,28,0,32,4
1681921515820,BISP 194,A00,192289,Leutgeb; Stefan,13,0,32,19
1681921515820,BISP 194,B00,245332,Nieh; James Charles,26,0,32,6
1681921516847,CAT 124,A01,202247,Staff,15,0,15,0
1681921517875,CAT 125,A00,202248,Staff,19,0,20,1
1681921517875,CAT 125,B00,202253,Staff,20,0,20,0
1681921517875,CAT 125,C00,202257,Staff,18,0,20,2
1681921518897,CAT 125GS,A01,202273,Bronstein; Phoebe Malan,20,0,20,0
1681921519933,CAT 125R,A00,202284,Staff,17,0,20,3
1681921519933,CAT 125R,C00,202286,Staff,10,0,20,10
1681921519933,CAT 125R,D00,202291,Staff,18,0,20,2
1681921519933,CAT 125R,E00,202295,Staff,13,0,20,7
1681921519933,CAT 125R,F00,202302,Staff,9,0,20,11
1681921520962,CENG 100,A00,204724,Opatkiewicz; Justin Paul,25,0,25,0
1681921521984,CGS 2A,A01,180420,Staff,31,0,36,5
1681921523009,CGS 101,A00,180421,Staff,16,0,20,4
1681921524037,CGS 112,A00,180422,Staff,9,0,16,7
1681921525062,CGS 113,A00,180423,Staff,18,0,20,2
1681921526085,CGS 137,A00,180424,Staff,12,0,12,0
1681921527112,CGS 147,A00,180425,Staff,10,0,10,0
1681921528147,CHEM 6A,A01,179556,Staff,96,0,100,4
1681921528147,CHEM 6A,A02,179558,Staff,0,0,0,0
1681921529174,CHEM 6B,A01,179560,Staff,100,0,100,0
1681921530209,CHEM 6C,A01,179565,Jazzar; Rodolphe,95,0,100,5
1681921531238,CHEM 7L,A01,179586,Schurmeier; Kimberly,11,0,24,13
1681921531238,CHEM 7L,A02,179587,Schurmeier; Kimberly,23,0,24,1
1681921531238,CHEM 7L,A03,179590,Schurmeier; Kimberly,22,0,24,2
1681921531238,CHEM 7L,A04,179591,Schurmeier; Kimberly,22,0,24,2
1681921531238,CHEM 7L,B01,179598,Schurmeier; Kimberly,16,0,24,8
1681921531238,CHEM 7L,B02,179599,Schurmeier; Kimberly,24,0,24,0
1681921531238,CHEM 7L,B03,179606,Schurmeier; Kimberly,23,0,24,1
1681921531238,CHEM 7L,B04,179607,Schurmeier; Kimberly,23,0,24,1
1681921532272,CHEM 11,A01,179609,Stallings; Dontarie M,88,0,100,12
1681921533295,CHEM 40A,A01,179621,Staff,40,0,50,10
1681921533295,CHEM 40A,A02,179622,Staff,46,0,50,4
1681921534319,CHEM 40B,A01,179630,Weizman; Haim,48,0,50,2
1681921534319,CHEM 40B,A02,179631,Weizman; Haim,45,0,50,5
1681921535345,CHEM 41A,A01,179660,Klosterman; Jeremy K,93,0,100,7
1681921536375,CHEM 43A,A01,179683,Klosterman; Jeremy K,0,0,24,24
1681921536375,CHEM 43A,A02,179688,Klosterman; Jeremy K,11,0,24,13
1681921536375,CHEM 43A,A03,179689,Klosterman; Jeremy K,19,0,24,5
1681921536375,CHEM 43A,A04,179691,Klosterman; Jeremy K,18,0,24,6
1681921537400,CHEM 114A,A01,179693,Stallings; Dontarie M,72,0,100,28
1681921538427,CHEM 143B,A01,179698,Weizman; Haim,16,0,24,8
1681921538427,CHEM 143B,A02,179700,Weizman; Haim,24,0,24,0
1681921539457,CHIN 169A,A00,179701,Wang; Xiao,20,0,20,0
1681921540480,COGS 2,A01,179750,Boyle; Mary E. T.,17,0,30,13
1681921541506,COGS 9,A01,179759,Jones; Cameron Robert,42,0,50,8
1681921542537,COGS 14A,A01,179854,Staff,15,0,50,35
1681921543568,COGS 14B,A01,179856,Staff,53,0,60,7
1681921544593,COGS 17,A01,179874,Staff,71,0,75,4
1681921545622,COGS 18,A01,179884,Staff,63,0,80,17
1681921546644,COGS 100,A01,179886,Staff,36,0,60,24
1681921547670,COGS 101B,A01,179892,Staff,1,0,30,29
1681921548697,COGS 101C,A01,179894,Staff,28,0,30,2
1681921549725,COGS 107A,A01,179896,Boyle; Mary E. T.,31,0,40,9
1681921550756,COGS 108,A01,179898,Simpkins; Charles Alexander,0,23,60,60
1681921551782,COGS 109,A01,179900,Staff,34,0,40,6
1681921552811,COGS 118A,A01,179946,Staff,8,0,40,32
1681921553841,COGS 153,A00,179978,Staff,0,2,30,30
1681921554866,COGS 156,A01,179981,Staff,25,0,30,5
1681921556914,COGS 172,A01,179987,Staff,13,0,30,17
1681921558964,COGS 186,A01,179991,Staff,12,0,30,18
1681921559987,COMM 10,A01,180001,Staff,14,0,25,11
1681921559987,COMM 10,A02,180004,Staff,20,0,25,5
1681921561013,COMM 100A,A01,180016,Staff,15,0,25,10
1681921561013,COMM 100A,A02,180020,Staff,24,0,25,1
1681921562036,COMM 101T,A00,180029,Halm; Gavin Patrick,23,0,35,12
1681921563132,COMM 106V,A00,180043,Staff,34,0,35,1
1681921564181,COMM 109P,A00,180044,Staff,30,0,35,5
1681921565204,COMM 113T,A00,180045,Havis; Allan,37,0,45,8
1681921566233,COMM 132,A00,180046,McKenna; Denise,23,0,30,7
1681921567266,COMM 143,A00,180047,Staff,18,0,30,12
1681921568288,COMM 190,A00,180048,Conner; Thomas Hartnell,19,0,23,4
1681921569325,CSE 8A,A50,180053,Cao; Yingjun,25,0,50,25
1681921569325,CSE 8A,B50,180180,Staff,50,0,50,0
1681921570351,CSE 11,A01,180190,Cao; Yingjun,26,0,50,24
1681921571377,CSE 20,A01,180192,Briones; Jor-el Thomas Caparas,23,0,30,7
1681921572405,CSE 21,A01,194538,Briones; Jor-el Thomas Caparas,50,0,60,10
1681921573427,CSE 30,A01,180324,Eldon; John,76,0,100,24
1681921574457,CSE 101,A01,201353,Staff,0,24,40,40
1681921575483,CSE 134B,A01,180326,Powell; Thomas Allan,74,0,100,26
1681921576505,CSE 140,A01,180328,Staff,41,0,75,34
1681921577535,CSE 140L,A01,180344,Eldon; John,64,0,100,36
1681921578559,CSE 150A,A01,180411,Staff,0,11,50,50
1681921579584,CSE 151A,A01,180414,Staff,0,8,50,50
1681921580607,CSE 175,A01,222521,Kumar; Rakesh,50,0,50,0
1681921581630,CSE 190,A00,201419,Staff,44,0,49,5
1681921582656,CSS 1,A01,194536,Staff,37,0,50,13
1681921583685,DSC 30,A01,202385,Staff,48,0,50,2
1681921584709,DSC 40A,A01,202387,Albuyeh; Rod,50,0,50,0
1681921585737,DSC 190,A01,202389,Silberman; Jack,21,0,21,0
1681921586774,DSGN 100,A01,179993,Staff,16,0,30,14
1681921587798,ECE 65,A50,180708,Staff,10,0,20,10
1681921587798,ECE 65,A51,180739,Staff,19,0,20,1
1681921588820,ECON 1,A01,180427,Famulari; Melissa,67,0,70,3
1681921589850,ECON 2,A01,180450,Levkoff; Steven B.,64,0,70,6
1681921590875,ECON 4,A01,203351,Anderson; John Charles,6,0,10,4
1681921591903,ECON 100A,A01,180472,Famulari; Melissa,64,0,70,6
1681921592928,ECON 120A,A01,180549,Staff,64,0,70,6
1681921593954,ECON 120B,A01,180655,Ma; Xinwei,43,0,70,27
1681921594981,ECON 129,A00,203333,Eckert; Fabian Paul,13,0,35,22
1681921596007,ECON 131,A00,180656,Staff,5,0,35,30
1681921597033,ECON 172B,A01,180672,Levkoff; Steven B.,31,0,35,4
1681921598056,ECON 178,A01,203342,Zhu; Ying,9,0,35,26
1681921599079,EDS 108GS,A00,202383,Wishard Guerra; Alison G.,20,0,20,0
1681921600104,EDS 111GS,A00,202347,Wishard Guerra; Alison G.,20,0,20,0
1681921601129,EDS 112,A01,202323,Staff,55,0,60,5
1681921602175,EDS 113,A00,202340,Staff,32,0,35,3
1681921603200,EDS 118,A00,201231,Staff,20,0,30,10
1681921604223,EDS 119,A00,204994,Staff,8,0,10,2
1681921605246,EDS 124BR,A00,202324,Eguchi; Emi,4,0,25,21
1681921606269,EDS 126,A01,203208,Jones; Makeba,26,0,30,4
1681921607303,EDS 135,A01,202333,Staff,18,0,20,2
1681921608332,EDS 180,A00,202311,Staff,47,0,50,3
1681921609360,ERC 190GS,A01,253747,Staff,28,0,28,0
1681921610399,ETHN 104,A00,180742,Staff,23,0,35,12
1681921611422,ETHN 118,A00,180745,Staff,27,0,35,8
1681921612448,ETHN 127,A00,180747,Staff,12,0,16,4
1681921613469,ETHN 137,A00,180880,Staff,11,0,12,1
1681921614492,ETHN 147,A00,180890,Staff,8,0,10,2
1681921615515,ETHN 154,A00,180891,Staff,7,0,8,1
1681921616538,ETHN 168,A00,180892,Staff,9,0,10,1
1681921617562,GLBH 20,A00,201051,Hannah; Seth Donal,0,2,0,1
1681921618585,GLBH 111,A01,209338,Burgos; Jose L.,0,0,0,0
1681921619614,GLBH 150,A00,258300,Staff,0,3,0,0
1681921620646,GLBH 181,A00,201207,Staff,13,0,40,27
1681921621669,HIEU 109,A00,180898,Staff,20,0,20,0
1681921622701,HIEU 111,A00,180899,Staff,0,1,20,20
1681921623723,HIEU 124,A00,180900,Staff,17,0,20,3
1681921624755,HILA 122,A00,180901,Staff,18,0,20,2
1681921625778,HILA 132,A00,180902,Vitz; Matthew,2,0,20,18
1681921626803,HILD 10,A01,180896,Staff,15,0,20,5
1681921627826,HILD 30GS,A00,180897,Edington; Claire Ellen,0,0,0,0
1681921628849,HISC 105,A00,180903,Staff,20,0,20,0
1681921629875,HISC 117,A00,180904,Staff,11,0,20,9
1681921630900,HIUS 108B,A00,181005,Staff,18,0,20,2
1681921631922,HIUS 113,A00,181093,Staff,1,0,20,19
1681921632945,HUM 3,A01,181190,Patterson; Patrick H.,39,0,50,11
1681921632945,HUM 3,B01,181195,Staff,46,0,50,4
1681921633967,HUM 3GS,A00,181196,Herbst; Matthew,0,0,0,0
1681921634991,HUM 4,A01,181227,West; Geoffrey Scott,33,0,50,17
1681921634991,HUM 4,B01,181282,Staff,42,0,50,8
1681921636019,HUM 4GS,A00,181377,Lyon; Antony J.,0,0,0,0
1681921637054,HUM 5,A01,181536,Zavodny; Tatiana Sophia,28,0,50,22
1681921637054,HUM 5,B01,181908,Staff,36,0,50,14
1681921638082,INTL 190,A00,181909,Segui; Alan S,0,0,0,8
1681921638082,INTL 190,B00,181961,Segui; Alan S,0,0,0,7
1681921639111,JAPN 20AR,A01,182113,Ross; Kayoko F,15,0,20,5
1681921640138,LATI 50,A01,202391,Martin-Cabrera; Luis,18,0,30,12
1681921640138,LATI 50,A02,202392,Martin-Cabrera; Luis,26,0,30,4
1681921641163,LATI 180,A00,202393,Kokinis; Troy Andreas,24,0,25,1
1681921642196,LIFR 1A,A00,182119,Staff,14,0,14,0
1681921643221,LIFR 1AX,A00,182324,Staff,14,0,14,0
1681921644247,LIFR 1B,A00,182259,Staff,13,0,14,1
1681921645273,LIFR 1BX,A00,182273,Staff,13,0,14,1
1681921646299,LIGN 8,A00,182330,Staff,135,0,150,15
1681921647322,LIGN 9GS,A00,182362,Staff,20,0,20,0
1681921648349,LIGN 119,A00,204992,Takahashi; Maho,12,0,15,3
1681921649376,LIGN 130,A01,182384,Staff,47,0,50,3
1681921650399,LIGN 149GS,A00,182390,Staff,20,0,20,0
1681921651424,LIGN 170,A00,182404,Staff,23,0,30,7
1681921652449,LISP 1D,A00,182281,Staff,7,0,14,7
1681921652449,LISP 1D,B00,182287,Staff,14,0,14,0
1681921652449,LISP 1D,C00,182295,Staff,11,0,14,3
1681921652449,LISP 1D,D00,182301,Staff,14,0,14,0
1681921653480,LISP 1DX,A00,182309,Staff,20,0,28,8
1681921653480,LISP 1DX,B00,182316,Staff,26,0,28,2
1681921654509,LTAF 120GS,A00,182412,Zhiri; Oumelbanine,20,0,20,0
1681921655534,LTCS 172GS,A00,182437,Bronstein; Phoebe Malan,20,0,20,0
1681921656557,LTEA 138,A00,182457,Staff,20,0,40,20
1681921657588,LTEN 114,A01,182490,Staff,23,0,25,2
1681921658610,LTEN 130GS,A00,182491,Lyon; Antony J.,20,0,20,0
1681921659633,LTEN 169,A00,182493,Cuong; Marisol,19,0,25,6
1681921660656,LTEN 178,A00,182501,Staff,14,0,15,1
1681921661692,LTEN 181,A00,182515,Staff,22,0,25,3
1681921662713,LTEN 185GS,A00,197655,Forbes; Camille,20,0,20,0
1681921663748,LTSP 100B,A00,202208,Bessett; Ryan Matthew,24,0,25,1
1681921664778,LTWL 100,A00,182516,Myerston Santana; Jacobo,21,0,30,9
1681921665808,LTWR 100GS,A00,182518,Forbes; Camille,20,0,20,0
1681921666904,LTWR 102,A00,182522,Staff,15,0,15,0
1681921666904,LTWR 102,B00,182525,Staff,14,0,15,1
1681921667929,LTWR 115,A00,182526,Staff,11,0,15,4
1681921668952,MAE 8,A01,182528,Pham; Hieu Tan,67,0,70,3
1681921669978,MAE 11,A00,182529,Bahadori; Mohammad Yousef,93,0,100,7
1681921671001,MAE 20,A00,182530,Evdokimenko; Ekaterina,68,0,70,2
1681921672028,MAE 30A,A00,182532,Staff,44,0,45,1
1681921673054,MAE 101A,A00,182533,Bahadori; Mohammad Yousef,95,0,100,5
1681921674076,MAE 101C,A00,182538,Staff,62,0,70,8
1681921675106,MAE 104,A00,182539,Staff,44,0,50,6
1681921676129,MAE 131A,A00,182540,Ghazinejad; Maziar,40,0,45,5
1681921677151,MAE 143A,A00,182548,Bewley; Thomas R,43,0,50,7
1681921678175,MAE 150,A00,182549,Staff,28,0,40,12
1681921679203,MAE 160,A00,182550,Evdokimenko; Ekaterina,42,0,60,18
1681921680229,MATH 3C,A01,182725,Staff,26,0,30,4
1681921681263,MATH 10A,A01,182729,Staff,25,0,30,5
1681921681263,MATH 10A,B01,182732,Staff,26,0,30,4
1681921682296,MATH 10B,A01,182737,Staff,21,0,30,9
1681921682296,MATH 10B,A02,182738,Staff,26,0,30,4
1681921682296,MATH 10B,B01,182744,Staff,27,0,30,3
1681921682296,MATH 10B,B02,182745,Staff,27,0,30,3
1681921683320,MATH 18,A01,182750,Anzaldo; Leesa B,28,0,30,2
1681921683320,MATH 18,A02,182751,Anzaldo; Leesa B,29,0,30,1
1681921683320,MATH 18,A03,182753,Anzaldo; Leesa B,27,0,30,3
1681921683320,MATH 18,A04,182757,Anzaldo; Leesa B,29,0,30,1
1681921683320,MATH 18,B01,182761,Anzaldo; Leesa B,27,0,30,3
1681921683320,MATH 18,B02,182764,Anzaldo; Leesa B,26,0,30,4
1681921683320,MATH 18,B03,182765,Anzaldo; Leesa B,29,0,30,1
1681921683320,MATH 18,B04,182766,Anzaldo; Leesa B,30,0,30,0
1681921684348,MATH 20A,A01,182771,Suk; Andrew Hoon,28,0,30,2
1681921685375,MATH 20B,A01,182775,Bach; Quang Tran,30,0,30,0
1681921685375,MATH 20B,A02,182777,Bach; Quang Tran,29,0,30,1
1681921685375,MATH 20B,B01,182780,Bach; Quang Tran,26,0,30,4
1681921685375,MATH 20B,B02,182782,Bach; Quang Tran,30,0,30,0
1681921686397,MATH 20C,A01,182787,Staff,25,0,30,5
1681921686397,MATH 20C,A02,182790,Staff,29,0,30,1
1681921686397,MATH 20C,B01,182792,Staff,25,0,30,5
1681921686397,MATH 20C,B02,182796,Staff,26,0,30,4
1681921687423,MATH 20D,A01,182799,Staff,28,0,30,2
1681921687423,MATH 20D,A02,182802,Staff,29,0,30,1
1681921687423,MATH 20D,A03,182803,Staff,30,0,30,0
1681921688450,MATH 20E,A01,182809,Verstraete; Jacques Allan,23,0,30,7
1681921688450,MATH 20E,A02,182811,Verstraete; Jacques Allan,28,0,30,2
1681921688450,MATH 20E,B01,182814,Verstraete; Jacques Allan,23,0,30,7
1681921688450,MATH 20E,B02,182815,Verstraete; Jacques Allan,30,0,30,0
1681921689477,MATH 103A,A01,182820,Staff,8,0,30,22
1681921689477,MATH 103A,A02,182821,Staff,27,0,30,3
1681921689477,MATH 103A,A03,182822,Staff,23,0,30,7
1681921689477,MATH 103A,B01,182825,Staff,23,0,30,7
1681921689477,MATH 103A,B02,182826,Staff,30,0,30,0
1681921689477,MATH 103A,B03,182830,Staff,30,0,30,0
1681921690501,MATH 109,A01,182836,Chow; Bennett,24,0,30,6
1681921690501,MATH 109,A02,182838,Chow; Bennett,29,0,30,1
1681921690501,MATH 109,A03,182894,Chow; Bennett,29,0,30,1
1681921690501,MATH 109,B01,182908,Chow; Bennett,27,0,30,3
1681921690501,MATH 109,B02,182909,Chow; Bennett,30,0,30,0
1681921690501,MATH 109,B03,182910,Chow; Bennett,27,0,30,3
1681921691527,MATH 142A,A01,182925,Staff,9,0,30,21
1681921691527,MATH 142A,A02,182935,Staff,24,0,30,6
1681921691527,MATH 142A,A03,182967,Staff,26,0,30,4
1681921691527,MATH 142A,B01,183125,Staff,22,0,30,8
1681921691527,MATH 142A,B02,183157,Staff,28,0,30,2
1681921691527,MATH 142A,B03,183158,Staff,29,0,30,1
1681921692554,MATH 183,A01,183160,Arias-Castro; Ery,23,0,30,7
1681921692554,MATH 183,A02,183161,Arias-Castro; Ery,29,0,30,1
1681921692554,MATH 183,B01,183163,Arias-Castro; Ery,28,0,30,2
1681921692554,MATH 183,B02,183164,Arias-Castro; Ery,28,0,30,2
1681921693581,MATH 193A,A01,183167,Staff,2,0,35,33
1681921693581,MATH 193A,A02,183168,Staff,28,0,35,7
1681921693581,MATH 193A,A03,183169,Staff,34,0,35,1
1681921693581,MATH 193A,A04,183170,Staff,28,0,35,7
1681921694603,MGT 4,A01,202395,Anderson; John Charles,75,0,80,5
1681921695629,MGT 5,A00,202396,Houskeeper; Robert,79,0,90,11
1681921696653,MGT 103,A00,202397,Eberhard; Craig A,50,0,90,40
1681921697677,MGT 131A,A00,202398,Houskeeper; Robert,84,0,90,6
1681921698710,MGT 135,A00,202399,Anderson; John Charles,81,0,90,9
1681921699736,MGT 162R,A00,202403,Gneezy; Uri,140,0,200,60
1681921700761,MGT 172,A00,202404,Hedges; Kathleen,44,0,90,46
1681921701791,MGT 181,A00,202405,Dunn; Louis Jean,80,0,90,10
1681921702818,MMW 14,A01,183200,Staff,11,0,28,17
1681921702818,MMW 14,A02,183201,Staff,26,0,28,2
1681921702818,MMW 14,A03,183202,Staff,24,0,28,4
1681921702818,MMW 14,A04,183203,Staff,25,0,28,3
1681921702818,MMW 14,A05,183204,Staff,26,0,28,2
1681921702818,MMW 14,A06,183205,Staff,27,0,28,1
1681921702818,MMW 14,B01,183207,Staff,26,0,28,2
1681921702818,MMW 14,B02,183208,Staff,28,0,28,0
1681921702818,MMW 14,B03,183209,Staff,28,0,28,0
1681921702818,MMW 14,B04,183210,Staff,28,0,28,0
1681921702818,MMW 14,B05,183211,Staff,28,0,28,0
1681921702818,MMW 14,B06,183212,Staff,27,0,28,1
1681921703842,MMW 14GS,A00,183213,Zhiri; Oumelbanine,28,0,28,0
1681921704865,MMW 15GS,B00,183215,Rahimi; Babak,28,0,28,0
1681921705892,MMW 121,A01,183217,Patterson; Patrick H.,13,0,28,15
1681921705892,MMW 121,A02,183218,Patterson; Patrick H.,25,0,28,3
1681921706915,MUS 1A,A01,182554,Staff,7,0,35,28
1681921707946,MUS 5,A01,182558,Staff,19,0,35,16
1681921708983,MUS 6,A01,182562,Staff,22,0,35,13
1681921710007,MUS 8GS,A00,182563,Borgo; David Garcia,25,0,25,0
1681921711031,MUS 13,A01,182567,Staff,24,0,25,1
1681921712053,MUS 15,A01,182570,Staff,32,0,35,3
1681921712053,MUS 15,B01,182575,Staff,9,0,35,26
1681921713082,MUS 80,A00,182578,Staff,22,0,25,3
1681921713082,MUS 80,B00,182581,Staff,20,0,25,5
1681921714104,MUS 113,A00,182582,Staff,25,0,25,0
1681921715129,MUS 114,A00,182583,Staff,3,0,25,22
1681921716152,MUS 150GS,A01,182588,Borgo; David Garcia,25,0,25,0
1681921717175,PHIL 1,A00,182590,Staff,35,0,40,5
1681921718199,PHIL 10,A01,182596,Grush; Rick Scott,31,0,35,4
1681921718199,PHIL 10,A02,182597,Grush; Rick Scott,34,0,35,1
1681921719225,PHIL 15,A01,182601,Staff,31,0,35,4
1681921719225,PHIL 15,A02,182602,Staff,33,0,35,2
1681921720252,PHIL 27,A01,182604,Staff,30,0,35,5
1681921720252,PHIL 27,A02,182607,Staff,35,0,35,0
1681921721277,PHIL 32,A01,182609,Staff,35,0,35,0
1681921721277,PHIL 32,A02,182612,Staff,35,0,35,0
1681921722300,PHIL 130,A00,182614,Staff,62,0,70,8
1681921723328,PHIL 136,A00,182616,Cohen; Jonathan David,66,0,70,4
1681921724356,PHIL 155,A00,182617,Vargas; Manuel Rogelio,58,0,70,12
1681921725383,PHIL 163,A01,182620,Staff,15,0,20,5
1681921725383,PHIL 163,A02,182624,Staff,10,0,20,10
1681921726417,PHIL 164,A00,182627,Staff,29,0,40,11
1681921727442,PHIL 173,A00,182628,Staff,36,0,40,4
1681921728470,PHYS 1A,A00,183221,Staff,54,0,60,6
1681921729494,PHYS 1AL,001,183222,Staff,25,0,30,5
1681921729494,PHYS 1AL,002,183223,Staff,28,0,30,2
1681921730531,PHYS 1B,A00,183231,Staff,43,0,60,17
1681921731569,PHYS 1BL,001,183232,Staff,20,0,30,10
1681921731569,PHYS 1BL,002,183233,Staff,27,0,30,3
1681921732592,PHYS 1C,A00,183240,Staff,28,0,60,32
1681921733614,PHYS 1CL,001,183241,Staff,11,0,30,19
1681921733614,PHYS 1CL,002,183242,Staff,22,0,30,8
1681921734635,PHYS 2AR,A01,183250,Staff,43,0,50,7
1681921735658,PHYS 2B,A01,183252,Staff,104,0,115,11
1681921736681,PHYS 2BL,A01,183254,Staff,21,0,24,3
1681921736681,PHYS 2BL,A02,183255,Staff,22,0,24,2
1681921737704,PHYS 2C,A01,183522,Staff,103,0,115,12
1681921738727,PHYS 4A,A01,183524,Staff,49,0,50,1
1681921739758,POLI 5,A00,183525,Staff,44,0,50,6
1681921740781,POLI 12,A00,183540,Staff,45,0,50,5
1681921741805,POLI 13R,A00,183541,Forman; Fonna,42,0,50,8
1681921742830,POLI 30,A00,183542,Mignozzetti; Umberto,47,0,50,3
1681921743852,POLI 100A,A00,183543,Staff,45,0,50,5
1681921744877,POLI 100E,A00,223598,Staff,32,0,35,3
1681921745901,POLI 103A,A00,183564,Kousser; Thad,37,0,50,13
1681921746933,POLI 104B,A00,201329,Staff,28,0,35,7
1681921747956,POLI 113BR,A00,183576,Hoston; Germaine,25,0,50,25
1681921748982,POLI 114BR,A00,183588,Staff,27,0,30,3
1681921750021,POLI 117R,A00,183595,Forman; Fonna,6,0,20,14
1681921751046,POLI 120H,A00,183596,Fisk; David Lee,13,0,20,7
1681921752069,POLI 130AA,A00,183597,Staff,14,0,20,6
1681921753090,POLI 134AA,A00,183598,Staff,19,0,20,1
1681921754113,POLI 135,A00,183599,Fisk; David Lee,20,0,25,5
1681921755138,POLI 142P,A00,183623,Staff,37,0,40,3
1681921756159,POLI 144D,A00,183624,Staff,22,0,25,3
1681921757190,POLI 151,A00,183625,Staff,15,0,20,5
1681921758214,POLI 162,A00,183626,Mignozzetti; Umberto,17,0,20,3
1681921759245,PSYC 1,A00,253748,Staff,86,0,90,4
1681921760271,PSYC 2,A00,183627,Moranton; Nirelia Melbina-,25,0,35,10
1681921761293,PSYC 3,A00,183628,Staff,43,0,45,2
1681921763350,PSYC 60,A01,183631,Lowe; Angela Beth,35,0,40,5
1681921764373,PSYC 70,A01,253757,Staff,37,0,45,8
1681921765401,PSYC 101,A00,183632,Heyman; Gail D.,47,0,60,13
1681921766430,PSYC 105,A00,183848,Lowe; Angela Beth,47,0,60,13
1681921767458,PSYC 106,A00,183849,Dobkins; Karen R.,43,0,60,17
1681921768484,PSYC 108,A00,253750,Staff,23,0,60,37
1681921769507,PSYC 114,A01,184275,Winkielman; Piotr,0,7,30,30
1681921770621,PSYC 122,A00,183856,Moranton; Nirelia Melbina-,0,13,30,30
1681921771645,PSYC 124,A00,183865,Chapman; Eddie Nathaniel,49,0,80,31
1681921772670,PSYC 137,A00,183880,Staff,19,0,25,6
1681921774714,PSYC 154,A00,183910,Lacefield; Katharine I,0,12,90,90
1681921776762,PSYC 162,A00,183946,Wixted; John T,55,0,90,35
1681921777784,PSYC 172,A00,183947,Gorman; Michael R.,10,0,30,20
1681921778812,PSYC 178,A00,183963,Glaser; Dale,18,0,40,22
1681921779835,PSYC 181GS,A00,183964,Anagnostaras; Stephan,10,0,10,0
1681921780861,PSYC 186GS,A01,257660,Staff,10,0,10,0
1681921781884,PSYC 193,B00,253749,Staff,23,0,25,2
1681921783932,PSYC 193L,A01,184122,Staff,33,0,35,2
1681921783932,PSYC 193L,C01,184167,Winkielman; Piotr,15,0,30,15
1681921784954,RELI 188GS,A00,182629,Rahimi; Babak,20,0,20,0
1681921785979,SE 101A,A00,182646,Staff,26,0,30,4
1681921787001,SE 101C,A00,182650,Staff,17,0,20,3
1681921788027,SE 110A,A00,182651,Staff,28,0,28,0
1681921789058,SE 130A,A00,182652,Staff,39,0,40,1
1681921790083,SIO 46GS,A00,182636,Cook; Geoffrey W,27,0,28,1
1681921791105,SIO 109R,A00,194459,Staff,5,0,20,15
1681921792131,SIO 121GS,A00,182639,Cook; Geoffrey W,27,0,28,1
1681921793159,SIO 132,A01,182642,Staff,32,0,40,8
1681921794190,SIO 139,A00,182644,Kacev; David,36,0,40,4
1681921795212,SOCI 2,A01,258404,Staff,33,0,36,3
1681921795212,SOCI 2,A02,258405,Staff,35,0,36,1
1681921796248,SOCI 60,A01,258408,Staff,29,0,30,1
1681921796248,SOCI 60,A02,258413,Staff,30,0,30,0
1681921797273,SOCI 100,A01,258415,Staff,29,0,30,1
1681921797273,SOCI 100,A02,258416,Staff,28,0,30,2
1681921803425,SOCI 127,A00,258421,Staff,21,0,30,9
1681921804460,SOCI 132,A00,258422,Staff,45,0,50,5
1681921805482,SOCI 133,A00,258423,Staff,26,0,30,4
1681921806504,SOCI 138GS,A00,258424,Staff,15,0,15,0
1681921807530,SOCI 145,A00,258425,Staff,25,0,30,5
1681921808560,SOCI 148,A00,258426,Staff,25,0,30,5
1681921809590,SOCI 153,A00,199217,Staff,29,0,30,1
1681921810613,SOCI 160,A00,258427,Staff,28,0,30,2
1681921811646,SOCI 160E,A00,258435,Staff,56,0,60,4
1681921812671,SOCI 189GS,A00,258436,Staff,15,0,15,0
1681921813697,SOCI 190GS,A00,258437,Staff,15,0,15,0
1681921814725,SYN 2,001,182658,Staff,8,0,16,8
1681921814725,SYN 2,002,201439,Staff,14,0,16,2
1681921814725,SYN 2,003,201443,Staff,16,0,16,0
1681921815758,SYN 100,A01,182657,Staff,16,0,20,4
1681921816782,TDAC 1,A00,184381,Salovey; Todd,16,0,20,4
1681921816782,TDAC 1,B00,184385,Harting; Carla Kelso,19,0,20,1
1681921816782,TDAC 1,C00,184394,Staff,19,0,20,1
1681921817809,TDAC 101,A00,184483,Harting; Carla Kelso,19,0,20,1
1681921818831,TDDE 111,A00,184496,Staff,14,0,15,1
1681921819853,TDDE 131,A00,184504,Staff,20,0,20,0
1681921819853,TDDE 131,B00,184505,Staff,17,0,18,1
1681921819853,TDDE 131,C00,184534,Staff,49,0,50,1
1681921819853,TDDE 131,D00,184564,Staff,15,0,15,0
1681921819853,TDDE 131,E00,204725,Staff,19,0,20,1
1681921820887,TDGE 1,A01,184414,Salovey; Todd,36,0,50,14
1681921821910,TDGE 5,A01,184419,Staff,23,0,24,1
1681921822935,TDGE 10,A00,184428,Fulton; Julia,29,0,50,21
1681921823979,TDGE 124,A00,184565,Fulton; Julia,7,0,50,43
1681921825003,TDGE 125,B00,184567,Meyer; Ursula,9,0,25,16
1681921826032,TDHT 101,A00,184568,Staff,21,0,25,4
1681921826032,TDHT 101,B00,184569,Staff,20,0,20,0
1681921827056,TDHT 114,A00,184570,Staff,49,0,50,1
1681921828083,TDMV 1,A00,184437,Arcidiacono; Kristin,22,0,30,8
1681921828083,TDMV 1,B00,184448,Caligagan; Maria T.,23,0,30,7
1681921829108,TDMV 2,A00,184449,Weinberg; Sadie,27,0,30,3
1681921829108,TDMV 2,B00,184453,Arcidiacono; Kristin,29,0,30,1
1681921830130,TDMV 110,A00,184571,Weinberg; Sadie,30,0,30,0
1681921831156,TDMV 142,A00,184572,Caligagan; Tony,27,0,30,3
1681921831156,TDMV 142,B00,184573,Caligagan; Maria T.,26,0,30,4
1681921832180,TDTR 20,A00,184482,Jun; Grace Shin Hae,25,0,25,0
1681921833206,USP 2,A01,184290,Hinds; Juli Beth,24,0,25,1
1681921834229,USP 3,A01,184295,Staff,20,0,25,5
1681921835268,USP 4,A00,184304,McTague; Sarah,13,0,25,12
1681921836294,USP 100,A00,184315,Staff,16,0,25,9
1681921837317,USP 105,A00,184326,Staff,21,0,25,4
1681921838340,USP 151,A00,184327,Staff,20,0,25,5
1681921839365,USP 170,A00,184380,Hinds; Juli Beth,13,0,25,12
1681921840389,VIS 21B,A01,182660,Staff,28,0,31,3
1681921840389,VIS 21B,A02,182662,Staff,30,0,31,1
1681921841413,VIS 103D,A00,182663,Staff,74,0,75,1
1681921842445,VIS 105D,A00,182667,Li; Huai,14,0,22,8
1681921843476,VIS 122GS,A00,182668,Herbst; Matthew,20,0,20,0
1681921844501,VIS 128C,A00,182673,Staff,69,0,75,6
1681921845526,VIS 130,A00,182675,Staff,20,0,22,2
1681921846554,VIS 160A,A00,182678,Stalbaum; Brett,4,0,10,6
1681921848603,WCWP 10B,A00,201679,Staff,15,0,15,0
1681921848603,WCWP 10B,B00,201695,Staff,15,0,15,0
1681921849632,WCWP 100,A00,201716,Staff,12,0,15,3
1681921849632,WCWP 100,B00,201717,Staff,6,0,15,9
1681921851736,ANSC 105GS,A00,258289,Staff,0,0,0,0
1681921852762,ANSC 125GS,A00,258295,Staff,0,0,0,0
1681921853784,ANSC 150,A00,258267,Staff,30,0,40,10
1681921854809,ANSC 190GS,A00,258280,Staff,0,0,0,0
1681921855832,ANTH 1,A00,258264,Staff,38,0,40,2
1681921856861,ANTH 2,A01,258259,Staff,72,0,76,4
1681921857884,ANTH 23,A01,258228,Staff,36,0,40,4
1681921858910,ANTH 101,A01,258236,Staff,38,0,40,2
1681921859934,ANTH 102,A00,258272,Staff,59,0,60,1
1681921860961,ANTH 105,A00,258244,Staff,31,0,35,4
1681921861996,BENG 130,A00,253975,Staff,38,0,40,2
1681921863025,BIBC 102,A01,191866,Flagg; Matthew Paul,19,0,32,13
1681921863025,BIBC 102,A02,191867,Flagg; Matthew Paul,22,0,32,10
1681921863025,BIBC 102,A03,191868,Flagg; Matthew Paul,29,0,32,3
1681921863025,BIBC 102,A04,191936,Flagg; Matthew Paul,26,0,32,6
1681921863025,BIBC 102,A05,191937,Flagg; Matthew Paul,5,0,32,27
1681921864049,BICD 100,A01,191939,Cooper; Andrew Michael,28,0,32,4
1681921864049,BICD 100,A02,191940,Cooper; Andrew Michael,32,0,32,0
1681921864049,BICD 100,A03,191941,Cooper; Andrew Michael,32,0,32,0
1681921864049,BICD 100,A04,191942,Cooper; Andrew Michael,32,0,32,0
1681921864049,BICD 100,A05,191943,Cooper; Andrew Michael,32,0,32,0
1681921865076,BIEB 126,A01,191945,Cleland; Elsa Eleanor,0,0,32,32
1681921865076,BIEB 126,A02,191946,Cleland; Elsa Eleanor,27,0,32,5
1681921865076,BIEB 126,A03,191947,Cleland; Elsa Eleanor,29,0,32,3
1681921865076,BIEB 126,A04,191948,Cleland; Elsa Eleanor,23,0,32,9
1681921865076,BIEB 126,A05,191996,Cleland; Elsa Eleanor,28,0,32,4
1681921866102,BIEB 136GS,A00,191997,Shurin; Jonathan & Holway; David A.,0,0,0,3
1681921867137,BIEB 137GS,A01,191999,Shurin; Jonathan & Holway; David A.,0,0,0,2
1681921868170,BILD 1,A01,205385,Staff,31,0,32,1
1681921868170,BILD 1,A02,205386,Staff,30,0,32,2
1681921868170,BILD 1,A03,205387,Staff,32,0,32,0
1681921868170,BILD 1,A04,205388,Staff,27,0,32,5
1681921869199,BILD 2,A01,191774,Staff,28,0,32,4
1681921869199,BILD 2,A02,191775,Staff,30,0,32,2
1681921869199,BILD 2,A03,191777,Staff,30,0,32,2
1681921869199,BILD 2,A04,191856,Staff,31,0,32,1
1681921869199,BILD 2,A05,191857,Staff,32,0,32,0
1681921869199,BILD 2,A06,191858,Staff,32,0,32,0
1681921869199,BILD 2,A07,191859,Staff,31,0,32,1
1681921870227,BILD 3,A01,205391,Staff,29,0,32,3
1681921870227,BILD 3,A02,205393,Staff,32,0,32,0
1681921870227,BILD 3,A03,205394,Staff,28,0,32,4
1681921870227,BILD 3,A04,205395,Staff,32,0,32,0
1681921871252,BILD 20,A01,191861,Staff,32,0,32,0
1681921871252,BILD 20,A02,191862,Staff,32,0,32,0
1681921872277,BILD 30,A01,191864,Staff,31,0,32,1
1681921873305,BIMM 100,A01,192019,Staff,0,0,32,32
1681921873305,BIMM 100,A02,192020,Staff,20,0,32,12
1681921873305,BIMM 100,A03,192035,Staff,21,0,32,11
1681921874417,BIMM 110,A01,192037,Tat; John,0,0,32,32
1681921874417,BIMM 110,A02,192038,Tat; John,9,0,32,23
1681921875442,BIMM 120,A01,192040,Pickett; Brooke Elizabeth,1,0,32,31
1681921875442,BIMM 120,A02,192041,Pickett; Brooke Elizabeth,15,0,32,17
1681921875442,BIMM 120,A03,192042,Pickett; Brooke Elizabeth,15,0,32,17
1681921876478,BIPN 100,A01,192044,Armour; Jon Christopher,24,0,32,8
1681921876478,BIPN 100,A02,192059,Armour; Jon Christopher,30,0,32,2
1681921876478,BIPN 100,A03,192064,Armour; Jon Christopher,30,0,32,2
1681921876478,BIPN 100,A04,192073,Armour; Jon Christopher,28,0,32,4
1681921877506,BIPN 148,A01,205411,Leutgeb; Jill K.,15,0,32,17
1681921877506,BIPN 148,A02,205412,Leutgeb; Jill K.,31,0,32,1
1681921877506,BIPN 148,A03,205413,Leutgeb; Jill K.,30,0,32,2
1681921877506,BIPN 148,A04,205414,Leutgeb; Jill K.,30,0,32,2
1681921878529,BIPN 160,A01,192115,Marino; Marc J,17,0,32,15
1681921878529,BIPN 160,A02,192148,Marino; Marc J,27,0,32,5
1681921878529,BIPN 160,A03,192158,Marino; Marc J,31,0,32,1
1681921878529,BIPN 160,A04,192190,Marino; Marc J,32,0,32,0
1681921878529,BIPN 160,A05,192287,Marino; Marc J,32,0,32,0
1681921878529,BIPN 160,A06,192288,Marino; Marc J,32,0,32,0
1681921879555,BIPN 194,A00,206038,Staff,28,0,32,4
1681921880578,BISP 194,A00,192289,Leutgeb; Stefan,13,0,32,19
1681921880578,BISP 194,B00,245332,Nieh; James Charles,26,0,32,6
1681921881613,CAT 124,A01,202247,Staff,15,0,15,0
1681921882637,CAT 125,A00,202248,Staff,19,0,20,1
1681921882637,CAT 125,B00,202253,Staff,20,0,20,0
1681921882637,CAT 125,C00,202257,Staff,18,0,20,2
1681921883662,CAT 125GS,A01,202273,Bronstein; Phoebe Malan,20,0,20,0
1681921884689,CAT 125R,A00,202284,Staff,18,0,20,2
1681921884689,CAT 125R,C00,202286,Staff,10,0,20,10
1681921884689,CAT 125R,D00,202291,Staff,18,0,20,2
1681921884689,CAT 125R,E00,202295,Staff,13,0,20,7
1681921884689,CAT 125R,F00,202302,Staff,9,0,20,11
1681921885715,CENG 100,A00,204724,Opatkiewicz; Justin Paul,25,0,25,0
1681921886738,CGS 2A,A01,180420,Staff,31,0,36,5
1681921887773,CGS 101,A00,180421,Staff,16,0,20,4
1681921888797,CGS 112,A00,180422,Staff,9,0,16,7
1681921889829,CGS 113,A00,180423,Staff,18,0,20,2
1681921890850,CGS 137,A00,180424,Staff,12,0,12,0
1681921891874,CGS 147,A00,180425,Staff,10,0,10,0
1681921892900,CHEM 6A,A01,179556,Staff,96,0,100,4
1681921892900,CHEM 6A,A02,179558,Staff,0,0,0,0
1681921893927,CHEM 6B,A01,179560,Staff,100,0,100,0
1681921894955,CHEM 6C,A01,179565,Jazzar; Rodolphe,95,0,100,5
1681921895984,CHEM 7L,A01,179586,Schurmeier; Kimberly,11,0,24,13
1681921895984,CHEM 7L,A02,179587,Schurmeier; Kimberly,23,0,24,1
1681921895984,CHEM 7L,A03,179590,Schurmeier; Kimberly,22,0,24,2
1681921895984,CHEM 7L,A04,179591,Schurmeier; Kimberly,22,0,24,2
1681921895984,CHEM 7L,B01,179598,Schurmeier; Kimberly,16,0,24,8
1681921895984,CHEM 7L,B02,179599,Schurmeier; Kimberly,24,0,24,0
1681921895984,CHEM 7L,B03,179606,Schurmeier; Kimberly,23,0,24,1
1681921895984,CHEM 7L,B04,179607,Schurmeier; Kimberly,23,0,24,1
1681921897011,CHEM 11,A01,179609,Stallings; Dontarie M,88,0,100,12
1681921898038,CHEM 40A,A01,179621,Staff,40,0,50,10
1681921898038,CHEM 40A,A02,179622,Staff,46,0,50,4
1681921899061,CHEM 40B,A01,179630,Weizman; Haim,48,0,50,2
1681921899061,CHEM 40B,A02,179631,Weizman; Haim,45,0,50,5
1681921900084,CHEM 41A,A01,179660,Klosterman; Jeremy K,93,0,100,7
1681921901107,CHEM 43A,A01,179683,Klosterman; Jeremy K,0,0,24,24
1681921901107,CHEM 43A,A02,179688,Klosterman; Jeremy K,9,0,24,15
1681921901107,CHEM 43A,A03,179689,Klosterman; Jeremy K,19,0,24,5
1681921901107,CHEM 43A,A04,179691,Klosterman; Jeremy K,18,0,24,6
1681921902131,CHEM 114A,A01,179693,Stallings; Dontarie M,72,0,100,28
1681921903158,CHEM 143B,A01,179698,Weizman; Haim,16,0,24,8
1681921903158,CHEM 143B,A02,179700,Weizman; Haim,24,0,24,0
1681921904180,CHIN 169A,A00,179701,Wang; Xiao,20,0,20,0
1681921905202,COGS 2,A01,179750,Boyle; Mary E. T.,17,0,30,13
1681921906225,COGS 9,A01,179759,Jones; Cameron Robert,42,0,50,8
1681921907254,COGS 14A,A01,179854,Staff,15,0,50,35
1681921908277,COGS 14B,A01,179856,Staff,53,0,60,7
1681921909300,COGS 17,A01,179874,Staff,71,0,75,4
1681921910327,COGS 18,A01,179884,Staff,63,0,80,17
1681921911353,COGS 100,A01,179886,Staff,36,0,60,24
1681921912379,COGS 101B,A01,179892,Staff,1,0,30,29
1681921913415,COGS 101C,A01,179894,Staff,28,0,30,2
1681921914441,COGS 107A,A01,179896,Boyle; Mary E. T.,31,0,40,9
1681921915476,COGS 108,A01,179898,Simpkins; Charles Alexander,0,24,60,60
1681921916509,COGS 109,A01,179900,Staff,34,0,40,6
1681921917531,COGS 118A,A01,179946,Staff,8,0,40,32
1681921918556,COGS 153,A00,179978,Staff,0,2,30,30
1681921919578,COGS 156,A01,179981,Staff,25,0,30,5
1681921921623,COGS 172,A01,179987,Staff,13,0,30,17
1681921923677,COGS 186,A01,179991,Staff,12,0,30,18
1681921924699,COMM 10,A01,180001,Staff,14,0,25,11
1681921924699,COMM 10,A02,180004,Staff,20,0,25,5
1681921925721,COMM 100A,A01,180016,Staff,15,0,25,10
1681921925721,COMM 100A,A02,180020,Staff,24,0,25,1
1681921926748,COMM 101T,A00,180029,Halm; Gavin Patrick,23,0,35,12
1681921927777,COMM 106V,A00,180043,Staff,34,0,35,1
1681921928808,COMM 109P,A00,180044,Staff,30,0,35,5
1681921929831,COMM 113T,A00,180045,Havis; Allan,37,0,45,8
1681921930856,COMM 132,A00,180046,McKenna; Denise,23,0,30,7
1681921931878,COMM 143,A00,180047,Staff,18,0,30,12
1681921932900,COMM 190,A00,180048,Conner; Thomas Hartnell,19,0,23,4
1681921933929,CSE 8A,A50,180053,Cao; Yingjun,24,0,50,26
1681921933929,CSE 8A,B50,180180,Staff,50,0,50,0
1681921934957,CSE 11,A01,180190,Cao; Yingjun,26,0,50,24
1681921935984,CSE 20,A01,180192,Briones; Jor-el Thomas Caparas,23,0,30,7
1681921937010,CSE 21,A01,194538,Briones; Jor-el Thomas Caparas,50,0,60,10
1681921938033,CSE 30,A01,180324,Eldon; John,76,0,100,24
1681921939057,CSE 101,A01,201353,Staff,0,24,40,40
1681921940084,CSE 134B,A01,180326,Powell; Thomas Allan,74,0,100,26
1681921941107,CSE 140,A01,180328,Staff,41,0,75,34
1681921942131,CSE 140L,A01,180344,Eldon; John,64,0,100,36
1681921943158,CSE 150A,A01,180411,Staff,0,12,50,50
1681921944183,CSE 151A,A01,180414,Staff,0,8,50,50
1681921945211,CSE 175,A01,222521,Kumar; Rakesh,50,0,50,0
1681921946240,CSE 190,A00,201419,Staff,44,0,49,5
1681921947263,CSS 1,A01,194536,Staff,37,0,50,13
1681921948289,DSC 30,A01,202385,Staff,48,0,50,2
1681921949322,DSC 40A,A01,202387,Albuyeh; Rod,50,0,50,0
1681921950352,DSC 190,A01,202389,Silberman; Jack,21,0,21,0
1681921951374,DSGN 100,A01,179993,Staff,15,0,30,15
1681921952410,ECE 65,A50,180708,Staff,10,0,20,10
1681921952410,ECE 65,A51,180739,Staff,19,0,20,1
1681921953443,ECON 1,A01,180427,Famulari; Melissa,67,0,70,3
1681921954469,ECON 2,A01,180450,Levkoff; Steven B.,64,0,70,6
1681921955494,ECON 4,A01,203351,Anderson; John Charles,6,0,10,4
1681921956518,ECON 100A,A01,180472,Famulari; Melissa,64,0,70,6
1681921957551,ECON 120A,A01,180549,Staff,64,0,70,6
1681921958578,ECON 120B,A01,180655,Ma; Xinwei,43,0,70,27
1681921959607,ECON 129,A00,203333,Eckert; Fabian Paul,13,0,35,22
1681921960631,ECON 131,A00,180656,Staff,5,0,35,30
1681921961658,ECON 172B,A01,180672,Levkoff; Steven B.,31,0,35,4
1681921962681,ECON 178,A01,203342,Zhu; Ying,9,0,35,26
1681921963705,EDS 108GS,A00,202383,Wishard Guerra; Alison G.,20,0,20,0
1681921964730,EDS 111GS,A00,202347,Wishard Guerra; Alison G.,20,0,20,0
1681921965770,EDS 112,A01,202323,Staff,55,0,60,5
1681921966794,EDS 113,A00,202340,Staff,32,0,35,3
1681921967818,EDS 118,A00,201231,Staff,20,0,30,10
1681921968849,EDS 119,A00,204994,Staff,8,0,10,2
1681921969875,EDS 124BR,A00,202324,Eguchi; Emi,3,0,25,22
1681921970898,EDS 126,A01,203208,Jones; Makeba,26,0,30,4
1681921971921,EDS 135,A01,202333,Staff,18,0,20,2
1681921972944,EDS 180,A00,202311,Staff,47,0,50,3
1681921973967,ERC 190GS,A01,253747,Staff,28,0,28,0
1681921974993,ETHN 104,A00,180742,Staff,23,0,35,12
1681921976015,ETHN 118,A00,180745,Staff,27,0,35,8
1681921977040,ETHN 127,A00,180747,Staff,11,0,16,5
1681921978140,ETHN 137,A00,180880,Staff,11,0,12,1
1681921979163,ETHN 147,A00,180890,Staff,8,0,10,2
1681921980187,ETHN 154,A00,180891,Staff,7,0,8,1
1681921981212,ETHN 168,A00,180892,Staff,9,0,10,1
1681921982249,GLBH 20,A00,201051,Hannah; Seth Donal,0,2,0,1
1681921983285,GLBH 111,A01,209338,Burgos; Jose L.,0,0,0,0
1681921984310,GLBH 150,A00,258300,Staff,0,3,0,0
1681921985332,GLBH 181,A00,201207,Staff,13,0,40,27
1681921986359,HIEU 109,A00,180898,Staff,20,0,20,0
1681921987385,HIEU 111,A00,180899,Staff,0,1,20,20
1681921988421,HIEU 124,A00,180900,Staff,17,0,20,3
1681921989443,HILA 122,A00,180901,Staff,18,0,20,2
1681921990465,HILA 132,A00,180902,Vitz; Matthew,1,0,20,19
1681921991492,HILD 10,A01,180896,Staff,15,0,20,5
1681921992516,HILD 30GS,A00,180897,Edington; Claire Ellen,0,0,0,0
1681921993543,HISC 105,A00,180903,Staff,20,0,20,0
1681921994565,HISC 117,A00,180904,Staff,11,0,20,9
1681921995590,HIUS 108B,A00,181005,Staff,18,0,20,2
1681921996612,HIUS 113,A00,181093,Staff,1,0,20,19
1681921997636,HUM 3,A01,181190,Patterson; Patrick H.,39,0,50,11
1681921997636,HUM 3,B01,181195,Staff,46,0,50,4
1681921998659,HUM 3GS,A00,181196,Herbst; Matthew,0,0,0,0
1681921999685,HUM 4,A01,181227,West; Geoffrey Scott,33,0,50,17
1681921999685,HUM 4,B01,181282,Staff,41,0,50,9
1681922000710,HUM 4GS,A00,181377,Lyon; Antony J.,0,0,0,0
1681922001734,HUM 5,A01,181536,Zavodny; Tatiana Sophia,28,0,50,22
1681922001734,HUM 5,B01,181908,Staff,36,0,50,14
1681922002764,INTL 190,A00,181909,Segui; Alan S,0,0,0,8
1681922002764,INTL 190,B00,181961,Segui; Alan S,0,0,0,7
1681922003789,JAPN 20AR,A01,182113,Ross; Kayoko F,15,0,20,5
1681922004812,LATI 50,A01,202391,Martin-Cabrera; Luis,18,0,30,12
1681922004812,LATI 50,A02,202392,Martin-Cabrera; Luis,26,0,30,4
1681922005838,LATI 180,A00,202393,Kokinis; Troy Andreas,24,0,25,1
1681922006864,LIFR 1A,A00,182119,Staff,14,0,14,0
1681922007889,LIFR 1AX,A00,182324,Staff,14,0,14,0
1681922008911,LIFR 1B,A00,182259,Staff,13,0,14,1
1681922009933,LIFR 1BX,A00,182273,Staff,13,0,14,1
1681922010965,LIGN 8,A00,182330,Staff,134,0,150,16
1681922011986,LIGN 9GS,A00,182362,Staff,20,0,20,0
1681922013009,LIGN 119,A00,204992,Takahashi; Maho,12,0,15,3
1681922014034,LIGN 130,A01,182384,Staff,47,0,50,3
1681922015056,LIGN 149GS,A00,182390,Staff,20,0,20,0
1681922016081,LIGN 170,A00,182404,Staff,23,0,30,7
1681922017108,LISP 1D,A00,182281,Staff,7,0,14,7
1681922017108,LISP 1D,B00,182287,Staff,13,0,14,1
1681922017108,LISP 1D,C00,182295,Staff,11,0,14,3
1681922017108,LISP 1D,D00,182301,Staff,14,0,14,0
1681922018131,LISP 1DX,A00,182309,Staff,19,0,28,9
1681922018131,LISP 1DX,B00,182316,Staff,26,0,28,2
1681922019154,LTAF 120GS,A00,182412,Zhiri; Oumelbanine,20,0,20,0
1681922020177,LTCS 172GS,A00,182437,Bronstein; Phoebe Malan,20,0,20,0
1681922021203,LTEA 138,A00,182457,Staff,20,0,40,20
1681922022228,LTEN 114,A01,182490,Staff,23,0,25,2
1681922023257,LTEN 130GS,A00,182491,Lyon; Antony J.,20,0,20,0
1681922024290,LTEN 169,A00,182493,Cuong; Marisol,19,0,25,6
1681922025312,LTEN 178,A00,182501,Staff,14,0,15,1
1681922026339,LTEN 181,A00,182515,Staff,21,0,25,4
1681922027366,LTEN 185GS,A00,197655,Forbes; Camille,20,0,20,0
1681922028390,LTSP 100B,A00,202208,Bessett; Ryan Matthew,24,0,25,1
1681922029414,LTWL 100,A00,182516,Myerston Santana; Jacobo,21,0,30,9
1681922030437,LTWR 100GS,A00,182518,Forbes; Camille,20,0,20,0
1681922031461,LTWR 102,A00,182522,Staff,15,0,15,0
1681922031461,LTWR 102,B00,182525,Staff,14,0,15,1
1681922032488,LTWR 115,A00,182526,Staff,11,0,15,4
1681922033513,MAE 8,A01,182528,Pham; Hieu Tan,67,0,70,3
1681922034537,MAE 11,A00,182529,Bahadori; Mohammad Yousef,93,0,100,7
1681922035561,MAE 20,A00,182530,Evdokimenko; Ekaterina,68,0,70,2
1681922036583,MAE 30A,A00,182532,Staff,44,0,45,1
1681922037605,MAE 101A,A00,182533,Bahadori; Mohammad Yousef,95,0,100,5
1681922038631,MAE 101C,A00,182538,Staff,62,0,70,8
1681922039655,MAE 104,A00,182539,Staff,44,0,50,6
1681922040686,MAE 131A,A00,182540,Ghazinejad; Maziar,40,0,45,5
1681922041711,MAE 143A,A00,182548,Bewley; Thomas R,43,0,50,7
1681922042733,MAE 150,A00,182549,Staff,28,0,40,12
1681922043762,MAE 160,A00,182550,Evdokimenko; Ekaterina,41,0,60,19
1681922044790,MATH 3C,A01,182725,Staff,26,0,30,4
1681922045817,MATH 10A,A01,182729,Staff,25,0,30,5
1681922045817,MATH 10A,B01,182732,Staff,26,0,30,4
1681922046839,MATH 10B,A01,182737,Staff,21,0,30,9
1681922046839,MATH 10B,A02,182738,Staff,26,0,30,4
1681922046839,MATH 10B,B01,182744,Staff,27,0,30,3
1681922046839,MATH 10B,B02,182745,Staff,27,0,30,3
1681922047862,MATH 18,A01,182750,Anzaldo; Leesa B,28,0,30,2
1681922047862,MATH 18,A02,182751,Anzaldo; Leesa B,29,0,30,1
1681922047862,MATH 18,A03,182753,Anzaldo; Leesa B,27,0,30,3
1681922047862,MATH 18,A04,182757,Anzaldo; Leesa B,29,0,30,1
1681922047862,MATH 18,B01,182761,Anzaldo; Leesa B,27,0,30,3
1681922047862,MATH 18,B02,182764,Anzaldo; Leesa B,26,0,30,4
1681922047862,MATH 18,B03,182765,Anzaldo; Leesa B,29,0,30,1
1681922047862,MATH 18,B04,182766,Anzaldo; Leesa B,30,0,30,0
1681922048891,MATH 20A,A01,182771,Suk; Andrew Hoon,28,0,30,2
1681922049915,MATH 20B,A01,182775,Bach; Quang Tran,30,0,30,0
1681922049915,MATH 20B,A02,182777,Bach; Quang Tran,29,0,30,1
1681922049915,MATH 20B,B01,182780,Bach; Quang Tran,26,0,30,4
1681922049915,MATH 20B,B02,182782,Bach; Quang Tran,30,0,30,0
1681922050947,MATH 20C,A01,182787,Staff,25,0,30,5
1681922050947,MATH 20C,A02,182790,Staff,29,0,30,1
1681922050947,MATH 20C,B01,182792,Staff,25,0,30,5
1681922050947,MATH 20C,B02,182796,Staff,26,0,30,4
1681922051975,MATH 20D,A01,182799,Staff,28,0,30,2
1681922051975,MATH 20D,A02,182802,Staff,29,0,30,1
1681922051975,MATH 20D,A03,182803,Staff,30,0,30,0
1681922053002,MATH 20E,A01,182809,Verstraete; Jacques Allan,23,0,30,7
1681922053002,MATH 20E,A02,182811,Verstraete; Jacques Allan,28,0,30,2
1681922053002,MATH 20E,B01,182814,Verstraete; Jacques Allan,23,0,30,7
1681922053002,MATH 20E,B02,182815,Verstraete; Jacques Allan,30,0,30,0
1681922054029,MATH 103A,A01,182820,Staff,8,0,30,22
1681922054029,MATH 103A,A02,182821,Staff,27,0,30,3
1681922054029,MATH 103A,A03,182822,Staff,23,0,30,7
1681922054029,MATH 103A,B01,182825,Staff,23,0,30,7
1681922054029,MATH 103A,B02,182826,Staff,30,0,30,0
1681922054029,MATH 103A,B03,182830,Staff,30,0,30,0
1681922055054,MATH 109,A01,182836,Chow; Bennett,24,0,30,6
1681922055054,MATH 109,A02,182838,Chow; Bennett,29,0,30,1
1681922055054,MATH 109,A03,182894,Chow; Bennett,29,0,30,1
1681922055054,MATH 109,B01,182908,Chow; Bennett,27,0,30,3
1681922055054,MATH 109,B02,182909,Chow; Bennett,30,0,30,0
1681922055054,MATH 109,B03,182910,Chow; Bennett,27,0,30,3
1681922056077,MATH 142A,A01,182925,Staff,9,0,30,21
1681922056077,MATH 142A,A02,182935,Staff,24,0,30,6
1681922056077,MATH 142A,A03,182967,Staff,26,0,30,4
1681922056077,MATH 142A,B01,183125,Staff,22,0,30,8
1681922056077,MATH 142A,B02,183157,Staff,28,0,30,2
1681922056077,MATH 142A,B03,183158,Staff,29,0,30,1
1681922057103,MATH 183,A01,183160,Arias-Castro; Ery,23,0,30,7
1681922057103,MATH 183,A02,183161,Arias-Castro; Ery,29,0,30,1
1681922057103,MATH 183,B01,183163,Arias-Castro; Ery,28,0,30,2
1681922057103,MATH 183,B02,183164,Arias-Castro; Ery,28,0,30,2
1681922058126,MATH 193A,A01,183167,Staff,2,0,35,33
1681922058126,MATH 193A,A02,183168,Staff,28,0,35,7
1681922058126,MATH 193A,A03,183169,Staff,34,0,35,1
1681922058126,MATH 193A,A04,183170,Staff,28,0,35,7
1681922059154,MGT 4,A01,202395,Anderson; John Charles,75,0,80,5
1681922060177,MGT 5,A00,202396,Houskeeper; Robert,79,0,90,11
1681922061203,MGT 103,A00,202397,Eberhard; Craig A,50,0,90,40
1681922062228,MGT 131A,A00,202398,Houskeeper; Robert,84,0,90,6
1681922063253,MGT 135,A00,202399,Anderson; John Charles,81,0,90,9
1681922064278,MGT 162R,A00,202403,Gneezy; Uri,140,0,200,60
1681922065301,MGT 172,A00,202404,Hedges; Kathleen,44,0,90,46
1681922066325,MGT 181,A00,202405,Dunn; Louis Jean,80,0,90,10
1681922067348,MMW 14,A01,183200,Staff,11,0,28,17
1681922067348,MMW 14,A02,183201,Staff,26,0,28,2
1681922067348,MMW 14,A03,183202,Staff,24,0,28,4
1681922067348,MMW 14,A04,183203,Staff,25,0,28,3
1681922067348,MMW 14,A05,183204,Staff,26,0,28,2
1681922067348,MMW 14,A06,183205,Staff,27,0,28,1
1681922067348,MMW 14,B01,183207,Staff,26,0,28,2
1681922067348,MMW 14,B02,183208,Staff,28,0,28,0
1681922067348,MMW 14,B03,183209,Staff,28,0,28,0
1681922067348,MMW 14,B04,183210,Staff,28,0,28,0
1681922067348,MMW 14,B05,183211,Staff,28,0,28,0
1681922067348,MMW 14,B06,183212,Staff,27,0,28,1
1681922068371,MMW 14GS,A00,183213,Zhiri; Oumelbanine,28,0,28,0
1681922069400,MMW 15GS,B00,183215,Rahimi; Babak,28,0,28,0
1681922070423,MMW 121,A01,183217,Patterson; Patrick H.,13,0,28,15
1681922070423,MMW 121,A02,183218,Patterson; Patrick H.,25,0,28,3
1681922071445,MUS 1A,A01,182554,Staff,7,0,35,28
1681922072481,MUS 5,A01,182558,Staff,19,0,35,16
1681922073504,MUS 6,A01,182562,Staff,22,0,35,13
1681922074537,MUS 8GS,A00,182563,Borgo; David Garcia,25,0,25,0
1681922075561,MUS 13,A01,182567,Staff,24,0,25,1
1681922076583,MUS 15,A01,182570,Staff,32,0,35,3
1681922076583,MUS 15,B01,182575,Staff,9,0,35,26
1681922077606,MUS 80,A00,182578,Staff,22,0,25,3
1681922077606,MUS 80,B00,182581,Staff,20,0,25,5
1681922078639,MUS 113,A00,182582,Staff,25,0,25,0
1681922079669,MUS 114,A00,182583,Staff,3,0,25,22
1681922080693,MUS 150GS,A01,182588,Borgo; David Garcia,25,0,25,0
1681922081789,PHIL 1,A00,182590,Staff,35,0,40,5
1681922082813,PHIL 10,A01,182596,Grush; Rick Scott,31,0,35,4
1681922082813,PHIL 10,A02,182597,Grush; Rick Scott,34,0,35,1
1681922083839,PHIL 15,A01,182601,Staff,31,0,35,4
1681922083839,PHIL 15,A02,182602,Staff,33,0,35,2
1681922084867,PHIL 27,A01,182604,Staff,30,0,35,5
1681922084867,PHIL 27,A02,182607,Staff,35,0,35,0
1681922085893,PHIL 32,A01,182609,Staff,35,0,35,0
1681922085893,PHIL 32,A02,182612,Staff,35,0,35,0
1681922086916,PHIL 130,A00,182614,Staff,62,0,70,8
1681922087940,PHIL 136,A00,182616,Cohen; Jonathan David,66,0,70,4
1681922088963,PHIL 155,A00,182617,Vargas; Manuel Rogelio,58,0,70,12
1681922089990,PHIL 163,A01,182620,Staff,15,0,20,5
1681922089990,PHIL 163,A02,182624,Staff,10,0,20,10
1681922091014,PHIL 164,A00,182627,Staff,29,0,40,11
1681922092037,PHIL 173,A00,182628,Staff,36,0,40,4
1681922093061,PHYS 1A,A00,183221,Staff,54,0,60,6
1681922094084,PHYS 1AL,001,183222,Staff,25,0,30,5
1681922094084,PHYS 1AL,002,183223,Staff,28,0,30,2
1681922095112,PHYS 1B,A00,183231,Staff,43,0,60,17
1681922096136,PHYS 1BL,001,183232,Staff,20,0,30,10
1681922096136,PHYS 1BL,002,183233,Staff,27,0,30,3
1681922097161,PHYS 1C,A00,183240,Staff,28,0,60,32
1681922098188,PHYS 1CL,001,183241,Staff,11,0,30,19
1681922098188,PHYS 1CL,002,183242,Staff,22,0,30,8
1681922099216,PHYS 2AR,A01,183250,Staff,43,0,50,7
1681922100242,PHYS 2B,A01,183252,Staff,104,0,115,11
1681922101269,PHYS 2BL,A01,183254,Staff,21,0,24,3
1681922101269,PHYS 2BL,A02,183255,Staff,22,0,24,2
1681922102298,PHYS 2C,A01,183522,Staff,103,0,115,12
1681922103332,PHYS 4A,A01,183524,Staff,49,0,50,1
1681922104356,POLI 5,A00,183525,Staff,44,0,50,6
1681922105379,POLI 12,A00,183540,Staff,45,0,50,5
1681922106400,POLI 13R,A00,183541,Forman; Fonna,42,0,50,8
1681922107431,POLI 30,A00,183542,Mignozzetti; Umberto,48,0,50,2
1681922108467,POLI 100A,A00,183543,Staff,45,0,50,5
1681922109490,POLI 100E,A00,223598,Staff,32,0,35,3
1681922110520,POLI 103A,A00,183564,Kousser; Thad,37,0,50,13
1681922111542,POLI 104B,A00,201329,Staff,28,0,35,7
1681922112566,POLI 113BR,A00,183576,Hoston; Germaine,25,0,50,25
1681922113597,POLI 114BR,A00,183588,Staff,27,0,30,3
1681922114627,POLI 117R,A00,183595,Forman; Fonna,6,0,20,14
1681922115658,POLI 120H,A00,183596,Fisk; David Lee,13,0,20,7
1681922116686,POLI 130AA,A00,183597,Staff,14,0,20,6
1681922117712,POLI 134AA,A00,183598,Staff,19,0,20,1
1681922118735,POLI 135,A00,183599,Fisk; David Lee,19,0,25,6
1681922119758,POLI 142P,A00,183623,Staff,37,0,40,3
1681922120780,POLI 144D,A00,183624,Staff,22,0,25,3
1681922121803,POLI 151,A00,183625,Staff,15,0,20,5
1681922122826,POLI 162,A00,183626,Mignozzetti; Umberto,17,0,20,3
1681922123849,PSYC 1,A00,253748,Staff,86,0,90,4
1681922124878,PSYC 2,A00,183627,Moranton; Nirelia Melbina-,25,0,35,10
1681922125906,PSYC 3,A00,183628,Staff,43,0,45,2
1681922127955,PSYC 60,A01,183631,Lowe; Angela Beth,35,0,40,5
1681922128979,PSYC 70,A01,253757,Staff,37,0,45,8
1681922130008,PSYC 101,A00,183632,Heyman; Gail D.,47,0,60,13
1681922131039,PSYC 105,A00,183848,Lowe; Angela Beth,47,0,60,13
1681922132062,PSYC 106,A00,183849,Dobkins; Karen R.,43,0,60,17
1681922133089,PSYC 108,A00,253750,Staff,22,0,60,38
1681922134113,PSYC 114,A01,184275,Winkielman; Piotr,0,7,30,30
1681922135141,PSYC 122,A00,183856,Moranton; Nirelia Melbina-,0,14,30,30
1681922136162,PSYC 124,A00,183865,Chapman; Eddie Nathaniel,49,0,80,31
1681922137188,PSYC 137,A00,183880,Staff,19,0,25,6
1681922139239,PSYC 154,A00,183910,Lacefield; Katharine I,0,14,90,90
1681922141286,PSYC 162,A00,183946,Wixted; John T,55,0,90,35
1681922142311,PSYC 172,A00,183947,Gorman; Michael R.,10,0,30,20
1681922143334,PSYC 178,A00,183963,Glaser; Dale,17,0,40,23
1681922144357,PSYC 181GS,A00,183964,Anagnostaras; Stephan,10,0,10,0
1681922145380,PSYC 186GS,A01,257660,Staff,10,0,10,0
1681922146406,PSYC 193,B00,253749,Staff,23,0,25,2
1681922148460,PSYC 193L,A01,184122,Staff,33,0,35,2
1681922148460,PSYC 193L,C01,184167,Winkielman; Piotr,15,0,30,15
1681922149486,RELI 188GS,A00,182629,Rahimi; Babak,20,0,20,0
1681922150508,SE 101A,A00,182646,Staff,26,0,30,4
1681922151529,SE 101C,A00,182650,Staff,17,0,20,3
1681922152552,SE 110A,A00,182651,Staff,28,0,28,0
1681922153577,SE 130A,A00,182652,Staff,39,0,40,1
1681922154613,SIO 46GS,A00,182636,Cook; Geoffrey W,26,0,28,2
1681922155645,SIO 109R,A00,194459,Staff,4,0,20,16
1681922156668,SIO 121GS,A00,182639,Cook; Geoffrey W,26,0,28,2
1681922157692,SIO 132,A01,182642,Staff,32,0,40,8
1681922158718,SIO 139,A00,182644,Kacev; David,36,0,40,4
1681922159742,SOCI 2,A01,258404,Staff,33,0,36,3
1681922159742,SOCI 2,A02,258405,Staff,35,0,36,1
1681922160773,SOCI 60,A01,258408,Staff,29,0,30,1
1681922160773,SOCI 60,A02,258413,Staff,30,0,30,0
1681922161796,SOCI 100,A01,258415,Staff,29,0,30,1
1681922161796,SOCI 100,A02,258416,Staff,28,0,30,2
1681922167973,SOCI 127,A00,258421,Staff,21,0,30,9
1681922168996,SOCI 132,A00,258422,Staff,45,0,50,5
1681922170028,SOCI 133,A00,258423,Staff,26,0,30,4
1681922171052,SOCI 138GS,A00,258424,Staff,15,0,15,0
1681922172082,SOCI 145,A00,258425,Staff,25,0,30,5
1681922173110,SOCI 148,A00,258426,Staff,25,0,30,5
1681922174138,SOCI 153,A00,199217,Staff,29,0,30,1
1681922175161,SOCI 160,A00,258427,Staff,28,0,30,2
1681922176184,SOCI 160E,A00,258435,Staff,56,0,60,4
1681922177208,SOCI 189GS,A00,258436,Staff,15,0,15,0
1681922178230,SOCI 190GS,A00,258437,Staff,15,0,15,0
1681922179257,SYN 2,001,182658,Staff,8,0,16,8
1681922179257,SYN 2,002,201439,Staff,14,0,16,2
1681922179257,SYN 2,003,201443,Staff,16,0,16,0
1681922180286,SYN 100,A01,182657,Staff,16,0,20,4
1681922181315,TDAC 1,A00,184381,Salovey; Todd,16,0,20,4
1681922181315,TDAC 1,B00,184385,Harting; Carla Kelso,19,0,20,1
1681922181315,TDAC 1,C00,184394,Staff,19,0,20,1
1681922182337,TDAC 101,A00,184483,Harting; Carla Kelso,19,0,20,1
1681922183361,TDDE 111,A00,184496,Staff,14,0,15,1
1681922184386,TDDE 131,A00,184504,Staff,20,0,20,0
1681922184386,TDDE 131,B00,184505,Staff,17,0,18,1
1681922184386,TDDE 131,C00,184534,Staff,49,0,50,1
1681922184386,TDDE 131,D00,184564,Staff,15,0,15,0
1681922184386,TDDE 131,E00,204725,Staff,19,0,20,1
1681922185487,TDGE 1,A01,184414,Salovey; Todd,36,0,50,14
1681922186510,TDGE 5,A01,184419,Staff,23,0,24,1
1681922187535,TDGE 10,A00,184428,Fulton; Julia,29,0,50,21
1681922188559,TDGE 124,A00,184565,Fulton; Julia,6,0,50,44
1681922189586,TDGE 125,B00,184567,Meyer; Ursula,9,0,25,16
1681922190612,TDHT 101,A00,184568,Staff,21,0,25,4
1681922190612,TDHT 101,B00,184569,Staff,20,0,20,0
1681922191634,TDHT 114,A00,184570,Staff,49,0,50,1
1681922192660,TDMV 1,A00,184437,Arcidiacono; Kristin,22,0,30,8
1681922192660,TDMV 1,B00,184448,Caligagan; Maria T.,23,0,30,7
1681922193685,TDMV 2,A00,184449,Weinberg; Sadie,27,0,30,3
1681922193685,TDMV 2,B00,184453,Arcidiacono; Kristin,29,0,30,1
1681922194716,TDMV 110,A00,184571,Weinberg; Sadie,30,0,30,0
1681922195740,TDMV 142,A00,184572,Caligagan; Tony,27,0,30,3
1681922195740,TDMV 142,B00,184573,Caligagan; Maria T.,26,0,30,4
1681922196763,TDTR 20,A00,184482,Jun; Grace Shin Hae,25,0,25,0
1681922197786,USP 2,A01,184290,Hinds; Juli Beth,24,0,25,1
1681922198809,USP 3,A01,184295,Staff,21,0,25,4
1681922199831,USP 4,A00,184304,McTague; Sarah,13,0,25,12
1681922200854,USP 100,A00,184315,Staff,16,0,25,9
1681922201877,USP 105,A00,184326,Staff,21,0,25,4
1681922202901,USP 151,A00,184327,Staff,20,0,25,5
1681922203923,USP 170,A00,184380,Hinds; Juli Beth,13,0,25,12
1681922204946,VIS 21B,A01,182660,Staff,28,0,31,3
1681922204946,VIS 21B,A02,182662,Staff,30,0,31,1
1681922205975,VIS 103D,A00,182663,Staff,74,0,75,1
1681922206998,VIS 105D,A00,182667,Li; Huai,14,0,22,8
1681922208019,VIS 122GS,A00,182668,Herbst; Matthew,20,0,20,0
1681922209045,VIS 128C,A00,182673,Staff,69,0,75,6
1681922210071,VIS 130,A00,182675,Staff,19,0,22,3
1681922211103,VIS 160A,A00,182678,Stalbaum; Brett,4,0,10,6
1681922213154,WCWP 10B,A00,201679,Staff,15,0,15,0
1681922213154,WCWP 10B,B00,201695,Staff,15,0,15,0
1681922214189,WCWP 100,A00,201716,Staff,12,0,15,3
1681922214189,WCWP 100,B00,201717,Staff,6,0,15,9
1681922216250,ANSC 105GS,A00,258289,Staff,0,0,0,0
1681922217272,ANSC 125GS,A00,258295,Staff,0,0,0,0
1681922218296,ANSC 150,A00,258267,Staff,30,0,40,10
1681922219319,ANSC 190GS,A00,258280,Staff,0,0,0,0
1681922220350,ANTH 1,A00,258264,Staff,38,0,40,2
1681922221378,ANTH 2,A01,258259,Staff,72,0,76,4
1681922222403,ANTH 23,A01,258228,Staff,36,0,40,4
1681922223425,ANTH 101,A01,258236,Staff,38,0,40,2
1681922224448,ANTH 102,A00,258272,Staff,59,0,60,1
1681922225469,ANTH 105,A00,258244,Staff,31,0,35,4
1681922226493,BENG 130,A00,253975,Staff,38,0,40,2
1681922227518,BIBC 102,A01,191866,Flagg; Matthew Paul,19,0,32,13
1681922227518,BIBC 102,A02,191867,Flagg; Matthew Paul,22,0,32,10
1681922227518,BIBC 102,A03,191868,Flagg; Matthew Paul,29,0,32,3
1681922227518,BIBC 102,A04,191936,Flagg; Matthew Paul,26,0,32,6
1681922227518,BIBC 102,A05,191937,Flagg; Matthew Paul,5,0,32,27
1681922228550,BICD 100,A01,191939,Cooper; Andrew Michael,28,0,32,4
1681922228550,BICD 100,A02,191940,Cooper; Andrew Michael,32,0,32,0
1681922228550,BICD 100,A03,191941,Cooper; Andrew Michael,32,0,32,0
1681922228550,BICD 100,A04,191942,Cooper; Andrew Michael,32,0,32,0
1681922228550,BICD 100,A05,191943,Cooper; Andrew Michael,32,0,32,0
1681922229577,BIEB 126,A01,191945,Cleland; Elsa Eleanor,0,0,32,32
1681922229577,BIEB 126,A02,191946,Cleland; Elsa Eleanor,27,0,32,5
1681922229577,BIEB 126,A03,191947,Cleland; Elsa Eleanor,29,0,32,3
1681922229577,BIEB 126,A04,191948,Cleland; Elsa Eleanor,23,0,32,9
1681922229577,BIEB 126,A05,191996,Cleland; Elsa Eleanor,28,0,32,4
1681922230599,BIEB 136GS,A00,191997,Shurin; Jonathan & Holway; David A.,0,0,0,4
1681922231624,BIEB 137GS,A01,191999,Shurin; Jonathan & Holway; David A.,0,0,0,3
1681922232647,BILD 1,A01,205385,Staff,31,0,32,1
1681922232647,BILD 1,A02,205386,Staff,30,0,32,2
1681922232647,BILD 1,A03,205387,Staff,32,0,32,0
1681922232647,BILD 1,A04,205388,Staff,27,0,32,5
1681922233671,BILD 2,A01,191774,Staff,28,0,32,4
1681922233671,BILD 2,A02,191775,Staff,30,0,32,2
1681922233671,BILD 2,A03,191777,Staff,30,0,32,2
1681922233671,BILD 2,A04,191856,Staff,31,0,32,1
1681922233671,BILD 2,A05,191857,Staff,32,0,32,0
1681922233671,BILD 2,A06,191858,Staff,32,0,32,0
1681922233671,BILD 2,A07,191859,Staff,31,0,32,1
1681922234696,BILD 3,A01,205391,Staff,29,0,32,3
1681922234696,BILD 3,A02,205393,Staff,32,0,32,0
1681922234696,BILD 3,A03,205394,Staff,28,0,32,4
1681922234696,BILD 3,A04,205395,Staff,32,0,32,0
1681922235723,BILD 20,A01,191861,Staff,32,0,32,0
1681922235723,BILD 20,A02,191862,Staff,32,0,32,0
1681922236754,BILD 30,A01,191864,Staff,31,0,32,1
1681922237781,BIMM 100,A01,192019,Staff,0,0,32,32
1681922237781,BIMM 100,A02,192020,Staff,20,0,32,12
1681922237781,BIMM 100,A03,192035,Staff,21,0,32,11
1681922238804,BIMM 110,A01,192037,Tat; John,0,0,32,32
1681922238804,BIMM 110,A02,192038,Tat; John,8,0,32,24
1681922239830,BIMM 120,A01,192040,Pickett; Brooke Elizabeth,1,0,32,31
1681922239830,BIMM 120,A02,192041,Pickett; Brooke Elizabeth,15,0,32,17
1681922239830,BIMM 120,A03,192042,Pickett; Brooke Elizabeth,15,0,32,17
1681922240863,BIPN 100,A01,192044,Armour; Jon Christopher,23,0,32,9
1681922240863,BIPN 100,A02,192059,Armour; Jon Christopher,30,0,32,2
1681922240863,BIPN 100,A03,192064,Armour; Jon Christopher,30,0,32,2
1681922240863,BIPN 100,A04,192073,Armour; Jon Christopher,28,0,32,4
1681922241889,BIPN 148,A01,205411,Leutgeb; Jill K.,15,0,32,17
1681922241889,BIPN 148,A02,205412,Leutgeb; Jill K.,31,0,32,1
1681922241889,BIPN 148,A03,205413,Leutgeb; Jill K.,30,0,32,2
1681922241889,BIPN 148,A04,205414,Leutgeb; Jill K.,30,0,32,2
1681922242922,BIPN 160,A01,192115,Marino; Marc J,17,0,32,15
1681922242922,BIPN 160,A02,192148,Marino; Marc J,27,0,32,5
1681922242922,BIPN 160,A03,192158,Marino; Marc J,31,0,32,1
1681922242922,BIPN 160,A04,192190,Marino; Marc J,32,0,32,0
1681922242922,BIPN 160,A05,192287,Marino; Marc J,32,0,32,0
1681922242922,BIPN 160,A06,192288,Marino; Marc J,32,0,32,0
1681922243948,BIPN 194,A00,206038,Staff,28,0,32,4
1681922244978,BISP 194,A00,192289,Leutgeb; Stefan,13,0,32,19
1681922244978,BISP 194,B00,245332,Nieh; James Charles,26,0,32,6
1681922246011,CAT 124,A01,202247,Staff,15,0,15,0
1681922247038,CAT 125,A00,202248,Staff,19,0,20,1
1681922247038,CAT 125,B00,202253,Staff,20,0,20,0
1681922247038,CAT 125,C00,202257,Staff,18,0,20,2
1681922248063,CAT 125GS,A01,202273,Bronstein; Phoebe Malan,20,0,20,0
1681922249090,CAT 125R,A00,202284,Staff,18,0,20,2
1681922249090,CAT 125R,C00,202286,Staff,10,0,20,10
1681922249090,CAT 125R,D00,202291,Staff,18,0,20,2
1681922249090,CAT 125R,E00,202295,Staff,13,0,20,7
1681922249090,CAT 125R,F00,202302,Staff,9,0,20,11
1681922250119,CENG 100,A00,204724,Opatkiewicz; Justin Paul,25,0,25,0
1681922251142,CGS 2A,A01,180420,Staff,31,0,36,5
1681922252169,CGS 101,A00,180421,Staff,16,0,20,4
1681922253195,CGS 112,A00,180422,Staff,9,0,16,7
1681922254221,CGS 113,A00,180423,Staff,18,0,20,2
1681922255247,CGS 137,A00,180424,Staff,12,0,12,0
1681922256272,CGS 147,A00,180425,Staff,10,0,10,0
1681922257306,CHEM 6A,A01,179556,Staff,96,0,100,4
1681922257306,CHEM 6A,A02,179558,Staff,0,0,0,0
1681922258336,CHEM 6B,A01,179560,Staff,100,0,100,0
1681922259362,CHEM 6C,A01,179565,Jazzar; Rodolphe,95,0,100,5
1681922260398,CHEM 7L,A01,179586,Schurmeier; Kimberly,11,0,24,13
1681922260398,CHEM 7L,A02,179587,Schurmeier; Kimberly,23,0,24,1
1681922260398,CHEM 7L,A03,179590,Schurmeier; Kimberly,22,0,24,2
1681922260398,CHEM 7L,A04,179591,Schurmeier; Kimberly,22,0,24,2
1681922260398,CHEM 7L,B01,179598,Schurmeier; Kimberly,16,0,24,8
1681922260398,CHEM 7L,B02,179599,Schurmeier; Kimberly,24,0,24,0
1681922260398,CHEM 7L,B03,179606,Schurmeier; Kimberly,23,0,24,1
1681922260398,CHEM 7L,B04,179607,Schurmeier; Kimberly,23,0,24,1
1681922261425,CHEM 11,A01,179609,Stallings; Dontarie M,88,0,100,12
1681922262457,CHEM 40A,A01,179621,Staff,40,0,50,10
1681922262457,CHEM 40A,A02,179622,Staff,46,0,50,4
1681922263486,CHEM 40B,A01,179630,Weizman; Haim,47,0,50,3
1681922263486,CHEM 40B,A02,179631,Weizman; Haim,45,0,50,5
1681922264510,CHEM 41A,A01,179660,Klosterman; Jeremy K,93,0,100,7
1681922265533,CHEM 43A,A01,179683,Klosterman; Jeremy K,0,0,24,24
1681922265533,CHEM 43A,A02,179688,Klosterman; Jeremy K,9,0,24,15
1681922265533,CHEM 43A,A03,179689,Klosterman; Jeremy K,19,0,24,5
1681922265533,CHEM 43A,A04,179691,Klosterman; Jeremy K,18,0,24,6
1681922266560,CHEM 114A,A01,179693,Stallings; Dontarie M,72,0,100,28
1681922267582,CHEM 143B,A01,179698,Weizman; Haim,16,0,24,8
1681922267582,CHEM 143B,A02,179700,Weizman; Haim,24,0,24,0
1681922268607,CHIN 169A,A00,179701,Wang; Xiao,20,0,20,0
1681922269631,COGS 2,A01,179750,Boyle; Mary E. T.,17,0,30,13
1681922270658,COGS 9,A01,179759,Jones; Cameron Robert,42,0,50,8
1681922271681,COGS 14A,A01,179854,Staff,15,0,50,35
1681922272715,COGS 14B,A01,179856,Staff,53,0,60,7
1681922273738,COGS 17,A01,179874,Staff,71,0,75,4
1681922274769,COGS 18,A01,179884,Staff,63,0,80,17
1681922275799,COGS 100,A01,179886,Staff,36,0,60,24
1681922276829,COGS 101B,A01,179892,Staff,1,0,30,29
1681922277851,COGS 101C,A01,179894,Staff,28,0,30,2
1681922278874,COGS 107A,A01,179896,Boyle; Mary E. T.,31,0,40,9
1681922279897,COGS 108,A01,179898,Simpkins; Charles Alexander,0,24,60,60
1681922280920,COGS 109,A01,179900,Staff,34,0,40,6
1681922281947,COGS 118A,A01,179946,Staff,8,0,40,32
1681922282970,COGS 153,A00,179978,Staff,0,3,30,30
1681922284003,COGS 156,A01,179981,Staff,24,0,30,6
1681922286051,COGS 172,A01,179987,Staff,13,0,30,17
1681922288109,COGS 186,A01,179991,Staff,12,0,30,18
1681922289231,COMM 10,A01,180001,Staff,14,0,25,11
1681922289231,COMM 10,A02,180004,Staff,20,0,25,5
1681922290259,COMM 100A,A01,180016,Staff,15,0,25,10
1681922290259,COMM 100A,A02,180020,Staff,24,0,25,1
1681922291280,COMM 101T,A00,180029,Halm; Gavin Patrick,23,0,35,12
1681922292306,COMM 106V,A00,180043,Staff,34,0,35,1
1681922293334,COMM 109P,A00,180044,Staff,30,0,35,5
1681922294360,COMM 113T,A00,180045,Havis; Allan,37,0,45,8
1681922295383,COMM 132,A00,180046,McKenna; Denise,23,0,30,7
1681922296405,COMM 143,A00,180047,Staff,18,0,30,12
1681922297428,COMM 190,A00,180048,Conner; Thomas Hartnell,18,0,23,5
1681922298453,CSE 8A,A50,180053,Cao; Yingjun,24,0,50,26
1681922298453,CSE 8A,B50,180180,Staff,50,0,50,0
1681922299479,CSE 11,A01,180190,Cao; Yingjun,26,0,50,24
1681922300502,CSE 20,A01,180192,Briones; Jor-el Thomas Caparas,23,0,30,7
1681922301526,CSE 21,A01,194538,Briones; Jor-el Thomas Caparas,50,0,60,10
1681922302557,CSE 30,A01,180324,Eldon; John,76,0,100,24
1681922303580,CSE 101,A01,201353,Staff,0,24,40,40
1681922304606,CSE 134B,A01,180326,Powell; Thomas Allan,74,0,100,26
1681922305633,CSE 140,A01,180328,Staff,41,0,75,34
1681922306657,CSE 140L,A01,180344,Eldon; John,64,0,100,36
1681922307683,CSE 150A,A01,180411,Staff,0,13,50,50
1681922308708,CSE 151A,A01,180414,Staff,0,8,50,50
1681922309735,CSE 175,A01,222521,Kumar; Rakesh,50,0,50,0
1681922310760,CSE 190,A00,201419,Staff,44,0,49,5
1681922311786,CSS 1,A01,194536,Staff,37,0,50,13
1681922312814,DSC 30,A01,202385,Staff,48,0,50,2
1681922313841,DSC 40A,A01,202387,Albuyeh; Rod,50,0,50,0
1681922314865,DSC 190,A01,202389,Silberman; Jack,21,0,21,0
1681922315889,DSGN 100,A01,179993,Staff,15,0,30,15
1681922316917,ECE 65,A50,180708,Staff,10,0,20,10
1681922316917,ECE 65,A51,180739,Staff,19,0,20,1
1681922317946,ECON 1,A01,180427,Famulari; Melissa,67,0,70,3
1681922318969,ECON 2,A01,180450,Levkoff; Steven B.,64,0,70,6
1681922319993,ECON 4,A01,203351,Anderson; John Charles,6,0,10,4
1681922321019,ECON 100A,A01,180472,Famulari; Melissa,63,0,70,7
1681922322042,ECON 120A,A01,180549,Staff,64,0,70,6
1681922323066,ECON 120B,A01,180655,Ma; Xinwei,43,0,70,27
1681922324088,ECON 129,A00,203333,Eckert; Fabian Paul,13,0,35,22
1681922325111,ECON 131,A00,180656,Staff,5,0,35,30
1681922326133,ECON 172B,A01,180672,Levkoff; Steven B.,31,0,35,4
1681922327156,ECON 178,A01,203342,Zhu; Ying,9,0,35,26
1681922328179,EDS 108GS,A00,202383,Wishard Guerra; Alison G.,20,0,20,0
1681922329201,EDS 111GS,A00,202347,Wishard Guerra; Alison G.,20,0,20,0
1681922330224,EDS 112,A01,202323,Staff,55,0,60,5
1681922331249,EDS 113,A00,202340,Staff,32,0,35,3
1681922332281,EDS 118,A00,201231,Staff,20,0,30,10
1681922333309,EDS 119,A00,204994,Staff,8,0,10,2
1681922334335,EDS 124BR,A00,202324,Eguchi; Emi,2,0,25,23
1681922335376,EDS 126,A01,203208,Jones; Makeba,26,0,30,4
1681922336401,EDS 135,A01,202333,Staff,18,0,20,2
1681922337423,EDS 180,A00,202311,Staff,47,0,50,3
1681922338446,ERC 190GS,A01,253747,Staff,28,0,28,0
1681922339469,ETHN 104,A00,180742,Staff,23,0,35,12
1681922340495,ETHN 118,A00,180745,Staff,27,0,35,8
1681922341517,ETHN 127,A00,180747,Staff,11,0,16,5
1681922342543,ETHN 137,A00,180880,Staff,11,0,12,1
1681922343565,ETHN 147,A00,180890,Staff,8,0,10,2
1681922344594,ETHN 154,A00,180891,Staff,7,0,8,1
1681922345624,ETHN 168,A00,180892,Staff,9,0,10,1
1681922346647,GLBH 20,A00,201051,Hannah; Seth Donal,0,2,0,1
1681922347670,GLBH 111,A01,209338,Burgos; Jose L.,0,0,0,0
1681922348691,GLBH 150,A00,258300,Staff,0,3,0,0
1681922349716,GLBH 181,A00,201207,Staff,13,0,40,27
1681922350738,HIEU 109,A00,180898,Staff,19,0,20,1
1681922351768,HIEU 111,A00,180899,Staff,0,1,20,20
1681922352795,HIEU 124,A00,180900,Staff,17,0,20,3
1681922353819,HILA 122,A00,180901,Staff,18,0,20,2
1681922354842,HILA 132,A00,180902,Vitz; Matthew,1,0,20,19
1681922355866,HILD 10,A01,180896,Staff,15,0,20,5
1681922356891,HILD 30GS,A00,180897,Edington; Claire Ellen,0,0,0,0
1681922357918,HISC 105,A00,180903,Staff,20,0,20,0
1681922358949,HISC 117,A00,180904,Staff,11,0,20,9
1681922359975,HIUS 108B,A00,181005,Staff,18,0,20,2
1681922360997,HIUS 113,A00,181093,Staff,1,0,20,19
1681922362019,HUM 3,A01,181190,Patterson; Patrick H.,39,0,50,11
1681922362019,HUM 3,B01,181195,Staff,46,0,50,4
1681922363042,HUM 3GS,A00,181196,Herbst; Matthew,0,0,0,0
1681922364065,HUM 4,A01,181227,West; Geoffrey Scott,33,0,50,17
1681922364065,HUM 4,B01,181282,Staff,41,0,50,9
1681922365093,HUM 4GS,A00,181377,Lyon; Antony J.,0,0,0,0
1681922366116,HUM 5,A01,181536,Zavodny; Tatiana Sophia,28,0,50,22
1681922366116,HUM 5,B01,181908,Staff,36,0,50,14
1681922367139,INTL 190,A00,181909,Segui; Alan S,0,0,0,8
1681922367139,INTL 190,B00,181961,Segui; Alan S,0,0,0,7
1681922368162,JAPN 20AR,A01,182113,Ross; Kayoko F,15,0,20,5
1681922369185,LATI 50,A01,202391,Martin-Cabrera; Luis,18,0,30,12
1681922369185,LATI 50,A02,202392,Martin-Cabrera; Luis,26,0,30,4
1681922370209,LATI 180,A00,202393,Kokinis; Troy Andreas,24,0,25,1
1681922371235,LIFR 1A,A00,182119,Staff,14,0,14,0
1681922372261,LIFR 1AX,A00,182324,Staff,14,0,14,0
1681922373284,LIFR 1B,A00,182259,Staff,13,0,14,1
1681922374306,LIFR 1BX,A00,182273,Staff,13,0,14,1
1681922375343,LIGN 8,A00,182330,Staff,134,0,150,16
1681922376371,LIGN 9GS,A00,182362,Staff,20,0,20,0
1681922377397,LIGN 119,A00,204992,Takahashi; Maho,12,0,15,3
1681922378421,LIGN 130,A01,182384,Staff,47,0,50,3
1681922379446,LIGN 149GS,A00,182390,Staff,20,0,20,0
1681922380475,LIGN 170,A00,182404,Staff,23,0,30,7
1681922381501,LISP 1D,A00,182281,Staff,7,0,14,7
1681922381501,LISP 1D,B00,182287,Staff,13,0,14,1
1681922381501,LISP 1D,C00,182295,Staff,11,0,14,3
1681922381501,LISP 1D,D00,182301,Staff,14,0,14,0
1681922382527,LISP 1DX,A00,182309,Staff,19,0,28,9
1681922382527,LISP 1DX,B00,182316,Staff,26,0,28,2
1681922383562,LTAF 120GS,A00,182412,Zhiri; Oumelbanine,20,0,20,0
1681922384588,LTCS 172GS,A00,182437,Bronstein; Phoebe Malan,20,0,20,0
1681922385610,LTEA 138,A00,182457,Staff,20,0,40,20
1681922386632,LTEN 114,A01,182490,Staff,23,0,25,2
1681922387662,LTEN 130GS,A00,182491,Lyon; Antony J.,20,0,20,0
1681922388696,LTEN 169,A00,182493,Cuong; Marisol,19,0,25,6
1681922389719,LTEN 178,A00,182501,Staff,14,0,15,1
1681922390748,LTEN 181,A00,182515,Staff,21,0,25,4
1681922391771,LTEN 185GS,A00,197655,Forbes; Camille,20,0,20,0
1681922392865,LTSP 100B,A00,202208,Bessett; Ryan Matthew,24,0,25,1
1681922393892,LTWL 100,A00,182516,Myerston Santana; Jacobo,21,0,30,9
1681922394924,LTWR 100GS,A00,182518,Forbes; Camille,20,0,20,0
1681922395949,LTWR 102,A00,182522,Staff,15,0,15,0
1681922395949,LTWR 102,B00,182525,Staff,14,0,15,1
1681922396972,LTWR 115,A00,182526,Staff,11,0,15,4
1681922397997,MAE 8,A01,182528,Pham; Hieu Tan,67,0,70,3
1681922399018,MAE 11,A00,182529,Bahadori; Mohammad Yousef,93,0,100,7
1681922400040,MAE 20,A00,182530,Evdokimenko; Ekaterina,68,0,70,2
1681922401075,MAE 30A,A00,182532,Staff,44,0,45,1
1681922402097,MAE 101A,A00,182533,Bahadori; Mohammad Yousef,95,0,100,5
1681922403124,MAE 101C,A00,182538,Staff,62,0,70,8
1681922404149,MAE 104,A00,182539,Staff,44,0,50,6
1681922405173,MAE 131A,A00,182540,Ghazinejad; Maziar,40,0,45,5
1681922406199,MAE 143A,A00,182548,Bewley; Thomas R,43,0,50,7
1681922407222,MAE 150,A00,182549,Staff,28,0,40,12
1681922408249,MAE 160,A00,182550,Evdokimenko; Ekaterina,41,0,60,19
1681922409302,MATH 3C,A01,182725,Staff,26,0,30,4
1681922410330,MATH 10A,A01,182729,Staff,25,0,30,5
1681922410330,MATH 10A,B01,182732,Staff,26,0,30,4
1681922411359,MATH 10B,A01,182737,Staff,21,0,30,9
1681922411359,MATH 10B,A02,182738,Staff,26,0,30,4
1681922411359,MATH 10B,B01,182744,Staff,27,0,30,3
1681922411359,MATH 10B,B02,182745,Staff,27,0,30,3
1681922412383,MATH 18,A01,182750,Anzaldo; Leesa B,28,0,30,2
1681922412383,MATH 18,A02,182751,Anzaldo; Leesa B,29,0,30,1
1681922412383,MATH 18,A03,182753,Anzaldo; Leesa B,27,0,30,3
1681922412383,MATH 18,A04,182757,Anzaldo; Leesa B,29,0,30,1
1681922412383,MATH 18,B01,182761,Anzaldo; Leesa B,27,0,30,3
1681922412383,MATH 18,B02,182764,Anzaldo; Leesa B,26,0,30,4
1681922412383,MATH 18,B03,182765,Anzaldo; Leesa B,29,0,30,1
1681922412383,MATH 18,B04,182766,Anzaldo; Leesa B,30,0,30,0
1681922413414,MATH 20A,A01,182771,Suk; Andrew Hoon,28,0,30,2
1681922414441,MATH 20B,A01,182775,Bach; Quang Tran,30,0,30,0
1681922414441,MATH 20B,A02,182777,Bach; Quang Tran,29,0,30,1
1681922414441,MATH 20B,B01,182780,Bach; Quang Tran,26,0,30,4
1681922414441,MATH 20B,B02,182782,Bach; Quang Tran,30,0,30,0
1681922415471,MATH 20C,A01,182787,Staff,25,0,30,5
1681922415471,MATH 20C,A02,182790,Staff,29,0,30,1
1681922415471,MATH 20C,B01,182792,Staff,25,0,30,5
1681922415471,MATH 20C,B02,182796,Staff,26,0,30,4
1681922416494,MATH 20D,A01,182799,Staff,28,0,30,2
1681922416494,MATH 20D,A02,182802,Staff,29,0,30,1
1681922416494,MATH 20D,A03,182803,Staff,30,0,30,0
1681922417516,MATH 20E,A01,182809,Verstraete; Jacques Allan,23,0,30,7
1681922417516,MATH 20E,A02,182811,Verstraete; Jacques Allan,28,0,30,2
1681922417516,MATH 20E,B01,182814,Verstraete; Jacques Allan,23,0,30,7
1681922417516,MATH 20E,B02,182815,Verstraete; Jacques Allan,30,0,30,0
1681922418539,MATH 103A,A01,182820,Staff,8,0,30,22
1681922418539,MATH 103A,A02,182821,Staff,27,0,30,3
1681922418539,MATH 103A,A03,182822,Staff,23,0,30,7
1681922418539,MATH 103A,B01,182825,Staff,23,0,30,7
1681922418539,MATH 103A,B02,182826,Staff,30,0,30,0
1681922418539,MATH 103A,B03,182830,Staff,30,0,30,0
1681922419563,MATH 109,A01,182836,Chow; Bennett,24,0,30,6
1681922419563,MATH 109,A02,182838,Chow; Bennett,29,0,30,1
1681922419563,MATH 109,A03,182894,Chow; Bennett,29,0,30,1
1681922419563,MATH 109,B01,182908,Chow; Bennett,27,0,30,3
1681922419563,MATH 109,B02,182909,Chow; Bennett,30,0,30,0
1681922419563,MATH 109,B03,182910,Chow; Bennett,27,0,30,3
1681922420587,MATH 142A,A01,182925,Staff,8,0,30,22
1681922420587,MATH 142A,A02,182935,Staff,24,0,30,6
1681922420587,MATH 142A,A03,182967,Staff,26,0,30,4
1681922420587,MATH 142A,B01,183125,Staff,22,0,30,8
1681922420587,MATH 142A,B02,183157,Staff,28,0,30,2
1681922420587,MATH 142A,B03,183158,Staff,29,0,30,1
1681922421615,MATH 183,A01,183160,Arias-Castro; Ery,23,0,30,7
1681922421615,MATH 183,A02,183161,Arias-Castro; Ery,29,0,30,1
1681922421615,MATH 183,B01,183163,Arias-Castro; Ery,28,0,30,2
1681922421615,MATH 183,B02,183164,Arias-Castro; Ery,28,0,30,2
1681922422647,MATH 193A,A01,183167,Staff,1,0,35,34
1681922422647,MATH 193A,A02,183168,Staff,28,0,35,7
1681922422647,MATH 193A,A03,183169,Staff,34,0,35,1
1681922422647,MATH 193A,A04,183170,Staff,28,0,35,7
1681922423670,MGT 4,A01,202395,Anderson; John Charles,75,0,80,5
1681922424693,MGT 5,A00,202396,Houskeeper; Robert,79,0,90,11
1681922425716,MGT 103,A00,202397,Eberhard; Craig A,50,0,90,40
1681922426739,MGT 131A,A00,202398,Houskeeper; Robert,84,0,90,6
1681922427773,MGT 135,A00,202399,Anderson; John Charles,81,0,90,9
1681922428801,MGT 162R,A00,202403,Gneezy; Uri,140,0,200,60
1681922429828,MGT 172,A00,202404,Hedges; Kathleen,43,0,90,47
1681922430871,MGT 181,A00,202405,Dunn; Louis Jean,80,0,90,10
1681922431897,MMW 14,A01,183200,Staff,11,0,28,17
1681922431897,MMW 14,A02,183201,Staff,26,0,28,2
1681922431897,MMW 14,A03,183202,Staff,24,0,28,4
1681922431897,MMW 14,A04,183203,Staff,25,0,28,3
1681922431897,MMW 14,A05,183204,Staff,26,0,28,2
1681922431897,MMW 14,A06,183205,Staff,27,0,28,1
1681922431897,MMW 14,B01,183207,Staff,26,0,28,2
1681922431897,MMW 14,B02,183208,Staff,28,0,28,0
1681922431897,MMW 14,B03,183209,Staff,28,0,28,0
1681922431897,MMW 14,B04,183210,Staff,28,0,28,0
1681922431897,MMW 14,B05,183211,Staff,28,0,28,0
1681922431897,MMW 14,B06,183212,Staff,27,0,28,1
1681922432926,MMW 14GS,A00,183213,Zhiri; Oumelbanine,28,0,28,0
1681922433953,MMW 15GS,B00,183215,Rahimi; Babak,28,0,28,0
1681922434978,MMW 121,A01,183217,Patterson; Patrick H.,13,0,28,15
1681922434978,MMW 121,A02,183218,Patterson; Patrick H.,25,0,28,3
1681922436004,MUS 1A,A01,182554,Staff,6,0,35,29
1681922437031,MUS 5,A01,182558,Staff,19,0,35,16
1681922438058,MUS 6,A01,182562,Staff,22,0,35,13
1681922439080,MUS 8GS,A00,182563,Borgo; David Garcia,25,0,25,0
1681922440104,MUS 13,A01,182567,Staff,24,0,25,1
1681922441129,MUS 15,A01,182570,Staff,32,0,35,3
1681922441129,MUS 15,B01,182575,Staff,9,0,35,26
1681922442157,MUS 80,A00,182578,Staff,22,0,25,3
1681922442157,MUS 80,B00,182581,Staff,20,0,25,5
1681922443184,MUS 113,A00,182582,Staff,25,0,25,0
1681922444220,MUS 114,A00,182583,Staff,3,0,25,22
1681922445243,MUS 150GS,A01,182588,Borgo; David Garcia,25,0,25,0
1681922446268,PHIL 1,A00,182590,Staff,35,0,40,5
1681922447290,PHIL 10,A01,182596,Grush; Rick Scott,31,0,35,4
1681922447290,PHIL 10,A02,182597,Grush; Rick Scott,34,0,35,1
1681922448319,PHIL 15,A01,182601,Staff,31,0,35,4
1681922448319,PHIL 15,A02,182602,Staff,33,0,35,2
1681922449352,PHIL 27,A01,182604,Staff,30,0,35,5
1681922449352,PHIL 27,A02,182607,Staff,35,0,35,0
1681922450382,PHIL 32,A01,182609,Staff,35,0,35,0
1681922450382,PHIL 32,A02,182612,Staff,35,0,35,0
1681922451411,PHIL 130,A00,182614,Staff,62,0,70,8
1681922452443,PHIL 136,A00,182616,Cohen; Jonathan David,66,0,70,4
1681922453470,PHIL 155,A00,182617,Vargas; Manuel Rogelio,58,0,70,12
1681922454492,PHIL 163,A01,182620,Staff,15,0,20,5
1681922454492,PHIL 163,A02,182624,Staff,10,0,20,10
1681922455519,PHIL 164,A00,182627,Staff,29,0,40,11
1681922456541,PHIL 173,A00,182628,Staff,36,0,40,4
1681922457568,PHYS 1A,A00,183221,Staff,54,0,60,6
1681922458590,PHYS 1AL,001,183222,Staff,25,0,30,5
1681922458590,PHYS 1AL,002,183223,Staff,28,0,30,2
1681922459620,PHYS 1B,A00,183231,Staff,43,0,60,17
1681922460652,PHYS 1BL,001,183232,Staff,20,0,30,10
1681922460652,PHYS 1BL,002,183233,Staff,27,0,30,3
1681922461676,PHYS 1C,A00,183240,Staff,28,0,60,32
1681922462699,PHYS 1CL,001,183241,Staff,11,0,30,19
1681922462699,PHYS 1CL,002,183242,Staff,22,0,30,8
1681922463726,PHYS 2AR,A01,183250,Staff,43,0,50,7
1681922464747,PHYS 2B,A01,183252,Staff,104,0,115,11
1681922465774,PHYS 2BL,A01,183254,Staff,21,0,24,3
1681922465774,PHYS 2BL,A02,183255,Staff,22,0,24,2
1681922466809,PHYS 2C,A01,183522,Staff,103,0,115,12
1681922467835,PHYS 4A,A01,183524,Staff,49,0,50,1
1681922468865,POLI 5,A00,183525,Staff,44,0,50,6
1681922469887,POLI 12,A00,183540,Staff,45,0,50,5
1681922470917,POLI 13R,A00,183541,Forman; Fonna,42,0,50,8
1681922471940,POLI 30,A00,183542,Mignozzetti; Umberto,48,0,50,2
1681922472964,POLI 100A,A00,183543,Staff,45,0,50,5
1681922473993,POLI 100E,A00,223598,Staff,32,0,35,3
1681922475020,POLI 103A,A00,183564,Kousser; Thad,37,0,50,13
1681922476049,POLI 104B,A00,201329,Staff,28,0,35,7
1681922477071,POLI 113BR,A00,183576,Hoston; Germaine,25,0,50,25
1681922478093,POLI 114BR,A00,183588,Staff,27,0,30,3
1681922479129,POLI 117R,A00,183595,Forman; Fonna,6,0,20,14
1681922480155,POLI 120H,A00,183596,Fisk; David Lee,13,0,20,7
1681922481180,POLI 130AA,A00,183597,Staff,14,0,20,6
1681922482209,POLI 134AA,A00,183598,Staff,19,0,20,1
1681922483232,POLI 135,A00,183599,Fisk; David Lee,19,0,25,6
1681922484266,POLI 142P,A00,183623,Staff,37,0,40,3
1681922485292,POLI 144D,A00,183624,Staff,22,0,25,3
1681922486317,POLI 151,A00,183625,Staff,15,0,20,5
1681922487358,POLI 162,A00,183626,Mignozzetti; Umberto,17,0,20,3
1681922488391,PSYC 1,A00,253748,Staff,86,0,90,4
1681922489429,PSYC 2,A00,183627,Moranton; Nirelia Melbina-,25,0,35,10
1681922490453,PSYC 3,A00,183628,Staff,43,0,45,2
1681922492499,PSYC 60,A01,183631,Lowe; Angela Beth,35,0,40,5
1681922493523,PSYC 70,A01,253757,Staff,37,0,45,8
1681922494549,PSYC 101,A00,183632,Heyman; Gail D.,47,0,60,13
1681922495583,PSYC 105,A00,183848,Lowe; Angela Beth,46,0,60,14
1681922496682,PSYC 106,A00,183849,Dobkins; Karen R.,43,0,60,17
1681922497705,PSYC 108,A00,253750,Staff,22,0,60,38
1681922498739,PSYC 114,A01,184275,Winkielman; Piotr,0,7,30,30
1681922499767,PSYC 122,A00,183856,Moranton; Nirelia Melbina-,0,14,30,30
1681922500793,PSYC 124,A00,183865,Chapman; Eddie Nathaniel,49,0,80,31
1681922501820,PSYC 137,A00,183880,Staff,19,0,25,6
1681922503872,PSYC 154,A00,183910,Lacefield; Katharine I,0,14,90,90
1681922505923,PSYC 162,A00,183946,Wixted; John T,55,0,90,35
1681922506949,PSYC 172,A00,183947,Gorman; Michael R.,10,0,30,20
1681922507975,PSYC 178,A00,183963,Glaser; Dale,17,0,40,23
1681922508997,PSYC 181GS,A00,183964,Anagnostaras; Stephan,10,0,10,0
1681922510023,PSYC 186GS,A01,257660,Staff,10,0,10,0
1681922511053,PSYC 193,B00,253749,Staff,23,0,25,2
1681922513104,PSYC 193L,A01,184122,Staff,33,0,35,2
1681922513104,PSYC 193L,C01,184167,Winkielman; Piotr,14,0,30,16
1681922514126,RELI 188GS,A00,182629,Rahimi; Babak,20,0,20,0
1681922515149,SE 101A,A00,182646,Staff,26,0,30,4
1681922516174,SE 101C,A00,182650,Staff,17,0,20,3
1681922517197,SE 110A,A00,182651,Staff,28,0,28,0
1681922518219,SE 130A,A00,182652,Staff,39,0,40,1
1681922519241,SIO 46GS,A00,182636,Cook; Geoffrey W,26,0,28,2
1681922520264,SIO 109R,A00,194459,Staff,3,0,20,17
1681922521288,SIO 121GS,A00,182639,Cook; Geoffrey W,26,0,28,2
1681922522314,SIO 132,A01,182642,Staff,32,0,40,8
1681922523338,SIO 139,A00,182644,Kacev; David,36,0,40,4
1681922524370,SOCI 2,A01,258404,Staff,33,0,36,3
1681922524370,SOCI 2,A02,258405,Staff,35,0,36,1
1681922525403,SOCI 60,A01,258408,Staff,29,0,30,1
1681922525403,SOCI 60,A02,258413,Staff,30,0,30,0
1681922526431,SOCI 100,A01,258415,Staff,29,0,30,1
1681922526431,SOCI 100,A02,258416,Staff,28,0,30,2
1681922532585,SOCI 127,A00,258421,Staff,21,0,30,9
1681922533623,SOCI 132,A00,258422,Staff,45,0,50,5
1681922534644,SOCI 133,A00,258423,Staff,26,0,30,4
1681922535687,SOCI 138GS,A00,258424,Staff,15,0,15,0
1681922536711,SOCI 145,A00,258425,Staff,25,0,30,5
1681922537737,SOCI 148,A00,258426,Staff,24,0,30,6
1681922538762,SOCI 153,A00,199217,Staff,29,0,30,1
1681922539792,SOCI 160,A00,258427,Staff,28,0,30,2
1681922540817,SOCI 160E,A00,258435,Staff,56,0,60,4
1681922541843,SOCI 189GS,A00,258436,Staff,15,0,15,0
1681922542867,SOCI 190GS,A00,258437,Staff,15,0,15,0
1681922543890,SYN 2,001,182658,Staff,8,0,16,8
1681922543890,SYN 2,002,201439,Staff,14,0,16,2
1681922543890,SYN 2,003,201443,Staff,16,0,16,0
1681922544912,SYN 100,A01,182657,Staff,16,0,20,4
1681922545941,TDAC 1,A00,184381,Salovey; Todd,16,0,20,4
1681922545941,TDAC 1,B00,184385,Harting; Carla Kelso,19,0,20,1
1681922545941,TDAC 1,C00,184394,Staff,19,0,20,1
1681922546964,TDAC 101,A00,184483,Harting; Carla Kelso,19,0,20,1
1681922547987,TDDE 111,A00,184496,Staff,14,0,15,1
1681922549013,TDDE 131,A00,184504,Staff,20,0,20,0
1681922549013,TDDE 131,B00,184505,Staff,17,0,18,1
1681922549013,TDDE 131,C00,184534,Staff,49,0,50,1
1681922549013,TDDE 131,D00,184564,Staff,15,0,15,0
1681922549013,TDDE 131,E00,204725,Staff,19,0,20,1
1681922550047,TDGE 1,A01,184414,Salovey; Todd,36,0,50,14
1681922551074,TDGE 5,A01,184419,Staff,23,0,24,1
1681922552106,TDGE 10,A00,184428,Fulton; Julia,29,0,50,21
1681922553129,TDGE 124,A00,184565,Fulton; Julia,6,0,50,44
1681922554151,TDGE 125,B00,184567,Meyer; Ursula,9,0,25,16
1681922555174,TDHT 101,A00,184568,Staff,21,0,25,4
1681922555174,TDHT 101,B00,184569,Staff,20,0,20,0
1681922556197,TDHT 114,A00,184570,Staff,49,0,50,1
1681922557227,TDMV 1,A00,184437,Arcidiacono; Kristin,22,0,30,8
1681922557227,TDMV 1,B00,184448,Caligagan; Maria T.,23,0,30,7
1681922558254,TDMV 2,A00,184449,Weinberg; Sadie,27,0,30,3
1681922558254,TDMV 2,B00,184453,Arcidiacono; Kristin,29,0,30,1
1681922559278,TDMV 110,A00,184571,Weinberg; Sadie,30,0,30,0
1681922560312,TDMV 142,A00,184572,Caligagan; Tony,27,0,30,3
1681922560312,TDMV 142,B00,184573,Caligagan; Maria T.,26,0,30,4
1681922561369,TDTR 20,A00,184482,Jun; Grace Shin Hae,25,0,25,0
1681922562400,USP 2,A01,184290,Hinds; Juli Beth,24,0,25,1
1681922563424,USP 3,A01,184295,Staff,21,0,25,4
1681922564449,USP 4,A00,184304,McTague; Sarah,13,0,25,12
1681922565471,USP 100,A00,184315,Staff,16,0,25,9
1681922566496,USP 105,A00,184326,Staff,21,0,25,4
1681922567518,USP 151,A00,184327,Staff,20,0,25,5
1681922568541,USP 170,A00,184380,Hinds; Juli Beth,13,0,25,12
1681922569564,VIS 21B,A01,182660,Staff,28,0,31,3
1681922569564,VIS 21B,A02,182662,Staff,30,0,31,1
1681922570589,VIS 103D,A00,182663,Staff,74,0,75,1
1681922571615,VIS 105D,A00,182667,Li; Huai,14,0,22,8
1681922572642,VIS 122GS,A00,182668,Herbst; Matthew,20,0,20,0
1681922573666,VIS 128C,A00,182673,Staff,69,0,75,6
1681922574694,VIS 130,A00,182675,Staff,19,0,22,3
1681922575728,VIS 160A,A00,182678,Stalbaum; Brett,4,0,10,6
1681922577778,WCWP 10B,A00,201679,Staff,15,0,15,0
1681922577778,WCWP 10B,B00,201695,Staff,15,0,15,0
1681922578810,WCWP 100,A00,201716,Staff,12,0,15,3
1681922578810,WCWP 100,B00,201717,Staff,6,0,15,9
1681922580869,ANSC 105GS,A00,258289,Staff,0,0,0,0
1681922581897,ANSC 125GS,A00,258295,Staff,0,0,0,0
1681922582923,ANSC 150,A00,258267,Staff,30,0,40,10
1681922583954,ANSC 190GS,A00,258280,Staff,0,0,0,0
1681922584978,ANTH 1,A00,258264,Staff,38,0,40,2
1681922586009,ANTH 2,A01,258259,Staff,72,0,76,4
1681922587035,ANTH 23,A01,258228,Staff,36,0,40,4
1681922588062,ANTH 101,A01,258236,Staff,38,0,40,2
1681922589088,ANTH 102,A00,258272,Staff,59,0,60,1
1681922590114,ANTH 105,A00,258244,Staff,31,0,35,4
1681922591149,BENG 130,A00,253975,Staff,38,0,40,2
1681922592182,BIBC 102,A01,191866,Flagg; Matthew Paul,19,0,32,13
1681922592182,BIBC 102,A02,191867,Flagg; Matthew Paul,22,0,32,10
1681922592182,BIBC 102,A03,191868,Flagg; Matthew Paul,29,0,32,3
1681922592182,BIBC 102,A04,191936,Flagg; Matthew Paul,26,0,32,6
1681922592182,BIBC 102,A05,191937,Flagg; Matthew Paul,5,0,32,27
1681922593206,BICD 100,A01,191939,Cooper; Andrew Michael,28,0,32,4
1681922593206,BICD 100,A02,191940,Cooper; Andrew Michael,32,0,32,0
1681922593206,BICD 100,A03,191941,Cooper; Andrew Michael,32,0,32,0
1681922593206,BICD 100,A04,191942,Cooper; Andrew Michael,32,0,32,0
1681922593206,BICD 100,A05,191943,Cooper; Andrew Michael,32,0,32,0
1681922594228,BIEB 126,A01,191945,Cleland; Elsa Eleanor,0,0,32,32
1681922594228,BIEB 126,A02,191946,Cleland; Elsa Eleanor,27,0,32,5
1681922594228,BIEB 126,A03,191947,Cleland; Elsa Eleanor,29,0,32,3
1681922594228,BIEB 126,A04,191948,Cleland; Elsa Eleanor,23,0,32,9
1681922594228,BIEB 126,A05,191996,Cleland; Elsa Eleanor,28,0,32,4
1681922595256,BIEB 136GS,A00,191997,Shurin; Jonathan & Holway; David A.,0,0,0,4
1681922596279,BIEB 137GS,A01,191999,Shurin; Jonathan & Holway; David A.,0,0,0,3
1681922597307,BILD 1,A01,205385,Staff,31,0,32,1
1681922597307,BILD 1,A02,205386,Staff,30,0,32,2
1681922597307,BILD 1,A03,205387,Staff,32,0,32,0
1681922597307,BILD 1,A04,205388,Staff,27,0,32,5
1681922598330,BILD 2,A01,191774,Staff,28,0,32,4
1681922598330,BILD 2,A02,191775,Staff,30,0,32,2
1681922598330,BILD 2,A03,191777,Staff,30,0,32,2
1681922598330,BILD 2,A04,191856,Staff,31,0,32,1
1681922598330,BILD 2,A05,191857,Staff,32,0,32,0
1681922598330,BILD 2,A06,191858,Staff,32,0,32,0
1681922598330,BILD 2,A07,191859,Staff,31,0,32,1
1681922599353,BILD 3,A01,205391,Staff,29,0,32,3
1681922599353,BILD 3,A02,205393,Staff,32,0,32,0
1681922599353,BILD 3,A03,205394,Staff,27,0,32,5
1681922599353,BILD 3,A04,205395,Staff,32,0,32,0
1681922600457,BILD 20,A01,191861,Staff,32,0,32,0
1681922600457,BILD 20,A02,191862,Staff,32,0,32,0
1681922601481,BILD 30,A01,191864,Staff,31,0,32,1
1681922602507,BIMM 100,A01,192019,Staff,0,0,32,32
1681922602507,BIMM 100,A02,192020,Staff,20,0,32,12
1681922602507,BIMM 100,A03,192035,Staff,21,0,32,11
1681922603529,BIMM 110,A01,192037,Tat; John,0,0,32,32
1681922603529,BIMM 110,A02,192038,Tat; John,8,0,32,24
1681922604551,BIMM 120,A01,192040,Pickett; Brooke Elizabeth,1,0,32,31
1681922604551,BIMM 120,A02,192041,Pickett; Brooke Elizabeth,15,0,32,17
1681922604551,BIMM 120,A03,192042,Pickett; Brooke Elizabeth,15,0,32,17
1681922605577,BIPN 100,A01,192044,Armour; Jon Christopher,23,0,32,9
1681922605577,BIPN 100,A02,192059,Armour; Jon Christopher,30,0,32,2
1681922605577,BIPN 100,A03,192064,Armour; Jon Christopher,30,0,32,2
1681922605577,BIPN 100,A04,192073,Armour; Jon Christopher,28,0,32,4
1681922606603,BIPN 148,A01,205411,Leutgeb; Jill K.,15,0,32,17
1681922606603,BIPN 148,A02,205412,Leutgeb; Jill K.,31,0,32,1
1681922606603,BIPN 148,A03,205413,Leutgeb; Jill K.,30,0,32,2
1681922606603,BIPN 148,A04,205414,Leutgeb; Jill K.,30,0,32,2
1681922607643,BIPN 160,A01,192115,Marino; Marc J,17,0,32,15
1681922607643,BIPN 160,A02,192148,Marino; Marc J,27,0,32,5
1681922607643,BIPN 160,A03,192158,Marino; Marc J,31,0,32,1
1681922607643,BIPN 160,A04,192190,Marino; Marc J,32,0,32,0
1681922607643,BIPN 160,A05,192287,Marino; Marc J,32,0,32,0
1681922607643,BIPN 160,A06,192288,Marino; Marc J,32,0,32,0
1681922608675,BIPN 194,A00,206038,Staff,28,0,32,4
1681922609697,BISP 194,A00,192289,Leutgeb; Stefan,13,0,32,19
1681922609697,BISP 194,B00,245332,Nieh; James Charles,26,0,32,6
1681922610720,CAT 124,A01,202247,Staff,15,0,15,0
1681922611748,CAT 125,A00,202248,Staff,19,0,20,1
1681922611748,CAT 125,B00,202253,Staff,20,0,20,0
1681922611748,CAT 125,C00,202257,Staff,18,0,20,2
1681922612773,CAT 125GS,A01,202273,Bronstein; Phoebe Malan,20,0,20,0
1681922613805,CAT 125R,A00,202284,Staff,18,0,20,2
1681922613805,CAT 125R,C00,202286,Staff,10,0,20,10
1681922613805,CAT 125R,D00,202291,Staff,18,0,20,2
1681922613805,CAT 125R,E00,202295,Staff,13,0,20,7
1681922613805,CAT 125R,F00,202302,Staff,8,0,20,12
1681922614863,CENG 100,A00,204724,Opatkiewicz; Justin Paul,25,0,25,0
1681922615903,CGS 2A,A01,180420,Staff,31,0,36,5
1681922616934,CGS 101,A00,180421,Staff,16,0,20,4
1681922617960,CGS 112,A00,180422,Staff,9,0,16,7
1681922618996,CGS 113,A00,180423,Staff,18,0,20,2
1681922620018,CGS 137,A00,180424,Staff,12,0,12,0
1681922621041,CGS 147,A00,180425,Staff,10,0,10,0
1681922622065,CHEM 6A,A01,179556,Staff,96,0,100,4
1681922622065,CHEM 6A,A02,179558,Staff,0,0,0,0
1681922623090,CHEM 6B,A01,179560,Staff,100,0,100,0
1681922624113,CHEM 6C,A01,179565,Jazzar; Rodolphe,95,0,100,5
1681922625138,CHEM 7L,A01,179586,Schurmeier; Kimberly,11,0,24,13
1681922625138,CHEM 7L,A02,179587,Schurmeier; Kimberly,23,0,24,1
1681922625138,CHEM 7L,A03,179590,Schurmeier; Kimberly,22,0,24,2
1681922625138,CHEM 7L,A04,179591,Schurmeier; Kimberly,22,0,24,2
1681922625138,CHEM 7L,B01,179598,Schurmeier; Kimberly,16,0,24,8
1681922625138,CHEM 7L,B02,179599,Schurmeier; Kimberly,24,0,24,0
1681922625138,CHEM 7L,B03,179606,Schurmeier; Kimberly,23,0,24,1
1681922625138,CHEM 7L,B04,179607,Schurmeier; Kimberly,23,0,24,1
1681922626167,CHEM 11,A01,179609,Stallings; Dontarie M,88,0,100,12
1681922627191,CHEM 40A,A01,179621,Staff,40,0,50,10
1681922627191,CHEM 40A,A02,179622,Staff,46,0,50,4
1681922628219,CHEM 40B,A01,179630,Weizman; Haim,47,0,50,3
1681922628219,CHEM 40B,A02,179631,Weizman; Haim,44,0,50,6
1681922629241,CHEM 41A,A01,179660,Klosterman; Jeremy K,93,0,100,7
1681922630265,CHEM 43A,A01,179683,Klosterman; Jeremy K,0,0,24,24
1681922630265,CHEM 43A,A02,179688,Klosterman; Jeremy K,9,0,24,15
1681922630265,CHEM 43A,A03,179689,Klosterman; Jeremy K,19,0,24,5
1681922630265,CHEM 43A,A04,179691,Klosterman; Jeremy K,18,0,24,6
1681922631292,CHEM 114A,A01,179693,Stallings; Dontarie M,71,0,100,29
1681922632323,CHEM 143B,A01,179698,Weizman; Haim,16,0,24,8
1681922632323,CHEM 143B,A02,179700,Weizman; Haim,24,0,24,0
1681922633358,CHIN 169A,A00,179701,Wang; Xiao,20,0,20,0
1681922634383,COGS 2,A01,179750,Boyle; Mary E. T.,17,0,30,13
1681922635415,COGS 9,A01,179759,Jones; Cameron Robert,42,0,50,8
1681922636442,COGS 14A,A01,179854,Staff,15,0,50,35
1681922637468,COGS 14B,A01,179856,Staff,53,0,60,7
1681922638492,COGS 17,A01,179874,Staff,71,0,75,4
1681922639514,COGS 18,A01,179884,Staff,63,0,80,17
1681922640536,COGS 100,A01,179886,Staff,36,0,60,24
1681922641562,COGS 101B,A01,179892,Staff,0,0,30,30
1681922642598,COGS 101C,A01,179894,Staff,28,0,30,2
1681922643621,COGS 107A,A01,179896,Boyle; Mary E. T.,30,0,40,10
1681922644643,COGS 108,A01,179898,Simpkins; Charles Alexander,0,24,60,60
1681922645666,COGS 109,A01,179900,Staff,34,0,40,6
1681922646691,COGS 118A,A01,179946,Staff,8,0,40,32
1681922647716,COGS 153,A00,179978,Staff,0,3,30,30
1681922648740,COGS 156,A01,179981,Staff,24,0,30,6
1681922650786,COGS 172,A01,179987,Staff,13,0,30,17
1681922652848,COGS 186,A01,179991,Staff,12,0,30,18
1681922653871,COMM 10,A01,180001,Staff,14,0,25,11
1681922653871,COMM 10,A02,180004,Staff,20,0,25,5
1681922654915,COMM 100A,A01,180016,Staff,15,0,25,10
1681922654915,COMM 100A,A02,180020,Staff,24,0,25,1
1681922655944,COMM 101T,A00,180029,Halm; Gavin Patrick,22,0,35,13
1681922656970,COMM 106V,A00,180043,Staff,34,0,35,1
1681922657996,COMM 109P,A00,180044,Staff,30,0,35,5
1681922659030,COMM 113T,A00,180045,Havis; Allan,37,0,45,8
1681922660059,COMM 132,A00,180046,McKenna; Denise,23,0,30,7
1681922661081,COMM 143,A00,180047,Staff,18,0,30,12
1681922662104,COMM 190,A00,180048,Conner; Thomas Hartnell,18,0,23,5
1681922663131,CSE 8A,A50,180053,Cao; Yingjun,24,0,50,26
1681922663131,CSE 8A,B50,180180,Staff,50,0,50,0
1681922664154,CSE 11,A01,180190,Cao; Yingjun,26,0,50,24
1681922665177,CSE 20,A01,180192,Briones; Jor-el Thomas Caparas,23,0,30,7
1681922666203,CSE 21,A01,194538,Briones; Jor-el Thomas Caparas,50,0,60,10
1681922667231,CSE 30,A01,180324,Eldon; John,76,0,100,24
1681922668254,CSE 101,A01,201353,Staff,0,24,40,40
1681922669285,CSE 134B,A01,180326,Powell; Thomas Allan,74,0,100,26
1681922670309,CSE 140,A01,180328,Staff,41,0,75,34
1681922671332,CSE 140L,A01,180344,Eldon; John,64,0,100,36
1681922672355,CSE 150A,A01,180411,Staff,0,13,50,50
1681922673381,CSE 151A,A01,180414,Staff,0,8,50,50
1681922674407,CSE 175,A01,222521,Kumar; Rakesh,50,0,50,0
1681922675445,CSE 190,A00,201419,Staff,44,0,49,5
1681922676473,CSS 1,A01,194536,Staff,37,0,50,13
1681922677502,DSC 30,A01,202385,Staff,48,0,50,2
1681922678530,DSC 40A,A01,202387,Albuyeh; Rod,50,0,50,0
1681922679556,DSC 190,A01,202389,Silberman; Jack,21,0,21,0
1681922680588,DSGN 100,A01,179993,Staff,15,0,30,15
1681922681610,ECE 65,A50,180708,Staff,10,0,20,10
1681922681610,ECE 65,A51,180739,Staff,19,0,20,1
1681922682633,ECON 1,A01,180427,Famulari; Melissa,67,0,70,3
1681922683658,ECON 2,A01,180450,Levkoff; Steven B.,64,0,70,6
1681922684685,ECON 4,A01,203351,Anderson; John Charles,6,0,10,4
1681922685707,ECON 100A,A01,180472,Famulari; Melissa,63,0,70,7
1681922686730,ECON 120A,A01,180549,Staff,64,0,70,6
1681922687753,ECON 120B,A01,180655,Ma; Xinwei,43,0,70,27
1681922688786,ECON 129,A00,203333,Eckert; Fabian Paul,13,0,35,22
1681922689811,ECON 131,A00,180656,Staff,5,0,35,30
1681922690834,ECON 172B,A01,180672,Levkoff; Steven B.,31,0,35,4
1681922691857,ECON 178,A01,203342,Zhu; Ying,9,0,35,26
1681922692879,EDS 108GS,A00,202383,Wishard Guerra; Alison G.,20,0,20,0
1681922693907,EDS 111GS,A00,202347,Wishard Guerra; Alison G.,20,0,20,0
1681922694934,EDS 112,A01,202323,Staff,55,0,60,5
1681922695957,EDS 113,A00,202340,Staff,32,0,35,3
1681922696989,EDS 118,A00,201231,Staff,20,0,30,10
1681922698013,EDS 119,A00,204994,Staff,8,0,10,2
1681922699040,EDS 124BR,A00,202324,Eguchi; Emi,2,0,25,23
1681922700062,EDS 126,A01,203208,Jones; Makeba,26,0,30,4
1681922701085,EDS 135,A01,202333,Staff,18,0,20,2
1681922702111,EDS 180,A00,202311,Staff,47,0,50,3
1681922703148,ERC 190GS,A01,253747,Staff,28,0,28,0
1681922704256,ETHN 104,A00,180742,Staff,23,0,35,12
1681922705278,ETHN 118,A00,180745,Staff,27,0,35,8
1681922706299,ETHN 127,A00,180747,Staff,11,0,16,5
1681922707331,ETHN 137,A00,180880,Staff,11,0,12,1
1681922708364,ETHN 147,A00,180890,Staff,8,0,10,2
1681922709393,ETHN 154,A00,180891,Staff,7,0,8,1
1681922710420,ETHN 168,A00,180892,Staff,9,0,10,1
1681922711451,GLBH 20,A00,201051,Hannah; Seth Donal,0,3,0,1
1681922712476,GLBH 111,A01,209338,Burgos; Jose L.,0,0,0,0
1681922713499,GLBH 150,A00,258300,Staff,0,3,0,0
1681922714521,GLBH 181,A00,201207,Staff,12,0,40,28
1681922715544,HIEU 109,A00,180898,Staff,19,0,20,1
1681922716568,HIEU 111,A00,180899,Staff,0,1,20,20
1681922717599,HIEU 124,A00,180900,Staff,17,0,20,3
1681922718621,HILA 122,A00,180901,Staff,18,0,20,2
1681922719643,HILA 132,A00,180902,Vitz; Matthew,1,0,20,19
1681922720673,HILD 10,A01,180896,Staff,14,0,20,6
1681922721695,HILD 30GS,A00,180897,Edington; Claire Ellen,0,0,0,0
1681922722718,HISC 105,A00,180903,Staff,20,0,20,0
1681922723741,HISC 117,A00,180904,Staff,10,0,20,10
1681922724768,HIUS 108B,A00,181005,Staff,18,0,20,2
1681922725790,HIUS 113,A00,181093,Staff,1,0,20,19
1681922726818,HUM 3,A01,181190,Patterson; Patrick H.,39,0,50,11
1681922726818,HUM 3,B01,181195,Staff,46,0,50,4
1681922727845,HUM 3GS,A00,181196,Herbst; Matthew,0,0,0,0
1681922728876,HUM 4,A01,181227,West; Geoffrey Scott,33,0,50,17
1681922728876,HUM 4,B01,181282,Staff,41,0,50,9
1681922729902,HUM 4GS,A00,181377,Lyon; Antony J.,0,0,0,0
1681922730928,HUM 5,A01,181536,Zavodny; Tatiana Sophia,28,0,50,22
1681922730928,HUM 5,B01,181908,Staff,35,0,50,15
1681922731953,INTL 190,A00,181909,Segui; Alan S,0,0,0,8
1681922731953,INTL 190,B00,181961,Segui; Alan S,0,0,0,7
1681922732976,JAPN 20AR,A01,182113,Ross; Kayoko F,15,0,20,5
1681922733999,LATI 50,A01,202391,Martin-Cabrera; Luis,18,0,30,12
1681922733999,LATI 50,A02,202392,Martin-Cabrera; Luis,26,0,30,4
1681922735023,LATI 180,A00,202393,Kokinis; Troy Andreas,24,0,25,1
1681922736046,LIFR 1A,A00,182119,Staff,14,0,14,0
1681922737068,LIFR 1AX,A00,182324,Staff,14,0,14,0
1681922738093,LIFR 1B,A00,182259,Staff,13,0,14,1
1681922739119,LIFR 1BX,A00,182273,Staff,13,0,14,1
1681922740149,LIGN 8,A00,182330,Staff,134,0,150,16
1681922741171,LIGN 9GS,A00,182362,Staff,20,0,20,0
1681922742193,LIGN 119,A00,204992,Takahashi; Maho,12,0,15,3
1681922743218,LIGN 130,A01,182384,Staff,47,0,50,3
1681922744240,LIGN 149GS,A00,182390,Staff,20,0,20,0
1681922745267,LIGN 170,A00,182404,Staff,23,0,30,7
1681922746290,LISP 1D,A00,182281,Staff,7,0,14,7
1681922746290,LISP 1D,B00,182287,Staff,13,0,14,1
1681922746290,LISP 1D,C00,182295,Staff,11,0,14,3
1681922746290,LISP 1D,D00,182301,Staff,14,0,14,0
1681922747317,LISP 1DX,A00,182309,Staff,19,0,28,9
1681922747317,LISP 1DX,B00,182316,Staff,26,0,28,2
1681922748340,LTAF 120GS,A00,182412,Zhiri; Oumelbanine,20,0,20,0
1681922749363,LTCS 172GS,A00,182437,Bronstein; Phoebe Malan,20,0,20,0
1681922750389,LTEA 138,A00,182457,Staff,20,0,40,20
1681922751419,LTEN 114,A01,182490,Staff,23,0,25,2
1681922752448,LTEN 130GS,A00,182491,Lyon; Antony J.,20,0,20,0
1681922753477,LTEN 169,A00,182493,Cuong; Marisol,19,0,25,6
1681922754511,LTEN 178,A00,182501,Staff,14,0,15,1
1681922755567,LTEN 181,A00,182515,Staff,21,0,25,4
1681922756589,LTEN 185GS,A00,197655,Forbes; Camille,20,0,20,0
1681922757612,LTSP 100B,A00,202208,Bessett; Ryan Matthew,24,0,25,1
1681922758635,LTWL 100,A00,182516,Myerston Santana; Jacobo,21,0,30,9
1681922759657,LTWR 100GS,A00,182518,Forbes; Camille,20,0,20,0
1681922760688,LTWR 102,A00,182522,Staff,15,0,15,0
1681922760688,LTWR 102,B00,182525,Staff,14,0,15,1
1681922761714,LTWR 115,A00,182526,Staff,11,0,15,4
1681922762737,MAE 8,A01,182528,Pham; Hieu Tan,67,0,70,3
1681922763762,MAE 11,A00,182529,Bahadori; Mohammad Yousef,93,0,100,7
1681922764795,MAE 20,A00,182530,Evdokimenko; Ekaterina,68,0,70,2
1681922765818,MAE 30A,A00,182532,Staff,44,0,45,1
1681922766845,MAE 101A,A00,182533,Bahadori; Mohammad Yousef,95,0,100,5
1681922767869,MAE 101C,A00,182538,Staff,62,0,70,8
1681922768901,MAE 104,A00,182539,Staff,44,0,50,6
1681922769925,MAE 131A,A00,182540,Ghazinejad; Maziar,40,0,45,5
1681922770948,MAE 143A,A00,182548,Bewley; Thomas R,43,0,50,7
1681922771971,MAE 150,A00,182549,Staff,28,0,40,12
1681922772997,MAE 160,A00,182550,Evdokimenko; Ekaterina,41,0,60,19
1681922774020,MATH 3C,A01,182725,Staff,25,0,30,5
1681922775044,MATH 10A,A01,182729,Staff,25,0,30,5
1681922775044,MATH 10A,B01,182732,Staff,26,0,30,4
1681922776076,MATH 10B,A01,182737,Staff,21,0,30,9
1681922776076,MATH 10B,A02,182738,Staff,26,0,30,4
1681922776076,MATH 10B,B01,182744,Staff,27,0,30,3
1681922776076,MATH 10B,B02,182745,Staff,27,0,30,3
1681922777106,MATH 18,A01,182750,Anzaldo; Leesa B,28,0,30,2
1681922777106,MATH 18,A02,182751,Anzaldo; Leesa B,29,0,30,1
1681922777106,MATH 18,A03,182753,Anzaldo; Leesa B,27,0,30,3
1681922777106,MATH 18,A04,182757,Anzaldo; Leesa B,29,0,30,1
1681922777106,MATH 18,B01,182761,Anzaldo; Leesa B,27,0,30,3
1681922777106,MATH 18,B02,182764,Anzaldo; Leesa B,26,0,30,4
1681922777106,MATH 18,B03,182765,Anzaldo; Leesa B,29,0,30,1
1681922777106,MATH 18,B04,182766,Anzaldo; Leesa B,30,0,30,0
1681922778142,MATH 20A,A01,182771,Suk; Andrew Hoon,28,0,30,2
1681922779174,MATH 20B,A01,182775,Bach; Quang Tran,30,0,30,0
1681922779174,MATH 20B,A02,182777,Bach; Quang Tran,29,0,30,1
1681922779174,MATH 20B,B01,182780,Bach; Quang Tran,26,0,30,4
1681922779174,MATH 20B,B02,182782,Bach; Quang Tran,30,0,30,0
1681922780208,MATH 20C,A01,182787,Staff,25,0,30,5
1681922780208,MATH 20C,A02,182790,Staff,29,0,30,1
1681922780208,MATH 20C,B01,182792,Staff,25,0,30,5
1681922780208,MATH 20C,B02,182796,Staff,26,0,30,4
1681922781233,MATH 20D,A01,182799,Staff,28,0,30,2
1681922781233,MATH 20D,A02,182802,Staff,29,0,30,1
1681922781233,MATH 20D,A03,182803,Staff,30,0,30,0
1681922782256,MATH 20E,A01,182809,Verstraete; Jacques Allan,23,0,30,7
1681922782256,MATH 20E,A02,182811,Verstraete; Jacques Allan,28,0,30,2
1681922782256,MATH 20E,B01,182814,Verstraete; Jacques Allan,22,0,30,8
1681922782256,MATH 20E,B02,182815,Verstraete; Jacques Allan,30,0,30,0
1681922783278,MATH 103A,A01,182820,Staff,8,0,30,22
1681922783278,MATH 103A,A02,182821,Staff,27,0,30,3
1681922783278,MATH 103A,A03,182822,Staff,23,0,30,7
1681922783278,MATH 103A,B01,182825,Staff,23,0,30,7
1681922783278,MATH 103A,B02,182826,Staff,30,0,30,0
1681922783278,MATH 103A,B03,182830,Staff,30,0,30,0
1681922784309,MATH 109,A01,182836,Chow; Bennett,24,0,30,6
1681922784309,MATH 109,A02,182838,Chow; Bennett,29,0,30,1
1681922784309,MATH 109,A03,182894,Chow; Bennett,29,0,30,1
1681922784309,MATH 109,B01,182908,Chow; Bennett,27,0,30,3
1681922784309,MATH 109,B02,182909,Chow; Bennett,30,0,30,0
1681922784309,MATH 109,B03,182910,Chow; Bennett,27,0,30,3
1681922785337,MATH 142A,A01,182925,Staff,8,0,30,22
1681922785337,MATH 142A,A02,182935,Staff,24,0,30,6
1681922785337,MATH 142A,A03,182967,Staff,26,0,30,4
1681922785337,MATH 142A,B01,183125,Staff,22,0,30,8
1681922785337,MATH 142A,B02,183157,Staff,28,0,30,2
1681922785337,MATH 142A,B03,183158,Staff,29,0,30,1
1681922786362,MATH 183,A01,183160,Arias-Castro; Ery,23,0,30,7
1681922786362,MATH 183,A02,183161,Arias-Castro; Ery,29,0,30,1
1681922786362,MATH 183,B01,183163,Arias-Castro; Ery,28,0,30,2
1681922786362,MATH 183,B02,183164,Arias-Castro; Ery,28,0,30,2
1681922787386,MATH 193A,A01,183167,Staff,1,0,35,34
1681922787386,MATH 193A,A02,183168,Staff,28,0,35,7
1681922787386,MATH 193A,A03,183169,Staff,34,0,35,1
1681922787386,MATH 193A,A04,183170,Staff,27,0,35,8
1681922788411,MGT 4,A01,202395,Anderson; John Charles,75,0,80,5
1681922789435,MGT 5,A00,202396,Houskeeper; Robert,79,0,90,11
1681922790458,MGT 103,A00,202397,Eberhard; Craig A,50,0,90,40
1681922791490,MGT 131A,A00,202398,Houskeeper; Robert,84,0,90,6
1681922792519,MGT 135,A00,202399,Anderson; John Charles,81,0,90,9
1681922793547,MGT 162R,A00,202403,Gneezy; Uri,139,0,200,61
1681922794571,MGT 172,A00,202404,Hedges; Kathleen,42,0,90,48
1681922795596,MGT 181,A00,202405,Dunn; Louis Jean,80,0,90,10
1681922796620,MMW 14,A01,183200,Staff,10,0,28,18
1681922796620,MMW 14,A02,183201,Staff,26,0,28,2
1681922796620,MMW 14,A03,183202,Staff,24,0,28,4
1681922796620,MMW 14,A04,183203,Staff,25,0,28,3
1681922796620,MMW 14,A05,183204,Staff,26,0,28,2
1681922796620,MMW 14,A06,183205,Staff,27,0,28,1
1681922796620,MMW 14,B01,183207,Staff,26,0,28,2
1681922796620,MMW 14,B02,183208,Staff,28,0,28,0
1681922796620,MMW 14,B03,183209,Staff,28,0,28,0
1681922796620,MMW 14,B04,183210,Staff,28,0,28,0
1681922796620,MMW 14,B05,183211,Staff,28,0,28,0
1681922796620,MMW 14,B06,183212,Staff,27,0,28,1
1681922797643,MMW 14GS,A00,183213,Zhiri; Oumelbanine,28,0,28,0
1681922798666,MMW 15GS,B00,183215,Rahimi; Babak,28,0,28,0
1681922799705,MMW 121,A01,183217,Patterson; Patrick H.,13,0,28,15
1681922799705,MMW 121,A02,183218,Patterson; Patrick H.,25,0,28,3
1681922800727,MUS 1A,A01,182554,Staff,5,0,35,30
1681922801750,MUS 5,A01,182558,Staff,18,0,35,17
1681922802778,MUS 6,A01,182562,Staff,22,0,35,13
1681922803810,MUS 8GS,A00,182563,Borgo; David Garcia,25,0,25,0
1681922804835,MUS 13,A01,182567,Staff,24,0,25,1
1681922805857,MUS 15,A01,182570,Staff,32,0,35,3
1681922805857,MUS 15,B01,182575,Staff,9,0,35,26
1681922806895,MUS 80,A00,182578,Staff,22,0,25,3
1681922806895,MUS 80,B00,182581,Staff,20,0,25,5
1681922808006,MUS 113,A00,182582,Staff,25,0,25,0
1681922809027,MUS 114,A00,182583,Staff,3,0,25,22
1681922810049,MUS 150GS,A01,182588,Borgo; David Garcia,25,0,25,0
1681922811071,PHIL 1,A00,182590,Staff,35,0,40,5
1681922812094,PHIL 10,A01,182596,Grush; Rick Scott,31,0,35,4
1681922812094,PHIL 10,A02,182597,Grush; Rick Scott,34,0,35,1
1681922813121,PHIL 15,A01,182601,Staff,31,0,35,4
1681922813121,PHIL 15,A02,182602,Staff,33,0,35,2
1681922814143,PHIL 27,A01,182604,Staff,30,0,35,5
1681922814143,PHIL 27,A02,182607,Staff,35,0,35,0
1681922815190,PHIL 32,A01,182609,Staff,35,0,35,0
1681922815190,PHIL 32,A02,182612,Staff,35,0,35,0
1681922816213,PHIL 130,A00,182614,Staff,62,0,70,8
1681922817243,PHIL 136,A00,182616,Cohen; Jonathan David,66,0,70,4
1681922818265,PHIL 155,A00,182617,Vargas; Manuel Rogelio,58,0,70,12
1681922819287,PHIL 163,A01,182620,Staff,15,0,20,5
1681922819287,PHIL 163,A02,182624,Staff,10,0,20,10
1681922820312,PHIL 164,A00,182627,Staff,29,0,40,11
1681922821386,PHIL 173,A00,182628,Staff,36,0,40,4
1681922822413,PHYS 1A,A00,183221,Staff,54,0,60,6
1681922823436,PHYS 1AL,001,183222,Staff,25,0,30,5
1681922823436,PHYS 1AL,002,183223,Staff,28,0,30,2
1681922824461,PHYS 1B,A00,183231,Staff,43,0,60,17
1681922825487,PHYS 1BL,001,183232,Staff,20,0,30,10
1681922825487,PHYS 1BL,002,183233,Staff,27,0,30,3
1681922826511,PHYS 1C,A00,183240,Staff,25,0,60,35
1681922827538,PHYS 1CL,001,183241,Staff,10,0,30,20
1681922827538,PHYS 1CL,002,183242,Staff,22,0,30,8
1681922828567,PHYS 2AR,A01,183250,Staff,43,0,50,7
1681922829605,PHYS 2B,A01,183252,Staff,104,0,115,11
1681922830635,PHYS 2BL,A01,183254,Staff,21,0,24,3
1681922830635,PHYS 2BL,A02,183255,Staff,22,0,24,2
1681922831658,PHYS 2C,A01,183522,Staff,103,0,115,12
1681922832689,PHYS 4A,A01,183524,Staff,49,0,50,1
1681922833714,POLI 5,A00,183525,Staff,44,0,50,6
1681922834739,POLI 12,A00,183540,Staff,45,0,50,5
1681922835762,POLI 13R,A00,183541,Forman; Fonna,42,0,50,8
1681922836785,POLI 30,A00,183542,Mignozzetti; Umberto,48,0,50,2
1681922837810,POLI 100A,A00,183543,Staff,45,0,50,5
1681922838835,POLI 100E,A00,223598,Staff,32,0,35,3
1681922839858,POLI 103A,A00,183564,Kousser; Thad,37,0,50,13
1681922840881,POLI 104B,A00,201329,Staff,28,0,35,7
1681922841909,POLI 113BR,A00,183576,Hoston; Germaine,24,0,50,26
1681922842930,POLI 114BR,A00,183588,Staff,27,0,30,3
1681922843954,POLI 117R,A00,183595,Forman; Fonna,5,0,20,15
1681922844980,POLI 120H,A00,183596,Fisk; David Lee,13,0,20,7
1681922846014,POLI 130AA,A00,183597,Staff,13,0,20,7
1681922847039,POLI 134AA,A00,183598,Staff,19,0,20,1
1681922848066,POLI 135,A00,183599,Fisk; David Lee,19,0,25,6
1681922849089,POLI 142P,A00,183623,Staff,37,0,40,3
1681922850114,POLI 144D,A00,183624,Staff,22,0,25,3
1681922851135,POLI 151,A00,183625,Staff,15,0,20,5
1681922852166,POLI 162,A00,183626,Mignozzetti; Umberto,17,0,20,3
1681922853188,PSYC 1,A00,253748,Staff,86,0,90,4
1681922854222,PSYC 2,A00,183627,Moranton; Nirelia Melbina-,24,0,35,11
1681922855248,PSYC 3,A00,183628,Staff,43,0,45,2
1681922857301,PSYC 60,A01,183631,Lowe; Angela Beth,35,0,40,5
1681922858333,PSYC 70,A01,253757,Staff,37,0,45,8
1681922859357,PSYC 101,A00,183632,Heyman; Gail D.,47,0,60,13
1681922860383,PSYC 105,A00,183848,Lowe; Angela Beth,47,0,60,13
1681922861405,PSYC 106,A00,183849,Dobkins; Karen R.,42,0,60,18
1681922862444,PSYC 108,A00,253750,Staff,22,0,60,38
1681922863471,PSYC 114,A01,184275,Winkielman; Piotr,0,7,30,30
1681922864493,PSYC 122,A00,183856,Moranton; Nirelia Melbina-,0,14,30,30
1681922865515,PSYC 124,A00,183865,Chapman; Eddie Nathaniel,49,0,80,31
1681922866539,PSYC 137,A00,183880,Staff,19,0,25,6
1681922868586,PSYC 154,A00,183910,Lacefield; Katharine I,0,14,90,90
1681922870664,PSYC 162,A00,183946,Wixted; John T,55,0,90,35
1681922871694,PSYC 172,A00,183947,Gorman; Michael R.,10,0,30,20
1681922872721,PSYC 178,A00,183963,Glaser; Dale,17,0,40,23
1681922873745,PSYC 181GS,A00,183964,Anagnostaras; Stephan,10,0,10,0
1681922874768,PSYC 186GS,A01,257660,Staff,10,0,10,0
1681922875799,PSYC 193,B00,253749,Staff,23,0,25,2
1681922877849,PSYC 193L,A01,184122,Staff,33,0,35,2
1681922877849,PSYC 193L,C01,184167,Winkielman; Piotr,14,0,30,16
1681922878873,RELI 188GS,A00,182629,Rahimi; Babak,20,0,20,0
1681922879898,SE 101A,A00,182646,Staff,26,0,30,4
1681922880928,SE 101C,A00,182650,Staff,17,0,20,3
1681922881950,SE 110A,A00,182651,Staff,28,0,28,0
1681922882973,SE 130A,A00,182652,Staff,39,0,40,1
1681922883996,SIO 46GS,A00,182636,Cook; Geoffrey W,26,0,28,2
1681922885017,SIO 109R,A00,194459,Staff,3,0,20,17
1681922886044,SIO 121GS,A00,182639,Cook; Geoffrey W,26,0,28,2
1681922887079,SIO 132,A01,182642,Staff,32,0,40,8
1681922888105,SIO 139,A00,182644,Kacev; David,36,0,40,4
1681922889137,SOCI 2,A01,258404,Staff,33,0,36,3
1681922889137,SOCI 2,A02,258405,Staff,35,0,36,1
1681922890160,SOCI 60,A01,258408,Staff,29,0,30,1
1681922890160,SOCI 60,A02,258413,Staff,30,0,30,0
1681922891187,SOCI 100,A01,258415,Staff,29,0,30,1
1681922891187,SOCI 100,A02,258416,Staff,28,0,30,2
1681922897347,SOCI 127,A00,258421,Staff,21,0,30,9
1681922898379,SOCI 132,A00,258422,Staff,45,0,50,5
1681922899412,SOCI 133,A00,258423,Staff,26,0,30,4
1681922900439,SOCI 138GS,A00,258424,Staff,15,0,15,0
1681922901462,SOCI 145,A00,258425,Staff,25,0,30,5
1681922902492,SOCI 148,A00,258426,Staff,24,0,30,6
1681922903518,SOCI 153,A00,199217,Staff,29,0,30,1
1681922904545,SOCI 160,A00,258427,Staff,28,0,30,2
1681922905569,SOCI 160E,A00,258435,Staff,56,0,60,4
1681922906597,SOCI 189GS,A00,258436,Staff,15,0,15,0
1681922907621,SOCI 190GS,A00,258437,Staff,15,0,15,0
1681922908646,SYN 2,001,182658,Staff,8,0,16,8
1681922908646,SYN 2,002,201439,Staff,14,0,16,2
1681922908646,SYN 2,003,201443,Staff,16,0,16,0
1681922909675,SYN 100,A01,182657,Staff,16,0,20,4
1681922910703,TDAC 1,A00,184381,Salovey; Todd,16,0,20,4
1681922910703,TDAC 1,B00,184385,Harting; Carla Kelso,19,0,20,1
1681922910703,TDAC 1,C00,184394,Staff,19,0,20,1
1681922911805,TDAC 101,A00,184483,Harting; Carla Kelso,19,0,20,1
1681922912828,TDDE 111,A00,184496,Staff,14,0,15,1
1681922913856,TDDE 131,A00,184504,Staff,20,0,20,0
1681922913856,TDDE 131,B00,184505,Staff,17,0,18,1
1681922913856,TDDE 131,C00,184534,Staff,49,0,50,1
1681922913856,TDDE 131,D00,184564,Staff,15,0,15,0
1681922913856,TDDE 131,E00,204725,Staff,19,0,20,1
1681922914879,TDGE 1,A01,184414,Salovey; Todd,36,0,50,14
1681922915906,TDGE 5,A01,184419,Staff,23,0,24,1
1681922916928,TDGE 10,A00,184428,Fulton; Julia,29,0,50,21
1681922917953,TDGE 124,A00,184565,Fulton; Julia,6,0,50,44
1681922918983,TDGE 125,B00,184567,Meyer; Ursula,9,0,25,16
1681922920006,TDHT 101,A00,184568,Staff,21,0,25,4
1681922920006,TDHT 101,B00,184569,Staff,20,0,20,0
1681922921040,TDHT 114,A00,184570,Staff,49,0,50,1
1681922922065,TDMV 1,A00,184437,Arcidiacono; Kristin,22,0,30,8
1681922922065,TDMV 1,B00,184448,Caligagan; Maria T.,23,0,30,7
1681922923089,TDMV 2,A00,184449,Weinberg; Sadie,27,0,30,3
1681922923089,TDMV 2,B00,184453,Arcidiacono; Kristin,29,0,30,1
1681922924115,TDMV 110,A00,184571,Weinberg; Sadie,30,0,30,0
1681922925138,TDMV 142,A00,184572,Caligagan; Tony,27,0,30,3
1681922925138,TDMV 142,B00,184573,Caligagan; Maria T.,26,0,30,4
1681922926165,TDTR 20,A00,184482,Jun; Grace Shin Hae,25,0,25,0
1681922927189,USP 2,A01,184290,Hinds; Juli Beth,24,0,25,1
1681922928215,USP 3,A01,184295,Staff,21,0,25,4
1681922929240,USP 4,A00,184304,McTague; Sarah,13,0,25,12
1681922930265,USP 100,A00,184315,Staff,16,0,25,9
1681922931291,USP 105,A00,184326,Staff,21,0,25,4
1681922932313,USP 151,A00,184327,Staff,20,0,25,5
1681922933338,USP 170,A00,184380,Hinds; Juli Beth,13,0,25,12
1681922934360,VIS 21B,A01,182660,Staff,28,0,31,3
1681922934360,VIS 21B,A02,182662,Staff,30,0,31,1
1681922935383,VIS 103D,A00,182663,Staff,74,0,75,1
1681922936405,VIS 105D,A00,182667,Li; Huai,14,0,22,8
1681922937429,VIS 122GS,A00,182668,Herbst; Matthew,20,0,20,0
1681922938451,VIS 128C,A00,182673,Staff,69,0,75,6
1681922939472,VIS 130,A00,182675,Staff,19,0,22,3
1681922940497,VIS 160A,A00,182678,Stalbaum; Brett,4,0,10,6
1681922942545,WCWP 10B,A00,201679,Staff,15,0,15,0
1681922942545,WCWP 10B,B00,201695,Staff,15,0,15,0
1681922943569,WCWP 100,A00,201716,Staff,12,0,15,3
1681922943569,WCWP 100,B00,201717,Staff,6,0,15,9
1681922945682,ANSC 105GS,A00,258289,Staff,0,0,0,0
1681922946704,ANSC 125GS,A00,258295,Staff,0,0,0,0
1681922947726,ANSC 150,A00,258267,Staff,30,0,40,10
1681922948762,ANSC 190GS,A00,258280,Staff,0,0,0,0
1681922949786,ANTH 1,A00,258264,Staff,38,0,40,2
1681922950809,ANTH 2,A01,258259,Staff,72,0,76,4
1681922951836,ANTH 23,A01,258228,Staff,36,0,40,4
1681922952860,ANTH 101,A01,258236,Staff,38,0,40,2
1681922953884,ANTH 102,A00,258272,Staff,59,0,60,1
1681922954906,ANTH 105,A00,258244,Staff,31,0,35,4
1681922955932,BENG 130,A00,253975,Staff,38,0,40,2
1681922956959,BIBC 102,A01,191866,Flagg; Matthew Paul,19,0,32,13
1681922956959,BIBC 102,A02,191867,Flagg; Matthew Paul,22,0,32,10
1681922956959,BIBC 102,A03,191868,Flagg; Matthew Paul,29,0,32,3
1681922956959,BIBC 102,A04,191936,Flagg; Matthew Paul,26,0,32,6
1681922956959,BIBC 102,A05,191937,Flagg; Matthew Paul,5,0,32,27
1681922957986,BICD 100,A01,191939,Cooper; Andrew Michael,28,0,32,4
1681922957986,BICD 100,A02,191940,Cooper; Andrew Michael,32,0,32,0
1681922957986,BICD 100,A03,191941,Cooper; Andrew Michael,32,0,32,0
1681922957986,BICD 100,A04,191942,Cooper; Andrew Michael,32,0,32,0
1681922957986,BICD 100,A05,191943,Cooper; Andrew Michael,32,0,32,0
1681922959013,BIEB 126,A01,191945,Cleland; Elsa Eleanor,0,0,32,32
1681922959013,BIEB 126,A02,191946,Cleland; Elsa Eleanor,27,0,32,5
1681922959013,BIEB 126,A03,191947,Cleland; Elsa Eleanor,29,0,32,3
1681922959013,BIEB 126,A04,191948,Cleland; Elsa Eleanor,23,0,32,9
1681922959013,BIEB 126,A05,191996,Cleland; Elsa Eleanor,28,0,32,4
1681922960035,BIEB 136GS,A00,191997,Shurin; Jonathan & Holway; David A.,0,0,0,4
1681922961061,BIEB 137GS,A01,191999,Shurin; Jonathan & Holway; David A.,0,0,0,3
1681922962094,BILD 1,A01,205385,Staff,31,0,32,1
1681922962094,BILD 1,A02,205386,Staff,30,0,32,2
1681922962094,BILD 1,A03,205387,Staff,32,0,32,0
1681922962094,BILD 1,A04,205388,Staff,27,0,32,5
1681922963122,BILD 2,A01,191774,Staff,28,0,32,4
1681922963122,BILD 2,A02,191775,Staff,30,0,32,2
1681922963122,BILD 2,A03,191777,Staff,30,0,32,2
1681922963122,BILD 2,A04,191856,Staff,31,0,32,1
1681922963122,BILD 2,A05,191857,Staff,32,0,32,0
1681922963122,BILD 2,A06,191858,Staff,32,0,32,0
1681922963122,BILD 2,A07,191859,Staff,31,0,32,1
1681922964149,BILD 3,A01,205391,Staff,29,0,32,3
1681922964149,BILD 3,A02,205393,Staff,32,0,32,0
1681922964149,BILD 3,A03,205394,Staff,27,0,32,5
1681922964149,BILD 3,A04,205395,Staff,32,0,32,0
1681922965171,BILD 20,A01,191861,Staff,32,0,32,0
1681922965171,BILD 20,A02,191862,Staff,32,0,32,0
1681922966196,BILD 30,A01,191864,Staff,31,0,32,1
1681922967221,BIMM 100,A01,192019,Staff,0,0,32,32
1681922967221,BIMM 100,A02,192020,Staff,19,0,32,13
1681922967221,BIMM 100,A03,192035,Staff,21,0,32,11
1681922968259,BIMM 110,A01,192037,Tat; John,0,0,32,32
1681922968259,BIMM 110,A02,192038,Tat; John,7,0,32,25
1681922969291,BIMM 120,A01,192040,Pickett; Brooke Elizabeth,1,0,32,31
1681922969291,BIMM 120,A02,192041,Pickett; Brooke Elizabeth,15,0,32,17
1681922969291,BIMM 120,A03,192042,Pickett; Brooke Elizabeth,15,0,32,17
1681922970317,BIPN 100,A01,192044,Armour; Jon Christopher,23,0,32,9
1681922970317,BIPN 100,A02,192059,Armour; Jon Christopher,30,0,32,2
1681922970317,BIPN 100,A03,192064,Armour; Jon Christopher,30,0,32,2
1681922970317,BIPN 100,A04,192073,Armour; Jon Christopher,28,0,32,4
1681922971351,BIPN 148,A01,205411,Leutgeb; Jill K.,15,0,32,17
1681922971351,BIPN 148,A02,205412,Leutgeb; Jill K.,31,0,32,1
1681922971351,BIPN 148,A03,205413,Leutgeb; Jill K.,30,0,32,2
1681922971351,BIPN 148,A04,205414,Leutgeb; Jill K.,30,0,32,2
1681922972378,BIPN 160,A01,192115,Marino; Marc J,17,0,32,15
1681922972378,BIPN 160,A02,192148,Marino; Marc J,27,0,32,5
1681922972378,BIPN 160,A03,192158,Marino; Marc J,31,0,32,1
1681922972378,BIPN 160,A04,192190,Marino; Marc J,32,0,32,0
1681922972378,BIPN 160,A05,192287,Marino; Marc J,32,0,32,0
1681922972378,BIPN 160,A06,192288,Marino; Marc J,32,0,32,0
1681922973406,BIPN 194,A00,206038,Staff,28,0,32,4
1681922974429,BISP 194,A00,192289,Leutgeb; Stefan,13,0,32,19
1681922974429,BISP 194,B00,245332,Nieh; James Charles,26,0,32,6
1681922975453,CAT 124,A01,202247,Staff,15,0,15,0
1681922976480,CAT 125,A00,202248,Staff,19,0,20,1
1681922976480,CAT 125,B00,202253,Staff,20,0,20,0
1681922976480,CAT 125,C00,202257,Staff,18,0,20,2
1681922977505,CAT 125GS,A01,202273,Bronstein; Phoebe Malan,20,0,20,0
1681922978529,CAT 125R,A00,202284,Staff,18,0,20,2
1681922978529,CAT 125R,C00,202286,Staff,10,0,20,10
1681922978529,CAT 125R,D00,202291,Staff,18,0,20,2
1681922978529,CAT 125R,E00,202295,Staff,13,0,20,7
1681922978529,CAT 125R,F00,202302,Staff,8,0,20,12
1681922979556,CENG 100,A00,204724,Opatkiewicz; Justin Paul,25,0,25,0
1681922980585,CGS 2A,A01,180420,Staff,31,0,36,5
1681922981613,CGS 101,A00,180421,Staff,16,0,20,4
1681922982644,CGS 112,A00,180422,Staff,9,0,16,7
1681922983666,CGS 113,A00,180423,Staff,18,0,20,2
1681922984701,CGS 137,A00,180424,Staff,12,0,12,0
1681922985723,CGS 147,A00,180425,Staff,10,0,10,0
1681922986755,CHEM 6A,A01,179556,Staff,95,0,100,5
1681922986755,CHEM 6A,A02,179558,Staff,0,0,0,0
1681922987777,CHEM 6B,A01,179560,Staff,100,0,100,0
1681922988810,CHEM 6C,A01,179565,Jazzar; Rodolphe,95,0,100,5
1681922989839,CHEM 7L,A01,179586,Schurmeier; Kimberly,11,0,24,13
1681922989839,CHEM 7L,A02,179587,Schurmeier; Kimberly,23,0,24,1
1681922989839,CHEM 7L,A03,179590,Schurmeier; Kimberly,22,0,24,2
1681922989839,CHEM 7L,A04,179591,Schurmeier; Kimberly,22,0,24,2
1681922989839,CHEM 7L,B01,179598,Schurmeier; Kimberly,16,0,24,8
1681922989839,CHEM 7L,B02,179599,Schurmeier; Kimberly,24,0,24,0
1681922989839,CHEM 7L,B03,179606,Schurmeier; Kimberly,23,0,24,1
1681922989839,CHEM 7L,B04,179607,Schurmeier; Kimberly,23,0,24,1
1681922990864,CHEM 11,A01,179609,Stallings; Dontarie M,88,0,100,12
1681922991889,CHEM 40A,A01,179621,Staff,40,0,50,10
1681922991889,CHEM 40A,A02,179622,Staff,46,0,50,4
1681922992913,CHEM 40B,A01,179630,Weizman; Haim,47,0,50,3
1681922992913,CHEM 40B,A02,179631,Weizman; Haim,44,0,50,6
1681922993939,CHEM 41A,A01,179660,Klosterman; Jeremy K,93,0,100,7
1681922994963,CHEM 43A,A01,179683,Klosterman; Jeremy K,0,0,24,24
1681922994963,CHEM 43A,A02,179688,Klosterman; Jeremy K,9,0,24,15
1681922994963,CHEM 43A,A03,179689,Klosterman; Jeremy K,19,0,24,5
1681922994963,CHEM 43A,A04,179691,Klosterman; Jeremy K,18,0,24,6
1681922995993,CHEM 114A,A01,179693,Stallings; Dontarie M,71,0,100,29
1681922997020,CHEM 143B,A01,179698,Weizman; Haim,16,0,24,8
1681922997020,CHEM 143B,A02,179700,Weizman; Haim,24,0,24,0
1681922998042,CHIN 169A,A00,179701,Wang; Xiao,20,0,20,0
1681922999065,COGS 2,A01,179750,Boyle; Mary E. T.,17,0,30,13
1681923000088,COGS 9,A01,179759,Jones; Cameron Robert,42,0,50,8
1681923001110,COGS 14A,A01,179854,Staff,15,0,50,35
1681923002141,COGS 14B,A01,179856,Staff,53,0,60,7
1681923003167,COGS 17,A01,179874,Staff,71,0,75,4
1681923004201,COGS 18,A01,179884,Staff,63,0,80,17
1681923005227,COGS 100,A01,179886,Staff,36,0,60,24
1681923006257,COGS 101B,A01,179892,Staff,0,0,30,30
1681923007280,COGS 101C,A01,179894,Staff,28,0,30,2
1681923008311,COGS 107A,A01,179896,Boyle; Mary E. T.,30,0,40,10
1681923009336,COGS 108,A01,179898,Simpkins; Charles Alexander,0,24,60,60
1681923010361,COGS 109,A01,179900,Staff,34,0,40,6
1681923011389,COGS 118A,A01,179946,Staff,8,0,40,32
1681923012414,COGS 153,A00,179978,Staff,0,3,30,30
1681923013440,COGS 156,A01,179981,Staff,24,0,30,6
1681923015564,COGS 172,A01,179987,Staff,13,0,30,17
1681923017610,COGS 186,A01,179991,Staff,12,0,30,18
1681923018647,COMM 10,A01,180001,Staff,14,0,25,11
1681923018647,COMM 10,A02,180004,Staff,20,0,25,5
1681923019670,COMM 100A,A01,180016,Staff,15,0,25,10
1681923019670,COMM 100A,A02,180020,Staff,24,0,25,1
1681923020696,COMM 101T,A00,180029,Halm; Gavin Patrick,22,0,35,13
1681923021721,COMM 106V,A00,180043,Staff,34,0,35,1
1681923022747,COMM 109P,A00,180044,Staff,30,0,35,5
1681923023769,COMM 113T,A00,180045,Havis; Allan,37,0,45,8
1681923024802,COMM 132,A00,180046,McKenna; Denise,23,0,30,7
1681923025824,COMM 143,A00,180047,Staff,18,0,30,12
1681923026856,COMM 190,A00,180048,Conner; Thomas Hartnell,18,0,23,5
1681923027884,CSE 8A,A50,180053,Cao; Yingjun,24,0,50,26
1681923027884,CSE 8A,B50,180180,Staff,50,0,50,0
1681923028912,CSE 11,A01,180190,Cao; Yingjun,26,0,50,24
1681923029943,CSE 20,A01,180192,Briones; Jor-el Thomas Caparas,23,0,30,7
1681923030966,CSE 21,A01,194538,Briones; Jor-el Thomas Caparas,50,0,60,10
1681923031988,CSE 30,A01,180324,Eldon; John,76,0,100,24
1681923033010,CSE 101,A01,201353,Staff,0,25,40,40
1681923034047,CSE 134B,A01,180326,Powell; Thomas Allan,74,0,100,26
1681923035070,CSE 140,A01,180328,Staff,41,0,75,34
1681923036096,CSE 140L,A01,180344,Eldon; John,64,0,100,36
1681923037125,CSE 150A,A01,180411,Staff,0,13,50,50
1681923038155,CSE 151A,A01,180414,Staff,0,8,50,50
1681923039184,CSE 175,A01,222521,Kumar; Rakesh,50,0,50,0
1681923040208,CSE 190,A00,201419,Staff,44,0,49,5
1681923041237,CSS 1,A01,194536,Staff,37,0,50,13
1681923042270,DSC 30,A01,202385,Staff,48,0,50,2
1681923043298,DSC 40A,A01,202387,Albuyeh; Rod,50,0,50,0
1681923044321,DSC 190,A01,202389,Silberman; Jack,21,0,21,0
1681923045343,DSGN 100,A01,179993,Staff,15,0,30,15
1681923046376,ECE 65,A50,180708,Staff,10,0,20,10
1681923046376,ECE 65,A51,180739,Staff,19,0,20,1
1681923047401,ECON 1,A01,180427,Famulari; Melissa,67,0,70,3
1681923048455,ECON 2,A01,180450,Levkoff; Steven B.,64,0,70,6
1681923049481,ECON 4,A01,203351,Anderson; John Charles,6,0,10,4
1681923050504,ECON 100A,A01,180472,Famulari; Melissa,63,0,70,7
1681923051536,ECON 120A,A01,180549,Staff,64,0,70,6
1681923052559,ECON 120B,A01,180655,Ma; Xinwei,43,0,70,27
1681923053581,ECON 129,A00,203333,Eckert; Fabian Paul,13,0,35,22
1681923054615,ECON 131,A00,180656,Staff,5,0,35,30
1681923055639,ECON 172B,A01,180672,Levkoff; Steven B.,31,0,35,4
1681923056662,ECON 178,A01,203342,Zhu; Ying,9,0,35,26
1681923057693,EDS 108GS,A00,202383,Wishard Guerra; Alison G.,20,0,20,0
1681923058717,EDS 111GS,A00,202347,Wishard Guerra; Alison G.,20,0,20,0
1681923059753,EDS 112,A01,202323,Staff,55,0,60,5
1681923060778,EDS 113,A00,202340,Staff,32,0,35,3
1681923061801,EDS 118,A00,201231,Staff,20,0,30,10
1681923062826,EDS 119,A00,204994,Staff,8,0,10,2
1681923063860,EDS 124BR,A00,202324,Eguchi; Emi,2,0,25,23
1681923064886,EDS 126,A01,203208,Jones; Makeba,26,0,30,4
1681923065918,EDS 135,A01,202333,Staff,18,0,20,2
1681923066944,EDS 180,A00,202311,Staff,47,0,50,3
1681923067978,ERC 190GS,A01,253747,Staff,28,0,28,0
1681923069001,ETHN 104,A00,180742,Staff,23,0,35,12
1681923070026,ETHN 118,A00,180745,Staff,27,0,35,8
1681923071051,ETHN 127,A00,180747,Staff,11,0,16,5
1681923072075,ETHN 137,A00,180880,Staff,11,0,12,1
1681923073100,ETHN 147,A00,180890,Staff,8,0,10,2
1681923074125,ETHN 154,A00,180891,Staff,7,0,8,1
1681923075153,ETHN 168,A00,180892,Staff,9,0,10,1
1681923076178,GLBH 20,A00,201051,Hannah; Seth Donal,0,3,0,1
1681923077204,GLBH 111,A01,209338,Burgos; Jose L.,0,0,0,0
1681923078227,GLBH 150,A00,258300,Staff,0,3,0,0
1681923079261,GLBH 181,A00,201207,Staff,12,0,40,28
1681923080299,HIEU 109,A00,180898,Staff,19,0,20,1
1681923081322,HIEU 111,A00,180899,Staff,0,1,20,20
1681923082348,HIEU 124,A00,180900,Staff,17,0,20,3
1681923083415,HILA 122,A00,180901,Staff,18,0,20,2
1681923084437,HILA 132,A00,180902,Vitz; Matthew,1,0,20,19
1681923085463,HILD 10,A01,180896,Staff,14,0,20,6
1681923086486,HILD 30GS,A00,180897,Edington; Claire Ellen,0,0,0,0
1681923087511,HISC 105,A00,180903,Staff,20,0,20,0
1681923088534,HISC 117,A00,180904,Staff,10,0,20,10
1681923089573,HIUS 108B,A00,181005,Staff,18,0,20,2
1681923090605,HIUS 113,A00,181093,Staff,1,0,20,19
1681923091630,HUM 3,A01,181190,Patterson; Patrick H.,38,0,50,12
1681923091630,HUM 3,B01,181195,Staff,46,0,50,4
1681923092653,HUM 3GS,A00,181196,Herbst; Matthew,0,0,0,0
1681923093680,HUM 4,A01,181227,West; Geoffrey Scott,33,0,50,17
1681923093680,HUM 4,B01,181282,Staff,41,0,50,9
1681923094706,HUM 4GS,A00,181377,Lyon; Antony J.,0,0,0,0
1681923095739,HUM 5,A01,181536,Zavodny; Tatiana Sophia,28,0,50,22
1681923095739,HUM 5,B01,181908,Staff,35,0,50,15
1681923096777,INTL 190,A00,181909,Segui; Alan S,0,0,0,8
1681923096777,INTL 190,B00,181961,Segui; Alan S,0,0,0,7
1681923097801,JAPN 20AR,A01,182113,Ross; Kayoko F,15,0,20,5
1681923098830,LATI 50,A01,202391,Martin-Cabrera; Luis,18,0,30,12
1681923098830,LATI 50,A02,202392,Martin-Cabrera; Luis,26,0,30,4
1681923099866,LATI 180,A00,202393,Kokinis; Troy Andreas,24,0,25,1
1681923100889,LIFR 1A,A00,182119,Staff,14,0,14,0
1681923101914,LIFR 1AX,A00,182324,Staff,14,0,14,0
1681923102939,LIFR 1B,A00,182259,Staff,13,0,14,1
1681923103965,LIFR 1BX,A00,182273,Staff,13,0,14,1
1681923104988,LIGN 8,A00,182330,Staff,132,0,150,18
1681923106013,LIGN 9GS,A00,182362,Staff,20,0,20,0
1681923107035,LIGN 119,A00,204992,Takahashi; Maho,12,0,15,3
1681923108061,LIGN 130,A01,182384,Staff,47,0,50,3
1681923109086,LIGN 149GS,A00,182390,Staff,20,0,20,0
1681923110119,LIGN 170,A00,182404,Staff,23,0,30,7
1681923111151,LISP 1D,A00,182281,Staff,7,0,14,7
1681923111151,LISP 1D,B00,182287,Staff,13,0,14,1
1681923111151,LISP 1D,C00,182295,Staff,11,0,14,3
1681923111151,LISP 1D,D00,182301,Staff,14,0,14,0
1681923112174,LISP 1DX,A00,182309,Staff,19,0,28,9
1681923112174,LISP 1DX,B00,182316,Staff,26,0,28,2
1681923113200,LTAF 120GS,A00,182412,Zhiri; Oumelbanine,20,0,20,0
1681923114226,LTCS 172GS,A00,182437,Bronstein; Phoebe Malan,20,0,20,0
1681923115250,LTEA 138,A00,182457,Staff,20,0,40,20
1681923116273,LTEN 114,A01,182490,Staff,23,0,25,2
1681923117295,LTEN 130GS,A00,182491,Lyon; Antony J.,20,0,20,0
1681923118318,LTEN 169,A00,182493,Cuong; Marisol,19,0,25,6
1681923119418,LTEN 178,A00,182501,Staff,14,0,15,1
1681923120439,LTEN 181,A00,182515,Staff,21,0,25,4
1681923121464,LTEN 185GS,A00,197655,Forbes; Camille,20,0,20,0
1681923122487,LTSP 100B,A00,202208,Bessett; Ryan Matthew,24,0,25,1
1681923123522,LTWL 100,A00,182516,Myerston Santana; Jacobo,21,0,30,9
1681923124548,LTWR 100GS,A00,182518,Forbes; Camille,20,0,20,0
1681923125572,LTWR 102,A00,182522,Staff,15,0,15,0
1681923125572,LTWR 102,B00,182525,Staff,14,0,15,1
1681923126597,LTWR 115,A00,182526,Staff,11,0,15,4
1681923127621,MAE 8,A01,182528,Pham; Hieu Tan,67,0,70,3
1681923128643,MAE 11,A00,182529,Bahadori; Mohammad Yousef,93,0,100,7
1681923129665,MAE 20,A00,182530,Evdokimenko; Ekaterina,68,0,70,2
1681923130688,MAE 30A,A00,182532,Staff,44,0,45,1
1681923131711,MAE 101A,A00,182533,Bahadori; Mohammad Yousef,95,0,100,5
1681923132735,MAE 101C,A00,182538,Staff,62,0,70,8
1681923133762,MAE 104,A00,182539,Staff,44,0,50,6
1681923134787,MAE 131A,A00,182540,Ghazinejad; Maziar,40,0,45,5
1681923135812,MAE 143A,A00,182548,Bewley; Thomas R,43,0,50,7
1681923136834,MAE 150,A00,182549,Staff,28,0,40,12
1681923137864,MAE 160,A00,182550,Evdokimenko; Ekaterina,41,0,60,19
1681923138896,MATH 3C,A01,182725,Staff,25,0,30,5
1681923139919,MATH 10A,A01,182729,Staff,25,0,30,5
1681923139919,MATH 10A,B01,182732,Staff,26,0,30,4
1681923140945,MATH 10B,A01,182737,Staff,21,0,30,9
1681923140945,MATH 10B,A02,182738,Staff,26,0,30,4
1681923140945,MATH 10B,B01,182744,Staff,27,0,30,3
1681923140945,MATH 10B,B02,182745,Staff,27,0,30,3
1681923141973,MATH 18,A01,182750,Anzaldo; Leesa B,28,0,30,2
1681923141973,MATH 18,A02,182751,Anzaldo; Leesa B,29,0,30,1
1681923141973,MATH 18,A03,182753,Anzaldo; Leesa B,27,0,30,3
1681923141973,MATH 18,A04,182757,Anzaldo; Leesa B,29,0,30,1
1681923141973,MATH 18,B01,182761,Anzaldo; Leesa B,27,0,30,3
1681923141973,MATH 18,B02,182764,Anzaldo; Leesa B,26,0,30,4
1681923141973,MATH 18,B03,182765,Anzaldo; Leesa B,29,0,30,1
1681923141973,MATH 18,B04,182766,Anzaldo; Leesa B,30,0,30,0
1681923142998,MATH 20A,A01,182771,Suk; Andrew Hoon,28,0,30,2
1681923144026,MATH 20B,A01,182775,Bach; Quang Tran,30,0,30,0
1681923144026,MATH 20B,A02,182777,Bach; Quang Tran,29,0,30,1
1681923144026,MATH 20B,B01,182780,Bach; Quang Tran,26,0,30,4
1681923144026,MATH 20B,B02,182782,Bach; Quang Tran,30,0,30,0
1681923145050,MATH 20C,A01,182787,Staff,25,0,30,5
1681923145050,MATH 20C,A02,182790,Staff,29,0,30,1
1681923145050,MATH 20C,B01,182792,Staff,25,0,30,5
1681923145050,MATH 20C,B02,182796,Staff,26,0,30,4
1681923146077,MATH 20D,A01,182799,Staff,28,0,30,2
1681923146077,MATH 20D,A02,182802,Staff,29,0,30,1
1681923146077,MATH 20D,A03,182803,Staff,30,0,30,0
1681923147100,MATH 20E,A01,182809,Verstraete; Jacques Allan,23,0,30,7
1681923147100,MATH 20E,A02,182811,Verstraete; Jacques Allan,28,0,30,2
1681923147100,MATH 20E,B01,182814,Verstraete; Jacques Allan,22,0,30,8
1681923147100,MATH 20E,B02,182815,Verstraete; Jacques Allan,30,0,30,0
1681923148137,MATH 103A,A01,182820,Staff,8,0,30,22
1681923148137,MATH 103A,A02,182821,Staff,27,0,30,3
1681923148137,MATH 103A,A03,182822,Staff,23,0,30,7
1681923148137,MATH 103A,B01,182825,Staff,23,0,30,7
1681923148137,MATH 103A,B02,182826,Staff,30,0,30,0
1681923148137,MATH 103A,B03,182830,Staff,30,0,30,0
1681923149160,MATH 109,A01,182836,Chow; Bennett,24,0,30,6
1681923149160,MATH 109,A02,182838,Chow; Bennett,29,0,30,1
1681923149160,MATH 109,A03,182894,Chow; Bennett,29,0,30,1
1681923149160,MATH 109,B01,182908,Chow; Bennett,27,0,30,3
1681923149160,MATH 109,B02,182909,Chow; Bennett,30,0,30,0
1681923149160,MATH 109,B03,182910,Chow; Bennett,26,0,30,4
1681923150183,MATH 142A,A01,182925,Staff,8,0,30,22
1681923150183,MATH 142A,A02,182935,Staff,24,0,30,6
1681923150183,MATH 142A,A03,182967,Staff,26,0,30,4
1681923150183,MATH 142A,B01,183125,Staff,22,0,30,8
1681923150183,MATH 142A,B02,183157,Staff,28,0,30,2
1681923150183,MATH 142A,B03,183158,Staff,29,0,30,1
1681923151217,MATH 183,A01,183160,Arias-Castro; Ery,23,0,30,7
1681923151217,MATH 183,A02,183161,Arias-Castro; Ery,29,0,30,1
1681923151217,MATH 183,B01,183163,Arias-Castro; Ery,28,0,30,2
1681923151217,MATH 183,B02,183164,Arias-Castro; Ery,28,0,30,2
1681923152256,MATH 193A,A01,183167,Staff,1,0,35,34
1681923152256,MATH 193A,A02,183168,Staff,28,0,35,7
1681923152256,MATH 193A,A03,183169,Staff,34,0,35,1
1681923152256,MATH 193A,A04,183170,Staff,27,0,35,8
1681923153278,MGT 4,A01,202395,Anderson; John Charles,75,0,80,5
1681923154309,MGT 5,A00,202396,Houskeeper; Robert,79,0,90,11
1681923155336,MGT 103,A00,202397,Eberhard; Craig A,50,0,90,40
1681923156369,MGT 131A,A00,202398,Houskeeper; Robert,84,0,90,6
1681923157393,MGT 135,A00,202399,Anderson; John Charles,81,0,90,9
1681923158416,MGT 162R,A00,202403,Gneezy; Uri,137,0,200,63
1681923159450,MGT 172,A00,202404,Hedges; Kathleen,41,0,90,49
1681923160472,MGT 181,A00,202405,Dunn; Louis Jean,80,0,90,10
1681923161500,MMW 14,A01,183200,Staff,10,0,28,18
1681923161500,MMW 14,A02,183201,Staff,26,0,28,2
1681923161500,MMW 14,A03,183202,Staff,24,0,28,4
1681923161500,MMW 14,A04,183203,Staff,25,0,28,3
1681923161500,MMW 14,A05,183204,Staff,26,0,28,2
1681923161500,MMW 14,A06,183205,Staff,27,0,28,1
1681923161500,MMW 14,B01,183207,Staff,26,0,28,2
1681923161500,MMW 14,B02,183208,Staff,28,0,28,0
1681923161500,MMW 14,B03,183209,Staff,28,0,28,0
1681923161500,MMW 14,B04,183210,Staff,28,0,28,0
1681923161500,MMW 14,B05,183211,Staff,28,0,28,0
1681923161500,MMW 14,B06,183212,Staff,27,0,28,1
1681923162527,MMW 14GS,A00,183213,Zhiri; Oumelbanine,28,0,28,0
1681923163550,MMW 15GS,B00,183215,Rahimi; Babak,28,0,28,0
1681923164575,MMW 121,A01,183217,Patterson; Patrick H.,13,0,28,15
1681923164575,MMW 121,A02,183218,Patterson; Patrick H.,25,0,28,3
1681923165596,MUS 1A,A01,182554,Staff,5,0,35,30
1681923166621,MUS 5,A01,182558,Staff,17,0,35,18
1681923167646,MUS 6,A01,182562,Staff,22,0,35,13
1681923168670,MUS 8GS,A00,182563,Borgo; David Garcia,25,0,25,0
1681923169692,MUS 13,A01,182567,Staff,24,0,25,1
1681923170715,MUS 15,A01,182570,Staff,32,0,35,3
1681923170715,MUS 15,B01,182575,Staff,9,0,35,26
1681923171737,MUS 80,A00,182578,Staff,22,0,25,3
1681923171737,MUS 80,B00,182581,Staff,20,0,25,5
1681923172760,MUS 113,A00,182582,Staff,25,0,25,0
1681923173795,MUS 114,A00,182583,Staff,3,0,25,22
1681923174818,MUS 150GS,A01,182588,Borgo; David Garcia,25,0,25,0
1681923175842,PHIL 1,A00,182590,Staff,35,0,40,5
1681923176875,PHIL 10,A01,182596,Grush; Rick Scott,31,0,35,4
1681923176875,PHIL 10,A02,182597,Grush; Rick Scott,34,0,35,1
1681923177901,PHIL 15,A01,182601,Staff,31,0,35,4
1681923177901,PHIL 15,A02,182602,Staff,33,0,35,2
1681923178927,PHIL 27,A01,182604,Staff,30,0,35,5
1681923178927,PHIL 27,A02,182607,Staff,35,0,35,0
1681923179952,PHIL 32,A01,182609,Staff,35,0,35,0
1681923179952,PHIL 32,A02,182612,Staff,35,0,35,0
1681923180978,PHIL 130,A00,182614,Staff,62,0,70,8
1681923182002,PHIL 136,A00,182616,Cohen; Jonathan David,66,0,70,4
1681923183024,PHIL 155,A00,182617,Vargas; Manuel Rogelio,58,0,70,12
1681923184050,PHIL 163,A01,182620,Staff,15,0,20,5
1681923184050,PHIL 163,A02,182624,Staff,10,0,20,10
1681923185074,PHIL 164,A00,182627,Staff,29,0,40,11
1681923186103,PHIL 173,A00,182628,Staff,36,0,40,4
1681923187128,PHYS 1A,A00,183221,Staff,54,0,60,6
1681923188170,PHYS 1AL,001,183222,Staff,25,0,30,5
1681923188170,PHYS 1AL,002,183223,Staff,28,0,30,2
1681923189192,PHYS 1B,A00,183231,Staff,43,0,60,17
1681923190228,PHYS 1BL,001,183232,Staff,20,0,30,10
1681923190228,PHYS 1BL,002,183233,Staff,27,0,30,3
1681923191249,PHYS 1C,A00,183240,Staff,25,0,60,35
1681923192271,PHYS 1CL,001,183241,Staff,10,0,30,20
1681923192271,PHYS 1CL,002,183242,Staff,22,0,30,8
1681923193294,PHYS 2AR,A01,183250,Staff,43,0,50,7
1681923194327,PHYS 2B,A01,183252,Staff,104,0,115,11
1681923195353,PHYS 2BL,A01,183254,Staff,21,0,24,3
1681923195353,PHYS 2BL,A02,183255,Staff,22,0,24,2
1681923196375,PHYS 2C,A01,183522,Staff,103,0,115,12
1681923197398,PHYS 4A,A01,183524,Staff,49,0,50,1
1681923198422,POLI 5,A00,183525,Staff,44,0,50,6
1681923199456,POLI 12,A00,183540,Staff,45,0,50,5
1681923200480,POLI 13R,A00,183541,Forman; Fonna,41,0,50,9
1681923201511,POLI 30,A00,183542,Mignozzetti; Umberto,48,0,50,2
1681923202541,POLI 100A,A00,183543,Staff,45,0,50,5
1681923203563,POLI 100E,A00,223598,Staff,32,0,35,3
1681923204589,POLI 103A,A00,183564,Kousser; Thad,37,0,50,13
1681923205611,POLI 104B,A00,201329,Staff,28,0,35,7
1681923206634,POLI 113BR,A00,183576,Hoston; Germaine,24,0,50,26
1681923207658,POLI 114BR,A00,183588,Staff,27,0,30,3
1681923208680,POLI 117R,A00,183595,Forman; Fonna,5,0,20,15
1681923209701,POLI 120H,A00,183596,Fisk; David Lee,13,0,20,7
1681923210724,POLI 130AA,A00,183597,Staff,13,0,20,7
1681923211750,POLI 134AA,A00,183598,Staff,19,0,20,1
1681923212796,POLI 135,A00,183599,Fisk; David Lee,19,0,25,6
1681923213820,POLI 142P,A00,183623,Staff,37,0,40,3
1681923214843,POLI 144D,A00,183624,Staff,22,0,25,3
1681923215866,POLI 151,A00,183625,Staff,15,0,20,5
1681923216891,POLI 162,A00,183626,Mignozzetti; Umberto,17,0,20,3
1681923217920,PSYC 1,A00,253748,Staff,86,0,90,4
1681923218941,PSYC 2,A00,183627,Moranton; Nirelia Melbina-,24,0,35,11
1681923219964,PSYC 3,A00,183628,Staff,43,0,45,2
1681923222010,PSYC 60,A01,183631,Lowe; Angela Beth,35,0,40,5
1681923223106,PSYC 70,A01,253757,Staff,37,0,45,8
1681923224143,PSYC 101,A00,183632,Heyman; Gail D.,46,0,60,14
1681923225167,PSYC 105,A00,183848,Lowe; Angela Beth,47,0,60,13
1681923226192,PSYC 106,A00,183849,Dobkins; Karen R.,42,0,60,18
1681923227220,PSYC 108,A00,253750,Staff,21,0,60,39
1681923228241,PSYC 114,A01,184275,Winkielman; Piotr,0,7,30,30
1681923229264,PSYC 122,A00,183856,Moranton; Nirelia Melbina-,0,14,30,30
1681923230289,PSYC 124,A00,183865,Chapman; Eddie Nathaniel,49,0,80,31
1681923231313,PSYC 137,A00,183880,Staff,19,0,25,6
1681923233362,PSYC 154,A00,183910,Lacefield; Katharine I,0,16,90,90
1681923235419,PSYC 162,A00,183946,Wixted; John T,53,0,90,37
1681923236445,PSYC 172,A00,183947,Gorman; Michael R.,10,0,30,20
1681923237469,PSYC 178,A00,183963,Glaser; Dale,17,0,40,23
1681923238500,PSYC 181GS,A00,183964,Anagnostaras; Stephan,10,0,10,0
1681923239523,PSYC 186GS,A01,257660,Staff,10,0,10,0
1681923240558,PSYC 193,B00,253749,Staff,23,0,25,2
1681923242613,PSYC 193L,A01,184122,Staff,33,0,35,2
1681923242613,PSYC 193L,C01,184167,Winkielman; Piotr,14,0,30,16
1681923243643,RELI 188GS,A00,182629,Rahimi; Babak,20,0,20,0
1681923244666,SE 101A,A00,182646,Staff,26,0,30,4
1681923245698,SE 101C,A00,182650,Staff,17,0,20,3
1681923246721,SE 110A,A00,182651,Staff,28,0,28,0
1681923247747,SE 130A,A00,182652,Staff,39,0,40,1
1681923248773,SIO 46GS,A00,182636,Cook; Geoffrey W,26,0,28,2
1681923249798,SIO 109R,A00,194459,Staff,3,0,20,17
1681923250823,SIO 121GS,A00,182639,Cook; Geoffrey W,25,0,28,3
1681923251849,SIO 132,A01,182642,Staff,32,0,40,8
1681923252877,SIO 139,A00,182644,Kacev; David,36,0,40,4
1681923253902,SOCI 2,A01,258404,Staff,33,0,36,3
1681923253902,SOCI 2,A02,258405,Staff,35,0,36,1
1681923254924,SOCI 60,A01,258408,Staff,29,0,30,1
1681923254924,SOCI 60,A02,258413,Staff,30,0,30,0
1681923255947,SOCI 100,A01,258415,Staff,29,0,30,1
1681923255947,SOCI 100,A02,258416,Staff,28,0,30,2
1681923262109,SOCI 127,A00,258421,Staff,21,0,30,9
1681923263134,SOCI 132,A00,258422,Staff,45,0,50,5
1681923264157,SOCI 133,A00,258423,Staff,26,0,30,4
1681923265179,SOCI 138GS,A00,258424,Staff,15,0,15,0
1681923266204,SOCI 145,A00,258425,Staff,25,0,30,5
1681923267226,SOCI 148,A00,258426,Staff,24,0,30,6
1681923268255,SOCI 153,A00,199217,Staff,29,0,30,1
1681923269289,SOCI 160,A00,258427,Staff,28,0,30,2
1681923270312,SOCI 160E,A00,258435,Staff,56,0,60,4
1681923271338,SOCI 189GS,A00,258436,Staff,15,0,15,0
1681923272360,SOCI 190GS,A00,258437,Staff,15,0,15,0
1681923273382,SYN 2,001,182658,Staff,8,0,16,8
1681923273382,SYN 2,002,201439,Staff,14,0,16,2
1681923273382,SYN 2,003,201443,Staff,16,0,16,0
1681923274406,SYN 100,A01,182657,Staff,16,0,20,4
1681923275438,TDAC 1,A00,184381,Salovey; Todd,16,0,20,4
1681923275438,TDAC 1,B00,184385,Harting; Carla Kelso,19,0,20,1
1681923275438,TDAC 1,C00,184394,Staff,19,0,20,1
1681923276462,TDAC 101,A00,184483,Harting; Carla Kelso,19,0,20,1
1681923277488,TDDE 111,A00,184496,Staff,14,0,15,1
1681923278515,TDDE 131,A00,184504,Staff,20,0,20,0
1681923278515,TDDE 131,B00,184505,Staff,17,0,18,1
1681923278515,TDDE 131,C00,184534,Staff,49,0,50,1
1681923278515,TDDE 131,D00,184564,Staff,15,0,15,0
1681923278515,TDDE 131,E00,204725,Staff,19,0,20,1
1681923279543,TDGE 1,A01,184414,Salovey; Todd,36,0,50,14
1681923280569,TDGE 5,A01,184419,Staff,23,0,24,1
1681923281594,TDGE 10,A00,184428,Fulton; Julia,29,0,50,21
1681923282617,TDGE 124,A00,184565,Fulton; Julia,5,0,50,45
1681923283644,TDGE 125,B00,184567,Meyer; Ursula,9,0,25,16
1681923284667,TDHT 101,A00,184568,Staff,21,0,25,4
1681923284667,TDHT 101,B00,184569,Staff,20,0,20,0
1681923285694,TDHT 114,A00,184570,Staff,49,0,50,1
1681923286718,TDMV 1,A00,184437,Arcidiacono; Kristin,22,0,30,8
1681923286718,TDMV 1,B00,184448,Caligagan; Maria T.,23,0,30,7
1681923287742,TDMV 2,A00,184449,Weinberg; Sadie,27,0,30,3
1681923287742,TDMV 2,B00,184453,Arcidiacono; Kristin,29,0,30,1
1681923288765,TDMV 110,A00,184571,Weinberg; Sadie,30,0,30,0
1681923289795,TDMV 142,A00,184572,Caligagan; Tony,27,0,30,3
1681923289795,TDMV 142,B00,184573,Caligagan; Maria T.,26,0,30,4
1681923290817,TDTR 20,A00,184482,Jun; Grace Shin Hae,25,0,25,0
1681923291842,USP 2,A01,184290,Hinds; Juli Beth,24,0,25,1
1681923292873,USP 3,A01,184295,Staff,21,0,25,4
1681923293898,USP 4,A00,184304,McTague; Sarah,13,0,25,12
1681923294921,USP 100,A00,184315,Staff,16,0,25,9
1681923295953,USP 105,A00,184326,Staff,21,0,25,4
1681923296991,USP 151,A00,184327,Staff,20,0,25,5
1681923298018,USP 170,A00,184380,Hinds; Juli Beth,13,0,25,12
1681923299041,VIS 21B,A01,182660,Staff,28,0,31,3
1681923299041,VIS 21B,A02,182662,Staff,30,0,31,1
1681923300064,VIS 103D,A00,182663,Staff,74,0,75,1
1681923301090,VIS 105D,A00,182667,Li; Huai,14,0,22,8
1681923302122,VIS 122GS,A00,182668,Herbst; Matthew,20,0,20,0
1681923303161,VIS 128C,A00,182673,Staff,69,0,75,6
1681923304187,VIS 130,A00,182675,Staff,19,0,22,3
1681923305217,VIS 160A,A00,182678,Stalbaum; Brett,4,0,10,6
1681923307268,WCWP 10B,A00,201679,Staff,15,0,15,0
1681923307268,WCWP 10B,B00,201695,Staff,15,0,15,0
1681923308296,WCWP 100,A00,201716,Staff,12,0,15,3
1681923308296,WCWP 100,B00,201717,Staff,5,0,15,10
1681923310393,ANSC 105GS,A00,258289,Staff,0,0,0,0
1681923311417,ANSC 125GS,A00,258295,Staff,0,0,0,0
1681923312441,ANSC 150,A00,258267,Staff,30,0,40,10
1681923313470,ANSC 190GS,A00,258280,Staff,0,0,0,0
1681923314493,ANTH 1,A00,258264,Staff,38,0,40,2
1681923315519,ANTH 2,A01,258259,Staff,72,0,76,4
1681923316548,ANTH 23,A01,258228,Staff,36,0,40,4
1681923317574,ANTH 101,A01,258236,Staff,38,0,40,2
1681923318598,ANTH 102,A00,258272,Staff,59,0,60,1
1681923319623,ANTH 105,A00,258244,Staff,31,0,35,4
1681923320649,BENG 130,A00,253975,Staff,38,0,40,2
1681923321671,BIBC 102,A01,191866,Flagg; Matthew Paul,19,0,32,13
1681923321671,BIBC 102,A02,191867,Flagg; Matthew Paul,22,0,32,10
1681923321671,BIBC 102,A03,191868,Flagg; Matthew Paul,29,0,32,3
1681923321671,BIBC 102,A04,191936,Flagg; Matthew Paul,26,0,32,6
1681923321671,BIBC 102,A05,191937,Flagg; Matthew Paul,3,0,32,29
1681923322695,BICD 100,A01,191939,Cooper; Andrew Michael,28,0,32,4
1681923322695,BICD 100,A02,191940,Cooper; Andrew Michael,32,0,32,0
1681923322695,BICD 100,A03,191941,Cooper; Andrew Michael,32,0,32,0
1681923322695,BICD 100,A04,191942,Cooper; Andrew Michael,32,0,32,0
1681923322695,BICD 100,A05,191943,Cooper; Andrew Michael,32,0,32,0
1681923323718,BIEB 126,A01,191945,Cleland; Elsa Eleanor,0,1,32,32
1681923323718,BIEB 126,A02,191946,Cleland; Elsa Eleanor,27,0,32,5
1681923323718,BIEB 126,A03,191947,Cleland; Elsa Eleanor,29,0,32,3
1681923323718,BIEB 126,A04,191948,Cleland; Elsa Eleanor,23,0,32,9
1681923323718,BIEB 126,A05,191996,Cleland; Elsa Eleanor,28,0,32,4
1681923324743,BIEB 136GS,A00,191997,Shurin; Jonathan & Holway; David A.,0,0,0,4
1681923325767,BIEB 137GS,A01,191999,Shurin; Jonathan & Holway; David A.,0,0,0,3
1681923326871,BILD 1,A01,205385,Staff,31,0,32,1
1681923326871,BILD 1,A02,205386,Staff,30,0,32,2
1681923326871,BILD 1,A03,205387,Staff,32,0,32,0
1681923326871,BILD 1,A04,205388,Staff,27,0,32,5
1681923327893,BILD 2,A01,191774,Staff,28,0,32,4
1681923327893,BILD 2,A02,191775,Staff,30,0,32,2
1681923327893,BILD 2,A03,191777,Staff,30,0,32,2
1681923327893,BILD 2,A04,191856,Staff,31,0,32,1
1681923327893,BILD 2,A05,191857,Staff,32,0,32,0
1681923327893,BILD 2,A06,191858,Staff,32,0,32,0
1681923327893,BILD 2,A07,191859,Staff,31,0,32,1
1681923328917,BILD 3,A01,205391,Staff,29,0,32,3
1681923328917,BILD 3,A02,205393,Staff,32,0,32,0
1681923328917,BILD 3,A03,205394,Staff,27,0,32,5
1681923328917,BILD 3,A04,205395,Staff,32,0,32,0
1681923329941,BILD 20,A01,191861,Staff,32,0,32,0
1681923329941,BILD 20,A02,191862,Staff,32,0,32,0
1681923330962,BILD 30,A01,191864,Staff,31,0,32,1
1681923331991,BIMM 100,A01,192019,Staff,0,0,32,32
1681923331991,BIMM 100,A02,192020,Staff,19,0,32,13
1681923331991,BIMM 100,A03,192035,Staff,21,0,32,11
1681923333014,BIMM 110,A01,192037,Tat; John,0,0,32,32
1681923333014,BIMM 110,A02,192038,Tat; John,8,0,32,24
1681923334037,BIMM 120,A01,192040,Pickett; Brooke Elizabeth,1,0,32,31
1681923334037,BIMM 120,A02,192041,Pickett; Brooke Elizabeth,15,0,32,17
1681923334037,BIMM 120,A03,192042,Pickett; Brooke Elizabeth,15,0,32,17
1681923335066,BIPN 100,A01,192044,Armour; Jon Christopher,23,0,32,9
1681923335066,BIPN 100,A02,192059,Armour; Jon Christopher,30,0,32,2
1681923335066,BIPN 100,A03,192064,Armour; Jon Christopher,30,0,32,2
1681923335066,BIPN 100,A04,192073,Armour; Jon Christopher,28,0,32,4
1681923336089,BIPN 148,A01,205411,Leutgeb; Jill K.,15,0,32,17
1681923336089,BIPN 148,A02,205412,Leutgeb; Jill K.,31,0,32,1
1681923336089,BIPN 148,A03,205413,Leutgeb; Jill K.,30,0,32,2
1681923336089,BIPN 148,A04,205414,Leutgeb; Jill K.,30,0,32,2
1681923337122,BIPN 160,A01,192115,Marino; Marc J,16,0,32,16
1681923337122,BIPN 160,A02,192148,Marino; Marc J,27,0,32,5
1681923337122,BIPN 160,A03,192158,Marino; Marc J,31,0,32,1
1681923337122,BIPN 160,A04,192190,Marino; Marc J,32,0,32,0
1681923337122,BIPN 160,A05,192287,Marino; Marc J,32,0,32,0
1681923337122,BIPN 160,A06,192288,Marino; Marc J,32,0,32,0
1681923338146,BIPN 194,A00,206038,Staff,28,0,32,4
1681923339173,BISP 194,A00,192289,Leutgeb; Stefan,13,0,32,19
1681923339173,BISP 194,B00,245332,Nieh; James Charles,26,0,32,6
1681923340205,CAT 124,A01,202247,Staff,15,0,15,0
1681923341236,CAT 125,A00,202248,Staff,19,0,20,1
1681923341236,CAT 125,B00,202253,Staff,20,0,20,0
1681923341236,CAT 125,C00,202257,Staff,18,0,20,2
1681923342261,CAT 125GS,A01,202273,Bronstein; Phoebe Malan,20,0,20,0
1681923343296,CAT 125R,A00,202284,Staff,18,0,20,2
1681923343296,CAT 125R,C00,202286,Staff,10,0,20,10
1681923343296,CAT 125R,D00,202291,Staff,17,0,20,3
1681923343296,CAT 125R,E00,202295,Staff,13,0,20,7
1681923343296,CAT 125R,F00,202302,Staff,8,0,20,12
1681923344323,CENG 100,A00,204724,Opatkiewicz; Justin Paul,25,0,25,0
1681923345346,CGS 2A,A01,180420,Staff,31,0,36,5
1681923346369,CGS 101,A00,180421,Staff,16,0,20,4
1681923347397,CGS 112,A00,180422,Staff,9,0,16,7
1681923348420,CGS 113,A00,180423,Staff,18,0,20,2
1681923349445,CGS 137,A00,180424,Staff,12,0,12,0
1681923350467,CGS 147,A00,180425,Staff,10,0,10,0
1681923351492,CHEM 6A,A01,179556,Staff,95,0,100,5
1681923351492,CHEM 6A,A02,179558,Staff,0,0,0,0
1681923352515,CHEM 6B,A01,179560,Staff,100,0,100,0
1681923353539,CHEM 6C,A01,179565,Jazzar; Rodolphe,95,0,100,5
1681923354565,CHEM 7L,A01,179586,Schurmeier; Kimberly,10,0,24,14
1681923354565,CHEM 7L,A02,179587,Schurmeier; Kimberly,23,0,24,1
1681923354565,CHEM 7L,A03,179590,Schurmeier; Kimberly,22,0,24,2
1681923354565,CHEM 7L,A04,179591,Schurmeier; Kimberly,22,0,24,2
1681923354565,CHEM 7L,B01,179598,Schurmeier; Kimberly,16,0,24,8
1681923354565,CHEM 7L,B02,179599,Schurmeier; Kimberly,24,0,24,0
1681923354565,CHEM 7L,B03,179606,Schurmeier; Kimberly,23,0,24,1
1681923354565,CHEM 7L,B04,179607,Schurmeier; Kimberly,23,0,24,1
1681923355588,CHEM 11,A01,179609,Stallings; Dontarie M,87,0,100,13
1681923356613,CHEM 40A,A01,179621,Staff,40,0,50,10
1681923356613,CHEM 40A,A02,179622,Staff,46,0,50,4
1681923357638,CHEM 40B,A01,179630,Weizman; Haim,47,0,50,3
1681923357638,CHEM 40B,A02,179631,Weizman; Haim,44,0,50,6
1681923358665,CHEM 41A,A01,179660,Klosterman; Jeremy K,93,0,100,7
1681923359691,CHEM 43A,A01,179683,Klosterman; Jeremy K,0,0,24,24
1681923359691,CHEM 43A,A02,179688,Klosterman; Jeremy K,8,0,24,16
1681923359691,CHEM 43A,A03,179689,Klosterman; Jeremy K,19,0,24,5
1681923359691,CHEM 43A,A04,179691,Klosterman; Jeremy K,18,0,24,6
1681923360717,CHEM 114A,A01,179693,Stallings; Dontarie M,71,0,100,29
1681923361742,CHEM 143B,A01,179698,Weizman; Haim,16,0,24,8
1681923361742,CHEM 143B,A02,179700,Weizman; Haim,24,0,24,0
1681923362767,CHIN 169A,A00,179701,Wang; Xiao,20,0,20,0
1681923363789,COGS 2,A01,179750,Boyle; Mary E. T.,17,0,30,13
1681923364818,COGS 9,A01,179759,Jones; Cameron Robert,42,0,50,8
1681923365844,COGS 14A,A01,179854,Staff,15,0,50,35
1681923366867,COGS 14B,A01,179856,Staff,53,0,60,7
1681923367894,COGS 17,A01,179874,Staff,71,0,75,4
1681923368919,COGS 18,A01,179884,Staff,63,0,80,17
1681923369941,COGS 100,A01,179886,Staff,36,0,60,24
1681923370964,COGS 101B,A01,179892,Staff,0,0,30,30
1681923371990,COGS 101C,A01,179894,Staff,28,0,30,2
1681923373014,COGS 107A,A01,179896,Boyle; Mary E. T.,30,0,40,10
1681923374035,COGS 108,A01,179898,Simpkins; Charles Alexander,0,24,60,60
1681923375058,COGS 109,A01,179900,Staff,34,0,40,6
1681923376079,COGS 118A,A01,179946,Staff,8,0,40,32
1681923377101,COGS 153,A00,179978,Staff,0,3,30,30
1681923378133,COGS 156,A01,179981,Staff,24,0,30,6
1681923380185,COGS 172,A01,179987,Staff,13,0,30,17
1681923382233,COGS 186,A01,179991,Staff,12,0,30,18
1681923383262,COMM 10,A01,180001,Staff,14,0,25,11
1681923383262,COMM 10,A02,180004,Staff,20,0,25,5
1681923384288,COMM 100A,A01,180016,Staff,15,0,25,10
1681923384288,COMM 100A,A02,180020,Staff,24,0,25,1
1681923385315,COMM 101T,A00,180029,Halm; Gavin Patrick,22,0,35,13
1681923386350,COMM 106V,A00,180043,Staff,34,0,35,1
1681923387372,COMM 109P,A00,180044,Staff,30,0,35,5
1681923388394,COMM 113T,A00,180045,Havis; Allan,37,0,45,8
1681923389418,COMM 132,A00,180046,McKenna; Denise,23,0,30,7
1681923390441,COMM 143,A00,180047,Staff,18,0,30,12
1681923391475,COMM 190,A00,180048,Conner; Thomas Hartnell,18,0,23,5
1681923392509,CSE 8A,A50,180053,Cao; Yingjun,23,0,50,27
1681923392509,CSE 8A,B50,180180,Staff,50,0,50,0
1681923393535,CSE 11,A01,180190,Cao; Yingjun,26,0,50,24
1681923394561,CSE 20,A01,180192,Briones; Jor-el Thomas Caparas,22,0,30,8
1681923395590,CSE 21,A01,194538,Briones; Jor-el Thomas Caparas,50,0,60,10
1681923396612,CSE 30,A01,180324,Eldon; John,76,0,100,24
1681923397647,CSE 101,A01,201353,Staff,0,25,40,40
1681923398670,CSE 134B,A01,180326,Powell; Thomas Allan,74,0,100,26
1681923399692,CSE 140,A01,180328,Staff,41,0,75,34
1681923400717,CSE 140L,A01,180344,Eldon; John,64,0,100,36
1681923401753,CSE 150A,A01,180411,Staff,0,13,50,50
1681923402786,CSE 151A,A01,180414,Staff,0,8,50,50
1681923403811,CSE 175,A01,222521,Kumar; Rakesh,50,0,50,0
1681923404833,CSE 190,A00,201419,Staff,44,0,49,5
1681923405858,CSS 1,A01,194536,Staff,37,0,50,13
1681923406883,DSC 30,A01,202385,Staff,48,0,50,2
1681923407907,DSC 40A,A01,202387,Albuyeh; Rod,50,0,50,0
1681923408930,DSC 190,A01,202389,Silberman; Jack,21,0,21,0
1681923409953,DSGN 100,A01,179993,Staff,15,0,30,15
1681923410975,ECE 65,A50,180708,Staff,10,0,20,10
1681923410975,ECE 65,A51,180739,Staff,19,0,20,1
1681923412001,ECON 1,A01,180427,Famulari; Melissa,67,0,70,3
1681923413027,ECON 2,A01,180450,Levkoff; Steven B.,64,0,70,6
1681923414051,ECON 4,A01,203351,Anderson; John Charles,6,0,10,4
1681923415078,ECON 100A,A01,180472,Famulari; Melissa,62,0,70,8
1681923416103,ECON 120A,A01,180549,Staff,63,0,70,7
1681923417126,ECON 120B,A01,180655,Ma; Xinwei,43,0,70,27
1681923418153,ECON 129,A00,203333,Eckert; Fabian Paul,13,0,35,22
1681923419177,ECON 131,A00,180656,Staff,5,0,35,30
1681923420199,ECON 172B,A01,180672,Levkoff; Steven B.,31,0,35,4
1681923421223,ECON 178,A01,203342,Zhu; Ying,9,0,35,26
1681923422245,EDS 108GS,A00,202383,Wishard Guerra; Alison G.,20,0,20,0
1681923423266,EDS 111GS,A00,202347,Wishard Guerra; Alison G.,20,0,20,0
1681923424289,EDS 112,A01,202323,Staff,55,0,60,5
1681923425314,EDS 113,A00,202340,Staff,32,0,35,3
1681923426337,EDS 118,A00,201231,Staff,20,0,30,10
1681923427361,EDS 119,A00,204994,Staff,8,0,10,2
1681923428385,EDS 124BR,A00,202324,Eguchi; Emi,1,0,25,24
1681923429409,EDS 126,A01,203208,Jones; Makeba,26,0,30,4
1681923430507,EDS 135,A01,202333,Staff,18,0,20,2
1681923431531,EDS 180,A00,202311,Staff,47,0,50,3
1681923432562,ERC 190GS,A01,253747,Staff,28,0,28,0
1681923433594,ETHN 104,A00,180742,Staff,22,0,35,13
1681923434620,ETHN 118,A00,180745,Staff,27,0,35,8
1681923435645,ETHN 127,A00,180747,Staff,11,0,16,5
1681923436667,ETHN 137,A00,180880,Staff,11,0,12,1
1681923437700,ETHN 147,A00,180890,Staff,8,0,10,2
1681923438727,ETHN 154,A00,180891,Staff,7,0,8,1
1681923439757,ETHN 168,A00,180892,Staff,9,0,10,1
1681923440782,GLBH 20,A00,201051,Hannah; Seth Donal,0,3,0,1
1681923441805,GLBH 111,A01,209338,Burgos; Jose L.,0,0,0,0
1681923442831,GLBH 150,A00,258300,Staff,0,3,0,0
1681923443856,GLBH 181,A00,201207,Staff,12,0,40,28
1681923444878,HIEU 109,A00,180898,Staff,19,0,20,1
1681923445904,HIEU 111,A00,180899,Staff,0,1,20,20
1681923446929,HIEU 124,A00,180900,Staff,17,0,20,3
1681923447952,HILA 122,A00,180901,Staff,18,0,20,2
1681923448975,HILA 132,A00,180902,Vitz; Matthew,1,0,20,19
1681923449998,HILD 10,A01,180896,Staff,14,0,20,6
1681923451022,HILD 30GS,A00,180897,Edington; Claire Ellen,0,0,0,0
1681923452046,HISC 105,A00,180903,Staff,20,0,20,0
1681923453070,HISC 117,A00,180904,Staff,10,0,20,10
1681923454097,HIUS 108B,A00,181005,Staff,18,0,20,2
1681923455121,HIUS 113,A00,181093,Staff,1,0,20,19
1681923456143,HUM 3,A01,181190,Patterson; Patrick H.,38,0,50,12
1681923456143,HUM 3,B01,181195,Staff,46,0,50,4
1681923457174,HUM 3GS,A00,181196,Herbst; Matthew,0,0,0,0
1681923458201,HUM 4,A01,181227,West; Geoffrey Scott,33,0,50,17
1681923458201,HUM 4,B01,181282,Staff,41,0,50,9
1681923459223,HUM 4GS,A00,181377,Lyon; Antony J.,0,0,0,0
1681923460251,HUM 5,A01,181536,Zavodny; Tatiana Sophia,28,0,50,22
1681923460251,HUM 5,B01,181908,Staff,35,0,50,15
1681923461276,INTL 190,A00,181909,Segui; Alan S,0,0,0,8
1681923461276,INTL 190,B00,181961,Segui; Alan S,0,0,0,7
1681923462302,JAPN 20AR,A01,182113,Ross; Kayoko F,15,0,20,5
1681923463335,LATI 50,A01,202391,Martin-Cabrera; Luis,18,0,30,12
1681923463335,LATI 50,A02,202392,Martin-Cabrera; Luis,26,0,30,4
1681923464357,LATI 180,A00,202393,Kokinis; Troy Andreas,24,0,25,1
1681923465380,LIFR 1A,A00,182119,Staff,14,0,14,0
1681923466407,LIFR 1AX,A00,182324,Staff,14,0,14,0
1681923467432,LIFR 1B,A00,182259,Staff,13,0,14,1
1681923468461,LIFR 1BX,A00,182273,Staff,13,0,14,1
1681923469484,LIGN 8,A00,182330,Staff,132,0,150,18
1681923470514,LIGN 9GS,A00,182362,Staff,20,0,20,0
1681923471537,LIGN 119,A00,204992,Takahashi; Maho,12,0,15,3
1681923472560,LIGN 130,A01,182384,Staff,47,0,50,3
1681923473584,LIGN 149GS,A00,182390,Staff,20,0,20,0
1681923474607,LIGN 170,A00,182404,Staff,23,0,30,7
1681923475634,LISP 1D,A00,182281,Staff,7,0,14,7
1681923475634,LISP 1D,B00,182287,Staff,13,0,14,1
1681923475634,LISP 1D,C00,182295,Staff,11,0,14,3
1681923475634,LISP 1D,D00,182301,Staff,14,0,14,0
1681923476658,LISP 1DX,A00,182309,Staff,19,0,28,9
1681923476658,LISP 1DX,B00,182316,Staff,26,0,28,2
1681923477682,LTAF 120GS,A00,182412,Zhiri; Oumelbanine,20,0,20,0
1681923478705,LTCS 172GS,A00,182437,Bronstein; Phoebe Malan,20,0,20,0
1681923479731,LTEA 138,A00,182457,Staff,20,0,40,20
1681923480764,LTEN 114,A01,182490,Staff,23,0,25,2
1681923481787,LTEN 130GS,A00,182491,Lyon; Antony J.,20,0,20,0
1681923482814,LTEN 169,A00,182493,Cuong; Marisol,19,0,25,6
1681923483844,LTEN 178,A00,182501,Staff,14,0,15,1
1681923484869,LTEN 181,A00,182515,Staff,21,0,25,4
1681923485895,LTEN 185GS,A00,197655,Forbes; Camille,20,0,20,0
1681923486920,LTSP 100B,A00,202208,Bessett; Ryan Matthew,24,0,25,1
1681923487945,LTWL 100,A00,182516,Myerston Santana; Jacobo,21,0,30,9
1681923488966,LTWR 100GS,A00,182518,Forbes; Camille,20,0,20,0
1681923489992,LTWR 102,A00,182522,Staff,15,0,15,0
1681923489992,LTWR 102,B00,182525,Staff,14,0,15,1
1681923491025,LTWR 115,A00,182526,Staff,11,0,15,4
1681923492053,MAE 8,A01,182528,Pham; Hieu Tan,67,0,70,3
1681923493077,MAE 11,A00,182529,Bahadori; Mohammad Yousef,93,0,100,7
1681923494103,MAE 20,A00,182530,Evdokimenko; Ekaterina,68,0,70,2
1681923495126,MAE 30A,A00,182532,Staff,44,0,45,1
1681923496151,MAE 101A,A00,182533,Bahadori; Mohammad Yousef,95,0,100,5
1681923497179,MAE 101C,A00,182538,Staff,62,0,70,8
1681923498203,MAE 104,A00,182539,Staff,44,0,50,6
1681923499230,MAE 131A,A00,182540,Ghazinejad; Maziar,40,0,45,5
1681923500269,MAE 143A,A00,182548,Bewley; Thomas R,43,0,50,7
1681923501295,MAE 150,A00,182549,Staff,28,0,40,12
1681923502317,MAE 160,A00,182550,Evdokimenko; Ekaterina,41,0,60,19
1681923503341,MATH 3C,A01,182725,Staff,25,0,30,5
1681923504366,MATH 10A,A01,182729,Staff,25,0,30,5
1681923504366,MATH 10A,B01,182732,Staff,26,0,30,4
1681923505389,MATH 10B,A01,182737,Staff,21,0,30,9
1681923505389,MATH 10B,A02,182738,Staff,26,0,30,4
1681923505389,MATH 10B,B01,182744,Staff,27,0,30,3
1681923505389,MATH 10B,B02,182745,Staff,27,0,30,3
1681923506420,MATH 18,A01,182750,Anzaldo; Leesa B,28,0,30,2
1681923506420,MATH 18,A02,182751,Anzaldo; Leesa B,29,0,30,1
1681923506420,MATH 18,A03,182753,Anzaldo; Leesa B,27,0,30,3
1681923506420,MATH 18,A04,182757,Anzaldo; Leesa B,29,0,30,1
1681923506420,MATH 18,B01,182761,Anzaldo; Leesa B,27,0,30,3
1681923506420,MATH 18,B02,182764,Anzaldo; Leesa B,26,0,30,4
1681923506420,MATH 18,B03,182765,Anzaldo; Leesa B,29,0,30,1
1681923506420,MATH 18,B04,182766,Anzaldo; Leesa B,30,0,30,0
1681923507447,MATH 20A,A01,182771,Suk; Andrew Hoon,28,0,30,2
1681923508470,MATH 20B,A01,182775,Bach; Quang Tran,30,0,30,0
1681923508470,MATH 20B,A02,182777,Bach; Quang Tran,29,0,30,1
1681923508470,MATH 20B,B01,182780,Bach; Quang Tran,26,0,30,4
1681923508470,MATH 20B,B02,182782,Bach; Quang Tran,30,0,30,0
1681923509492,MATH 20C,A01,182787,Staff,25,0,30,5
1681923509492,MATH 20C,A02,182790,Staff,29,0,30,1
1681923509492,MATH 20C,B01,182792,Staff,25,0,30,5
1681923509492,MATH 20C,B02,182796,Staff,26,0,30,4
1681923510518,MATH 20D,A01,182799,Staff,28,0,30,2
1681923510518,MATH 20D,A02,182802,Staff,29,0,30,1
1681923510518,MATH 20D,A03,182803,Staff,30,0,30,0
1681923511541,MATH 20E,A01,182809,Verstraete; Jacques Allan,23,0,30,7
1681923511541,MATH 20E,A02,182811,Verstraete; Jacques Allan,28,0,30,2
1681923511541,MATH 20E,B01,182814,Verstraete; Jacques Allan,22,0,30,8
1681923511541,MATH 20E,B02,182815,Verstraete; Jacques Allan,30,0,30,0
1681923512563,MATH 103A,A01,182820,Staff,8,0,30,22
1681923512563,MATH 103A,A02,182821,Staff,27,0,30,3
1681923512563,MATH 103A,A03,182822,Staff,23,0,30,7
1681923512563,MATH 103A,B01,182825,Staff,23,0,30,7
1681923512563,MATH 103A,B02,182826,Staff,30,0,30,0
1681923512563,MATH 103A,B03,182830,Staff,30,0,30,0
1681923513610,MATH 109,A01,182836,Chow; Bennett,24,0,30,6
1681923513610,MATH 109,A02,182838,Chow; Bennett,29,0,30,1
1681923513610,MATH 109,A03,182894,Chow; Bennett,29,0,30,1
1681923513610,MATH 109,B01,182908,Chow; Bennett,27,0,30,3
1681923513610,MATH 109,B02,182909,Chow; Bennett,30,0,30,0
1681923513610,MATH 109,B03,182910,Chow; Bennett,26,0,30,4
1681923514633,MATH 142A,A01,182925,Staff,8,0,30,22
1681923514633,MATH 142A,A02,182935,Staff,24,0,30,6
1681923514633,MATH 142A,A03,182967,Staff,26,0,30,4
1681923514633,MATH 142A,B01,183125,Staff,22,0,30,8
1681923514633,MATH 142A,B02,183157,Staff,28,0,30,2
1681923514633,MATH 142A,B03,183158,Staff,29,0,30,1
1681923515657,MATH 183,A01,183160,Arias-Castro; Ery,23,0,30,7
1681923515657,MATH 183,A02,183161,Arias-Castro; Ery,29,0,30,1
1681923515657,MATH 183,B01,183163,Arias-Castro; Ery,28,0,30,2
1681923515657,MATH 183,B02,183164,Arias-Castro; Ery,28,0,30,2
1681923516681,MATH 193A,A01,183167,Staff,1,0,35,34
1681923516681,MATH 193A,A02,183168,Staff,28,0,35,7
1681923516681,MATH 193A,A03,183169,Staff,34,0,35,1
1681923516681,MATH 193A,A04,183170,Staff,27,0,35,8
1681923517705,MGT 4,A01,202395,Anderson; John Charles,75,0,80,5
1681923518745,MGT 5,A00,202396,Houskeeper; Robert,79,0,90,11
1681923519770,MGT 103,A00,202397,Eberhard; Craig A,49,0,90,41
1681923520792,MGT 131A,A00,202398,Houskeeper; Robert,83,0,90,7
1681923521815,MGT 135,A00,202399,Anderson; John Charles,81,0,90,9
1681923522840,MGT 162R,A00,202403,Gneezy; Uri,137,0,200,63
1681923523863,MGT 172,A00,202404,Hedges; Kathleen,40,0,90,50
1681923524886,MGT 181,A00,202405,Dunn; Louis Jean,80,0,90,10
1681923525915,MMW 14,A01,183200,Staff,10,0,28,18
1681923525915,MMW 14,A02,183201,Staff,26,0,28,2
1681923525915,MMW 14,A03,183202,Staff,24,0,28,4
1681923525915,MMW 14,A04,183203,Staff,25,0,28,3
1681923525915,MMW 14,A05,183204,Staff,26,0,28,2
1681923525915,MMW 14,A06,183205,Staff,27,0,28,1
1681923525915,MMW 14,B01,183207,Staff,26,0,28,2
1681923525915,MMW 14,B02,183208,Staff,28,0,28,0
1681923525915,MMW 14,B03,183209,Staff,28,0,28,0
1681923525915,MMW 14,B04,183210,Staff,28,0,28,0
1681923525915,MMW 14,B05,183211,Staff,28,0,28,0
1681923525915,MMW 14,B06,183212,Staff,27,0,28,1
1681923526944,MMW 14GS,A00,183213,Zhiri; Oumelbanine,28,0,28,0
1681923527984,MMW 15GS,B00,183215,Rahimi; Babak,28,0,28,0
1681923529011,MMW 121,A01,183217,Patterson; Patrick H.,12,0,28,16
1681923529011,MMW 121,A02,183218,Patterson; Patrick H.,25,0,28,3
1681923530037,MUS 1A,A01,182554,Staff,4,0,35,31
1681923531064,MUS 5,A01,182558,Staff,17,0,35,18
1681923532088,MUS 6,A01,182562,Staff,22,0,35,13
1681923533115,MUS 8GS,A00,182563,Borgo; David Garcia,25,0,25,0
1681923534235,MUS 13,A01,182567,Staff,24,0,25,1
1681923535276,MUS 15,A01,182570,Staff,32,0,35,3
1681923535276,MUS 15,B01,182575,Staff,9,0,35,26
1681923536300,MUS 80,A00,182578,Staff,22,0,25,3
1681923536300,MUS 80,B00,182581,Staff,20,0,25,5
1681923537328,MUS 113,A00,182582,Staff,25,0,25,0
1681923538352,MUS 114,A00,182583,Staff,3,0,25,22
1681923539376,MUS 150GS,A01,182588,Borgo; David Garcia,25,0,25,0
1681923540402,PHIL 1,A00,182590,Staff,35,0,40,5
1681923541426,PHIL 10,A01,182596,Grush; Rick Scott,31,0,35,4
1681923541426,PHIL 10,A02,182597,Grush; Rick Scott,34,0,35,1
1681923542450,PHIL 15,A01,182601,Staff,31,0,35,4
1681923542450,PHIL 15,A02,182602,Staff,33,0,35,2
1681923543474,PHIL 27,A01,182604,Staff,30,0,35,5
1681923543474,PHIL 27,A02,182607,Staff,35,0,35,0
1681923544498,PHIL 32,A01,182609,Staff,35,0,35,0
1681923544498,PHIL 32,A02,182612,Staff,35,0,35,0
1681923545546,PHIL 130,A00,182614,Staff,62,0,70,8
1681923546576,PHIL 136,A00,182616,Cohen; Jonathan David,66,0,70,4
1681923547603,PHIL 155,A00,182617,Vargas; Manuel Rogelio,58,0,70,12
1681923548627,PHIL 163,A01,182620,Staff,15,0,20,5
1681923548627,PHIL 163,A02,182624,Staff,10,0,20,10
1681923549650,PHIL 164,A00,182627,Staff,29,0,40,11
1681923550673,PHIL 173,A00,182628,Staff,36,0,40,4
1681923551695,PHYS 1A,A00,183221,Staff,54,0,60,6
1681923552720,PHYS 1AL,001,183222,Staff,25,0,30,5
1681923552720,PHYS 1AL,002,183223,Staff,28,0,30,2
1681923553742,PHYS 1B,A00,183231,Staff,43,0,60,17
1681923554768,PHYS 1BL,001,183232,Staff,20,0,30,10
1681923554768,PHYS 1BL,002,183233,Staff,27,0,30,3
1681923555790,PHYS 1C,A00,183240,Staff,25,0,60,35
1681923556816,PHYS 1CL,001,183241,Staff,10,0,30,20
1681923556816,PHYS 1CL,002,183242,Staff,22,0,30,8
1681923557848,PHYS 2AR,A01,183250,Staff,43,0,50,7
1681923558871,PHYS 2B,A01,183252,Staff,104,0,115,11
1681923559901,PHYS 2BL,A01,183254,Staff,21,0,24,3
1681923559901,PHYS 2BL,A02,183255,Staff,22,0,24,2
1681923560929,PHYS 2C,A01,183522,Staff,103,0,115,12
1681923561953,PHYS 4A,A01,183524,Staff,49,0,50,1
1681923562976,POLI 5,A00,183525,Staff,44,0,50,6
1681923564002,POLI 12,A00,183540,Staff,45,0,50,5
1681923565029,POLI 13R,A00,183541,Forman; Fonna,41,0,50,9
1681923566058,POLI 30,A00,183542,Mignozzetti; Umberto,48,0,50,2
1681923567087,POLI 100A,A00,183543,Staff,45,0,50,5
1681923568110,POLI 100E,A00,223598,Staff,32,0,35,3
1681923569144,POLI 103A,A00,183564,Kousser; Thad,37,0,50,13
1681923570169,POLI 104B,A00,201329,Staff,28,0,35,7
1681923571191,POLI 113BR,A00,183576,Hoston; Germaine,24,0,50,26
1681923572217,POLI 114BR,A00,183588,Staff,27,0,30,3
1681923573242,POLI 117R,A00,183595,Forman; Fonna,5,0,20,15
1681923574264,POLI 120H,A00,183596,Fisk; David Lee,13,0,20,7
1681923575286,POLI 130AA,A00,183597,Staff,13,0,20,7
1681923576310,POLI 134AA,A00,183598,Staff,19,0,20,1
1681923577333,POLI 135,A00,183599,Fisk; David Lee,19,0,25,6
1681923578356,POLI 142P,A00,183623,Staff,37,0,40,3
1681923579379,POLI 144D,A00,183624,Staff,22,0,25,3
1681923580404,POLI 151,A00,183625,Staff,15,0,20,5
1681923581431,POLI 162,A00,183626,Mignozzetti; Umberto,17,0,20,3
1681923582455,PSYC 1,A00,253748,Staff,86,0,90,4
1681923583479,PSYC 2,A00,183627,Moranton; Nirelia Melbina-,24,0,35,11
1681923584506,PSYC 3,A00,183628,Staff,43,0,45,2
1681923586556,PSYC 60,A01,183631,Lowe; Angela Beth,35,0,40,5
1681923587586,PSYC 70,A01,253757,Staff,37,0,45,8
1681923588613,PSYC 101,A00,183632,Heyman; Gail D.,46,0,60,14
1681923589640,PSYC 105,A00,183848,Lowe; Angela Beth,47,0,60,13
1681923590667,PSYC 106,A00,183849,Dobkins; Karen R.,42,0,60,18
1681923591689,PSYC 108,A00,253750,Staff,21,0,60,39
1681923592711,PSYC 114,A01,184275,Winkielman; Piotr,0,7,30,30
1681923593745,PSYC 122,A00,183856,Moranton; Nirelia Melbina-,0,15,30,30
1681923594794,PSYC 124,A00,183865,Chapman; Eddie Nathaniel,49,0,80,31
1681923595817,PSYC 137,A00,183880,Staff,19,0,25,6
1681923597872,PSYC 154,A00,183910,Lacefield; Katharine I,0,16,90,90
1681923599926,PSYC 162,A00,183946,Wixted; John T,53,0,90,37
1681923600953,PSYC 172,A00,183947,Gorman; Michael R.,10,0,30,20
1681923601981,PSYC 178,A00,183963,Glaser; Dale,17,0,40,23
1681923603003,PSYC 181GS,A00,183964,Anagnostaras; Stephan,10,0,10,0
1681923604025,PSYC 186GS,A01,257660,Staff,10,0,10,0
1681923605056,PSYC 193,B00,253749,Staff,23,0,25,2
1681923607141,PSYC 193L,A01,184122,Staff,33,0,35,2
1681923607141,PSYC 193L,C01,184167,Winkielman; Piotr,14,0,30,16
1681923608195,RELI 188GS,A00,182629,Rahimi; Babak,20,0,20,0
1681923609227,SE 101A,A00,182646,Staff,26,0,30,4
1681923610254,SE 101C,A00,182650,Staff,17,0,20,3
1681923611276,SE 110A,A00,182651,Staff,28,0,28,0
1681923612298,SE 130A,A00,182652,Staff,38,0,40,2
1681923613320,SIO 46GS,A00,182636,Cook; Geoffrey W,25,0,28,3
1681923614345,SIO 109R,A00,194459,Staff,3,0,20,17
1681923615376,SIO 121GS,A00,182639,Cook; Geoffrey W,25,0,28,3
1681923616399,SIO 132,A01,182642,Staff,32,0,40,8
1681923617425,SIO 139,A00,182644,Kacev; David,36,0,40,4
1681923618449,SOCI 2,A01,258404,Staff,33,0,36,3
1681923618449,SOCI 2,A02,258405,Staff,35,0,36,1
1681923619477,SOCI 60,A01,258408,Staff,29,0,30,1
1681923619477,SOCI 60,A02,258413,Staff,30,0,30,0
1681923620503,SOCI 100,A01,258415,Staff,29,0,30,1
1681923620503,SOCI 100,A02,258416,Staff,28,0,30,2
1681923626679,SOCI 127,A00,258421,Staff,21,0,30,9
1681923627701,SOCI 132,A00,258422,Staff,45,0,50,5
1681923628731,SOCI 133,A00,258423,Staff,26,0,30,4
1681923629759,SOCI 138GS,A00,258424,Staff,15,0,15,0
1681923630785,SOCI 145,A00,258425,Staff,25,0,30,5
1681923631807,SOCI 148,A00,258426,Staff,24,0,30,6
1681923632834,SOCI 153,A00,199217,Staff,29,0,30,1
1681923633865,SOCI 160,A00,258427,Staff,28,0,30,2
1681923634887,SOCI 160E,A00,258435,Staff,56,0,60,4
1681923635918,SOCI 189GS,A00,258436,Staff,15,0,15,0
1681923636948,SOCI 190GS,A00,258437,Staff,15,0,15,0
1681923638058,SYN 2,001,182658,Staff,8,0,16,8
1681923638058,SYN 2,002,201439,Staff,14,0,16,2
1681923638058,SYN 2,003,201443,Staff,16,0,16,0
1681923639082,SYN 100,A01,182657,Staff,16,0,20,4
1681923640113,TDAC 1,A00,184381,Salovey; Todd,16,0,20,4
1681923640113,TDAC 1,B00,184385,Harting; Carla Kelso,19,0,20,1
1681923640113,TDAC 1,C00,184394,Staff,19,0,20,1
1681923641137,TDAC 101,A00,184483,Harting; Carla Kelso,19,0,20,1
1681923642165,TDDE 111,A00,184496,Staff,14,0,15,1
1681923643188,TDDE 131,A00,184504,Staff,20,0,20,0
1681923643188,TDDE 131,B00,184505,Staff,17,0,18,1
1681923643188,TDDE 131,C00,184534,Staff,49,0,50,1
1681923643188,TDDE 131,D00,184564,Staff,15,0,15,0
1681923643188,TDDE 131,E00,204725,Staff,19,0,20,1
1681923644214,TDGE 1,A01,184414,Salovey; Todd,36,0,50,14
1681923645236,TDGE 5,A01,184419,Staff,23,0,24,1
1681923646260,TDGE 10,A00,184428,Fulton; Julia,29,0,50,21
1681923647283,TDGE 124,A00,184565,Fulton; Julia,4,0,50,46
1681923648305,TDGE 125,B00,184567,Meyer; Ursula,9,0,25,16
1681923649331,TDHT 101,A00,184568,Staff,21,0,25,4
1681923649331,TDHT 101,B00,184569,Staff,20,0,20,0
1681923650353,TDHT 114,A00,184570,Staff,49,0,50,1
1681923651377,TDMV 1,A00,184437,Arcidiacono; Kristin,22,0,30,8
1681923651377,TDMV 1,B00,184448,Caligagan; Maria T.,23,0,30,7
1681923652404,TDMV 2,A00,184449,Weinberg; Sadie,27,0,30,3
1681923652404,TDMV 2,B00,184453,Arcidiacono; Kristin,29,0,30,1
1681923653435,TDMV 110,A00,184571,Weinberg; Sadie,30,0,30,0
1681923654457,TDMV 142,A00,184572,Caligagan; Tony,27,0,30,3
1681923654457,TDMV 142,B00,184573,Caligagan; Maria T.,26,0,30,4
1681923655486,TDTR 20,A00,184482,Jun; Grace Shin Hae,25,0,25,0
1681923656512,USP 2,A01,184290,Hinds; Juli Beth,24,0,25,1
1681923657535,USP 3,A01,184295,Staff,21,0,25,4
1681923658558,USP 4,A00,184304,McTague; Sarah,13,0,25,12
1681923659581,USP 100,A00,184315,Staff,16,0,25,9
1681923660609,USP 105,A00,184326,Staff,21,0,25,4
1681923661638,USP 151,A00,184327,Staff,20,0,25,5
1681923662661,USP 170,A00,184380,Hinds; Juli Beth,13,0,25,12
1681923663699,VIS 21B,A01,182660,Staff,28,0,31,3
1681923663699,VIS 21B,A02,182662,Staff,30,0,31,1
1681923664733,VIS 103D,A00,182663,Staff,74,0,75,1
1681923665755,VIS 105D,A00,182667,Li; Huai,14,0,22,8
1681923666785,VIS 122GS,A00,182668,Herbst; Matthew,20,0,20,0
1681923667816,VIS 128C,A00,182673,Staff,69,0,75,6
1681923668842,VIS 130,A00,182675,Staff,19,0,22,3
1681923669870,VIS 160A,A00,182678,Stalbaum; Brett,4,0,10,6
1681923671919,WCWP 10B,A00,201679,Staff,15,0,15,0
1681923671919,WCWP 10B,B00,201695,Staff,15,0,15,0
1681923672945,WCWP 100,A00,201716,Staff,12,0,15,3
1681923672945,WCWP 100,B00,201717,Staff,5,0,15,10
1681923675017,ANSC 105GS,A00,258289,Staff,0,0,0,0
1681923676047,ANSC 125GS,A00,258295,Staff,0,0,0,0
1681923677070,ANSC 150,A00,258267,Staff,30,0,40,10
1681923678094,ANSC 190GS,A00,258280,Staff,0,0,0,0
1681923679117,ANTH 1,A00,258264,Staff,38,0,40,2
1681923680140,ANTH 2,A01,258259,Staff,72,0,76,4
1681923681173,ANTH 23,A01,258228,Staff,36,0,40,4
1681923682198,ANTH 101,A01,258236,Staff,38,0,40,2
1681923683225,ANTH 102,A00,258272,Staff,59,0,60,1
1681923684250,ANTH 105,A00,258244,Staff,31,0,35,4
1681923685274,BENG 130,A00,253975,Staff,38,0,40,2
1681923686298,BIBC 102,A01,191866,Flagg; Matthew Paul,19,0,32,13
1681923686298,BIBC 102,A02,191867,Flagg; Matthew Paul,22,0,32,10
1681923686298,BIBC 102,A03,191868,Flagg; Matthew Paul,29,0,32,3
1681923686298,BIBC 102,A04,191936,Flagg; Matthew Paul,26,0,32,6
1681923686298,BIBC 102,A05,191937,Flagg; Matthew Paul,2,0,32,30
1681923687324,BICD 100,A01,191939,Cooper; Andrew Michael,28,0,32,4
1681923687324,BICD 100,A02,191940,Cooper; Andrew Michael,32,0,32,0
1681923687324,BICD 100,A03,191941,Cooper; Andrew Michael,32,0,32,0
1681923687324,BICD 100,A04,191942,Cooper; Andrew Michael,32,0,32,0
1681923687324,BICD 100,A05,191943,Cooper; Andrew Michael,32,0,32,0
1681923688352,BIEB 126,A01,191945,Cleland; Elsa Eleanor,0,1,32,32
1681923688352,BIEB 126,A02,191946,Cleland; Elsa Eleanor,27,0,32,5
1681923688352,BIEB 126,A03,191947,Cleland; Elsa Eleanor,29,0,32,3
1681923688352,BIEB 126,A04,191948,Cleland; Elsa Eleanor,23,0,32,9
1681923688352,BIEB 126,A05,191996,Cleland; Elsa Eleanor,28,0,32,4
1681923689379,BIEB 136GS,A00,191997,Shurin; Jonathan & Holway; David A.,0,0,0,4
1681923690405,BIEB 137GS,A01,191999,Shurin; Jonathan & Holway; David A.,0,0,0,3
1681923691434,BILD 1,A01,205385,Staff,31,0,32,1
1681923691434,BILD 1,A02,205386,Staff,30,0,32,2
1681923691434,BILD 1,A03,205387,Staff,32,0,32,0
1681923691434,BILD 1,A04,205388,Staff,27,0,32,5
1681923692456,BILD 2,A01,191774,Staff,28,0,32,4
1681923692456,BILD 2,A02,191775,Staff,30,0,32,2
1681923692456,BILD 2,A03,191777,Staff,30,0,32,2
1681923692456,BILD 2,A04,191856,Staff,31,0,32,1
1681923692456,BILD 2,A05,191857,Staff,32,0,32,0
1681923692456,BILD 2,A06,191858,Staff,32,0,32,0
1681923692456,BILD 2,A07,191859,Staff,31,0,32,1
1681923693483,BILD 3,A01,205391,Staff,29,0,32,3
1681923693483,BILD 3,A02,205393,Staff,32,0,32,0
1681923693483,BILD 3,A03,205394,Staff,27,0,32,5
1681923693483,BILD 3,A04,205395,Staff,32,0,32,0
1681923694519,BILD 20,A01,191861,Staff,32,0,32,0
1681923694519,BILD 20,A02,191862,Staff,32,0,32,0
1681923695560,BILD 30,A01,191864,Staff,31,0,32,1
1681923696584,BIMM 100,A01,192019,Staff,0,0,32,32
1681923696584,BIMM 100,A02,192020,Staff,19,0,32,13
1681923696584,BIMM 100,A03,192035,Staff,21,0,32,11
1681923697611,BIMM 110,A01,192037,Tat; John,0,0,32,32
1681923697611,BIMM 110,A02,192038,Tat; John,8,0,32,24
1681923698633,BIMM 120,A01,192040,Pickett; Brooke Elizabeth,0,0,32,32
1681923698633,BIMM 120,A02,192041,Pickett; Brooke Elizabeth,15,0,32,17
1681923698633,BIMM 120,A03,192042,Pickett; Brooke Elizabeth,15,0,32,17
1681923699660,BIPN 100,A01,192044,Armour; Jon Christopher,23,0,32,9
1681923699660,BIPN 100,A02,192059,Armour; Jon Christopher,30,0,32,2
1681923699660,BIPN 100,A03,192064,Armour; Jon Christopher,30,0,32,2
1681923699660,BIPN 100,A04,192073,Armour; Jon Christopher,28,0,32,4
1681923700683,BIPN 148,A01,205411,Leutgeb; Jill K.,15,0,32,17
1681923700683,BIPN 148,A02,205412,Leutgeb; Jill K.,31,0,32,1
1681923700683,BIPN 148,A03,205413,Leutgeb; Jill K.,30,0,32,2
1681923700683,BIPN 148,A04,205414,Leutgeb; Jill K.,30,0,32,2
1681923701714,BIPN 160,A01,192115,Marino; Marc J,16,0,32,16
1681923701714,BIPN 160,A02,192148,Marino; Marc J,27,0,32,5
1681923701714,BIPN 160,A03,192158,Marino; Marc J,31,0,32,1
1681923701714,BIPN 160,A04,192190,Marino; Marc J,32,0,32,0
1681923701714,BIPN 160,A05,192287,Marino; Marc J,32,0,32,0
1681923701714,BIPN 160,A06,192288,Marino; Marc J,32,0,32,0
1681923702735,BIPN 194,A00,206038,Staff,28,0,32,4
1681923703757,BISP 194,A00,192289,Leutgeb; Stefan,13,0,32,19
1681923703757,BISP 194,B00,245332,Nieh; James Charles,26,0,32,6
1681923704787,CAT 124,A01,202247,Staff,15,0,15,0
1681923705813,CAT 125,A00,202248,Staff,19,0,20,1
1681923705813,CAT 125,B00,202253,Staff,20,0,20,0
1681923705813,CAT 125,C00,202257,Staff,18,0,20,2
1681923706847,CAT 125GS,A01,202273,Bronstein; Phoebe Malan,20,0,20,0
1681923707880,CAT 125R,A00,202284,Staff,18,0,20,2
1681923707880,CAT 125R,C00,202286,Staff,9,0,20,11
1681923707880,CAT 125R,D00,202291,Staff,17,0,20,3
1681923707880,CAT 125R,E00,202295,Staff,13,0,20,7
1681923707880,CAT 125R,F00,202302,Staff,8,0,20,12
1681923708906,CENG 100,A00,204724,Opatkiewicz; Justin Paul,25,0,25,0
1681923709929,CGS 2A,A01,180420,Staff,31,0,36,5
1681923710955,CGS 101,A00,180421,Staff,16,0,20,4
1681923711978,CGS 112,A00,180422,Staff,9,0,16,7
1681923713002,CGS 113,A00,180423,Staff,18,0,20,2
1681923714023,CGS 137,A00,180424,Staff,12,0,12,0
1681923715047,CGS 147,A00,180425,Staff,10,0,10,0
1681923716071,CHEM 6A,A01,179556,Staff,95,0,100,5
1681923716071,CHEM 6A,A02,179558,Staff,0,0,0,0
1681923717093,CHEM 6B,A01,179560,Staff,100,0,100,0
1681923718124,CHEM 6C,A01,179565,Jazzar; Rodolphe,94,0,100,6
1681923719151,CHEM 7L,A01,179586,Schurmeier; Kimberly,10,0,24,14
1681923719151,CHEM 7L,A02,179587,Schurmeier; Kimberly,23,0,24,1
1681923719151,CHEM 7L,A03,179590,Schurmeier; Kimberly,22,0,24,2
1681923719151,CHEM 7L,A04,179591,Schurmeier; Kimberly,22,0,24,2
1681923719151,CHEM 7L,B01,179598,Schurmeier; Kimberly,16,0,24,8
1681923719151,CHEM 7L,B02,179599,Schurmeier; Kimberly,24,0,24,0
1681923719151,CHEM 7L,B03,179606,Schurmeier; Kimberly,23,0,24,1
1681923719151,CHEM 7L,B04,179607,Schurmeier; Kimberly,23,0,24,1
1681923720178,CHEM 11,A01,179609,Stallings; Dontarie M,87,0,100,13
1681923721200,CHEM 40A,A01,179621,Staff,40,0,50,10
1681923721200,CHEM 40A,A02,179622,Staff,46,0,50,4
1681923722224,CHEM 40B,A01,179630,Weizman; Haim,47,0,50,3
1681923722224,CHEM 40B,A02,179631,Weizman; Haim,44,0,50,6
1681923723246,CHEM 41A,A01,179660,Klosterman; Jeremy K,93,0,100,7
1681923724313,CHEM 43A,A01,179683,Klosterman; Jeremy K,0,0,24,24
1681923724313,CHEM 43A,A02,179688,Klosterman; Jeremy K,8,0,24,16
1681923724313,CHEM 43A,A03,179689,Klosterman; Jeremy K,19,0,24,5
1681923724313,CHEM 43A,A04,179691,Klosterman; Jeremy K,18,0,24,6
1681923725344,CHEM 114A,A01,179693,Stallings; Dontarie M,71,0,100,29
1681923726369,CHEM 143B,A01,179698,Weizman; Haim,16,0,24,8
1681923726369,CHEM 143B,A02,179700,Weizman; Haim,24,0,24,0
1681923727393,CHIN 169A,A00,179701,Wang; Xiao,20,0,20,0
1681923728421,COGS 2,A01,179750,Boyle; Mary E. T.,17,0,30,13
1681923729447,COGS 9,A01,179759,Jones; Cameron Robert,42,0,50,8
1681923730469,COGS 14A,A01,179854,Staff,15,0,50,35
1681923731490,COGS 14B,A01,179856,Staff,53,0,60,7
1681923732520,COGS 17,A01,179874,Staff,71,0,75,4
1681923733549,COGS 18,A01,179884,Staff,63,0,80,17
1681923734570,COGS 100,A01,179886,Staff,36,0,60,24
1681923735592,COGS 101B,A01,179892,Staff,0,0,30,30
1681923736622,COGS 101C,A01,179894,Staff,28,0,30,2
1681923737654,COGS 107A,A01,179896,Boyle; Mary E. T.,30,0,40,10
1681923738703,COGS 108,A01,179898,Simpkins; Charles Alexander,0,24,60,60
1681923739732,COGS 109,A01,179900,Staff,34,0,40,6
1681923740753,COGS 118A,A01,179946,Staff,7,0,40,33
1681923741859,COGS 153,A00,179978,Staff,0,3,30,30
1681923742881,COGS 156,A01,179981,Staff,23,0,30,7
1681923744936,COGS 172,A01,179987,Staff,13,0,30,17
1681923746987,COGS 186,A01,179991,Staff,12,0,30,18
1681923748011,COMM 10,A01,180001,Staff,13,0,25,12
1681923748011,COMM 10,A02,180004,Staff,20,0,25,5
1681923749041,COMM 100A,A01,180016,Staff,15,0,25,10
1681923749041,COMM 100A,A02,180020,Staff,24,0,25,1
1681923750065,COMM 101T,A00,180029,Halm; Gavin Patrick,22,0,35,13
1681923751092,COMM 106V,A00,180043,Staff,34,0,35,1
1681923752171,COMM 109P,A00,180044,Staff,30,0,35,5
1681923753202,COMM 113T,A00,180045,Havis; Allan,37,0,45,8
1681923754224,COMM 132,A00,180046,McKenna; Denise,23,0,30,7
1681923755249,COMM 143,A00,180047,Staff,18,0,30,12
1681923756278,COMM 190,A00,180048,Conner; Thomas Hartnell,18,0,23,5
1681923757301,CSE 8A,A50,180053,Cao; Yingjun,22,0,50,28
1681923757301,CSE 8A,B50,180180,Staff,50,0,50,0
1681923758328,CSE 11,A01,180190,Cao; Yingjun,26,0,50,24
1681923759360,CSE 20,A01,180192,Briones; Jor-el Thomas Caparas,22,0,30,8
1681923760386,CSE 21,A01,194538,Briones; Jor-el Thomas Caparas,50,0,60,10
1681923761408,CSE 30,A01,180324,Eldon; John,75,0,100,25
1681923762434,CSE 101,A01,201353,Staff,0,25,40,40
1681923763461,CSE 134B,A01,180326,Powell; Thomas Allan,74,0,100,26
1681923764485,CSE 140,A01,180328,Staff,40,0,75,35
1681923765511,CSE 140L,A01,180344,Eldon; John,63,0,100,37
1681923766533,CSE 150A,A01,180411,Staff,0,15,50,50
1681923767557,CSE 151A,A01,180414,Staff,0,8,50,50
1681923768583,CSE 175,A01,222521,Kumar; Rakesh,50,0,50,0
1681923769605,CSE 190,A00,201419,Staff,44,0,49,5
1681923770628,CSS 1,A01,194536,Staff,37,0,50,13
1681923771652,DSC 30,A01,202385,Staff,48,0,50,2
1681923772674,DSC 40A,A01,202387,Albuyeh; Rod,50,0,50,0
1681923773699,DSC 190,A01,202389,Silberman; Jack,21,0,21,0
1681923774725,DSGN 100,A01,179993,Staff,15,0,30,15
1681923775761,ECE 65,A50,180708,Staff,10,0,20,10
1681923775761,ECE 65,A51,180739,Staff,19,0,20,1
1681923776784,ECON 1,A01,180427,Famulari; Melissa,67,0,70,3
1681923777806,ECON 2,A01,180450,Levkoff; Steven B.,64,0,70,6
1681923778832,ECON 4,A01,203351,Anderson; John Charles,6,0,10,4
1681923779858,ECON 100A,A01,180472,Famulari; Melissa,62,0,70,8
1681923780884,ECON 120A,A01,180549,Staff,63,0,70,7
1681923781907,ECON 120B,A01,180655,Ma; Xinwei,43,0,70,27
1681923782936,ECON 129,A00,203333,Eckert; Fabian Paul,12,0,35,23
1681923783960,ECON 131,A00,180656,Staff,5,0,35,30
1681923784983,ECON 172B,A01,180672,Levkoff; Steven B.,31,0,35,4
1681923786006,ECON 178,A01,203342,Zhu; Ying,8,0,35,27
1681923787033,EDS 108GS,A00,202383,Wishard Guerra; Alison G.,20,0,20,0
1681923788054,EDS 111GS,A00,202347,Wishard Guerra; Alison G.,20,0,20,0
1681923789080,EDS 112,A01,202323,Staff,55,0,60,5
1681923790104,EDS 113,A00,202340,Staff,32,0,35,3
1681923791126,EDS 118,A00,201231,Staff,20,0,30,10
1681923792151,EDS 119,A00,204994,Staff,8,0,10,2
1681923793176,EDS 124BR,A00,202324,Eguchi; Emi,1,0,25,24
1681923794207,EDS 126,A01,203208,Jones; Makeba,26,0,30,4
1681923795232,EDS 135,A01,202333,Staff,18,0,20,2
1681923796264,EDS 180,A00,202311,Staff,47,0,50,3
1681923797286,ERC 190GS,A01,253747,Staff,28,0,28,0
1681923798308,ETHN 104,A00,180742,Staff,22,0,35,13
1681923799331,ETHN 118,A00,180745,Staff,27,0,35,8
1681923800356,ETHN 127,A00,180747,Staff,11,0,16,5
1681923801378,ETHN 137,A00,180880,Staff,11,0,12,1
1681923802405,ETHN 147,A00,180890,Staff,8,0,10,2
1681923803428,ETHN 154,A00,180891,Staff,7,0,8,1
1681923804451,ETHN 168,A00,180892,Staff,9,0,10,1
1681923805474,GLBH 20,A00,201051,Hannah; Seth Donal,0,3,0,1
1681923806495,GLBH 111,A01,209338,Burgos; Jose L.,0,0,0,0
1681923807521,GLBH 150,A00,258300,Staff,0,3,0,0
1681923808545,GLBH 181,A00,201207,Staff,12,0,40,28
1681923809577,HIEU 109,A00,180898,Staff,19,0,20,1
1681923810599,HIEU 111,A00,180899,Staff,0,1,20,20
1681923811628,HIEU 124,A00,180900,Staff,17,0,20,3
1681923812651,HILA 122,A00,180901,Staff,18,0,20,2
1681923813674,HILA 132,A00,180902,Vitz; Matthew,1,0,20,19
1681923814705,HILD 10,A01,180896,Staff,14,0,20,6
1681923815730,HILD 30GS,A00,180897,Edington; Claire Ellen,0,0,0,0
1681923816754,HISC 105,A00,180903,Staff,20,0,20,0
1681923817777,HISC 117,A00,180904,Staff,10,0,20,10
1681923818816,HIUS 108B,A00,181005,Staff,18,0,20,2
1681923819838,HIUS 113,A00,181093,Staff,1,0,20,19
1681923820860,HUM 3,A01,181190,Patterson; Patrick H.,38,0,50,12
1681923820860,HUM 3,B01,181195,Staff,46,0,50,4
1681923821885,HUM 3GS,A00,181196,Herbst; Matthew,0,0,0,0
1681923822911,HUM 4,A01,181227,West; Geoffrey Scott,33,0,50,17
1681923822911,HUM 4,B01,181282,Staff,41,0,50,9
1681923823935,HUM 4GS,A00,181377,Lyon; Antony J.,0,0,0,0
1681923824965,HUM 5,A01,181536,Zavodny; Tatiana Sophia,28,0,50,22
1681923824965,HUM 5,B01,181908,Staff,35,0,50,15
1681923825996,INTL 190,A00,181909,Segui; Alan S,0,0,0,8
1681923825996,INTL 190,B00,181961,Segui; Alan S,0,0,0,7
1681923827019,JAPN 20AR,A01,182113,Ross; Kayoko F,15,0,20,5
1681923828051,LATI 50,A01,202391,Martin-Cabrera; Luis,17,0,30,13
1681923828051,LATI 50,A02,202392,Martin-Cabrera; Luis,26,0,30,4
1681923829075,LATI 180,A00,202393,Kokinis; Troy Andreas,24,0,25,1
1681923830100,LIFR 1A,A00,182119,Staff,14,0,14,0
1681923831123,LIFR 1AX,A00,182324,Staff,14,0,14,0
1681923832151,LIFR 1B,A00,182259,Staff,13,0,14,1
1681923833177,LIFR 1BX,A00,182273,Staff,13,0,14,1
1681923834202,LIGN 8,A00,182330,Staff,132,0,150,18
1681923835228,LIGN 9GS,A00,182362,Staff,20,0,20,0
1681923836254,LIGN 119,A00,204992,Takahashi; Maho,11,0,15,4
1681923837284,LIGN 130,A01,182384,Staff,47,0,50,3
1681923838306,LIGN 149GS,A00,182390,Staff,20,0,20,0
1681923839337,LIGN 170,A00,182404,Staff,23,0,30,7
1681923840360,LISP 1D,A00,182281,Staff,7,0,14,7
1681923840360,LISP 1D,B00,182287,Staff,13,0,14,1
1681923840360,LISP 1D,C00,182295,Staff,11,0,14,3
1681923840360,LISP 1D,D00,182301,Staff,14,0,14,0
1681923841389,LISP 1DX,A00,182309,Staff,19,0,28,9
1681923841389,LISP 1DX,B00,182316,Staff,26,0,28,2
1681923842415,LTAF 120GS,A00,182412,Zhiri; Oumelbanine,20,0,20,0
1681923843441,LTCS 172GS,A00,182437,Bronstein; Phoebe Malan,20,0,20,0
1681923844471,LTEA 138,A00,182457,Staff,19,0,40,21
1681923845571,LTEN 114,A01,182490,Staff,23,0,25,2
1681923846599,LTEN 130GS,A00,182491,Lyon; Antony J.,20,0,20,0
1681923847625,LTEN 169,A00,182493,Cuong; Marisol,19,0,25,6
1681923848650,LTEN 178,A00,182501,Staff,14,0,15,1
1681923849675,LTEN 181,A00,182515,Staff,21,0,25,4
1681923850697,LTEN 185GS,A00,197655,Forbes; Camille,20,0,20,0
1681923851720,LTSP 100B,A00,202208,Bessett; Ryan Matthew,24,0,25,1
1681923852756,LTWL 100,A00,182516,Myerston Santana; Jacobo,21,0,30,9
1681923853778,LTWR 100GS,A00,182518,Forbes; Camille,20,0,20,0
1681923854801,LTWR 102,A00,182522,Staff,15,0,15,0
1681923854801,LTWR 102,B00,182525,Staff,14,0,15,1
1681923855824,LTWR 115,A00,182526,Staff,11,0,15,4
1681923856852,MAE 8,A01,182528,Pham; Hieu Tan,67,0,70,3
1681923857873,MAE 11,A00,182529,Bahadori; Mohammad Yousef,93,0,100,7
1681923858897,MAE 20,A00,182530,Evdokimenko; Ekaterina,68,0,70,2
1681923859928,MAE 30A,A00,182532,Staff,44,0,45,1
1681923860950,MAE 101A,A00,182533,Bahadori; Mohammad Yousef,95,0,100,5
1681923862054,MAE 101C,A00,182538,Staff,62,0,70,8
1681923863083,MAE 104,A00,182539,Staff,44,0,50,6
1681923864106,MAE 131A,A00,182540,Ghazinejad; Maziar,40,0,45,5
1681923865139,MAE 143A,A00,182548,Bewley; Thomas R,43,0,50,7
1681923866165,MAE 150,A00,182549,Staff,28,0,40,12
1681923867193,MAE 160,A00,182550,Evdokimenko; Ekaterina,41,0,60,19
1681923868227,MATH 3C,A01,182725,Staff,25,0,30,5
1681923869255,MATH 10A,A01,182729,Staff,25,0,30,5
1681923869255,MATH 10A,B01,182732,Staff,25,0,30,5
1681923870278,MATH 10B,A01,182737,Staff,20,0,30,10
1681923870278,MATH 10B,A02,182738,Staff,26,0,30,4
1681923870278,MATH 10B,B01,182744,Staff,27,0,30,3
1681923870278,MATH 10B,B02,182745,Staff,27,0,30,3
1681923871314,MATH 18,A01,182750,Anzaldo; Leesa B,28,0,30,2
1681923871314,MATH 18,A02,182751,Anzaldo; Leesa B,29,0,30,1
1681923871314,MATH 18,A03,182753,Anzaldo; Leesa B,27,0,30,3
1681923871314,MATH 18,A04,182757,Anzaldo; Leesa B,29,0,30,1
1681923871314,MATH 18,B01,182761,Anzaldo; Leesa B,27,0,30,3
1681923871314,MATH 18,B02,182764,Anzaldo; Leesa B,26,0,30,4
1681923871314,MATH 18,B03,182765,Anzaldo; Leesa B,29,0,30,1
1681923871314,MATH 18,B04,182766,Anzaldo; Leesa B,30,0,30,0
1681923872343,MATH 20A,A01,182771,Suk; Andrew Hoon,28,0,30,2
1681923873373,MATH 20B,A01,182775,Bach; Quang Tran,30,0,30,0
1681923873373,MATH 20B,A02,182777,Bach; Quang Tran,29,0,30,1
1681923873373,MATH 20B,B01,182780,Bach; Quang Tran,26,0,30,4
1681923873373,MATH 20B,B02,182782,Bach; Quang Tran,30,0,30,0
1681923874400,MATH 20C,A01,182787,Staff,25,0,30,5
1681923874400,MATH 20C,A02,182790,Staff,29,0,30,1
1681923874400,MATH 20C,B01,182792,Staff,25,0,30,5
1681923874400,MATH 20C,B02,182796,Staff,26,0,30,4
1681923875441,MATH 20D,A01,182799,Staff,28,0,30,2
1681923875441,MATH 20D,A02,182802,Staff,29,0,30,1
1681923875441,MATH 20D,A03,182803,Staff,30,0,30,0
1681923876465,MATH 20E,A01,182809,Verstraete; Jacques Allan,23,0,30,7
1681923876465,MATH 20E,A02,182811,Verstraete; Jacques Allan,28,0,30,2
1681923876465,MATH 20E,B01,182814,Verstraete; Jacques Allan,22,0,30,8
1681923876465,MATH 20E,B02,182815,Verstraete; Jacques Allan,30,0,30,0
1681923877491,MATH 103A,A01,182820,Staff,7,0,30,23
1681923877491,MATH 103A,A02,182821,Staff,27,0,30,3
1681923877491,MATH 103A,A03,182822,Staff,23,0,30,7
1681923877491,MATH 103A,B01,182825,Staff,23,0,30,7
1681923877491,MATH 103A,B02,182826,Staff,30,0,30,0
1681923877491,MATH 103A,B03,182830,Staff,30,0,30,0
1681923878517,MATH 109,A01,182836,Chow; Bennett,24,0,30,6
1681923878517,MATH 109,A02,182838,Chow; Bennett,29,0,30,1
1681923878517,MATH 109,A03,182894,Chow; Bennett,29,0,30,1
1681923878517,MATH 109,B01,182908,Chow; Bennett,27,0,30,3
1681923878517,MATH 109,B02,182909,Chow; Bennett,30,0,30,0
1681923878517,MATH 109,B03,182910,Chow; Bennett,26,0,30,4
1681923879550,MATH 142A,A01,182925,Staff,8,0,30,22
1681923879550,MATH 142A,A02,182935,Staff,24,0,30,6
1681923879550,MATH 142A,A03,182967,Staff,26,0,30,4
1681923879550,MATH 142A,B01,183125,Staff,23,0,30,7
1681923879550,MATH 142A,B02,183157,Staff,28,0,30,2
1681923879550,MATH 142A,B03,183158,Staff,29,0,30,1
1681923880578,MATH 183,A01,183160,Arias-Castro; Ery,23,0,30,7
1681923880578,MATH 183,A02,183161,Arias-Castro; Ery,29,0,30,1
1681923880578,MATH 183,B01,183163,Arias-Castro; Ery,28,0,30,2
1681923880578,MATH 183,B02,183164,Arias-Castro; Ery,28,0,30,2
1681923881600,MATH 193A,A01,183167,Staff,0,0,35,35
1681923881600,MATH 193A,A02,183168,Staff,28,0,35,7
1681923881600,MATH 193A,A03,183169,Staff,34,0,35,1
1681923881600,MATH 193A,A04,183170,Staff,27,0,35,8
1681923882624,MGT 4,A01,202395,Anderson; John Charles,75,0,80,5
1681923883690,MGT 5,A00,202396,Houskeeper; Robert,79,0,90,11
1681923884711,MGT 103,A00,202397,Eberhard; Craig A,49,0,90,41
1681923885758,MGT 131A,A00,202398,Houskeeper; Robert,83,0,90,7
1681923886780,MGT 135,A00,202399,Anderson; John Charles,81,0,90,9
1681923887801,MGT 162R,A00,202403,Gneezy; Uri,136,0,200,64
1681923888827,MGT 172,A00,202404,Hedges; Kathleen,40,0,90,50
1681923889850,MGT 181,A00,202405,Dunn; Louis Jean,80,0,90,10
1681923890875,MMW 14,A01,183200,Staff,8,0,28,20
1681923890875,MMW 14,A02,183201,Staff,26,0,28,2
1681923890875,MMW 14,A03,183202,Staff,24,0,28,4
1681923890875,MMW 14,A04,183203,Staff,25,0,28,3
1681923890875,MMW 14,A05,183204,Staff,26,0,28,2
1681923890875,MMW 14,A06,183205,Staff,27,0,28,1
1681923890875,MMW 14,B01,183207,Staff,26,0,28,2
1681923890875,MMW 14,B02,183208,Staff,28,0,28,0
1681923890875,MMW 14,B03,183209,Staff,28,0,28,0
1681923890875,MMW 14,B04,183210,Staff,28,0,28,0
1681923890875,MMW 14,B05,183211,Staff,28,0,28,0
1681923890875,MMW 14,B06,183212,Staff,27,0,28,1
1681923891906,MMW 14GS,A00,183213,Zhiri; Oumelbanine,28,0,28,0
1681923892933,MMW 15GS,B00,183215,Rahimi; Babak,28,0,28,0
1681923893955,MMW 121,A01,183217,Patterson; Patrick H.,12,0,28,16
1681923893955,MMW 121,A02,183218,Patterson; Patrick H.,25,0,28,3
1681923894997,MUS 1A,A01,182554,Staff,4,0,35,31
1681923896019,MUS 5,A01,182558,Staff,17,0,35,18
1681923897044,MUS 6,A01,182562,Staff,22,0,35,13
1681923898066,MUS 8GS,A00,182563,Borgo; David Garcia,25,0,25,0
1681923899090,MUS 13,A01,182567,Staff,24,0,25,1
1681923900114,MUS 15,A01,182570,Staff,32,0,35,3
1681923900114,MUS 15,B01,182575,Staff,7,0,35,28
1681923901138,MUS 80,A00,182578,Staff,22,0,25,3
1681923901138,MUS 80,B00,182581,Staff,20,0,25,5
1681923902169,MUS 113,A00,182582,Staff,25,0,25,0
1681923903199,MUS 114,A00,182583,Staff,3,0,25,22
1681923904229,MUS 150GS,A01,182588,Borgo; David Garcia,25,0,25,0
1681923905253,PHIL 1,A00,182590,Staff,34,0,40,6
1681923906279,PHIL 10,A01,182596,Grush; Rick Scott,31,0,35,4
1681923906279,PHIL 10,A02,182597,Grush; Rick Scott,33,0,35,2
1681923907310,PHIL 15,A01,182601,Staff,31,0,35,4
1681923907310,PHIL 15,A02,182602,Staff,33,0,35,2
1681923908338,PHIL 27,A01,182604,Staff,30,0,35,5
1681923908338,PHIL 27,A02,182607,Staff,35,0,35,0
1681923909370,PHIL 32,A01,182609,Staff,35,0,35,0
1681923909370,PHIL 32,A02,182612,Staff,35,0,35,0
1681923910394,PHIL 130,A00,182614,Staff,61,0,70,9
1681923911420,PHIL 136,A00,182616,Cohen; Jonathan David,66,0,70,4
1681923912448,PHIL 155,A00,182617,Vargas; Manuel Rogelio,58,0,70,12
1681923913471,PHIL 163,A01,182620,Staff,15,0,20,5
1681923913471,PHIL 163,A02,182624,Staff,10,0,20,10
1681923914493,PHIL 164,A00,182627,Staff,29,0,40,11
1681923915516,PHIL 173,A00,182628,Staff,36,0,40,4
1681923916542,PHYS 1A,A00,183221,Staff,54,0,60,6
1681923917563,PHYS 1AL,001,183222,Staff,25,0,30,5
1681923917563,PHYS 1AL,002,183223,Staff,28,0,30,2
1681923918594,PHYS 1B,A00,183231,Staff,43,0,60,17
1681923919623,PHYS 1BL,001,183232,Staff,20,0,30,10
1681923919623,PHYS 1BL,002,183233,Staff,27,0,30,3
1681923920649,PHYS 1C,A00,183240,Staff,25,0,60,35
1681923921672,PHYS 1CL,001,183241,Staff,10,0,30,20
1681923921672,PHYS 1CL,002,183242,Staff,22,0,30,8
1681923922696,PHYS 2AR,A01,183250,Staff,43,0,50,7
1681923923724,PHYS 2B,A01,183252,Staff,104,0,115,11
1681923924749,PHYS 2BL,A01,183254,Staff,21,0,24,3
1681923924749,PHYS 2BL,A02,183255,Staff,22,0,24,2
1681923925797,PHYS 2C,A01,183522,Staff,103,0,115,12
1681923926821,PHYS 4A,A01,183524,Staff,49,0,50,1
1681923927846,POLI 5,A00,183525,Staff,44,0,50,6
1681923928878,POLI 12,A00,183540,Staff,45,0,50,5
1681923929982,POLI 13R,A00,183541,Forman; Fonna,41,0,50,9
1681923931005,POLI 30,A00,183542,Mignozzetti; Umberto,48,0,50,2
1681923932027,POLI 100A,A00,183543,Staff,45,0,50,5
1681923933064,POLI 100E,A00,223598,Staff,32,0,35,3
1681923934089,POLI 103A,A00,183564,Kousser; Thad,37,0,50,13
1681923935112,POLI 104B,A00,201329,Staff,28,0,35,7
1681923936137,POLI 113BR,A00,183576,Hoston; Germaine,24,0,50,26
1681923937167,POLI 114BR,A00,183588,Staff,27,0,30,3
1681923938192,POLI 117R,A00,183595,Forman; Fonna,4,0,20,16
1681923939216,POLI 120H,A00,183596,Fisk; David Lee,13,0,20,7
1681923940242,POLI 130AA,A00,183597,Staff,13,0,20,7
1681923941275,POLI 134AA,A00,183598,Staff,19,0,20,1
1681923942301,POLI 135,A00,183599,Fisk; David Lee,19,0,25,6
1681923943326,POLI 142P,A00,183623,Staff,37,0,40,3
1681923944349,POLI 144D,A00,183624,Staff,22,0,25,3
1681923945372,POLI 151,A00,183625,Staff,15,0,20,5
1681923946397,POLI 162,A00,183626,Mignozzetti; Umberto,17,0,20,3
1681923947426,PSYC 1,A00,253748,Staff,86,0,90,4
1681923948455,PSYC 2,A00,183627,Moranton; Nirelia Melbina-,24,0,35,11
1681923949554,PSYC 3,A00,183628,Staff,43,0,45,2
1681923951605,PSYC 60,A01,183631,Lowe; Angela Beth,35,0,40,5
1681923952627,PSYC 70,A01,253757,Staff,37,0,45,8
1681923953650,PSYC 101,A00,183632,Heyman; Gail D.,45,0,60,15
1681923954672,PSYC 105,A00,183848,Lowe; Angela Beth,47,0,60,13
1681923955694,PSYC 106,A00,183849,Dobkins; Karen R.,42,0,60,18
1681923956715,PSYC 108,A00,253750,Staff,21,0,60,39
1681923957741,PSYC 114,A01,184275,Winkielman; Piotr,0,7,30,30
1681923958764,PSYC 122,A00,183856,Moranton; Nirelia Melbina-,0,15,30,30
1681923959790,PSYC 124,A00,183865,Chapman; Eddie Nathaniel,49,0,80,31
1681923960815,PSYC 137,A00,183880,Staff,19,0,25,6
1681923962864,PSYC 154,A00,183910,Lacefield; Katharine I,0,16,90,90
1681923964911,PSYC 162,A00,183946,Wixted; John T,53,0,90,37
1681923965941,PSYC 172,A00,183947,Gorman; Michael R.,10,0,30,20
1681923966977,PSYC 178,A00,183963,Glaser; Dale,17,0,40,23
1681923968004,PSYC 181GS,A00,183964,Anagnostaras; Stephan,10,0,10,0
1681923969026,PSYC 186GS,A01,257660,Staff,10,0,10,0
1681923970050,PSYC 193,B00,253749,Staff,23,0,25,2
1681923972098,PSYC 193L,A01,184122,Staff,33,0,35,2
1681923972098,PSYC 193L,C01,184167,Winkielman; Piotr,14,0,30,16
1681923973127,RELI 188GS,A00,182629,Rahimi; Babak,20,0,20,0
1681923974151,SE 101A,A00,182646,Staff,26,0,30,4
1681923975179,SE 101C,A00,182650,Staff,17,0,20,3
1681923976209,SE 110A,A00,182651,Staff,28,0,28,0
1681923977232,SE 130A,A00,182652,Staff,38,0,40,2
1681923978254,SIO 46GS,A00,182636,Cook; Geoffrey W,25,0,28,3
1681923979294,SIO 109R,A00,194459,Staff,3,0,20,17
1681923980319,SIO 121GS,A00,182639,Cook; Geoffrey W,25,0,28,3
1681923981343,SIO 132,A01,182642,Staff,32,0,40,8
1681923982376,SIO 139,A00,182644,Kacev; David,36,0,40,4
1681923983399,SOCI 2,A01,258404,Staff,33,0,36,3
1681923983399,SOCI 2,A02,258405,Staff,35,0,36,1
1681923984425,SOCI 60,A01,258408,Staff,29,0,30,1
1681923984425,SOCI 60,A02,258413,Staff,30,0,30,0
1681923985459,SOCI 100,A01,258415,Staff,29,0,30,1
1681923985459,SOCI 100,A02,258416,Staff,28,0,30,2
1681923991613,SOCI 127,A00,258421,Staff,21,0,30,9
1681923992638,SOCI 132,A00,258422,Staff,45,0,50,5
1681923993661,SOCI 133,A00,258423,Staff,26,0,30,4
1681923994683,SOCI 138GS,A00,258424,Staff,15,0,15,0
1681923995710,SOCI 145,A00,258425,Staff,25,0,30,5
1681923996735,SOCI 148,A00,258426,Staff,24,0,30,6
1681923997757,SOCI 153,A00,199217,Staff,29,0,30,1
1681923998788,SOCI 160,A00,258427,Staff,28,0,30,2
1681923999811,SOCI 160E,A00,258435,Staff,56,0,60,4
1681924000840,SOCI 189GS,A00,258436,Staff,15,0,15,0
1681924001867,SOCI 190GS,A00,258437,Staff,15,0,15,0
1681924002893,SYN 2,001,182658,Staff,8,0,16,8
1681924002893,SYN 2,002,201439,Staff,14,0,16,2
1681924002893,SYN 2,003,201443,Staff,16,0,16,0
1681924003919,SYN 100,A01,182657,Staff,16,0,20,4
1681924004942,TDAC 1,A00,184381,Salovey; Todd,16,0,20,4
1681924004942,TDAC 1,B00,184385,Harting; Carla Kelso,19,0,20,1
1681924004942,TDAC 1,C00,184394,Staff,19,0,20,1
1681924005964,TDAC 101,A00,184483,Harting; Carla Kelso,19,0,20,1
1681924006997,TDDE 111,A00,184496,Staff,14,0,15,1
1681924008023,TDDE 131,A00,184504,Staff,20,0,20,0
1681924008023,TDDE 131,B00,184505,Staff,17,0,18,1
1681924008023,TDDE 131,C00,184534,Staff,49,0,50,1
1681924008023,TDDE 131,D00,184564,Staff,15,0,15,0
1681924008023,TDDE 131,E00,204725,Staff,19,0,20,1
1681924009049,TDGE 1,A01,184414,Salovey; Todd,36,0,50,14
1681924010071,TDGE 5,A01,184419,Staff,23,0,24,1
1681924011095,TDGE 10,A00,184428,Fulton; Julia,29,0,50,21
1681924012122,TDGE 124,A00,184565,Fulton; Julia,3,0,50,47
1681924013149,TDGE 125,B00,184567,Meyer; Ursula,9,0,25,16
1681924014176,TDHT 101,A00,184568,Staff,21,0,25,4
1681924014176,TDHT 101,B00,184569,Staff,20,0,20,0
1681924015204,TDHT 114,A00,184570,Staff,49,0,50,1
1681924016227,TDMV 1,A00,184437,Arcidiacono; Kristin,22,0,30,8
1681924016227,TDMV 1,B00,184448,Caligagan; Maria T.,23,0,30,7
1681924017253,TDMV 2,A00,184449,Weinberg; Sadie,27,0,30,3
1681924017253,TDMV 2,B00,184453,Arcidiacono; Kristin,29,0,30,1
1681924018275,TDMV 110,A00,184571,Weinberg; Sadie,30,0,30,0
1681924019299,TDMV 142,A00,184572,Caligagan; Tony,27,0,30,3
1681924019299,TDMV 142,B00,184573,Caligagan; Maria T.,26,0,30,4
1681924020322,TDTR 20,A00,184482,Jun; Grace Shin Hae,25,0,25,0
1681924021345,USP 2,A01,184290,Hinds; Juli Beth,24,0,25,1
1681924022373,USP 3,A01,184295,Staff,21,0,25,4
1681924023411,USP 4,A00,184304,McTague; Sarah,13,0,25,12
1681924024437,USP 100,A00,184315,Staff,16,0,25,9
1681924025458,USP 105,A00,184326,Staff,21,0,25,4
1681924026481,USP 151,A00,184327,Staff,19,0,25,6
1681924027511,USP 170,A00,184380,Hinds; Juli Beth,13,0,25,12
1681924028536,VIS 21B,A01,182660,Staff,28,0,31,3
1681924028536,VIS 21B,A02,182662,Staff,30,0,31,1
1681924029561,VIS 103D,A00,182663,Staff,74,0,75,1
1681924030586,VIS 105D,A00,182667,Li; Huai,14,0,22,8
1681924031617,VIS 122GS,A00,182668,Herbst; Matthew,20,0,20,0
1681924032641,VIS 128C,A00,182673,Staff,69,0,75,6
1681924033664,VIS 130,A00,182675,Staff,19,0,22,3
1681924034694,VIS 160A,A00,182678,Stalbaum; Brett,4,0,10,6
1681924036742,WCWP 10B,A00,201679,Staff,15,0,15,0
1681924036742,WCWP 10B,B00,201695,Staff,15,0,15,0
1681924037768,WCWP 100,A00,201716,Staff,12,0,15,3
1681924037768,WCWP 100,B00,201717,Staff,4,0,15,11
1681924039872,ANSC 105GS,A00,258289,Staff,0,0,0,0
1681924040895,ANSC 125GS,A00,258295,Staff,0,0,0,0
1681924041925,ANSC 150,A00,258267,Staff,30,0,40,10
1681924042948,ANSC 190GS,A00,258280,Staff,0,0,0,0
1681924043971,ANTH 1,A00,258264,Staff,38,0,40,2
1681924044996,ANTH 2,A01,258259,Staff,72,0,76,4
1681924046018,ANTH 23,A01,258228,Staff,36,0,40,4
1681924047041,ANTH 101,A01,258236,Staff,38,0,40,2
1681924048064,ANTH 102,A00,258272,Staff,59,0,60,1
1681924049085,ANTH 105,A00,258244,Staff,31,0,35,4
1681924050109,BENG 130,A00,253975,Staff,38,0,40,2
1681924051135,BIBC 102,A01,191866,Flagg; Matthew Paul,19,0,32,13
1681924051135,BIBC 102,A02,191867,Flagg; Matthew Paul,22,0,32,10
1681924051135,BIBC 102,A03,191868,Flagg; Matthew Paul,29,0,32,3
1681924051135,BIBC 102,A04,191936,Flagg; Matthew Paul,26,0,32,6
1681924051135,BIBC 102,A05,191937,Flagg; Matthew Paul,1,0,32,31
1681924052171,BICD 100,A01,191939,Cooper; Andrew Michael,28,0,32,4
1681924052171,BICD 100,A02,191940,Cooper; Andrew Michael,32,0,32,0
1681924052171,BICD 100,A03,191941,Cooper; Andrew Michael,32,0,32,0
1681924052171,BICD 100,A04,191942,Cooper; Andrew Michael,32,0,32,0
1681924052171,BICD 100,A05,191943,Cooper; Andrew Michael,32,0,32,0
1681924053270,BIEB 126,A01,191945,Cleland; Elsa Eleanor,0,1,32,32
1681924053270,BIEB 126,A02,191946,Cleland; Elsa Eleanor,27,0,32,5
1681924053270,BIEB 126,A03,191947,Cleland; Elsa Eleanor,29,0,32,3
1681924053270,BIEB 126,A04,191948,Cleland; Elsa Eleanor,22,0,32,10
1681924053270,BIEB 126,A05,191996,Cleland; Elsa Eleanor,28,0,32,4
1681924054293,BIEB 136GS,A00,191997,Shurin; Jonathan & Holway; David A.,0,0,0,4
1681924055320,BIEB 137GS,A01,191999,Shurin; Jonathan & Holway; David A.,0,0,0,3
1681924056355,BILD 1,A01,205385,Staff,31,0,32,1
1681924056355,BILD 1,A02,205386,Staff,30,0,32,2
1681924056355,BILD 1,A03,205387,Staff,32,0,32,0
1681924056355,BILD 1,A04,205388,Staff,27,0,32,5
1681924057387,BILD 2,A01,191774,Staff,28,0,32,4
1681924057387,BILD 2,A02,191775,Staff,30,0,32,2
1681924057387,BILD 2,A03,191777,Staff,30,0,32,2
1681924057387,BILD 2,A04,191856,Staff,31,0,32,1
1681924057387,BILD 2,A05,191857,Staff,32,0,32,0
1681924057387,BILD 2,A06,191858,Staff,32,0,32,0
1681924057387,BILD 2,A07,191859,Staff,31,0,32,1
1681924058418,BILD 3,A01,205391,Staff,29,0,32,3
1681924058418,BILD 3,A02,205393,Staff,32,0,32,0
1681924058418,BILD 3,A03,205394,Staff,27,0,32,5
1681924058418,BILD 3,A04,205395,Staff,32,0,32,0
1681924059444,BILD 20,A01,191861,Staff,32,0,32,0
1681924059444,BILD 20,A02,191862,Staff,32,0,32,0
1681924060469,BILD 30,A01,191864,Staff,31,0,32,1
1681924061491,BIMM 100,A01,192019,Staff,0,0,32,32
1681924061491,BIMM 100,A02,192020,Staff,19,0,32,13
1681924061491,BIMM 100,A03,192035,Staff,20,0,32,12
1681924062517,BIMM 110,A01,192037,Tat; John,0,0,32,32
1681924062517,BIMM 110,A02,192038,Tat; John,8,0,32,24
1681924063547,BIMM 120,A01,192040,Pickett; Brooke Elizabeth,0,0,32,32
1681924063547,BIMM 120,A02,192041,Pickett; Brooke Elizabeth,14,0,32,18
1681924063547,BIMM 120,A03,192042,Pickett; Brooke Elizabeth,15,0,32,17
1681924064570,BIPN 100,A01,192044,Armour; Jon Christopher,23,0,32,9
1681924064570,BIPN 100,A02,192059,Armour; Jon Christopher,30,0,32,2
1681924064570,BIPN 100,A03,192064,Armour; Jon Christopher,30,0,32,2
1681924064570,BIPN 100,A04,192073,Armour; Jon Christopher,28,0,32,4
1681924065597,BIPN 148,A01,205411,Leutgeb; Jill K.,15,0,32,17
1681924065597,BIPN 148,A02,205412,Leutgeb; Jill K.,31,0,32,1
1681924065597,BIPN 148,A03,205413,Leutgeb; Jill K.,30,0,32,2
1681924065597,BIPN 148,A04,205414,Leutgeb; Jill K.,30,0,32,2
1681924066629,BIPN 160,A01,192115,Marino; Marc J,16,0,32,16
1681924066629,BIPN 160,A02,192148,Marino; Marc J,27,0,32,5
1681924066629,BIPN 160,A03,192158,Marino; Marc J,31,0,32,1
1681924066629,BIPN 160,A04,192190,Marino; Marc J,32,0,32,0
1681924066629,BIPN 160,A05,192287,Marino; Marc J,32,0,32,0
1681924066629,BIPN 160,A06,192288,Marino; Marc J,32,0,32,0
1681924067654,BIPN 194,A00,206038,Staff,28,0,32,4
1681924068678,BISP 194,A00,192289,Leutgeb; Stefan,12,0,32,20
1681924068678,BISP 194,B00,245332,Nieh; James Charles,26,0,32,6
1681924069703,CAT 124,A01,202247,Staff,15,0,15,0
1681924070731,CAT 125,A00,202248,Staff,19,0,20,1
1681924070731,CAT 125,B00,202253,Staff,20,0,20,0
1681924070731,CAT 125,C00,202257,Staff,18,0,20,2
1681924071758,CAT 125GS,A01,202273,Bronstein; Phoebe Malan,20,0,20,0
1681924072782,CAT 125R,A00,202284,Staff,18,0,20,2
1681924072782,CAT 125R,C00,202286,Staff,9,0,20,11
1681924072782,CAT 125R,D00,202291,Staff,17,0,20,3
1681924072782,CAT 125R,E00,202295,Staff,13,0,20,7
1681924072782,CAT 125R,F00,202302,Staff,8,0,20,12
1681924073805,CENG 100,A00,204724,Opatkiewicz; Justin Paul,25,0,25,0
1681924074828,CGS 2A,A01,180420,Staff,31,0,36,5
1681924075859,CGS 101,A00,180421,Staff,16,0,20,4
1681924076885,CGS 112,A00,180422,Staff,9,0,16,7
1681924078016,CGS 113,A00,180423,Staff,18,0,20,2
1681924079038,CGS 137,A00,180424,Staff,12,0,12,0
1681924080063,CGS 147,A00,180425,Staff,10,0,10,0
1681924081087,CHEM 6A,A01,179556,Staff,95,0,100,5
1681924081087,CHEM 6A,A02,179558,Staff,0,0,0,0
1681924082109,CHEM 6B,A01,179560,Staff,100,0,100,0
1681924083133,CHEM 6C,A01,179565,Jazzar; Rodolphe,94,0,100,6
1681924084162,CHEM 7L,A01,179586,Schurmeier; Kimberly,10,0,24,14
1681924084162,CHEM 7L,A02,179587,Schurmeier; Kimberly,23,0,24,1
1681924084162,CHEM 7L,A03,179590,Schurmeier; Kimberly,22,0,24,2
1681924084162,CHEM 7L,A04,179591,Schurmeier; Kimberly,22,0,24,2
1681924084162,CHEM 7L,B01,179598,Schurmeier; Kimberly,16,0,24,8
1681924084162,CHEM 7L,B02,179599,Schurmeier; Kimberly,24,0,24,0
1681924084162,CHEM 7L,B03,179606,Schurmeier; Kimberly,23,0,24,1
1681924084162,CHEM 7L,B04,179607,Schurmeier; Kimberly,23,0,24,1
1681924085184,CHEM 11,A01,179609,Stallings; Dontarie M,87,0,100,13
1681924086207,CHEM 40A,A01,179621,Staff,40,0,50,10
1681924086207,CHEM 40A,A02,179622,Staff,46,0,50,4
1681924087230,CHEM 40B,A01,179630,Weizman; Haim,47,0,50,3
1681924087230,CHEM 40B,A02,179631,Weizman; Haim,44,0,50,6
1681924088253,CHEM 41A,A01,179660,Klosterman; Jeremy K,93,0,100,7
1681924089275,CHEM 43A,A01,179683,Klosterman; Jeremy K,0,0,24,24
1681924089275,CHEM 43A,A02,179688,Klosterman; Jeremy K,8,0,24,16
1681924089275,CHEM 43A,A03,179689,Klosterman; Jeremy K,19,0,24,5
1681924089275,CHEM 43A,A04,179691,Klosterman; Jeremy K,18,0,24,6
1681924090298,CHEM 114A,A01,179693,Stallings; Dontarie M,71,0,100,29
1681924091327,CHEM 143B,A01,179698,Weizman; Haim,16,0,24,8
1681924091327,CHEM 143B,A02,179700,Weizman; Haim,24,0,24,0
1681924092350,CHIN 169A,A00,179701,Wang; Xiao,20,0,20,0
1681924093378,COGS 2,A01,179750,Boyle; Mary E. T.,17,0,30,13
1681924094404,COGS 9,A01,179759,Jones; Cameron Robert,42,0,50,8
1681924095433,COGS 14A,A01,179854,Staff,15,0,50,35
1681924096456,COGS 14B,A01,179856,Staff,53,0,60,7
1681924097482,COGS 17,A01,179874,Staff,71,0,75,4
1681924098511,COGS 18,A01,179884,Staff,63,0,80,17
1681924099537,COGS 100,A01,179886,Staff,36,0,60,24
1681924100559,COGS 101B,A01,179892,Staff,0,0,30,30
1681924101581,COGS 101C,A01,179894,Staff,28,0,30,2
1681924102608,COGS 107A,A01,179896,Boyle; Mary E. T.,30,0,40,10
1681924103636,COGS 108,A01,179898,Simpkins; Charles Alexander,0,25,60,60
1681924104660,COGS 109,A01,179900,Staff,34,0,40,6
1681924105683,COGS 118A,A01,179946,Staff,7,0,40,33
1681924106715,COGS 153,A00,179978,Staff,0,3,30,30
1681924107748,COGS 156,A01,179981,Staff,23,0,30,7
1681924109794,COGS 172,A01,179987,Staff,13,0,30,17
1681924111844,COGS 186,A01,179991,Staff,12,0,30,18
1681924112871,COMM 10,A01,180001,Staff,13,0,25,12
1681924112871,COMM 10,A02,180004,Staff,20,0,25,5
1681924113897,COMM 100A,A01,180016,Staff,15,0,25,10
1681924113897,COMM 100A,A02,180020,Staff,24,0,25,1
1681924114922,COMM 101T,A00,180029,Halm; Gavin Patrick,22,0,35,13
1681924115945,COMM 106V,A00,180043,Staff,34,0,35,1
1681924116971,COMM 109P,A00,180044,Staff,30,0,35,5
1681924117994,COMM 113T,A00,180045,Havis; Allan,37,0,45,8
1681924119019,COMM 132,A00,180046,McKenna; Denise,23,0,30,7
1681924120041,COMM 143,A00,180047,Staff,18,0,30,12
1681924121064,COMM 190,A00,180048,Conner; Thomas Hartnell,18,0,23,5
1681924122089,CSE 8A,A50,180053,Cao; Yingjun,22,0,50,28
1681924122089,CSE 8A,B50,180180,Staff,50,0,50,0
1681924123113,CSE 11,A01,180190,Cao; Yingjun,26,0,50,24
1681924124137,CSE 20,A01,180192,Briones; Jor-el Thomas Caparas,22,0,30,8
1681924125167,CSE 21,A01,194538,Briones; Jor-el Thomas Caparas,50,0,60,10
1681924126193,CSE 30,A01,180324,Eldon; John,75,0,100,25
1681924127217,CSE 101,A01,201353,Staff,0,26,40,40
1681924128242,CSE 134B,A01,180326,Powell; Thomas Allan,74,0,100,26
1681924129277,CSE 140,A01,180328,Staff,40,0,75,35
1681924130303,CSE 140L,A01,180344,Eldon; John,63,0,100,37
1681924131330,CSE 150A,A01,180411,Staff,0,15,50,50
1681924132353,CSE 151A,A01,180414,Staff,0,8,50,50
1681924133385,CSE 175,A01,222521,Kumar; Rakesh,50,0,50,0
1681924134407,CSE 190,A00,201419,Staff,44,0,49,5
1681924135430,CSS 1,A01,194536,Staff,36,0,50,14
1681924136460,DSC 30,A01,202385,Staff,48,0,50,2
1681924137484,DSC 40A,A01,202387,Albuyeh; Rod,50,0,50,0
1681924138511,DSC 190,A01,202389,Silberman; Jack,21,0,21,0
1681924139536,DSGN 100,A01,179993,Staff,15,0,30,15
1681924140567,ECE 65,A50,180708,Staff,10,0,20,10
1681924140567,ECE 65,A51,180739,Staff,19,0,20,1
1681924141592,ECON 1,A01,180427,Famulari; Melissa,67,0,70,3
1681924142614,ECON 2,A01,180450,Levkoff; Steven B.,64,0,70,6
1681924143648,ECON 4,A01,203351,Anderson; John Charles,6,0,10,4
1681924144689,ECON 100A,A01,180472,Famulari; Melissa,62,0,70,8
1681924145713,ECON 120A,A01,180549,Staff,63,0,70,7
1681924146749,ECON 120B,A01,180655,Ma; Xinwei,43,0,70,27
1681924147774,ECON 129,A00,203333,Eckert; Fabian Paul,12,0,35,23
1681924148801,ECON 131,A00,180656,Staff,5,0,35,30
1681924149824,ECON 172B,A01,180672,Levkoff; Steven B.,31,0,35,4
1681924150858,ECON 178,A01,203342,Zhu; Ying,8,0,35,27
1681924151882,EDS 108GS,A00,202383,Wishard Guerra; Alison G.,20,0,20,0
1681924152909,EDS 111GS,A00,202347,Wishard Guerra; Alison G.,20,0,20,0
1681924153932,EDS 112,A01,202323,Staff,55,0,60,5
1681924154956,EDS 113,A00,202340,Staff,32,0,35,3
1681924155988,EDS 118,A00,201231,Staff,19,0,30,11
1681924157107,EDS 119,A00,204994,Staff,8,0,10,2
1681924158135,EDS 124BR,A00,202324,Eguchi; Emi,1,0,25,24
1681924159161,EDS 126,A01,203208,Jones; Makeba,26,0,30,4
1681924160185,EDS 135,A01,202333,Staff,17,0,20,3
1681924161215,EDS 180,A00,202311,Staff,47,0,50,3
1681924162237,ERC 190GS,A01,253747,Staff,28,0,28,0
1681924163263,ETHN 104,A00,180742,Staff,22,0,35,13
1681924164318,ETHN 118,A00,180745,Staff,27,0,35,8
1681924165344,ETHN 127,A00,180747,Staff,11,0,16,5
1681924166371,ETHN 137,A00,180880,Staff,11,0,12,1
1681924167400,ETHN 147,A00,180890,Staff,8,0,10,2
1681924168422,ETHN 154,A00,180891,Staff,7,0,8,1
1681924169449,ETHN 168,A00,180892,Staff,9,0,10,1
1681924170483,GLBH 20,A00,201051,Hannah; Seth Donal,0,3,0,1
1681924171509,GLBH 111,A01,209338,Burgos; Jose L.,0,0,0,0
1681924172540,GLBH 150,A00,258300,Staff,0,3,0,0
1681924173567,GLBH 181,A00,201207,Staff,12,0,40,28
1681924174597,HIEU 109,A00,180898,Staff,19,0,20,1
1681924175626,HIEU 111,A00,180899,Staff,0,1,20,20
1681924176651,HIEU 124,A00,180900,Staff,17,0,20,3
1681924177674,HILA 122,A00,180901,Staff,18,0,20,2
1681924178703,HILA 132,A00,180902,Vitz; Matthew,1,0,20,19
1681924179736,HILD 10,A01,180896,Staff,14,0,20,6
1681924180762,HILD 30GS,A00,180897,Edington; Claire Ellen,0,0,0,0
1681924181784,HISC 105,A00,180903,Staff,20,0,20,0
1681924182809,HISC 117,A00,180904,Staff,10,0,20,10
1681924183833,HIUS 108B,A00,181005,Staff,18,0,20,2
1681924184861,HIUS 113,A00,181093,Staff,1,0,20,19
1681924185886,HUM 3,A01,181190,Patterson; Patrick H.,38,0,50,12
1681924185886,HUM 3,B01,181195,Staff,46,0,50,4
1681924186915,HUM 3GS,A00,181196,Herbst; Matthew,0,0,0,0
1681924187948,HUM 4,A01,181227,West; Geoffrey Scott,33,0,50,17
1681924187948,HUM 4,B01,181282,Staff,41,0,50,9
1681924188973,HUM 4GS,A00,181377,Lyon; Antony J.,0,0,0,0
1681924189999,HUM 5,A01,181536,Zavodny; Tatiana Sophia,28,0,50,22
1681924189999,HUM 5,B01,181908,Staff,35,0,50,15
1681924191046,INTL 190,A00,181909,Segui; Alan S,0,0,0,8
1681924191046,INTL 190,B00,181961,Segui; Alan S,0,0,0,7
1681924192073,JAPN 20AR,A01,182113,Ross; Kayoko F,15,0,20,5
1681924193099,LATI 50,A01,202391,Martin-Cabrera; Luis,17,0,30,13
1681924193099,LATI 50,A02,202392,Martin-Cabrera; Luis,26,0,30,4
1681924194122,LATI 180,A00,202393,Kokinis; Troy Andreas,24,0,25,1
1681924195144,LIFR 1A,A00,182119,Staff,14,0,14,0
1681924196166,LIFR 1AX,A00,182324,Staff,14,0,14,0
1681924197193,LIFR 1B,A00,182259,Staff,13,0,14,1
1681924198217,LIFR 1BX,A00,182273,Staff,13,0,14,1
1681924199242,LIGN 8,A00,182330,Staff,132,0,150,18
1681924200265,LIGN 9GS,A00,182362,Staff,20,0,20,0
1681924201288,LIGN 119,A00,204992,Takahashi; Maho,11,0,15,4
1681924202311,LIGN 130,A01,182384,Staff,47,0,50,3
1681924203333,LIGN 149GS,A00,182390,Staff,20,0,20,0
1681924204362,LIGN 170,A00,182404,Staff,23,0,30,7
1681924205385,LISP 1D,A00,182281,Staff,7,0,14,7
1681924205385,LISP 1D,B00,182287,Staff,13,0,14,1
1681924205385,LISP 1D,C00,182295,Staff,11,0,14,3
1681924205385,LISP 1D,D00,182301,Staff,14,0,14,0
1681924206412,LISP 1DX,A00,182309,Staff,19,0,28,9
1681924206412,LISP 1DX,B00,182316,Staff,26,0,28,2
1681924207439,LTAF 120GS,A00,182412,Zhiri; Oumelbanine,20,0,20,0
1681924208467,LTCS 172GS,A00,182437,Bronstein; Phoebe Malan,20,0,20,0
1681924209493,LTEA 138,A00,182457,Staff,19,0,40,21
1681924210519,LTEN 114,A01,182490,Staff,23,0,25,2
1681924211552,LTEN 130GS,A00,182491,Lyon; Antony J.,20,0,20,0
1681924212577,LTEN 169,A00,182493,Cuong; Marisol,19,0,25,6
1681924213601,LTEN 178,A00,182501,Staff,14,0,15,1
1681924214624,LTEN 181,A00,182515,Staff,21,0,25,4
1681924215651,LTEN 185GS,A00,197655,Forbes; Camille,20,0,20,0
1681924216672,LTSP 100B,A00,202208,Bessett; Ryan Matthew,24,0,25,1
1681924217695,LTWL 100,A00,182516,Myerston Santana; Jacobo,20,0,30,10
1681924218720,LTWR 100GS,A00,182518,Forbes; Camille,20,0,20,0
1681924219745,LTWR 102,A00,182522,Staff,15,0,15,0
1681924219745,LTWR 102,B00,182525,Staff,14,0,15,1
1681924220774,LTWR 115,A00,182526,Staff,11,0,15,4
1681924221797,MAE 8,A01,182528,Pham; Hieu Tan,67,0,70,3
1681924222829,MAE 11,A00,182529,Bahadori; Mohammad Yousef,93,0,100,7
1681924223853,MAE 20,A00,182530,Evdokimenko; Ekaterina,68,0,70,2
1681924224877,MAE 30A,A00,182532,Staff,44,0,45,1
1681924225899,MAE 101A,A00,182533,Bahadori; Mohammad Yousef,95,0,100,5
1681924226925,MAE 101C,A00,182538,Staff,62,0,70,8
1681924227957,MAE 104,A00,182539,Staff,44,0,50,6
1681924228989,MAE 131A,A00,182540,Ghazinejad; Maziar,40,0,45,5
1681924230017,MAE 143A,A00,182548,Bewley; Thomas R,43,0,50,7
1681924231039,MAE 150,A00,182549,Staff,28,0,40,12
1681924232066,MAE 160,A00,182550,Evdokimenko; Ekaterina,41,0,60,19
1681924233093,MATH 3C,A01,182725,Staff,25,0,30,5
1681924234120,MATH 10A,A01,182729,Staff,25,0,30,5
1681924234120,MATH 10A,B01,182732,Staff,25,0,30,5
1681924235154,MATH 10B,A01,182737,Staff,19,0,30,11
1681924235154,MATH 10B,A02,182738,Staff,26,0,30,4
1681924235154,MATH 10B,B01,182744,Staff,27,0,30,3
1681924235154,MATH 10B,B02,182745,Staff,27,0,30,3
1681924236182,MATH 18,A01,182750,Anzaldo; Leesa B,28,0,30,2
1681924236182,MATH 18,A02,182751,Anzaldo; Leesa B,29,0,30,1
1681924236182,MATH 18,A03,182753,Anzaldo; Leesa B,27,0,30,3
1681924236182,MATH 18,A04,182757,Anzaldo; Leesa B,29,0,30,1
1681924236182,MATH 18,B01,182761,Anzaldo; Leesa B,27,0,30,3
1681924236182,MATH 18,B02,182764,Anzaldo; Leesa B,26,0,30,4
1681924236182,MATH 18,B03,182765,Anzaldo; Leesa B,29,0,30,1
1681924236182,MATH 18,B04,182766,Anzaldo; Leesa B,30,0,30,0
1681924237205,MATH 20A,A01,182771,Suk; Andrew Hoon,28,0,30,2
1681924238237,MATH 20B,A01,182775,Bach; Quang Tran,30,0,30,0
1681924238237,MATH 20B,A02,182777,Bach; Quang Tran,29,0,30,1
1681924238237,MATH 20B,B01,182780,Bach; Quang Tran,26,0,30,4
1681924238237,MATH 20B,B02,182782,Bach; Quang Tran,30,0,30,0
1681924239268,MATH 20C,A01,182787,Staff,24,0,30,6
1681924239268,MATH 20C,A02,182790,Staff,29,0,30,1
1681924239268,MATH 20C,B01,182792,Staff,24,0,30,6
1681924239268,MATH 20C,B02,182796,Staff,26,0,30,4
1681924240305,MATH 20D,A01,182799,Staff,28,0,30,2
1681924240305,MATH 20D,A02,182802,Staff,29,0,30,1
1681924240305,MATH 20D,A03,182803,Staff,30,0,30,0
1681924241332,MATH 20E,A01,182809,Verstraete; Jacques Allan,23,0,30,7
1681924241332,MATH 20E,A02,182811,Verstraete; Jacques Allan,28,0,30,2
1681924241332,MATH 20E,B01,182814,Verstraete; Jacques Allan,22,0,30,8
1681924241332,MATH 20E,B02,182815,Verstraete; Jacques Allan,30,0,30,0
1681924242355,MATH 103A,A01,182820,Staff,7,0,30,23
1681924242355,MATH 103A,A02,182821,Staff,27,0,30,3
1681924242355,MATH 103A,A03,182822,Staff,23,0,30,7
1681924242355,MATH 103A,B01,182825,Staff,23,0,30,7
1681924242355,MATH 103A,B02,182826,Staff,30,0,30,0
1681924242355,MATH 103A,B03,182830,Staff,30,0,30,0
1681924243379,MATH 109,A01,182836,Chow; Bennett,24,0,30,6
1681924243379,MATH 109,A02,182838,Chow; Bennett,29,0,30,1
1681924243379,MATH 109,A03,182894,Chow; Bennett,29,0,30,1
1681924243379,MATH 109,B01,182908,Chow; Bennett,27,0,30,3
1681924243379,MATH 109,B02,182909,Chow; Bennett,30,0,30,0
1681924243379,MATH 109,B03,182910,Chow; Bennett,26,0,30,4
1681924244401,MATH 142A,A01,182925,Staff,8,0,30,22
1681924244401,MATH 142A,A02,182935,Staff,24,0,30,6
1681924244401,MATH 142A,A03,182967,Staff,26,0,30,4
1681924244401,MATH 142A,B01,183125,Staff,23,0,30,7
1681924244401,MATH 142A,B02,183157,Staff,28,0,30,2
1681924244401,MATH 142A,B03,183158,Staff,29,0,30,1
1681924245428,MATH 183,A01,183160,Arias-Castro; Ery,23,0,30,7
1681924245428,MATH 183,A02,183161,Arias-Castro; Ery,29,0,30,1
1681924245428,MATH 183,B01,183163,Arias-Castro; Ery,28,0,30,2
1681924245428,MATH 183,B02,183164,Arias-Castro; Ery,28,0,30,2
1681924246451,MATH 193A,A01,183167,Staff,0,0,35,35
1681924246451,MATH 193A,A02,183168,Staff,27,0,35,8
1681924246451,MATH 193A,A03,183169,Staff,34,0,35,1
1681924246451,MATH 193A,A04,183170,Staff,27,0,35,8
1681924247477,MGT 4,A01,202395,Anderson; John Charles,75,0,80,5
1681924248499,MGT 5,A00,202396,Houskeeper; Robert,79,0,90,11
1681924249522,MGT 103,A00,202397,Eberhard; Craig A,49,0,90,41
1681924250545,MGT 131A,A00,202398,Houskeeper; Robert,83,0,90,7
1681924251575,MGT 135,A00,202399,Anderson; John Charles,81,0,90,9
1681924252602,MGT 162R,A00,202403,Gneezy; Uri,136,0,200,64
1681924253627,MGT 172,A00,202404,Hedges; Kathleen,39,0,90,51
1681924254650,MGT 181,A00,202405,Dunn; Louis Jean,80,0,90,10
1681924255679,MMW 14,A01,183200,Staff,8,0,28,20
1681924255679,MMW 14,A02,183201,Staff,26,0,28,2
1681924255679,MMW 14,A03,183202,Staff,24,0,28,4
1681924255679,MMW 14,A04,183203,Staff,25,0,28,3
1681924255679,MMW 14,A05,183204,Staff,26,0,28,2
1681924255679,MMW 14,A06,183205,Staff,27,0,28,1
1681924255679,MMW 14,B01,183207,Staff,26,0,28,2
1681924255679,MMW 14,B02,183208,Staff,28,0,28,0
1681924255679,MMW 14,B03,183209,Staff,28,0,28,0
1681924255679,MMW 14,B04,183210,Staff,28,0,28,0
1681924255679,MMW 14,B05,183211,Staff,28,0,28,0
1681924255679,MMW 14,B06,183212,Staff,27,0,28,1
1681924256704,MMW 14GS,A00,183213,Zhiri; Oumelbanine,28,0,28,0
1681924257727,MMW 15GS,B00,183215,Rahimi; Babak,28,0,28,0
1681924258759,MMW 121,A01,183217,Patterson; Patrick H.,12,0,28,16
1681924258759,MMW 121,A02,183218,Patterson; Patrick H.,25,0,28,3
1681924259783,MUS 1A,A01,182554,Staff,4,0,35,31
1681924260885,MUS 5,A01,182558,Staff,17,0,35,18
1681924261911,MUS 6,A01,182562,Staff,22,0,35,13
1681924262934,MUS 8GS,A00,182563,Borgo; David Garcia,25,0,25,0
1681924263972,MUS 13,A01,182567,Staff,24,0,25,1
1681924264999,MUS 15,A01,182570,Staff,32,0,35,3
1681924264999,MUS 15,B01,182575,Staff,7,0,35,28
1681924266031,MUS 80,A00,182578,Staff,22,0,25,3
1681924266031,MUS 80,B00,182581,Staff,20,0,25,5
1681924267056,MUS 113,A00,182582,Staff,25,0,25,0
1681924268081,MUS 114,A00,182583,Staff,3,0,25,22
1681924269112,MUS 150GS,A01,182588,Borgo; David Garcia,25,0,25,0
1681924270134,PHIL 1,A00,182590,Staff,34,0,40,6
1681924271158,PHIL 10,A01,182596,Grush; Rick Scott,31,0,35,4
1681924271158,PHIL 10,A02,182597,Grush; Rick Scott,33,0,35,2
1681924272182,PHIL 15,A01,182601,Staff,31,0,35,4
1681924272182,PHIL 15,A02,182602,Staff,33,0,35,2
1681924273219,PHIL 27,A01,182604,Staff,30,0,35,5
1681924273219,PHIL 27,A02,182607,Staff,35,0,35,0
1681924274243,PHIL 32,A01,182609,Staff,35,0,35,0
1681924274243,PHIL 32,A02,182612,Staff,35,0,35,0
1681924275266,PHIL 130,A00,182614,Staff,61,0,70,9
1681924276287,PHIL 136,A00,182616,Cohen; Jonathan David,66,0,70,4
1681924277317,PHIL 155,A00,182617,Vargas; Manuel Rogelio,58,0,70,12
1681924278340,PHIL 163,A01,182620,Staff,15,0,20,5
1681924278340,PHIL 163,A02,182624,Staff,10,0,20,10
1681924279362,PHIL 164,A00,182627,Staff,29,0,40,11
1681924280386,PHIL 173,A00,182628,Staff,36,0,40,4
1681924281418,PHYS 1A,A00,183221,Staff,54,0,60,6
1681924282442,PHYS 1AL,001,183222,Staff,25,0,30,5
1681924282442,PHYS 1AL,002,183223,Staff,27,0,30,3
1681924283464,PHYS 1B,A00,183231,Staff,43,0,60,17
1681924284499,PHYS 1BL,001,183232,Staff,20,0,30,10
1681924284499,PHYS 1BL,002,183233,Staff,27,0,30,3
1681924285529,PHYS 1C,A00,183240,Staff,25,0,60,35
1681924286564,PHYS 1CL,001,183241,Staff,10,0,30,20
1681924286564,PHYS 1CL,002,183242,Staff,22,0,30,8
1681924287595,PHYS 2AR,A01,183250,Staff,43,0,50,7
1681924288621,PHYS 2B,A01,183252,Staff,104,0,115,11
1681924289643,PHYS 2BL,A01,183254,Staff,21,0,24,3
1681924289643,PHYS 2BL,A02,183255,Staff,21,0,24,3
1681924290674,PHYS 2C,A01,183522,Staff,102,0,115,13
1681924291696,PHYS 4A,A01,183524,Staff,49,0,50,1
1681924292825,POLI 5,A00,183525,Staff,44,0,50,6
1681924293851,POLI 12,A00,183540,Staff,45,0,50,5
1681924294876,POLI 13R,A00,183541,Forman; Fonna,41,0,50,9
1681924295912,POLI 30,A00,183542,Mignozzetti; Umberto,48,0,50,2
1681924296936,POLI 100A,A00,183543,Staff,45,0,50,5
1681924297963,POLI 100E,A00,223598,Staff,32,0,35,3
1681924298993,POLI 103A,A00,183564,Kousser; Thad,37,0,50,13
1681924300015,POLI 104B,A00,201329,Staff,28,0,35,7
1681924301046,POLI 113BR,A00,183576,Hoston; Germaine,24,0,50,26
1681924302069,POLI 114BR,A00,183588,Staff,27,0,30,3
1681924303091,POLI 117R,A00,183595,Forman; Fonna,4,0,20,16
1681924304114,POLI 120H,A00,183596,Fisk; David Lee,13,0,20,7
1681924305137,POLI 130AA,A00,183597,Staff,13,0,20,7
1681924306161,POLI 134AA,A00,183598,Staff,19,0,20,1
1681924307183,POLI 135,A00,183599,Fisk; David Lee,19,0,25,6
1681924308207,POLI 142P,A00,183623,Staff,37,0,40,3
1681924309245,POLI 144D,A00,183624,Staff,22,0,25,3
1681924310270,POLI 151,A00,183625,Staff,15,0,20,5
1681924311294,POLI 162,A00,183626,Mignozzetti; Umberto,17,0,20,3
1681924312320,PSYC 1,A00,253748,Staff,86,0,90,4
1681924313342,PSYC 2,A00,183627,Moranton; Nirelia Melbina-,24,0,35,11
1681924314372,PSYC 3,A00,183628,Staff,43,0,45,2
1681924316435,PSYC 60,A01,183631,Lowe; Angela Beth,35,0,40,5
1681924317465,PSYC 70,A01,253757,Staff,37,0,45,8
1681924318492,PSYC 101,A00,183632,Heyman; Gail D.,45,0,60,15
1681924319522,PSYC 105,A00,183848,Lowe; Angela Beth,47,0,60,13
1681924320550,PSYC 106,A00,183849,Dobkins; Karen R.,42,0,60,18
1681924321574,PSYC 108,A00,253750,Staff,20,0,60,40
1681924322616,PSYC 114,A01,184275,Winkielman; Piotr,0,7,30,30
1681924323651,PSYC 122,A00,183856,Moranton; Nirelia Melbina-,0,15,30,30
1681924324678,PSYC 124,A00,183865,Chapman; Eddie Nathaniel,49,0,80,31
1681924325701,PSYC 137,A00,183880,Staff,19,0,25,6
1681924327752,PSYC 154,A00,183910,Lacefield; Katharine I,0,18,90,90
1681924329808,PSYC 162,A00,183946,Wixted; John T,51,0,90,39
1681924330830,PSYC 172,A00,183947,Gorman; Michael R.,9,0,30,21
1681924331862,PSYC 178,A00,183963,Glaser; Dale,17,0,40,23
1681924332885,PSYC 181GS,A00,183964,Anagnostaras; Stephan,10,0,10,0
1681924333913,PSYC 186GS,A01,257660,Staff,10,0,10,0
1681924334937,PSYC 193,B00,253749,Staff,23,0,25,2
1681924336983,PSYC 193L,A01,184122,Staff,33,0,35,2
1681924336983,PSYC 193L,C01,184167,Winkielman; Piotr,14,0,30,16
1681924338005,RELI 188GS,A00,182629,Rahimi; Babak,20,0,20,0
1681924339031,SE 101A,A00,182646,Staff,26,0,30,4
1681924340061,SE 101C,A00,182650,Staff,17,0,20,3
1681924341089,SE 110A,A00,182651,Staff,28,0,28,0
1681924342112,SE 130A,A00,182652,Staff,38,0,40,2
1681924343150,SIO 46GS,A00,182636,Cook; Geoffrey W,25,0,28,3
1681924344176,SIO 109R,A00,194459,Staff,3,0,20,17
1681924345203,SIO 121GS,A00,182639,Cook; Geoffrey W,25,0,28,3
1681924346319,SIO 132,A01,182642,Staff,32,0,40,8
1681924347342,SIO 139,A00,182644,Kacev; David,36,0,40,4
1681924348365,SOCI 2,A01,258404,Staff,33,0,36,3
1681924348365,SOCI 2,A02,258405,Staff,35,0,36,1
1681924349411,SOCI 60,A01,258408,Staff,29,0,30,1
1681924349411,SOCI 60,A02,258413,Staff,30,0,30,0
1681924350433,SOCI 100,A01,258415,Staff,29,0,30,1
1681924350433,SOCI 100,A02,258416,Staff,28,0,30,2
1681924356590,SOCI 127,A00,258421,Staff,21,0,30,9
1681924357616,SOCI 132,A00,258422,Staff,45,0,50,5
1681924358644,SOCI 133,A00,258423,Staff,26,0,30,4
1681924359667,SOCI 138GS,A00,258424,Staff,15,0,15,0
1681924360697,SOCI 145,A00,258425,Staff,25,0,30,5
1681924361723,SOCI 148,A00,258426,Staff,24,0,30,6
1681924362753,SOCI 153,A00,199217,Staff,29,0,30,1
1681924363777,SOCI 160,A00,258427,Staff,28,0,30,2
1681924364881,SOCI 160E,A00,258435,Staff,56,0,60,4
1681924365903,SOCI 189GS,A00,258436,Staff,15,0,15,0
1681924366925,SOCI 190GS,A00,258437,Staff,15,0,15,0
1681924367948,SYN 2,001,182658,Staff,8,0,16,8
1681924367948,SYN 2,002,201439,Staff,14,0,16,2
1681924367948,SYN 2,003,201443,Staff,16,0,16,0
1681924368980,SYN 100,A01,182657,Staff,15,0,20,5
1681924370007,TDAC 1,A00,184381,Salovey; Todd,16,0,20,4
1681924370007,TDAC 1,B00,184385,Harting; Carla Kelso,19,0,20,1
1681924370007,TDAC 1,C00,184394,Staff,19,0,20,1
1681924371033,TDAC 101,A00,184483,Harting; Carla Kelso,19,0,20,1
1681924372057,TDDE 111,A00,184496,Staff,14,0,15,1
1681924373083,TDDE 131,A00,184504,Staff,20,0,20,0
1681924373083,TDDE 131,B00,184505,Staff,17,0,18,1
1681924373083,TDDE 131,C00,184534,Staff,49,0,50,1
1681924373083,TDDE 131,D00,184564,Staff,15,0,15,0
1681924373083,TDDE 131,E00,204725,Staff,19,0,20,1
1681924374106,TDGE 1,A01,184414,Salovey; Todd,36,0,50,14
1681924375132,TDGE 5,A01,184419,Staff,23,0,24,1
1681924376157,TDGE 10,A00,184428,Fulton; Julia,29,0,50,21
1681924377182,TDGE 124,A00,184565,Fulton; Julia,3,0,50,47
1681924378207,TDGE 125,B00,184567,Meyer; Ursula,9,0,25,16
1681924379230,TDHT 101,A00,184568,Staff,21,0,25,4
1681924379230,TDHT 101,B00,184569,Staff,20,0,20,0
1681924380254,TDHT 114,A00,184570,Staff,49,0,50,1
1681924381394,TDMV 1,A00,184437,Arcidiacono; Kristin,22,0,30,8
1681924381394,TDMV 1,B00,184448,Caligagan; Maria T.,23,0,30,7
1681924382424,TDMV 2,A00,184449,Weinberg; Sadie,27,0,30,3
1681924382424,TDMV 2,B00,184453,Arcidiacono; Kristin,29,0,30,1
1681924383446,TDMV 110,A00,184571,Weinberg; Sadie,30,0,30,0
1681924384474,TDMV 142,A00,184572,Caligagan; Tony,27,0,30,3
1681924384474,TDMV 142,B00,184573,Caligagan; Maria T.,26,0,30,4
1681924385498,TDTR 20,A00,184482,Jun; Grace Shin Hae,25,0,25,0
1681924386522,USP 2,A01,184290,Hinds; Juli Beth,24,0,25,1
1681924387545,USP 3,A01,184295,Staff,21,0,25,4
1681924388573,USP 4,A00,184304,McTague; Sarah,13,0,25,12
1681924389604,USP 100,A00,184315,Staff,16,0,25,9
1681924390637,USP 105,A00,184326,Staff,21,0,25,4
1681924391661,USP 151,A00,184327,Staff,19,0,25,6
1681924392687,USP 170,A00,184380,Hinds; Juli Beth,13,0,25,12
1681924393712,VIS 21B,A01,182660,Staff,28,0,31,3
1681924393712,VIS 21B,A02,182662,Staff,30,0,31,1
1681924394735,VIS 103D,A00,182663,Staff,74,0,75,1
1681924395758,VIS 105D,A00,182667,Li; Huai,14,0,22,8
1681924396781,VIS 122GS,A00,182668,Herbst; Matthew,20,0,20,0
1681924397805,VIS 128C,A00,182673,Staff,69,0,75,6
1681924398827,VIS 130,A00,182675,Staff,19,0,22,3
1681924399853,VIS 160A,A00,182678,Stalbaum; Brett,4,0,10,6
1681924401900,WCWP 10B,A00,201679,Staff,15,0,15,0
1681924401900,WCWP 10B,B00,201695,Staff,15,0,15,0
1681924402925,WCWP 100,A00,201716,Staff,12,0,15,3
1681924402925,WCWP 100,B00,201717,Staff,4,0,15,11
1681924405000,ANSC 105GS,A00,258289,Staff,0,0,0,0
1681924406026,ANSC 125GS,A00,258295,Staff,0,0,0,0
1681924407054,ANSC 150,A00,258267,Staff,30,0,40,10
1681924408077,ANSC 190GS,A00,258280,Staff,0,0,0,0
1681924409100,ANTH 1,A00,258264,Staff,38,0,40,2
1681924410130,ANTH 2,A01,258259,Staff,72,0,76,4
1681924411156,ANTH 23,A01,258228,Staff,36,0,40,4
1681924412183,ANTH 101,A01,258236,Staff,38,0,40,2
1681924413214,ANTH 102,A00,258272,Staff,59,0,60,1
1681924414240,ANTH 105,A00,258244,Staff,31,0,35,4
1681924415265,BENG 130,A00,253975,Staff,38,0,40,2
1681924416302,BIBC 102,A01,191866,Flagg; Matthew Paul,19,0,32,13
1681924416302,BIBC 102,A02,191867,Flagg; Matthew Paul,22,0,32,10
1681924416302,BIBC 102,A03,191868,Flagg; Matthew Paul,29,0,32,3
1681924416302,BIBC 102,A04,191936,Flagg; Matthew Paul,26,0,32,6
1681924416302,BIBC 102,A05,191937,Flagg; Matthew Paul,1,0,32,31
1681924417326,BICD 100,A01,191939,Cooper; Andrew Michael,28,0,32,4
1681924417326,BICD 100,A02,191940,Cooper; Andrew Michael,32,0,32,0
1681924417326,BICD 100,A03,191941,Cooper; Andrew Michael,32,0,32,0
1681924417326,BICD 100,A04,191942,Cooper; Andrew Michael,32,0,32,0
1681924417326,BICD 100,A05,191943,Cooper; Andrew Michael,32,0,32,0
1681924418349,BIEB 126,A01,191945,Cleland; Elsa Eleanor,0,1,32,32
1681924418349,BIEB 126,A02,191946,Cleland; Elsa Eleanor,27,0,32,5
1681924418349,BIEB 126,A03,191947,Cleland; Elsa Eleanor,29,0,32,3
1681924418349,BIEB 126,A04,191948,Cleland; Elsa Eleanor,22,0,32,10
1681924418349,BIEB 126,A05,191996,Cleland; Elsa Eleanor,28,0,32,4
1681924419379,BIEB 136GS,A00,191997,Shurin; Jonathan & Holway; David A.,0,0,0,4
1681924420407,BIEB 137GS,A01,191999,Shurin; Jonathan & Holway; David A.,0,0,0,3
1681924421433,BILD 1,A01,205385,Staff,31,0,32,1
1681924421433,BILD 1,A02,205386,Staff,30,0,32,2
1681924421433,BILD 1,A03,205387,Staff,32,0,32,0
1681924421433,BILD 1,A04,205388,Staff,26,0,32,6
1681924422461,BILD 2,A01,191774,Staff,28,0,32,4
1681924422461,BILD 2,A02,191775,Staff,30,0,32,2
1681924422461,BILD 2,A03,191777,Staff,30,0,32,2
1681924422461,BILD 2,A04,191856,Staff,31,0,32,1
1681924422461,BILD 2,A05,191857,Staff,32,0,32,0
1681924422461,BILD 2,A06,191858,Staff,32,0,32,0
1681924422461,BILD 2,A07,191859,Staff,31,0,32,1
1681924423483,BILD 3,A01,205391,Staff,29,0,32,3
1681924423483,BILD 3,A02,205393,Staff,32,0,32,0
1681924423483,BILD 3,A03,205394,Staff,27,0,32,5
1681924423483,BILD 3,A04,205395,Staff,32,0,32,0
1681924424509,BILD 20,A01,191861,Staff,32,0,32,0
1681924424509,BILD 20,A02,191862,Staff,32,0,32,0
1681924425534,BILD 30,A01,191864,Staff,31,0,32,1
1681924426557,BIMM 100,A01,192019,Staff,0,0,32,32
1681924426557,BIMM 100,A02,192020,Staff,19,0,32,13
1681924426557,BIMM 100,A03,192035,Staff,20,0,32,12
1681924427580,BIMM 110,A01,192037,Tat; John,0,0,32,32
1681924427580,BIMM 110,A02,192038,Tat; John,8,0,32,24
1681924428608,BIMM 120,A01,192040,Pickett; Brooke Elizabeth,0,0,32,32
1681924428608,BIMM 120,A02,192041,Pickett; Brooke Elizabeth,12,0,32,20
1681924428608,BIMM 120,A03,192042,Pickett; Brooke Elizabeth,15,0,32,17
1681924429635,BIPN 100,A01,192044,Armour; Jon Christopher,23,0,32,9
1681924429635,BIPN 100,A02,192059,Armour; Jon Christopher,30,0,32,2
1681924429635,BIPN 100,A03,192064,Armour; Jon Christopher,30,0,32,2
1681924429635,BIPN 100,A04,192073,Armour; Jon Christopher,28,0,32,4
1681924430661,BIPN 148,A01,205411,Leutgeb; Jill K.,15,0,32,17
1681924430661,BIPN 148,A02,205412,Leutgeb; Jill K.,31,0,32,1
1681924430661,BIPN 148,A03,205413,Leutgeb; Jill K.,30,0,32,2
1681924430661,BIPN 148,A04,205414,Leutgeb; Jill K.,30,0,32,2
1681924431690,BIPN 160,A01,192115,Marino; Marc J,16,0,32,16
1681924431690,BIPN 160,A02,192148,Marino; Marc J,27,0,32,5
1681924431690,BIPN 160,A03,192158,Marino; Marc J,31,0,32,1
1681924431690,BIPN 160,A04,192190,Marino; Marc J,32,0,32,0
1681924431690,BIPN 160,A05,192287,Marino; Marc J,32,0,32,0
1681924431690,BIPN 160,A06,192288,Marino; Marc J,32,0,32,0
1681924432716,BIPN 194,A00,206038,Staff,28,0,32,4
1681924433742,BISP 194,A00,192289,Leutgeb; Stefan,11,0,32,21
1681924433742,BISP 194,B00,245332,Nieh; James Charles,26,0,32,6
1681924434776,CAT 124,A01,202247,Staff,15,0,15,0
1681924435824,CAT 125,A00,202248,Staff,18,0,20,2
1681924435824,CAT 125,B00,202253,Staff,20,0,20,0
1681924435824,CAT 125,C00,202257,Staff,18,0,20,2
1681924436857,CAT 125GS,A01,202273,Bronstein; Phoebe Malan,20,0,20,0
1681924437884,CAT 125R,A00,202284,Staff,18,0,20,2
1681924437884,CAT 125R,C00,202286,Staff,8,0,20,12
1681924437884,CAT 125R,D00,202291,Staff,17,0,20,3
1681924437884,CAT 125R,E00,202295,Staff,13,0,20,7
1681924437884,CAT 125R,F00,202302,Staff,8,0,20,12
1681924438910,CENG 100,A00,204724,Opatkiewicz; Justin Paul,25,0,25,0
1681924439933,CGS 2A,A01,180420,Staff,31,0,36,5
1681924440957,CGS 101,A00,180421,Staff,16,0,20,4
1681924441980,CGS 112,A00,180422,Staff,9,0,16,7
1681924443007,CGS 113,A00,180423,Staff,18,0,20,2
1681924444039,CGS 137,A00,180424,Staff,12,0,12,0
1681924445062,CGS 147,A00,180425,Staff,10,0,10,0
1681924446085,CHEM 6A,A01,179556,Staff,95,0,100,5
1681924446085,CHEM 6A,A02,179558,Staff,0,0,0,0
1681924447119,CHEM 6B,A01,179560,Staff,100,0,100,0
1681924448145,CHEM 6C,A01,179565,Jazzar; Rodolphe,94,0,100,6
1681924449174,CHEM 7L,A01,179586,Schurmeier; Kimberly,10,0,24,14
1681924449174,CHEM 7L,A02,179587,Schurmeier; Kimberly,23,0,24,1
1681924449174,CHEM 7L,A03,179590,Schurmeier; Kimberly,22,0,24,2
1681924449174,CHEM 7L,A04,179591,Schurmeier; Kimberly,22,0,24,2
1681924449174,CHEM 7L,B01,179598,Schurmeier; Kimberly,16,0,24,8
1681924449174,CHEM 7L,B02,179599,Schurmeier; Kimberly,24,0,24,0
1681924449174,CHEM 7L,B03,179606,Schurmeier; Kimberly,23,0,24,1
1681924449174,CHEM 7L,B04,179607,Schurmeier; Kimberly,23,0,24,1
1681924450209,CHEM 11,A01,179609,Stallings; Dontarie M,87,0,100,13
1681924451231,CHEM 40A,A01,179621,Staff,40,0,50,10
1681924451231,CHEM 40A,A02,179622,Staff,46,0,50,4
1681924452254,CHEM 40B,A01,179630,Weizman; Haim,47,0,50,3
1681924452254,CHEM 40B,A02,179631,Weizman; Haim,44,0,50,6
1681924453289,CHEM 41A,A01,179660,Klosterman; Jeremy K,93,0,100,7
1681924454313,CHEM 43A,A01,179683,Klosterman; Jeremy K,0,0,24,24
1681924454313,CHEM 43A,A02,179688,Klosterman; Jeremy K,8,0,24,16
1681924454313,CHEM 43A,A03,179689,Klosterman; Jeremy K,19,0,24,5
1681924454313,CHEM 43A,A04,179691,Klosterman; Jeremy K,18,0,24,6
1681924455341,CHEM 114A,A01,179693,Stallings; Dontarie M,70,0,100,30
1681924456381,CHEM 143B,A01,179698,Weizman; Haim,16,0,24,8
1681924456381,CHEM 143B,A02,179700,Weizman; Haim,24,0,24,0
1681924457406,CHIN 169A,A00,179701,Wang; Xiao,20,0,20,0
1681924458433,COGS 2,A01,179750,Boyle; Mary E. T.,17,0,30,13
1681924459457,COGS 9,A01,179759,Jones; Cameron Robert,42,0,50,8
1681924460484,COGS 14A,A01,179854,Staff,15,0,50,35
1681924461512,COGS 14B,A01,179856,Staff,53,0,60,7
1681924462534,COGS 17,A01,179874,Staff,71,0,75,4
1681924463559,COGS 18,A01,179884,Staff,62,0,80,18
1681924464584,COGS 100,A01,179886,Staff,36,0,60,24
1681924465618,COGS 101B,A01,179892,Staff,0,0,30,30
1681924466642,COGS 101C,A01,179894,Staff,28,0,30,2
1681924467668,COGS 107A,A01,179896,Boyle; Mary E. T.,30,0,40,10
1681924468767,COGS 108,A01,179898,Simpkins; Charles Alexander,0,25,60,60
1681924469795,COGS 109,A01,179900,Staff,34,0,40,6
1681924470817,COGS 118A,A01,179946,Staff,6,0,40,34
1681924471842,COGS 153,A00,179978,Staff,0,3,30,30
1681924472865,COGS 156,A01,179981,Staff,23,0,30,7
1681924474916,COGS 172,A01,179987,Staff,13,0,30,17
1681924476966,COGS 186,A01,179991,Staff,12,0,30,18
1681924477990,COMM 10,A01,180001,Staff,13,0,25,12
1681924477990,COMM 10,A02,180004,Staff,20,0,25,5
1681924479017,COMM 100A,A01,180016,Staff,15,0,25,10
1681924479017,COMM 100A,A02,180020,Staff,24,0,25,1
1681924480041,COMM 101T,A00,180029,Halm; Gavin Patrick,22,0,35,13
1681924481077,COMM 106V,A00,180043,Staff,34,0,35,1
1681924482102,COMM 109P,A00,180044,Staff,30,0,35,5
1681924483127,COMM 113T,A00,180045,Havis; Allan,37,0,45,8
1681924484162,COMM 132,A00,180046,McKenna; Denise,23,0,30,7
1681924485184,COMM 143,A00,180047,Staff,18,0,30,12
1681924486207,COMM 190,A00,180048,Conner; Thomas Hartnell,18,0,23,5
1681924487231,CSE 8A,A50,180053,Cao; Yingjun,21,0,50,29
1681924487231,CSE 8A,B50,180180,Staff,50,0,50,0
1681924488253,CSE 11,A01,180190,Cao; Yingjun,25,0,50,25
1681924489279,CSE 20,A01,180192,Briones; Jor-el Thomas Caparas,22,0,30,8
1681924490301,CSE 21,A01,194538,Briones; Jor-el Thomas Caparas,50,0,60,10
1681924491327,CSE 30,A01,180324,Eldon; John,75,0,100,25
1681924492354,CSE 101,A01,201353,Staff,0,26,40,40
1681924493381,CSE 134B,A01,180326,Powell; Thomas Allan,74,0,100,26
1681924494404,CSE 140,A01,180328,Staff,38,0,75,37
1681924495427,CSE 140L,A01,180344,Eldon; John,61,0,100,39
1681924496458,CSE 150A,A01,180411,Staff,0,15,50,50
1681924497483,CSE 151A,A01,180414,Staff,0,8,50,50
1681924498508,CSE 175,A01,222521,Kumar; Rakesh,50,0,50,0
1681924499533,CSE 190,A00,201419,Staff,43,0,49,6
1681924500557,CSS 1,A01,194536,Staff,36,0,50,14
1681924501578,DSC 30,A01,202385,Staff,48,0,50,2
1681924502602,DSC 40A,A01,202387,Albuyeh; Rod,50,0,50,0
1681924503631,DSC 190,A01,202389,Silberman; Jack,21,0,21,0
1681924504657,DSGN 100,A01,179993,Staff,15,0,30,15
1681924505689,ECE 65,A50,180708,Staff,10,0,20,10
1681924505689,ECE 65,A51,180739,Staff,19,0,20,1
1681924506713,ECON 1,A01,180427,Famulari; Melissa,67,0,70,3
1681924507736,ECON 2,A01,180450,Levkoff; Steven B.,64,0,70,6
1681924508763,ECON 4,A01,203351,Anderson; John Charles,6,0,10,4
1681924509801,ECON 100A,A01,180472,Famulari; Melissa,59,0,70,11
1681924510823,ECON 120A,A01,180549,Staff,63,0,70,7
1681924511845,ECON 120B,A01,180655,Ma; Xinwei,42,0,70,28
1681924512873,ECON 129,A00,203333,Eckert; Fabian Paul,12,0,35,23
1681924513897,ECON 131,A00,180656,Staff,5,0,35,30
1681924514928,ECON 172B,A01,180672,Levkoff; Steven B.,31,0,35,4
1681924515965,ECON 178,A01,203342,Zhu; Ying,8,0,35,27
1681924516987,EDS 108GS,A00,202383,Wishard Guerra; Alison G.,20,0,20,0
1681924518013,EDS 111GS,A00,202347,Wishard Guerra; Alison G.,20,0,20,0
1681924519035,EDS 112,A01,202323,Staff,54,0,60,6
1681924520057,EDS 113,A00,202340,Staff,32,0,35,3
1681924521083,EDS 118,A00,201231,Staff,19,0,30,11
1681924522106,EDS 119,A00,204994,Staff,8,0,10,2
1681924523130,EDS 124BR,A00,202324,Eguchi; Emi,1,0,25,24
1681924524155,EDS 126,A01,203208,Jones; Makeba,26,0,30,4
1681924525178,EDS 135,A01,202333,Staff,17,0,20,3
1681924526202,EDS 180,A00,202311,Staff,47,0,50,3
1681924527227,ERC 190GS,A01,253747,Staff,28,0,28,0
1681924528253,ETHN 104,A00,180742,Staff,22,0,35,13
1681924529283,ETHN 118,A00,180745,Staff,27,0,35,8
1681924530306,ETHN 127,A00,180747,Staff,11,0,16,5
1681924531334,ETHN 137,A00,180880,Staff,11,0,12,1
1681924532357,ETHN 147,A00,180890,Staff,8,0,10,2
1681924533379,ETHN 154,A00,180891,Staff,7,0,8,1
1681924534404,ETHN 168,A00,180892,Staff,9,0,10,1
1681924535430,GLBH 20,A00,201051,Hannah; Seth Donal,0,3,0,1
1681924536456,GLBH 111,A01,209338,Burgos; Jose L.,0,0,0,0
1681924537481,GLBH 150,A00,258300,Staff,0,3,0,0
1681924538505,GLBH 181,A00,201207,Staff,12,0,40,28
1681924539531,HIEU 109,A00,180898,Staff,19,0,20,1
1681924540554,HIEU 111,A00,180899,Staff,0,2,20,20
1681924541585,HIEU 124,A00,180900,Staff,17,0,20,3
1681924542611,HILA 122,A00,180901,Staff,18,0,20,2
1681924543641,HILA 132,A00,180902,Vitz; Matthew,0,0,20,20
1681924544666,HILD 10,A01,180896,Staff,14,0,20,6
1681924545696,HILD 30GS,A00,180897,Edington; Claire Ellen,0,0,0,0
1681924546720,HISC 105,A00,180903,Staff,20,0,20,0
1681924547744,HISC 117,A00,180904,Staff,10,0,20,10
1681924548781,HIUS 108B,A00,181005,Staff,18,0,20,2
1681924549811,HIUS 113,A00,181093,Staff,0,0,20,20
1681924550838,HUM 3,A01,181190,Patterson; Patrick H.,38,0,50,12
1681924550838,HUM 3,B01,181195,Staff,46,0,50,4
1681924551863,HUM 3GS,A00,181196,Herbst; Matthew,0,0,0,0
1681924552890,HUM 4,A01,181227,West; Geoffrey Scott,33,0,50,17
1681924552890,HUM 4,B01,181282,Staff,41,0,50,9
1681924553913,HUM 4GS,A00,181377,Lyon; Antony J.,0,0,0,0
1681924554941,HUM 5,A01,181536,Zavodny; Tatiana Sophia,27,0,50,23
1681924554941,HUM 5,B01,181908,Staff,35,0,50,15
1681924555967,INTL 190,A00,181909,Segui; Alan S,0,0,0,8
1681924555967,INTL 190,B00,181961,Segui; Alan S,0,0,0,7
1681924556994,JAPN 20AR,A01,182113,Ross; Kayoko F,15,0,20,5
1681924558016,LATI 50,A01,202391,Martin-Cabrera; Luis,17,0,30,13
1681924558016,LATI 50,A02,202392,Martin-Cabrera; Luis,26,0,30,4
1681924559039,LATI 180,A00,202393,Kokinis; Troy Andreas,24,0,25,1
1681924560065,LIFR 1A,A00,182119,Staff,14,0,14,0
1681924561088,LIFR 1AX,A00,182324,Staff,14,0,14,0
1681924562110,LIFR 1B,A00,182259,Staff,12,0,14,2
1681924563144,LIFR 1BX,A00,182273,Staff,13,0,14,1
1681924564181,LIGN 8,A00,182330,Staff,132,0,150,18
1681924565205,LIGN 9GS,A00,182362,Staff,20,0,20,0
1681924566235,LIGN 119,A00,204992,Takahashi; Maho,11,0,15,4
1681924567261,LIGN 130,A01,182384,Staff,47,0,50,3
1681924568286,LIGN 149GS,A00,182390,Staff,20,0,20,0
1681924569319,LIGN 170,A00,182404,Staff,23,0,30,7
1681924570346,LISP 1D,A00,182281,Staff,7,0,14,7
1681924570346,LISP 1D,B00,182287,Staff,13,0,14,1
1681924570346,LISP 1D,C00,182295,Staff,10,0,14,4
1681924570346,LISP 1D,D00,182301,Staff,14,0,14,0
1681924571371,LISP 1DX,A00,182309,Staff,19,0,28,9
1681924571371,LISP 1DX,B00,182316,Staff,25,0,28,3
1681924572469,LTAF 120GS,A00,182412,Zhiri; Oumelbanine,20,0,20,0
1681924573496,LTCS 172GS,A00,182437,Bronstein; Phoebe Malan,20,0,20,0
1681924574522,LTEA 138,A00,182457,Staff,19,0,40,21
1681924575549,LTEN 114,A01,182490,Staff,23,0,25,2
1681924576572,LTEN 130GS,A00,182491,Lyon; Antony J.,20,0,20,0
1681924577598,LTEN 169,A00,182493,Cuong; Marisol,19,0,25,6
1681924578621,LTEN 178,A00,182501,Staff,14,0,15,1
1681924579648,LTEN 181,A00,182515,Staff,20,0,25,5
1681924580671,LTEN 185GS,A00,197655,Forbes; Camille,20,0,20,0
1681924581698,LTSP 100B,A00,202208,Bessett; Ryan Matthew,24,0,25,1
1681924582721,LTWL 100,A00,182516,Myerston Santana; Jacobo,20,0,30,10
1681924583747,LTWR 100GS,A00,182518,Forbes; Camille,20,0,20,0
1681924584793,LTWR 102,A00,182522,Staff,15,0,15,0
1681924584793,LTWR 102,B00,182525,Staff,14,0,15,1
1681924585820,LTWR 115,A00,182526,Staff,11,0,15,4
1681924586851,MAE 8,A01,182528,Pham; Hieu Tan,67,0,70,3
1681924587875,MAE 11,A00,182529,Bahadori; Mohammad Yousef,93,0,100,7
1681924588899,MAE 20,A00,182530,Evdokimenko; Ekaterina,68,0,70,2
1681924589922,MAE 30A,A00,182532,Staff,44,0,45,1
1681924590946,MAE 101A,A00,182533,Bahadori; Mohammad Yousef,95,0,100,5
1681924591968,MAE 101C,A00,182538,Staff,62,0,70,8
1681924592992,MAE 104,A00,182539,Staff,44,0,50,6
1681924594016,MAE 131A,A00,182540,Ghazinejad; Maziar,40,0,45,5
1681924595039,MAE 143A,A00,182548,Bewley; Thomas R,43,0,50,7
1681924596062,MAE 150,A00,182549,Staff,28,0,40,12
1681924597086,MAE 160,A00,182550,Evdokimenko; Ekaterina,41,0,60,19
1681924598111,MATH 3C,A01,182725,Staff,24,0,30,6
1681924599134,MATH 10A,A01,182729,Staff,25,0,30,5
1681924599134,MATH 10A,B01,182732,Staff,25,0,30,5
1681924600157,MATH 10B,A01,182737,Staff,18,0,30,12
1681924600157,MATH 10B,A02,182738,Staff,26,0,30,4
1681924600157,MATH 10B,B01,182744,Staff,27,0,30,3
1681924600157,MATH 10B,B02,182745,Staff,27,0,30,3
1681924601185,MATH 18,A01,182750,Anzaldo; Leesa B,28,0,30,2
1681924601185,MATH 18,A02,182751,Anzaldo; Leesa B,28,0,30,2
1681924601185,MATH 18,A03,182753,Anzaldo; Leesa B,27,0,30,3
1681924601185,MATH 18,A04,182757,Anzaldo; Leesa B,29,0,30,1
1681924601185,MATH 18,B01,182761,Anzaldo; Leesa B,27,0,30,3
1681924601185,MATH 18,B02,182764,Anzaldo; Leesa B,26,0,30,4
1681924601185,MATH 18,B03,182765,Anzaldo; Leesa B,29,0,30,1
1681924601185,MATH 18,B04,182766,Anzaldo; Leesa B,30,0,30,0
1681924602208,MATH 20A,A01,182771,Suk; Andrew Hoon,28,0,30,2
1681924603244,MATH 20B,A01,182775,Bach; Quang Tran,30,0,30,0
1681924603244,MATH 20B,A02,182777,Bach; Quang Tran,29,0,30,1
1681924603244,MATH 20B,B01,182780,Bach; Quang Tran,26,0,30,4
1681924603244,MATH 20B,B02,182782,Bach; Quang Tran,30,0,30,0
1681924604267,MATH 20C,A01,182787,Staff,24,0,30,6
1681924604267,MATH 20C,A02,182790,Staff,29,0,30,1
1681924604267,MATH 20C,B01,182792,Staff,24,0,30,6
1681924604267,MATH 20C,B02,182796,Staff,26,0,30,4
1681924605295,MATH 20D,A01,182799,Staff,27,0,30,3
1681924605295,MATH 20D,A02,182802,Staff,29,0,30,1
1681924605295,MATH 20D,A03,182803,Staff,30,0,30,0
1681924606323,MATH 20E,A01,182809,Verstraete; Jacques Allan,22,0,30,8
1681924606323,MATH 20E,A02,182811,Verstraete; Jacques Allan,28,0,30,2
1681924606323,MATH 20E,B01,182814,Verstraete; Jacques Allan,22,0,30,8
1681924606323,MATH 20E,B02,182815,Verstraete; Jacques Allan,30,0,30,0
1681924607353,MATH 103A,A01,182820,Staff,6,0,30,24
1681924607353,MATH 103A,A02,182821,Staff,27,0,30,3
1681924607353,MATH 103A,A03,182822,Staff,23,0,30,7
1681924607353,MATH 103A,B01,182825,Staff,23,0,30,7
1681924607353,MATH 103A,B02,182826,Staff,30,0,30,0
1681924607353,MATH 103A,B03,182830,Staff,30,0,30,0
1681924608378,MATH 109,A01,182836,Chow; Bennett,24,0,30,6
1681924608378,MATH 109,A02,182838,Chow; Bennett,29,0,30,1
1681924608378,MATH 109,A03,182894,Chow; Bennett,29,0,30,1
1681924608378,MATH 109,B01,182908,Chow; Bennett,27,0,30,3
1681924608378,MATH 109,B02,182909,Chow; Bennett,30,0,30,0
1681924608378,MATH 109,B03,182910,Chow; Bennett,26,0,30,4
1681924609401,MATH 142A,A01,182925,Staff,8,0,30,22
1681924609401,MATH 142A,A02,182935,Staff,24,0,30,6
1681924609401,MATH 142A,A03,182967,Staff,26,0,30,4
1681924609401,MATH 142A,B01,183125,Staff,23,0,30,7
1681924609401,MATH 142A,B02,183157,Staff,28,0,30,2
1681924609401,MATH 142A,B03,183158,Staff,29,0,30,1
1681924610429,MATH 183,A01,183160,Arias-Castro; Ery,23,0,30,7
1681924610429,MATH 183,A02,183161,Arias-Castro; Ery,29,0,30,1
1681924610429,MATH 183,B01,183163,Arias-Castro; Ery,28,0,30,2
1681924610429,MATH 183,B02,183164,Arias-Castro; Ery,28,0,30,2
1681924611454,MATH 193A,A01,183167,Staff,0,0,35,35
1681924611454,MATH 193A,A02,183168,Staff,27,0,35,8
1681924611454,MATH 193A,A03,183169,Staff,34,0,35,1
1681924611454,MATH 193A,A04,183170,Staff,27,0,35,8
1681924612481,MGT 4,A01,202395,Anderson; John Charles,75,0,80,5
1681924613510,MGT 5,A00,202396,Houskeeper; Robert,79,0,90,11
1681924614535,MGT 103,A00,202397,Eberhard; Craig A,49,0,90,41
1681924615561,MGT 131A,A00,202398,Houskeeper; Robert,83,0,90,7
1681924616582,MGT 135,A00,202399,Anderson; John Charles,81,0,90,9
1681924617611,MGT 162R,A00,202403,Gneezy; Uri,136,0,200,64
1681924618634,MGT 172,A00,202404,Hedges; Kathleen,39,0,90,51
1681924619664,MGT 181,A00,202405,Dunn; Louis Jean,80,0,90,10
1681924620689,MMW 14,A01,183200,Staff,7,0,28,21
1681924620689,MMW 14,A02,183201,Staff,26,0,28,2
1681924620689,MMW 14,A03,183202,Staff,24,0,28,4
1681924620689,MMW 14,A04,183203,Staff,25,0,28,3
1681924620689,MMW 14,A05,183204,Staff,26,0,28,2
1681924620689,MMW 14,A06,183205,Staff,27,0,28,1
1681924620689,MMW 14,B01,183207,Staff,26,0,28,2
1681924620689,MMW 14,B02,183208,Staff,28,0,28,0
1681924620689,MMW 14,B03,183209,Staff,28,0,28,0
1681924620689,MMW 14,B04,183210,Staff,28,0,28,0
1681924620689,MMW 14,B05,183211,Staff,28,0,28,0
1681924620689,MMW 14,B06,183212,Staff,27,0,28,1
1681924621714,MMW 14GS,A00,183213,Zhiri; Oumelbanine,28,0,28,0
1681924622737,MMW 15GS,B00,183215,Rahimi; Babak,28,0,28,0
1681924623761,MMW 121,A01,183217,Patterson; Patrick H.,11,0,28,17
1681924623761,MMW 121,A02,183218,Patterson; Patrick H.,25,0,28,3
1681924624784,MUS 1A,A01,182554,Staff,4,0,35,31
1681924625830,MUS 5,A01,182558,Staff,17,0,35,18
1681924626854,MUS 6,A01,182562,Staff,22,0,35,13
1681924627881,MUS 8GS,A00,182563,Borgo; David Garcia,25,0,25,0
1681924628905,MUS 13,A01,182567,Staff,24,0,25,1
1681924629935,MUS 15,A01,182570,Staff,31,0,35,4
1681924629935,MUS 15,B01,182575,Staff,7,0,35,28
1681924630974,MUS 80,A00,182578,Staff,22,0,25,3
1681924630974,MUS 80,B00,182581,Staff,20,0,25,5
1681924631996,MUS 113,A00,182582,Staff,25,0,25,0
1681924633019,MUS 114,A00,182583,Staff,3,0,25,22
1681924634042,MUS 150GS,A01,182588,Borgo; David Garcia,25,0,25,0
1681924635067,PHIL 1,A00,182590,Staff,34,0,40,6
1681924636093,PHIL 10,A01,182596,Grush; Rick Scott,30,0,35,5
1681924636093,PHIL 10,A02,182597,Grush; Rick Scott,33,0,35,2
1681924637116,PHIL 15,A01,182601,Staff,31,0,35,4
1681924637116,PHIL 15,A02,182602,Staff,33,0,35,2
1681924638138,PHIL 27,A01,182604,Staff,30,0,35,5
1681924638138,PHIL 27,A02,182607,Staff,35,0,35,0
1681924639168,PHIL 32,A01,182609,Staff,35,0,35,0
1681924639168,PHIL 32,A02,182612,Staff,35,0,35,0
1681924640202,PHIL 130,A00,182614,Staff,61,0,70,9
1681924641225,PHIL 136,A00,182616,Cohen; Jonathan David,66,0,70,4
1681924642250,PHIL 155,A00,182617,Vargas; Manuel Rogelio,58,0,70,12
1681924643286,PHIL 163,A01,182620,Staff,15,0,20,5
1681924643286,PHIL 163,A02,182624,Staff,10,0,20,10
1681924644315,PHIL 164,A00,182627,Staff,29,0,40,11
1681924645338,PHIL 173,A00,182628,Staff,36,0,40,4
1681924646362,PHYS 1A,A00,183221,Staff,54,0,60,6
1681924647392,PHYS 1AL,001,183222,Staff,25,0,30,5
1681924647392,PHYS 1AL,002,183223,Staff,27,0,30,3
1681924648417,PHYS 1B,A00,183231,Staff,43,0,60,17
1681924649440,PHYS 1BL,001,183232,Staff,20,0,30,10
1681924649440,PHYS 1BL,002,183233,Staff,27,0,30,3
1681924650474,PHYS 1C,A00,183240,Staff,24,0,60,36
1681924651496,PHYS 1CL,001,183241,Staff,9,0,30,21
1681924651496,PHYS 1CL,002,183242,Staff,22,0,30,8
1681924652518,PHYS 2AR,A01,183250,Staff,43,0,50,7
1681924653546,PHYS 2B,A01,183252,Staff,104,0,115,11
1681924654575,PHYS 2BL,A01,183254,Staff,21,0,24,3
1681924654575,PHYS 2BL,A02,183255,Staff,21,0,24,3
1681924655601,PHYS 2C,A01,183522,Staff,102,0,115,13
1681924656626,PHYS 4A,A01,183524,Staff,49,0,50,1
1681924657649,POLI 5,A00,183525,Staff,44,0,50,6
1681924658671,POLI 12,A00,183540,Staff,45,0,50,5
1681924659693,POLI 13R,A00,183541,Forman; Fonna,41,0,50,9
1681924660716,POLI 30,A00,183542,Mignozzetti; Umberto,48,0,50,2
1681924661739,POLI 100A,A00,183543,Staff,45,0,50,5
1681924662766,POLI 100E,A00,223598,Staff,32,0,35,3
1681924663790,POLI 103A,A00,183564,Kousser; Thad,37,0,50,13
1681924664815,POLI 104B,A00,201329,Staff,28,0,35,7
1681924665846,POLI 113BR,A00,183576,Hoston; Germaine,24,0,50,26
1681924666873,POLI 114BR,A00,183588,Staff,27,0,30,3
1681924667902,POLI 117R,A00,183595,Forman; Fonna,4,0,20,16
1681924668924,POLI 120H,A00,183596,Fisk; David Lee,13,0,20,7
1681924669947,POLI 130AA,A00,183597,Staff,13,0,20,7
1681924670970,POLI 134AA,A00,183598,Staff,19,0,20,1
1681924671993,POLI 135,A00,183599,Fisk; David Lee,19,0,25,6
1681924673023,POLI 142P,A00,183623,Staff,37,0,40,3
1681924674046,POLI 144D,A00,183624,Staff,22,0,25,3
1681924675074,POLI 151,A00,183625,Staff,15,0,20,5
1681924676176,POLI 162,A00,183626,Mignozzetti; Umberto,17,0,20,3
1681924677200,PSYC 1,A00,253748,Staff,86,0,90,4
1681924678224,PSYC 2,A00,183627,Moranton; Nirelia Melbina-,24,0,35,11
1681924679247,PSYC 3,A00,183628,Staff,43,0,45,2
1681924681305,PSYC 60,A01,183631,Lowe; Angela Beth,35,0,40,5
1681924682330,PSYC 70,A01,253757,Staff,37,0,45,8
1681924683352,PSYC 101,A00,183632,Heyman; Gail D.,45,0,60,15
1681924684375,PSYC 105,A00,183848,Lowe; Angela Beth,47,0,60,13
1681924685400,PSYC 106,A00,183849,Dobkins; Karen R.,42,0,60,18
1681924686432,PSYC 108,A00,253750,Staff,18,0,60,42
1681924687455,PSYC 114,A01,184275,Winkielman; Piotr,0,7,30,30
1681924688478,PSYC 122,A00,183856,Moranton; Nirelia Melbina-,0,15,30,30
1681924689505,PSYC 124,A00,183865,Chapman; Eddie Nathaniel,49,0,80,31
1681924690535,PSYC 137,A00,183880,Staff,19,0,25,6
1681924692583,PSYC 154,A00,183910,Lacefield; Katharine I,0,21,90,90
1681924694638,PSYC 162,A00,183946,Wixted; John T,51,0,90,39
1681924695661,PSYC 172,A00,183947,Gorman; Michael R.,9,0,30,21
1681924696687,PSYC 178,A00,183963,Glaser; Dale,17,0,40,23
1681924697712,PSYC 181GS,A00,183964,Anagnostaras; Stephan,10,0,10,0
1681924698733,PSYC 186GS,A01,257660,Staff,10,0,10,0
1681924699756,PSYC 193,B00,253749,Staff,23,0,25,2
1681924701810,PSYC 193L,A01,184122,Staff,33,0,35,2
1681924701810,PSYC 193L,C01,184167,Winkielman; Piotr,14,0,30,16
1681924702842,RELI 188GS,A00,182629,Rahimi; Babak,20,0,20,0
1681924703869,SE 101A,A00,182646,Staff,26,0,30,4
1681924704893,SE 101C,A00,182650,Staff,17,0,20,3
1681924705916,SE 110A,A00,182651,Staff,28,0,28,0
1681924706942,SE 130A,A00,182652,Staff,38,0,40,2
1681924707965,SIO 46GS,A00,182636,Cook; Geoffrey W,25,0,28,3
1681924708990,SIO 109R,A00,194459,Staff,3,0,20,17
1681924710017,SIO 121GS,A00,182639,Cook; Geoffrey W,25,0,28,3
1681924711042,SIO 132,A01,182642,Staff,32,0,40,8
1681924712065,SIO 139,A00,182644,Kacev; David,36,0,40,4
1681924713122,SOCI 2,A01,258404,Staff,33,0,36,3
1681924713122,SOCI 2,A02,258405,Staff,35,0,36,1
1681924714147,SOCI 60,A01,258408,Staff,29,0,30,1
1681924714147,SOCI 60,A02,258413,Staff,30,0,30,0
1681924715177,SOCI 100,A01,258415,Staff,29,0,30,1
1681924715177,SOCI 100,A02,258416,Staff,28,0,30,2
1681924721338,SOCI 127,A00,258421,Staff,21,0,30,9
1681924722361,SOCI 132,A00,258422,Staff,45,0,50,5
1681924723387,SOCI 133,A00,258423,Staff,26,0,30,4
1681924724410,SOCI 138GS,A00,258424,Staff,15,0,15,0
1681924725437,SOCI 145,A00,258425,Staff,25,0,30,5
1681924726463,SOCI 148,A00,258426,Staff,24,0,30,6
1681924727487,SOCI 153,A00,199217,Staff,29,0,30,1
1681924728520,SOCI 160,A00,258427,Staff,28,0,30,2
1681924729545,SOCI 160E,A00,258435,Staff,56,0,60,4
1681924730567,SOCI 189GS,A00,258436,Staff,15,0,15,0
1681924731590,SOCI 190GS,A00,258437,Staff,15,0,15,0
1681924732617,SYN 2,001,182658,Staff,8,0,16,8
1681924732617,SYN 2,002,201439,Staff,14,0,16,2
1681924732617,SYN 2,003,201443,Staff,16,0,16,0
1681924733646,SYN 100,A01,182657,Staff,15,0,20,5
1681924734674,TDAC 1,A00,184381,Salovey; Todd,16,0,20,4
1681924734674,TDAC 1,B00,184385,Harting; Carla Kelso,19,0,20,1
1681924734674,TDAC 1,C00,184394,Staff,19,0,20,1
1681924735702,TDAC 101,A00,184483,Harting; Carla Kelso,19,0,20,1
1681924736731,TDDE 111,A00,184496,Staff,14,0,15,1
1681924737755,TDDE 131,A00,184504,Staff,20,0,20,0
1681924737755,TDDE 131,B00,184505,Staff,17,0,18,1
1681924737755,TDDE 131,C00,184534,Staff,49,0,50,1
1681924737755,TDDE 131,D00,184564,Staff,15,0,15,0
1681924737755,TDDE 131,E00,204725,Staff,19,0,20,1
1681924738777,TDGE 1,A01,184414,Salovey; Todd,36,0,50,14
1681924739800,TDGE 5,A01,184419,Staff,23,0,24,1
1681924740826,TDGE 10,A00,184428,Fulton; Julia,29,0,50,21
1681924741855,TDGE 124,A00,184565,Fulton; Julia,3,0,50,47
1681924742882,TDGE 125,B00,184567,Meyer; Ursula,9,0,25,16
1681924743907,TDHT 101,A00,184568,Staff,21,0,25,4
1681924743907,TDHT 101,B00,184569,Staff,20,0,20,0
1681924744941,TDHT 114,A00,184570,Staff,49,0,50,1
1681924745975,TDMV 1,A00,184437,Arcidiacono; Kristin,22,0,30,8
1681924745975,TDMV 1,B00,184448,Caligagan; Maria T.,23,0,30,7
1681924746998,TDMV 2,A00,184449,Weinberg; Sadie,27,0,30,3
1681924746998,TDMV 2,B00,184453,Arcidiacono; Kristin,29,0,30,1
1681924748025,TDMV 110,A00,184571,Weinberg; Sadie,30,0,30,0
1681924749051,TDMV 142,A00,184572,Caligagan; Tony,27,0,30,3
1681924749051,TDMV 142,B00,184573,Caligagan; Maria T.,26,0,30,4
1681924750076,TDTR 20,A00,184482,Jun; Grace Shin Hae,25,0,25,0
1681924751103,USP 2,A01,184290,Hinds; Juli Beth,24,0,25,1
1681924752126,USP 3,A01,184295,Staff,21,0,25,4
1681924753154,USP 4,A00,184304,McTague; Sarah,13,0,25,12
1681924754177,USP 100,A00,184315,Staff,16,0,25,9
1681924755200,USP 105,A00,184326,Staff,21,0,25,4
1681924756236,USP 151,A00,184327,Staff,19,0,25,6
1681924757258,USP 170,A00,184380,Hinds; Juli Beth,13,0,25,12
1681924758284,VIS 21B,A01,182660,Staff,28,0,31,3
1681924758284,VIS 21B,A02,182662,Staff,30,0,31,1
1681924759306,VIS 103D,A00,182663,Staff,74,0,75,1
1681924760328,VIS 105D,A00,182667,Li; Huai,14,0,22,8
1681924761357,VIS 122GS,A00,182668,Herbst; Matthew,20,0,20,0
1681924762378,VIS 128C,A00,182673,Staff,69,0,75,6
1681924763403,VIS 130,A00,182675,Staff,19,0,22,3
1681924764425,VIS 160A,A00,182678,Stalbaum; Brett,4,0,10,6
1681924766475,WCWP 10B,A00,201679,Staff,15,0,15,0
1681924766475,WCWP 10B,B00,201695,Staff,15,0,15,0
1681924767498,WCWP 100,A00,201716,Staff,12,0,15,3
1681924767498,WCWP 100,B00,201717,Staff,4,0,15,11
1681924769568,ANSC 105GS,A00,258289,Staff,0,0,0,0
1681924770593,ANSC 125GS,A00,258295,Staff,0,0,0,0
1681924771620,ANSC 150,A00,258267,Staff,30,0,40,10
1681924772642,ANSC 190GS,A00,258280,Staff,0,0,0,0
1681924773664,ANTH 1,A00,258264,Staff,38,0,40,2
1681924774696,ANTH 2,A01,258259,Staff,72,0,76,4
1681924775723,ANTH 23,A01,258228,Staff,36,0,40,4
1681924776750,ANTH 101,A01,258236,Staff,38,0,40,2
1681924777774,ANTH 102,A00,258272,Staff,59,0,60,1
1681924778799,ANTH 105,A00,258244,Staff,31,0,35,4
1681924779901,BENG 130,A00,253975,Staff,38,0,40,2
1681924780925,BIBC 102,A01,191866,Flagg; Matthew Paul,19,0,32,13
1681924780925,BIBC 102,A02,191867,Flagg; Matthew Paul,22,0,32,10
1681924780925,BIBC 102,A03,191868,Flagg; Matthew Paul,29,0,32,3
1681924780925,BIBC 102,A04,191936,Flagg; Matthew Paul,26,0,32,6
1681924780925,BIBC 102,A05,191937,Flagg; Matthew Paul,1,0,32,31
1681924781949,BICD 100,A01,191939,Cooper; Andrew Michael,28,0,32,4
1681924781949,BICD 100,A02,191940,Cooper; Andrew Michael,32,0,32,0
1681924781949,BICD 100,A03,191941,Cooper; Andrew Michael,32,0,32,0
1681924781949,BICD 100,A04,191942,Cooper; Andrew Michael,32,0,32,0
1681924781949,BICD 100,A05,191943,Cooper; Andrew Michael,32,0,32,0
1681924782975,BIEB 126,A01,191945,Cleland; Elsa Eleanor,0,1,32,32
1681924782975,BIEB 126,A02,191946,Cleland; Elsa Eleanor,27,0,32,5
1681924782975,BIEB 126,A03,191947,Cleland; Elsa Eleanor,29,0,32,3
1681924782975,BIEB 126,A04,191948,Cleland; Elsa Eleanor,22,0,32,10
1681924782975,BIEB 126,A05,191996,Cleland; Elsa Eleanor,28,0,32,4
1681924783997,BIEB 136GS,A00,191997,Shurin; Jonathan & Holway; David A.,0,0,0,4
1681924785020,BIEB 137GS,A01,191999,Shurin; Jonathan & Holway; David A.,0,0,0,3
1681924786043,BILD 1,A01,205385,Staff,31,0,32,1
1681924786043,BILD 1,A02,205386,Staff,30,0,32,2
1681924786043,BILD 1,A03,205387,Staff,32,0,32,0
1681924786043,BILD 1,A04,205388,Staff,26,0,32,6
1681924787078,BILD 2,A01,191774,Staff,28,0,32,4
1681924787078,BILD 2,A02,191775,Staff,30,0,32,2
1681924787078,BILD 2,A03,191777,Staff,30,0,32,2
1681924787078,BILD 2,A04,191856,Staff,31,0,32,1
1681924787078,BILD 2,A05,191857,Staff,32,0,32,0
1681924787078,BILD 2,A06,191858,Staff,32,0,32,0
1681924787078,BILD 2,A07,191859,Staff,31,0,32,1
1681924788101,BILD 3,A01,205391,Staff,29,0,32,3
1681924788101,BILD 3,A02,205393,Staff,32,0,32,0
1681924788101,BILD 3,A03,205394,Staff,27,0,32,5
1681924788101,BILD 3,A04,205395,Staff,32,0,32,0
1681924789130,BILD 20,A01,191861,Staff,32,0,32,0
1681924789130,BILD 20,A02,191862,Staff,32,0,32,0
1681924790153,BILD 30,A01,191864,Staff,31,0,32,1
1681924791179,BIMM 100,A01,192019,Staff,0,0,32,32
1681924791179,BIMM 100,A02,192020,Staff,19,0,32,13
1681924791179,BIMM 100,A03,192035,Staff,20,0,32,12
1681924792205,BIMM 110,A01,192037,Tat; John,0,0,32,32
1681924792205,BIMM 110,A02,192038,Tat; John,8,0,32,24
1681924793228,BIMM 120,A01,192040,Pickett; Brooke Elizabeth,0,0,32,32
1681924793228,BIMM 120,A02,192041,Pickett; Brooke Elizabeth,12,0,32,20
1681924793228,BIMM 120,A03,192042,Pickett; Brooke Elizabeth,15,0,32,17
1681924794254,BIPN 100,A01,192044,Armour; Jon Christopher,23,0,32,9
1681924794254,BIPN 100,A02,192059,Armour; Jon Christopher,30,0,32,2
1681924794254,BIPN 100,A03,192064,Armour; Jon Christopher,30,0,32,2
1681924794254,BIPN 100,A04,192073,Armour; Jon Christopher,28,0,32,4
1681924795280,BIPN 148,A01,205411,Leutgeb; Jill K.,15,0,32,17
1681924795280,BIPN 148,A02,205412,Leutgeb; Jill K.,31,0,32,1
1681924795280,BIPN 148,A03,205413,Leutgeb; Jill K.,30,0,32,2
1681924795280,BIPN 148,A04,205414,Leutgeb; Jill K.,30,0,32,2
1681924796317,BIPN 160,A01,192115,Marino; Marc J,16,0,32,16
1681924796317,BIPN 160,A02,192148,Marino; Marc J,27,0,32,5
1681924796317,BIPN 160,A03,192158,Marino; Marc J,31,0,32,1
1681924796317,BIPN 160,A04,192190,Marino; Marc J,32,0,32,0
1681924796317,BIPN 160,A05,192287,Marino; Marc J,32,0,32,0
1681924796317,BIPN 160,A06,192288,Marino; Marc J,32,0,32,0
1681924797342,BIPN 194,A00,206038,Staff,28,0,32,4
1681924798365,BISP 194,A00,192289,Leutgeb; Stefan,11,0,32,21
1681924798365,BISP 194,B00,245332,Nieh; James Charles,26,0,32,6
1681924799393,CAT 124,A01,202247,Staff,15,0,15,0
1681924800419,CAT 125,A00,202248,Staff,18,0,20,2
1681924800419,CAT 125,B00,202253,Staff,20,0,20,0
1681924800419,CAT 125,C00,202257,Staff,18,0,20,2
1681924801442,CAT 125GS,A01,202273,Bronstein; Phoebe Malan,20,0,20,0
1681924802470,CAT 125R,A00,202284,Staff,18,0,20,2
1681924802470,CAT 125R,C00,202286,Staff,8,0,20,12
1681924802470,CAT 125R,D00,202291,Staff,17,0,20,3
1681924802470,CAT 125R,E00,202295,Staff,13,0,20,7
1681924802470,CAT 125R,F00,202302,Staff,8,0,20,12
1681924803506,CENG 100,A00,204724,Opatkiewicz; Justin Paul,25,0,25,0
1681924804528,CGS 2A,A01,180420,Staff,31,0,36,5
1681924805570,CGS 101,A00,180421,Staff,16,0,20,4
1681924806597,CGS 112,A00,180422,Staff,9,0,16,7
1681924807621,CGS 113,A00,180423,Staff,18,0,20,2
1681924808645,CGS 137,A00,180424,Staff,12,0,12,0
1681924809671,CGS 147,A00,180425,Staff,10,0,10,0
1681924810709,CHEM 6A,A01,179556,Staff,95,0,100,5
1681924810709,CHEM 6A,A02,179558,Staff,0,0,0,0
1681924811732,CHEM 6B,A01,179560,Staff,100,0,100,0
1681924812762,CHEM 6C,A01,179565,Jazzar; Rodolphe,94,0,100,6
1681924813792,CHEM 7L,A01,179586,Schurmeier; Kimberly,10,0,24,14
1681924813792,CHEM 7L,A02,179587,Schurmeier; Kimberly,23,0,24,1
1681924813792,CHEM 7L,A03,179590,Schurmeier; Kimberly,22,0,24,2
1681924813792,CHEM 7L,A04,179591,Schurmeier; Kimberly,22,0,24,2
1681924813792,CHEM 7L,B01,179598,Schurmeier; Kimberly,16,0,24,8
1681924813792,CHEM 7L,B02,179599,Schurmeier; Kimberly,24,0,24,0
1681924813792,CHEM 7L,B03,179606,Schurmeier; Kimberly,23,0,24,1
1681924813792,CHEM 7L,B04,179607,Schurmeier; Kimberly,23,0,24,1
1681924814815,CHEM 11,A01,179609,Stallings; Dontarie M,87,0,100,13
1681924815838,CHEM 40A,A01,179621,Staff,40,0,50,10
1681924815838,CHEM 40A,A02,179622,Staff,46,0,50,4
1681924816878,CHEM 40B,A01,179630,Weizman; Haim,47,0,50,3
1681924816878,CHEM 40B,A02,179631,Weizman; Haim,44,0,50,6
1681924817901,CHEM 41A,A01,179660,Klosterman; Jeremy K,93,0,100,7
1681924818926,CHEM 43A,A01,179683,Klosterman; Jeremy K,0,0,24,24
1681924818926,CHEM 43A,A02,179688,Klosterman; Jeremy K,8,0,24,16
1681924818926,CHEM 43A,A03,179689,Klosterman; Jeremy K,18,0,24,6
1681924818926,CHEM 43A,A04,179691,Klosterman; Jeremy K,18,0,24,6
1681924819958,CHEM 114A,A01,179693,Stallings; Dontarie M,70,0,100,30
1681924820983,CHEM 143B,A01,179698,Weizman; Haim,16,0,24,8
1681924820983,CHEM 143B,A02,179700,Weizman; Haim,24,0,24,0
1681924822009,CHIN 169A,A00,179701,Wang; Xiao,20,0,20,0
1681924823037,COGS 2,A01,179750,Boyle; Mary E. T.,17,0,30,13
1681924824061,COGS 9,A01,179759,Jones; Cameron Robert,42,0,50,8
1681924825092,COGS 14A,A01,179854,Staff,15,0,50,35
1681924826131,COGS 14B,A01,179856,Staff,53,0,60,7
1681924827166,COGS 17,A01,179874,Staff,71,0,75,4
1681924828189,COGS 18,A01,179884,Staff,62,0,80,18
1681924829223,COGS 100,A01,179886,Staff,36,0,60,24
1681924830248,COGS 101B,A01,179892,Staff,0,1,30,30
1681924831273,COGS 101C,A01,179894,Staff,28,0,30,2
1681924832296,COGS 107A,A01,179896,Boyle; Mary E. T.,30,0,40,10
1681924833320,COGS 108,A01,179898,Simpkins; Charles Alexander,0,25,60,60
1681924834345,COGS 109,A01,179900,Staff,34,0,40,6
1681924835370,COGS 118A,A01,179946,Staff,6,0,40,34
1681924836395,COGS 153,A00,179978,Staff,0,3,30,30
1681924837419,COGS 156,A01,179981,Staff,23,0,30,7
1681924839475,COGS 172,A01,179987,Staff,13,0,30,17
1681924841533,COGS 186,A01,179991,Staff,12,0,30,18
1681924842559,COMM 10,A01,180001,Staff,13,0,25,12
1681924842559,COMM 10,A02,180004,Staff,20,0,25,5
1681924843583,COMM 100A,A01,180016,Staff,15,0,25,10
1681924843583,COMM 100A,A02,180020,Staff,24,0,25,1
1681924844606,COMM 101T,A00,180029,Halm; Gavin Patrick,22,0,35,13
1681924845632,COMM 106V,A00,180043,Staff,34,0,35,1
1681924846661,COMM 109P,A00,180044,Staff,30,0,35,5
1681924847684,COMM 113T,A00,180045,Havis; Allan,37,0,45,8
1681924848712,COMM 132,A00,180046,McKenna; Denise,23,0,30,7
1681924849738,COMM 143,A00,180047,Staff,18,0,30,12
1681924850763,COMM 190,A00,180048,Conner; Thomas Hartnell,18,0,23,5
1681924851785,CSE 8A,A50,180053,Cao; Yingjun,21,0,50,29
1681924851785,CSE 8A,B50,180180,Staff,50,0,50,0
1681924852811,CSE 11,A01,180190,Cao; Yingjun,24,0,50,26
1681924853835,CSE 20,A01,180192,Briones; Jor-el Thomas Caparas,22,0,30,8
1681924854865,CSE 21,A01,194538,Briones; Jor-el Thomas Caparas,50,0,60,10
1681924855887,CSE 30,A01,180324,Eldon; John,75,0,100,25
1681924856914,CSE 101,A01,201353,Staff,0,26,40,40
1681924857939,CSE 134B,A01,180326,Powell; Thomas Allan,74,0,100,26
1681924858965,CSE 140,A01,180328,Staff,38,0,75,37
1681924859988,CSE 140L,A01,180344,Eldon; John,61,0,100,39
1681924861011,CSE 150A,A01,180411,Staff,0,15,50,50
1681924862033,CSE 151A,A01,180414,Staff,0,8,50,50
1681924863056,CSE 175,A01,222521,Kumar; Rakesh,50,0,50,0
1681924864082,CSE 190,A00,201419,Staff,44,0,49,5
1681924865104,CSS 1,A01,194536,Staff,36,0,50,14
1681924866132,DSC 30,A01,202385,Staff,48,0,50,2
1681924867157,DSC 40A,A01,202387,Albuyeh; Rod,50,0,50,0
1681924868180,DSC 190,A01,202389,Silberman; Jack,21,0,21,0
1681924869210,DSGN 100,A01,179993,Staff,14,0,30,16
1681924870236,ECE 65,A50,180708,Staff,10,0,20,10
1681924870236,ECE 65,A51,180739,Staff,19,0,20,1
1681924871261,ECON 1,A01,180427,Famulari; Melissa,67,0,70,3
1681924872290,ECON 2,A01,180450,Levkoff; Steven B.,64,0,70,6
1681924873316,ECON 4,A01,203351,Anderson; John Charles,6,0,10,4
1681924874349,ECON 100A,A01,180472,Famulari; Melissa,59,0,70,11
1681924875378,ECON 120A,A01,180549,Staff,63,0,70,7
1681924876401,ECON 120B,A01,180655,Ma; Xinwei,42,0,70,28
1681924877434,ECON 129,A00,203333,Eckert; Fabian Paul,12,0,35,23
1681924878457,ECON 131,A00,180656,Staff,5,0,35,30
1681924879489,ECON 172B,A01,180672,Levkoff; Steven B.,31,0,35,4
1681924880517,ECON 178,A01,203342,Zhu; Ying,8,0,35,27
1681924881544,EDS 108GS,A00,202383,Wishard Guerra; Alison G.,20,0,20,0
1681924882568,EDS 111GS,A00,202347,Wishard Guerra; Alison G.,20,0,20,0
1681924883670,EDS 112,A01,202323,Staff,53,0,60,7
1681924884701,EDS 113,A00,202340,Staff,32,0,35,3
1681924885732,EDS 118,A00,201231,Staff,19,0,30,11
1681924886754,EDS 119,A00,204994,Staff,8,0,10,2
1681924887779,EDS 124BR,A00,202324,Eguchi; Emi,1,0,25,24
1681924888803,EDS 126,A01,203208,Jones; Makeba,26,0,30,4
1681924889828,EDS 135,A01,202333,Staff,17,0,20,3
1681924890859,EDS 180,A00,202311,Staff,47,0,50,3
1681924891885,ERC 190GS,A01,253747,Staff,28,0,28,0
1681924892911,ETHN 104,A00,180742,Staff,22,0,35,13
1681924893933,ETHN 118,A00,180745,Staff,27,0,35,8
1681924894956,ETHN 127,A00,180747,Staff,11,0,16,5
1681924895982,ETHN 137,A00,180880,Staff,11,0,12,1
1681924897005,ETHN 147,A00,180890,Staff,8,0,10,2
1681924898029,ETHN 154,A00,180891,Staff,7,0,8,1
1681924899051,ETHN 168,A00,180892,Staff,9,0,10,1
1681924900084,GLBH 20,A00,201051,Hannah; Seth Donal,0,3,0,1
1681924901105,GLBH 111,A01,209338,Burgos; Jose L.,0,0,0,0
1681924902130,GLBH 150,A00,258300,Staff,0,3,0,0
1681924903159,GLBH 181,A00,201207,Staff,12,0,40,28
1681924904185,HIEU 109,A00,180898,Staff,19,0,20,1
1681924905218,HIEU 111,A00,180899,Staff,0,2,20,20
1681924906241,HIEU 124,A00,180900,Staff,17,0,20,3
1681924907265,HILA 122,A00,180901,Staff,18,0,20,2
1681924908289,HILA 132,A00,180902,Vitz; Matthew,0,0,20,20
1681924909312,HILD 10,A01,180896,Staff,14,0,20,6
1681924910334,HILD 30GS,A00,180897,Edington; Claire Ellen,0,0,0,0
1681924911359,HISC 105,A00,180903,Staff,20,0,20,0
1681924912381,HISC 117,A00,180904,Staff,10,0,20,10
1681924913410,HIUS 108B,A00,181005,Staff,18,0,20,2
1681924914433,HIUS 113,A00,181093,Staff,0,0,20,20
1681924915455,HUM 3,A01,181190,Patterson; Patrick H.,38,0,50,12
1681924915455,HUM 3,B01,181195,Staff,46,0,50,4
1681924916477,HUM 3GS,A00,181196,Herbst; Matthew,0,0,0,0
1681924917500,HUM 4,A01,181227,West; Geoffrey Scott,33,0,50,17
1681924917500,HUM 4,B01,181282,Staff,41,0,50,9
1681924918522,HUM 4GS,A00,181377,Lyon; Antony J.,0,0,0,0
1681924919544,HUM 5,A01,181536,Zavodny; Tatiana Sophia,27,0,50,23
1681924919544,HUM 5,B01,181908,Staff,35,0,50,15
1681924920575,INTL 190,A00,181909,Segui; Alan S,0,0,0,8
1681924920575,INTL 190,B00,181961,Segui; Alan S,0,0,0,7
1681924921597,JAPN 20AR,A01,182113,Ross; Kayoko F,15,0,20,5
1681924922628,LATI 50,A01,202391,Martin-Cabrera; Luis,17,0,30,13
1681924922628,LATI 50,A02,202392,Martin-Cabrera; Luis,26,0,30,4
1681924923652,LATI 180,A00,202393,Kokinis; Troy Andreas,24,0,25,1
1681924924678,LIFR 1A,A00,182119,Staff,14,0,14,0
1681924925704,LIFR 1AX,A00,182324,Staff,14,0,14,0
1681924926730,LIFR 1B,A00,182259,Staff,12,0,14,2
1681924927753,LIFR 1BX,A00,182273,Staff,12,0,14,2
1681924928774,LIGN 8,A00,182330,Staff,131,0,150,19
1681924929799,LIGN 9GS,A00,182362,Staff,19,0,20,1
1681924930822,LIGN 119,A00,204992,Takahashi; Maho,11,0,15,4
1681924931851,LIGN 130,A01,182384,Staff,47,0,50,3
1681924932873,LIGN 149GS,A00,182390,Staff,19,0,20,1
1681924933896,LIGN 170,A00,182404,Staff,23,0,30,7
1681924934923,LISP 1D,A00,182281,Staff,7,0,14,7
1681924934923,LISP 1D,B00,182287,Staff,13,0,14,1
1681924934923,LISP 1D,C00,182295,Staff,10,0,14,4
1681924934923,LISP 1D,D00,182301,Staff,14,0,14,0
1681924935945,LISP 1DX,A00,182309,Staff,19,0,28,9
1681924935945,LISP 1DX,B00,182316,Staff,25,0,28,3
1681924936968,LTAF 120GS,A00,182412,Zhiri; Oumelbanine,20,0,20,0
1681924937991,LTCS 172GS,A00,182437,Bronstein; Phoebe Malan,20,0,20,0
1681924939015,LTEA 138,A00,182457,Staff,19,0,40,21
1681924940037,LTEN 114,A01,182490,Staff,23,0,25,2
1681924941061,LTEN 130GS,A00,182491,Lyon; Antony J.,20,0,20,0
1681924942084,LTEN 169,A00,182493,Cuong; Marisol,19,0,25,6
1681924943109,LTEN 178,A00,182501,Staff,14,0,15,1
1681924944133,LTEN 181,A00,182515,Staff,20,0,25,5
1681924945169,LTEN 185GS,A00,197655,Forbes; Camille,20,0,20,0
1681924946191,LTSP 100B,A00,202208,Bessett; Ryan Matthew,24,0,25,1
1681924947219,LTWL 100,A00,182516,Myerston Santana; Jacobo,20,0,30,10
1681924948246,LTWR 100GS,A00,182518,Forbes; Camille,20,0,20,0
1681924949277,LTWR 102,A00,182522,Staff,15,0,15,0
1681924949277,LTWR 102,B00,182525,Staff,14,0,15,1
1681924950307,LTWR 115,A00,182526,Staff,11,0,15,4
1681924951333,MAE 8,A01,182528,Pham; Hieu Tan,67,0,70,3
1681924952356,MAE 11,A00,182529,Bahadori; Mohammad Yousef,92,0,100,8
1681924953383,MAE 20,A00,182530,Evdokimenko; Ekaterina,68,0,70,2
1681924954413,MAE 30A,A00,182532,Staff,44,0,45,1
1681924955438,MAE 101A,A00,182533,Bahadori; Mohammad Yousef,94,0,100,6
1681924956463,MAE 101C,A00,182538,Staff,62,0,70,8
1681924957489,MAE 104,A00,182539,Staff,44,0,50,6
1681924958514,MAE 131A,A00,182540,Ghazinejad; Maziar,40,0,45,5
1681924959539,MAE 143A,A00,182548,Bewley; Thomas R,43,0,50,7
1681924960564,MAE 150,A00,182549,Staff,28,0,40,12
1681924961590,MAE 160,A00,182550,Evdokimenko; Ekaterina,41,0,60,19
1681924962612,MATH 3C,A01,182725,Staff,24,0,30,6
1681924963637,MATH 10A,A01,182729,Staff,25,0,30,5
1681924963637,MATH 10A,B01,182732,Staff,25,0,30,5
1681924964661,MATH 10B,A01,182737,Staff,17,0,30,13
1681924964661,MATH 10B,A02,182738,Staff,26,0,30,4
1681924964661,MATH 10B,B01,182744,Staff,27,0,30,3
1681924964661,MATH 10B,B02,182745,Staff,27,0,30,3
1681924965684,MATH 18,A01,182750,Anzaldo; Leesa B,28,0,30,2
1681924965684,MATH 18,A02,182751,Anzaldo; Leesa B,28,0,30,2
1681924965684,MATH 18,A03,182753,Anzaldo; Leesa B,27,0,30,3
1681924965684,MATH 18,A04,182757,Anzaldo; Leesa B,29,0,30,1
1681924965684,MATH 18,B01,182761,Anzaldo; Leesa B,27,0,30,3
1681924965684,MATH 18,B02,182764,Anzaldo; Leesa B,26,0,30,4
1681924965684,MATH 18,B03,182765,Anzaldo; Leesa B,29,0,30,1
1681924965684,MATH 18,B04,182766,Anzaldo; Leesa B,30,0,30,0
1681924966710,MATH 20A,A01,182771,Suk; Andrew Hoon,28,0,30,2
1681924967732,MATH 20B,A01,182775,Bach; Quang Tran,30,0,30,0
1681924967732,MATH 20B,A02,182777,Bach; Quang Tran,29,0,30,1
1681924967732,MATH 20B,B01,182780,Bach; Quang Tran,26,0,30,4
1681924967732,MATH 20B,B02,182782,Bach; Quang Tran,30,0,30,0
1681924968756,MATH 20C,A01,182787,Staff,24,0,30,6
1681924968756,MATH 20C,A02,182790,Staff,29,0,30,1
1681924968756,MATH 20C,B01,182792,Staff,24,0,30,6
1681924968756,MATH 20C,B02,182796,Staff,26,0,30,4
1681924969782,MATH 20D,A01,182799,Staff,27,0,30,3
1681924969782,MATH 20D,A02,182802,Staff,29,0,30,1
1681924969782,MATH 20D,A03,182803,Staff,30,0,30,0
1681924970805,MATH 20E,A01,182809,Verstraete; Jacques Allan,22,0,30,8
1681924970805,MATH 20E,A02,182811,Verstraete; Jacques Allan,28,0,30,2
1681924970805,MATH 20E,B01,182814,Verstraete; Jacques Allan,22,0,30,8
1681924970805,MATH 20E,B02,182815,Verstraete; Jacques Allan,30,0,30,0
1681924971832,MATH 103A,A01,182820,Staff,5,0,30,25
1681924971832,MATH 103A,A02,182821,Staff,27,0,30,3
1681924971832,MATH 103A,A03,182822,Staff,23,0,30,7
1681924971832,MATH 103A,B01,182825,Staff,23,0,30,7
1681924971832,MATH 103A,B02,182826,Staff,30,0,30,0
1681924971832,MATH 103A,B03,182830,Staff,30,0,30,0
1681924972859,MATH 109,A01,182836,Chow; Bennett,24,0,30,6
1681924972859,MATH 109,A02,182838,Chow; Bennett,29,0,30,1
1681924972859,MATH 109,A03,182894,Chow; Bennett,29,0,30,1
1681924972859,MATH 109,B01,182908,Chow; Bennett,27,0,30,3
1681924972859,MATH 109,B02,182909,Chow; Bennett,30,0,30,0
1681924972859,MATH 109,B03,182910,Chow; Bennett,26,0,30,4
1681924973887,MATH 142A,A01,182925,Staff,7,0,30,23
1681924973887,MATH 142A,A02,182935,Staff,24,0,30,6
1681924973887,MATH 142A,A03,182967,Staff,26,0,30,4
1681924973887,MATH 142A,B01,183125,Staff,23,0,30,7
1681924973887,MATH 142A,B02,183157,Staff,28,0,30,2
1681924973887,MATH 142A,B03,183158,Staff,29,0,30,1
1681924974914,MATH 183,A01,183160,Arias-Castro; Ery,23,0,30,7
1681924974914,MATH 183,A02,183161,Arias-Castro; Ery,29,0,30,1
1681924974914,MATH 183,B01,183163,Arias-Castro; Ery,28,0,30,2
1681924974914,MATH 183,B02,183164,Arias-Castro; Ery,28,0,30,2
1681924975948,MATH 193A,A01,183167,Staff,0,0,35,35
1681924975948,MATH 193A,A02,183168,Staff,27,0,35,8
1681924975948,MATH 193A,A03,183169,Staff,34,0,35,1
1681924975948,MATH 193A,A04,183170,Staff,27,0,35,8
1681924976974,MGT 4,A01,202395,Anderson; John Charles,76,0,80,4
1681924978000,MGT 5,A00,202396,Houskeeper; Robert,79,0,90,11
1681924979025,MGT 103,A00,202397,Eberhard; Craig A,49,0,90,41
1681924980051,MGT 131A,A00,202398,Houskeeper; Robert,83,0,90,7
1681924981076,MGT 135,A00,202399,Anderson; John Charles,81,0,90,9
1681924982097,MGT 162R,A00,202403,Gneezy; Uri,136,0,200,64
1681924983122,MGT 172,A00,202404,Hedges; Kathleen,39,0,90,51
1681924984145,MGT 181,A00,202405,Dunn; Louis Jean,80,0,90,10
1681924985175,MMW 14,A01,183200,Staff,7,0,28,21
1681924985175,MMW 14,A02,183201,Staff,26,0,28,2
1681924985175,MMW 14,A03,183202,Staff,24,0,28,4
1681924985175,MMW 14,A04,183203,Staff,25,0,28,3
1681924985175,MMW 14,A05,183204,Staff,26,0,28,2
1681924985175,MMW 14,A06,183205,Staff,27,0,28,1
1681924985175,MMW 14,B01,183207,Staff,26,0,28,2
1681924985175,MMW 14,B02,183208,Staff,28,0,28,0
1681924985175,MMW 14,B03,183209,Staff,28,0,28,0
1681924985175,MMW 14,B04,183210,Staff,28,0,28,0
1681924985175,MMW 14,B05,183211,Staff,28,0,28,0
1681924985175,MMW 14,B06,183212,Staff,27,0,28,1
1681924986199,MMW 14GS,A00,183213,Zhiri; Oumelbanine,28,0,28,0
1681924987317,MMW 15GS,B00,183215,Rahimi; Babak,28,0,28,0
1681924988342,MMW 121,A01,183217,Patterson; Patrick H.,11,0,28,17
1681924988342,MMW 121,A02,183218,Patterson; Patrick H.,25,0,28,3
1681924989365,MUS 1A,A01,182554,Staff,4,0,35,31
1681924990393,MUS 5,A01,182558,Staff,17,0,35,18
1681924991420,MUS 6,A01,182562,Staff,22,0,35,13
1681924992442,MUS 8GS,A00,182563,Borgo; David Garcia,25,0,25,0
1681924993473,MUS 13,A01,182567,Staff,23,0,25,2
1681924994506,MUS 15,A01,182570,Staff,31,0,35,4
1681924994506,MUS 15,B01,182575,Staff,7,0,35,28
1681924995529,MUS 80,A00,182578,Staff,22,0,25,3
1681924995529,MUS 80,B00,182581,Staff,20,0,25,5
1681924996551,MUS 113,A00,182582,Staff,25,0,25,0
1681924997577,MUS 114,A00,182583,Staff,3,0,25,22
1681924998607,MUS 150GS,A01,182588,Borgo; David Garcia,25,0,25,0
1681924999637,PHIL 1,A00,182590,Staff,34,0,40,6
1681925000670,PHIL 10,A01,182596,Grush; Rick Scott,30,0,35,5
1681925000670,PHIL 10,A02,182597,Grush; Rick Scott,33,0,35,2
1681925001694,PHIL 15,A01,182601,Staff,31,0,35,4
1681925001694,PHIL 15,A02,182602,Staff,33,0,35,2
1681925002720,PHIL 27,A01,182604,Staff,30,0,35,5
1681925002720,PHIL 27,A02,182607,Staff,35,0,35,0
1681925003745,PHIL 32,A01,182609,Staff,35,0,35,0
1681925003745,PHIL 32,A02,182612,Staff,35,0,35,0
1681925004777,PHIL 130,A00,182614,Staff,61,0,70,9
1681925005802,PHIL 136,A00,182616,Cohen; Jonathan David,66,0,70,4
1681925006828,PHIL 155,A00,182617,Vargas; Manuel Rogelio,58,0,70,12
1681925007859,PHIL 163,A01,182620,Staff,15,0,20,5
1681925007859,PHIL 163,A02,182624,Staff,10,0,20,10
1681925008885,PHIL 164,A00,182627,Staff,29,0,40,11
1681925009922,PHIL 173,A00,182628,Staff,35,0,40,5
1681925010947,PHYS 1A,A00,183221,Staff,54,0,60,6
1681925011969,PHYS 1AL,001,183222,Staff,25,0,30,5
1681925011969,PHYS 1AL,002,183223,Staff,26,0,30,4
1681925012997,PHYS 1B,A00,183231,Staff,42,0,60,18
1681925014026,PHYS 1BL,001,183232,Staff,19,0,30,11
1681925014026,PHYS 1BL,002,183233,Staff,27,0,30,3
1681925015052,PHYS 1C,A00,183240,Staff,24,0,60,36
1681925016084,PHYS 1CL,001,183241,Staff,9,0,30,21
1681925016084,PHYS 1CL,002,183242,Staff,22,0,30,8
1681925017118,PHYS 2AR,A01,183250,Staff,43,0,50,7
1681925018143,PHYS 2B,A01,183252,Staff,104,0,115,11
1681925019169,PHYS 2BL,A01,183254,Staff,21,0,24,3
1681925019169,PHYS 2BL,A02,183255,Staff,21,0,24,3
1681925020192,PHYS 2C,A01,183522,Staff,102,0,115,13
1681925021217,PHYS 4A,A01,183524,Staff,49,0,50,1
1681925022249,POLI 5,A00,183525,Staff,44,0,50,6
1681925023278,POLI 12,A00,183540,Staff,45,0,50,5
1681925024300,POLI 13R,A00,183541,Forman; Fonna,41,0,50,9
1681925025325,POLI 30,A00,183542,Mignozzetti; Umberto,48,0,50,2
1681925026349,POLI 100A,A00,183543,Staff,45,0,50,5
1681925027371,POLI 100E,A00,223598,Staff,32,0,35,3
1681925028397,POLI 103A,A00,183564,Kousser; Thad,37,0,50,13
1681925029419,POLI 104B,A00,201329,Staff,28,0,35,7
1681925030441,POLI 113BR,A00,183576,Hoston; Germaine,23,0,50,27
1681925031466,POLI 114BR,A00,183588,Staff,27,0,30,3
1681925032488,POLI 117R,A00,183595,Forman; Fonna,4,0,20,16
1681925033513,POLI 120H,A00,183596,Fisk; David Lee,13,0,20,7
1681925034545,POLI 130AA,A00,183597,Staff,13,0,20,7
1681925035568,POLI 134AA,A00,183598,Staff,19,0,20,1
1681925036593,POLI 135,A00,183599,Fisk; David Lee,19,0,25,6
1681925037619,POLI 142P,A00,183623,Staff,37,0,40,3
1681925038647,POLI 144D,A00,183624,Staff,22,0,25,3
1681925039670,POLI 151,A00,183625,Staff,15,0,20,5
1681925040693,POLI 162,A00,183626,Mignozzetti; Umberto,17,0,20,3
1681925041716,PSYC 1,A00,253748,Staff,86,0,90,4
1681925042739,PSYC 2,A00,183627,Moranton; Nirelia Melbina-,24,0,35,11
1681925043766,PSYC 3,A00,183628,Staff,43,0,45,2
1681925045825,PSYC 60,A01,183631,Lowe; Angela Beth,35,0,40,5
1681925046851,PSYC 70,A01,253757,Staff,37,0,45,8
1681925047878,PSYC 101,A00,183632,Heyman; Gail D.,45,0,60,15
1681925048900,PSYC 105,A00,183848,Lowe; Angela Beth,47,0,60,13
1681925049925,PSYC 106,A00,183849,Dobkins; Karen R.,42,0,60,18
1681925050950,PSYC 108,A00,253750,Staff,18,0,60,42
1681925051973,PSYC 114,A01,184275,Winkielman; Piotr,0,8,30,30
1681925053001,PSYC 122,A00,183856,Moranton; Nirelia Melbina-,0,15,30,30
1681925054024,PSYC 124,A00,183865,Chapman; Eddie Nathaniel,48,0,80,32
1681925055046,PSYC 137,A00,183880,Staff,19,0,25,6
1681925057102,PSYC 154,A00,183910,Lacefield; Katharine I,0,21,90,90
1681925059157,PSYC 162,A00,183946,Wixted; John T,51,0,90,39
1681925060180,PSYC 172,A00,183947,Gorman; Michael R.,9,0,30,21
1681925061205,PSYC 178,A00,183963,Glaser; Dale,17,0,40,23
1681925062237,PSYC 181GS,A00,183964,Anagnostaras; Stephan,10,0,10,0
1681925063261,PSYC 186GS,A01,257660,Staff,10,0,10,0
1681925064287,PSYC 193,B00,253749,Staff,23,0,25,2
1681925066341,PSYC 193L,A01,184122,Staff,33,0,35,2
1681925066341,PSYC 193L,C01,184167,Winkielman; Piotr,14,0,30,16
1681925067368,RELI 188GS,A00,182629,Rahimi; Babak,20,0,20,0
1681925068392,SE 101A,A00,182646,Staff,26,0,30,4
1681925069418,SE 101C,A00,182650,Staff,17,0,20,3
1681925070441,SE 110A,A00,182651,Staff,28,0,28,0
1681925071467,SE 130A,A00,182652,Staff,38,0,40,2
1681925072519,SIO 46GS,A00,182636,Cook; Geoffrey W,25,0,28,3
1681925073542,SIO 109R,A00,194459,Staff,2,0,20,18
1681925074567,SIO 121GS,A00,182639,Cook; Geoffrey W,25,0,28,3
1681925075593,SIO 132,A01,182642,Staff,32,0,40,8
1681925076621,SIO 139,A00,182644,Kacev; David,36,0,40,4
1681925077644,SOCI 2,A01,258404,Staff,33,0,36,3
1681925077644,SOCI 2,A02,258405,Staff,35,0,36,1
1681925078665,SOCI 60,A01,258408,Staff,29,0,30,1
1681925078665,SOCI 60,A02,258413,Staff,30,0,30,0
1681925079690,SOCI 100,A01,258415,Staff,29,0,30,1
1681925079690,SOCI 100,A02,258416,Staff,28,0,30,2
1681925085834,SOCI 127,A00,258421,Staff,21,0,30,9
1681925086856,SOCI 132,A00,258422,Staff,45,0,50,5
1681925087880,SOCI 133,A00,258423,Staff,26,0,30,4
1681925088902,SOCI 138GS,A00,258424,Staff,15,0,15,0
1681925089931,SOCI 145,A00,258425,Staff,25,0,30,5
1681925091029,SOCI 148,A00,258426,Staff,24,0,30,6
1681925092057,SOCI 153,A00,199217,Staff,29,0,30,1
1681925093089,SOCI 160,A00,258427,Staff,28,0,30,2
1681925094110,SOCI 160E,A00,258435,Staff,56,0,60,4
1681925095134,SOCI 189GS,A00,258436,Staff,15,0,15,0
1681925096163,SOCI 190GS,A00,258437,Staff,15,0,15,0
1681925097186,SYN 2,001,182658,Staff,8,0,16,8
1681925097186,SYN 2,002,201439,Staff,14,0,16,2
1681925097186,SYN 2,003,201443,Staff,16,0,16,0
1681925098209,SYN 100,A01,182657,Staff,15,0,20,5
1681925099233,TDAC 1,A00,184381,Salovey; Todd,16,0,20,4
1681925099233,TDAC 1,B00,184385,Harting; Carla Kelso,19,0,20,1
1681925099233,TDAC 1,C00,184394,Staff,19,0,20,1
1681925100261,TDAC 101,A00,184483,Harting; Carla Kelso,19,0,20,1
1681925101283,TDDE 111,A00,184496,Staff,14,0,15,1
1681925102312,TDDE 131,A00,184504,Staff,20,0,20,0
1681925102312,TDDE 131,B00,184505,Staff,17,0,18,1
1681925102312,TDDE 131,C00,184534,Staff,49,0,50,1
1681925102312,TDDE 131,D00,184564,Staff,15,0,15,0
1681925102312,TDDE 131,E00,204725,Staff,19,0,20,1
1681925103338,TDGE 1,A01,184414,Salovey; Todd,36,0,50,14
1681925104365,TDGE 5,A01,184419,Staff,23,0,24,1
1681925105390,TDGE 10,A00,184428,Fulton; Julia,29,0,50,21
1681925106415,TDGE 124,A00,184565,Fulton; Julia,3,0,50,47
1681925107437,TDGE 125,B00,184567,Meyer; Ursula,9,0,25,16
1681925108463,TDHT 101,A00,184568,Staff,21,0,25,4
1681925108463,TDHT 101,B00,184569,Staff,20,0,20,0
1681925109486,TDHT 114,A00,184570,Staff,49,0,50,1
1681925110513,TDMV 1,A00,184437,Arcidiacono; Kristin,22,0,30,8
1681925110513,TDMV 1,B00,184448,Caligagan; Maria T.,23,0,30,7
1681925111544,TDMV 2,A00,184449,Weinberg; Sadie,27,0,30,3
1681925111544,TDMV 2,B00,184453,Arcidiacono; Kristin,29,0,30,1
1681925112567,TDMV 110,A00,184571,Weinberg; Sadie,30,0,30,0
1681925113611,TDMV 142,A00,184572,Caligagan; Tony,27,0,30,3
1681925113611,TDMV 142,B00,184573,Caligagan; Maria T.,26,0,30,4
1681925114634,TDTR 20,A00,184482,Jun; Grace Shin Hae,25,0,25,0
1681925115659,USP 2,A01,184290,Hinds; Juli Beth,24,0,25,1
1681925116681,USP 3,A01,184295,Staff,21,0,25,4
1681925117706,USP 4,A00,184304,McTague; Sarah,13,0,25,12
1681925118729,USP 100,A00,184315,Staff,16,0,25,9
1681925119755,USP 105,A00,184326,Staff,21,0,25,4
1681925120777,USP 151,A00,184327,Staff,19,0,25,6
1681925121801,USP 170,A00,184380,Hinds; Juli Beth,13,0,25,12
1681925122826,VIS 21B,A01,182660,Staff,28,0,31,3
1681925122826,VIS 21B,A02,182662,Staff,30,0,31,1
1681925123848,VIS 103D,A00,182663,Staff,74,0,75,1
1681925124870,VIS 105D,A00,182667,Li; Huai,14,0,22,8
1681925125893,VIS 122GS,A00,182668,Herbst; Matthew,20,0,20,0
1681925126919,VIS 128C,A00,182673,Staff,69,0,75,6
1681925127943,VIS 130,A00,182675,Staff,19,0,22,3
1681925128966,VIS 160A,A00,182678,Stalbaum; Brett,4,0,10,6
1681925131013,WCWP 10B,A00,201679,Staff,15,0,15,0
1681925131013,WCWP 10B,B00,201695,Staff,15,0,15,0
1681925132041,WCWP 100,A00,201716,Staff,12,0,15,3
1681925132041,WCWP 100,B00,201717,Staff,4,0,15,11
1681925134106,ANSC 105GS,A00,258289,Staff,0,0,0,0
1681925135129,ANSC 125GS,A00,258295,Staff,0,0,0,0
1681925136153,ANSC 150,A00,258267,Staff,30,0,40,10
1681925137176,ANSC 190GS,A00,258280,Staff,0,0,0,0
1681925138202,ANTH 1,A00,258264,Staff,38,0,40,2
1681925139230,ANTH 2,A01,258259,Staff,72,0,76,4
1681925140257,ANTH 23,A01,258228,Staff,36,0,40,4
1681925141280,ANTH 101,A01,258236,Staff,38,0,40,2
1681925142316,ANTH 102,A00,258272,Staff,59,0,60,1
1681925143344,ANTH 105,A00,258244,Staff,30,0,35,5
1681925144374,BENG 130,A00,253975,Staff,38,0,40,2
1681925145407,BIBC 102,A01,191866,Flagg; Matthew Paul,19,0,32,13
1681925145407,BIBC 102,A02,191867,Flagg; Matthew Paul,22,0,32,10
1681925145407,BIBC 102,A03,191868,Flagg; Matthew Paul,29,0,32,3
1681925145407,BIBC 102,A04,191936,Flagg; Matthew Paul,26,0,32,6
1681925145407,BIBC 102,A05,191937,Flagg; Matthew Paul,0,0,32,32
1681925146431,BICD 100,A01,191939,Cooper; Andrew Michael,28,0,32,4
1681925146431,BICD 100,A02,191940,Cooper; Andrew Michael,32,0,32,0
1681925146431,BICD 100,A03,191941,Cooper; Andrew Michael,32,0,32,0
1681925146431,BICD 100,A04,191942,Cooper; Andrew Michael,32,0,32,0
1681925146431,BICD 100,A05,191943,Cooper; Andrew Michael,32,0,32,0
1681925147457,BIEB 126,A01,191945,Cleland; Elsa Eleanor,0,1,32,32
1681925147457,BIEB 126,A02,191946,Cleland; Elsa Eleanor,27,0,32,5
1681925147457,BIEB 126,A03,191947,Cleland; Elsa Eleanor,29,0,32,3
1681925147457,BIEB 126,A04,191948,Cleland; Elsa Eleanor,21,0,32,11
1681925147457,BIEB 126,A05,191996,Cleland; Elsa Eleanor,28,0,32,4
1681925148482,BIEB 136GS,A00,191997,Shurin; Jonathan & Holway; David A.,0,0,0,5
1681925149514,BIEB 137GS,A01,191999,Shurin; Jonathan & Holway; David A.,0,0,0,4
1681925150538,BILD 1,A01,205385,Staff,31,0,32,1
1681925150538,BILD 1,A02,205386,Staff,30,0,32,2
1681925150538,BILD 1,A03,205387,Staff,31,0,32,1
1681925150538,BILD 1,A04,205388,Staff,26,0,32,6
1681925151561,BILD 2,A01,191774,Staff,28,0,32,4
1681925151561,BILD 2,A02,191775,Staff,30,0,32,2
1681925151561,BILD 2,A03,191777,Staff,30,0,32,2
1681925151561,BILD 2,A04,191856,Staff,31,0,32,1
1681925151561,BILD 2,A05,191857,Staff,32,0,32,0
1681925151561,BILD 2,A06,191858,Staff,32,0,32,0
1681925151561,BILD 2,A07,191859,Staff,31,0,32,1
1681925152586,BILD 3,A01,205391,Staff,29,0,32,3
1681925152586,BILD 3,A02,205393,Staff,32,0,32,0
1681925152586,BILD 3,A03,205394,Staff,27,0,32,5
1681925152586,BILD 3,A04,205395,Staff,32,0,32,0
1681925153609,BILD 20,A01,191861,Staff,32,0,32,0
1681925153609,BILD 20,A02,191862,Staff,32,0,32,0
1681925154635,BILD 30,A01,191864,Staff,31,0,32,1
1681925155657,BIMM 100,A01,192019,Staff,0,0,32,32
1681925155657,BIMM 100,A02,192020,Staff,19,0,32,13
1681925155657,BIMM 100,A03,192035,Staff,20,0,32,12
1681925156683,BIMM 110,A01,192037,Tat; John,0,0,32,32
1681925156683,BIMM 110,A02,192038,Tat; John,8,0,32,24
1681925157707,BIMM 120,A01,192040,Pickett; Brooke Elizabeth,0,0,32,32
1681925157707,BIMM 120,A02,192041,Pickett; Brooke Elizabeth,10,0,32,22
1681925157707,BIMM 120,A03,192042,Pickett; Brooke Elizabeth,15,0,32,17
1681925158733,BIPN 100,A01,192044,Armour; Jon Christopher,23,0,32,9
1681925158733,BIPN 100,A02,192059,Armour; Jon Christopher,30,0,32,2
1681925158733,BIPN 100,A03,192064,Armour; Jon Christopher,30,0,32,2
1681925158733,BIPN 100,A04,192073,Armour; Jon Christopher,27,0,32,5
1681925159791,BIPN 148,A01,205411,Leutgeb; Jill K.,15,0,32,17
1681925159791,BIPN 148,A02,205412,Leutgeb; Jill K.,31,0,32,1
1681925159791,BIPN 148,A03,205413,Leutgeb; Jill K.,30,0,32,2
1681925159791,BIPN 148,A04,205414,Leutgeb; Jill K.,30,0,32,2
1681925160823,BIPN 160,A01,192115,Marino; Marc J,16,0,32,16
1681925160823,BIPN 160,A02,192148,Marino; Marc J,27,0,32,5
1681925160823,BIPN 160,A03,192158,Marino; Marc J,31,0,32,1
1681925160823,BIPN 160,A04,192190,Marino; Marc J,32,0,32,0
1681925160823,BIPN 160,A05,192287,Marino; Marc J,32,0,32,0
1681925160823,BIPN 160,A06,192288,Marino; Marc J,32,0,32,0
1681925161846,BIPN 194,A00,206038,Staff,28,0,32,4
1681925162873,BISP 194,A00,192289,Leutgeb; Stefan,11,0,32,21
1681925162873,BISP 194,B00,245332,Nieh; James Charles,26,0,32,6
1681925163895,CAT 124,A01,202247,Staff,15,0,15,0
1681925164918,CAT 125,A00,202248,Staff,18,0,20,2
1681925164918,CAT 125,B00,202253,Staff,20,0,20,0
1681925164918,CAT 125,C00,202257,Staff,18,0,20,2
1681925165939,CAT 125GS,A01,202273,Bronstein; Phoebe Malan,20,0,20,0
1681925166962,CAT 125R,A00,202284,Staff,18,0,20,2
1681925166962,CAT 125R,C00,202286,Staff,7,0,20,13
1681925166962,CAT 125R,D00,202291,Staff,17,0,20,3
1681925166962,CAT 125R,E00,202295,Staff,13,0,20,7
1681925166962,CAT 125R,F00,202302,Staff,8,0,20,12
1681925167985,CENG 100,A00,204724,Opatkiewicz; Justin Paul,25,0,25,0
1681925169010,CGS 2A,A01,180420,Staff,31,0,36,5
1681925170053,CGS 101,A00,180421,Staff,16,0,20,4
1681925171078,CGS 112,A00,180422,Staff,9,0,16,7
1681925172105,CGS 113,A00,180423,Staff,18,0,20,2
1681925173129,CGS 137,A00,180424,Staff,12,0,12,0
1681925174161,CGS 147,A00,180425,Staff,10,0,10,0
1681925175188,CHEM 6A,A01,179556,Staff,94,0,100,6
1681925175188,CHEM 6A,A02,179558,Staff,0,0,0,0
1681925176222,CHEM 6B,A01,179560,Staff,100,0,100,0
1681925177249,CHEM 6C,A01,179565,Jazzar; Rodolphe,93,0,100,7
1681925178295,CHEM 7L,A01,179586,Schurmeier; Kimberly,10,0,24,14
1681925178295,CHEM 7L,A02,179587,Schurmeier; Kimberly,23,0,24,1
1681925178295,CHEM 7L,A03,179590,Schurmeier; Kimberly,22,0,24,2
1681925178295,CHEM 7L,A04,179591,Schurmeier; Kimberly,22,0,24,2
1681925178295,CHEM 7L,B01,179598,Schurmeier; Kimberly,16,0,24,8
1681925178295,CHEM 7L,B02,179599,Schurmeier; Kimberly,24,0,24,0
1681925178295,CHEM 7L,B03,179606,Schurmeier; Kimberly,23,0,24,1
1681925178295,CHEM 7L,B04,179607,Schurmeier; Kimberly,23,0,24,1
1681925179318,CHEM 11,A01,179609,Stallings; Dontarie M,87,0,100,13
1681925180342,CHEM 40A,A01,179621,Staff,40,0,50,10
1681925180342,CHEM 40A,A02,179622,Staff,46,0,50,4
1681925181366,CHEM 40B,A01,179630,Weizman; Haim,47,0,50,3
1681925181366,CHEM 40B,A02,179631,Weizman; Haim,44,0,50,6
1681925182394,CHEM 41A,A01,179660,Klosterman; Jeremy K,93,0,100,7
1681925183418,CHEM 43A,A01,179683,Klosterman; Jeremy K,0,0,24,24
1681925183418,CHEM 43A,A02,179688,Klosterman; Jeremy K,8,0,24,16
1681925183418,CHEM 43A,A03,179689,Klosterman; Jeremy K,18,0,24,6
1681925183418,CHEM 43A,A04,179691,Klosterman; Jeremy K,18,0,24,6
1681925184451,CHEM 114A,A01,179693,Stallings; Dontarie M,70,0,100,30
1681925185475,CHEM 143B,A01,179698,Weizman; Haim,16,0,24,8
1681925185475,CHEM 143B,A02,179700,Weizman; Haim,24,0,24,0
1681925186499,CHIN 169A,A00,179701,Wang; Xiao,20,0,20,0
1681925187523,COGS 2,A01,179750,Boyle; Mary E. T.,17,0,30,13
1681925188551,COGS 9,A01,179759,Jones; Cameron Robert,42,0,50,8
1681925189574,COGS 14A,A01,179854,Staff,15,0,50,35
1681925190597,COGS 14B,A01,179856,Staff,53,0,60,7
1681925191625,COGS 17,A01,179874,Staff,71,0,75,4
1681925192648,COGS 18,A01,179884,Staff,62,0,80,18
1681925193672,COGS 100,A01,179886,Staff,36,0,60,24
1681925194775,COGS 101B,A01,179892,Staff,0,0,30,30
1681925195798,COGS 101C,A01,179894,Staff,28,0,30,2
1681925196825,COGS 107A,A01,179896,Boyle; Mary E. T.,30,0,40,10
1681925197848,COGS 108,A01,179898,Simpkins; Charles Alexander,0,26,60,60
1681925198874,COGS 109,A01,179900,Staff,34,0,40,6
1681925199900,COGS 118A,A01,179946,Staff,6,0,40,34
1681925200927,COGS 153,A00,179978,Staff,0,3,30,30
1681925201953,COGS 156,A01,179981,Staff,23,0,30,7
1681925204019,COGS 172,A01,179987,Staff,13,0,30,17
1681925206081,COGS 186,A01,179991,Staff,12,0,30,18
1681925207111,COMM 10,A01,180001,Staff,13,0,25,12
1681925207111,COMM 10,A02,180004,Staff,20,0,25,5
1681925208138,COMM 100A,A01,180016,Staff,15,0,25,10
1681925208138,COMM 100A,A02,180020,Staff,24,0,25,1
1681925209163,COMM 101T,A00,180029,Halm; Gavin Patrick,22,0,35,13
1681925210190,COMM 106V,A00,180043,Staff,34,0,35,1
1681925211215,COMM 109P,A00,180044,Staff,30,0,35,5
1681925212237,COMM 113T,A00,180045,Havis; Allan,37,0,45,8
1681925213263,COMM 132,A00,180046,McKenna; Denise,23,0,30,7
1681925214286,COMM 143,A00,180047,Staff,18,0,30,12
1681925215315,COMM 190,A00,180048,Conner; Thomas Hartnell,18,0,23,5
1681925216361,CSE 8A,A50,180053,Cao; Yingjun,21,0,50,29
1681925216361,CSE 8A,B50,180180,Staff,50,0,50,0
1681925217385,CSE 11,A01,180190,Cao; Yingjun,24,0,50,26
1681925218416,CSE 20,A01,180192,Briones; Jor-el Thomas Caparas,22,0,30,8
1681925219442,CSE 21,A01,194538,Briones; Jor-el Thomas Caparas,50,0,60,10
1681925220467,CSE 30,A01,180324,Eldon; John,75,0,100,25
1681925221489,CSE 101,A01,201353,Staff,0,26,40,40
1681925222513,CSE 134B,A01,180326,Powell; Thomas Allan,74,0,100,26
1681925223538,CSE 140,A01,180328,Staff,38,0,75,37
1681925224569,CSE 140L,A01,180344,Eldon; John,61,0,100,39
1681925225592,CSE 150A,A01,180411,Staff,0,15,50,50
1681925226615,CSE 151A,A01,180414,Staff,0,8,50,50
1681925227639,CSE 175,A01,222521,Kumar; Rakesh,50,0,50,0
1681925228670,CSE 190,A00,201419,Staff,43,0,49,6
1681925229693,CSS 1,A01,194536,Staff,36,0,50,14
1681925230724,DSC 30,A01,202385,Staff,48,0,50,2
1681925231754,DSC 40A,A01,202387,Albuyeh; Rod,50,0,50,0
1681925232778,DSC 190,A01,202389,Silberman; Jack,21,0,21,0
1681925233801,DSGN 100,A01,179993,Staff,14,0,30,16
1681925234825,ECE 65,A50,180708,Staff,10,0,20,10
1681925234825,ECE 65,A51,180739,Staff,19,0,20,1
1681925235856,ECON 1,A01,180427,Famulari; Melissa,67,0,70,3
1681925236884,ECON 2,A01,180450,Levkoff; Steven B.,64,0,70,6
1681925237907,ECON 4,A01,203351,Anderson; John Charles,6,0,10,4
1681925238939,ECON 100A,A01,180472,Famulari; Melissa,59,0,70,11
1681925239970,ECON 120A,A01,180549,Staff,63,0,70,7
1681925240997,ECON 120B,A01,180655,Ma; Xinwei,42,0,70,28
1681925242027,ECON 129,A00,203333,Eckert; Fabian Paul,12,0,35,23
1681925243050,ECON 131,A00,180656,Staff,5,0,35,30
1681925244076,ECON 172B,A01,180672,Levkoff; Steven B.,31,0,35,4
1681925245107,ECON 178,A01,203342,Zhu; Ying,8,0,35,27
1681925246134,EDS 108GS,A00,202383,Wishard Guerra; Alison G.,20,0,20,0
1681925247161,EDS 111GS,A00,202347,Wishard Guerra; Alison G.,20,0,20,0
1681925248192,EDS 112,A01,202323,Staff,53,0,60,7
1681925249215,EDS 113,A00,202340,Staff,32,0,35,3
1681925250256,EDS 118,A00,201231,Staff,19,0,30,11
1681925251281,EDS 119,A00,204994,Staff,8,0,10,2
1681925252316,EDS 124BR,A00,202324,Eguchi; Emi,1,0,25,24
1681925253338,EDS 126,A01,203208,Jones; Makeba,26,0,30,4
1681925254365,EDS 135,A01,202333,Staff,17,0,20,3
1681925255400,EDS 180,A00,202311,Staff,47,0,50,3
1681925256422,ERC 190GS,A01,253747,Staff,28,0,28,0
1681925257444,ETHN 104,A00,180742,Staff,22,0,35,13
1681925258468,ETHN 118,A00,180745,Staff,27,0,35,8
1681925259494,ETHN 127,A00,180747,Staff,11,0,16,5
1681925260527,ETHN 137,A00,180880,Staff,11,0,12,1
1681925261562,ETHN 147,A00,180890,Staff,8,0,10,2
1681925262587,ETHN 154,A00,180891,Staff,7,0,8,1
1681925263616,ETHN 168,A00,180892,Staff,9,0,10,1
1681925264639,GLBH 20,A00,201051,Hannah; Seth Donal,0,3,0,1
1681925265665,GLBH 111,A01,209338,Burgos; Jose L.,0,0,0,0
1681925266686,GLBH 150,A00,258300,Staff,0,3,0,0
1681925267709,GLBH 181,A00,201207,Staff,12,0,40,28
1681925268733,HIEU 109,A00,180898,Staff,19,0,20,1
1681925269755,HIEU 111,A00,180899,Staff,0,2,20,20
1681925270781,HIEU 124,A00,180900,Staff,17,0,20,3
1681925271806,HILA 122,A00,180901,Staff,18,0,20,2
1681925272836,HILA 132,A00,180902,Vitz; Matthew,0,0,20,20
1681925273859,HILD 10,A01,180896,Staff,14,0,20,6
1681925274884,HILD 30GS,A00,180897,Edington; Claire Ellen,0,0,0,0
1681925275909,HISC 105,A00,180903,Staff,20,0,20,0
1681925276932,HISC 117,A00,180904,Staff,10,0,20,10
1681925277954,HIUS 108B,A00,181005,Staff,18,0,20,2
1681925278978,HIUS 113,A00,181093,Staff,0,0,20,20
1681925280006,HUM 3,A01,181190,Patterson; Patrick H.,38,0,50,12
1681925280006,HUM 3,B01,181195,Staff,46,0,50,4
1681925281032,HUM 3GS,A00,181196,Herbst; Matthew,0,0,0,0
1681925282059,HUM 4,A01,181227,West; Geoffrey Scott,33,0,50,17
1681925282059,HUM 4,B01,181282,Staff,41,0,50,9
1681925283085,HUM 4GS,A00,181377,Lyon; Antony J.,0,0,0,0
1681925284110,HUM 5,A01,181536,Zavodny; Tatiana Sophia,27,0,50,23
1681925284110,HUM 5,B01,181908,Staff,35,0,50,15
1681925285141,INTL 190,A00,181909,Segui; Alan S,0,0,0,8
1681925285141,INTL 190,B00,181961,Segui; Alan S,0,0,0,7
1681925286165,JAPN 20AR,A01,182113,Ross; Kayoko F,15,0,20,5
1681925287189,LATI 50,A01,202391,Martin-Cabrera; Luis,18,0,30,12
1681925287189,LATI 50,A02,202392,Martin-Cabrera; Luis,26,0,30,4
1681925288212,LATI 180,A00,202393,Kokinis; Troy Andreas,24,0,25,1
1681925289243,LIFR 1A,A00,182119,Staff,14,0,14,0
1681925290273,LIFR 1AX,A00,182324,Staff,14,0,14,0
1681925291298,LIFR 1B,A00,182259,Staff,12,0,14,2
1681925292328,LIFR 1BX,A00,182273,Staff,12,0,14,2
1681925293358,LIGN 8,A00,182330,Staff,131,0,150,19
1681925294384,LIGN 9GS,A00,182362,Staff,17,0,20,3
1681925295407,LIGN 119,A00,204992,Takahashi; Maho,11,0,15,4
1681925296435,LIGN 130,A01,182384,Staff,47,0,50,3
1681925297466,LIGN 149GS,A00,182390,Staff,17,0,20,3
1681925298585,LIGN 170,A00,182404,Staff,23,0,30,7
1681925299611,LISP 1D,A00,182281,Staff,7,0,14,7
1681925299611,LISP 1D,B00,182287,Staff,13,0,14,1
1681925299611,LISP 1D,C00,182295,Staff,10,0,14,4
1681925299611,LISP 1D,D00,182301,Staff,14,0,14,0
1681925300637,LISP 1DX,A00,182309,Staff,19,0,28,9
1681925300637,LISP 1DX,B00,182316,Staff,25,0,28,3
1681925301665,LTAF 120GS,A00,182412,Zhiri; Oumelbanine,20,0,20,0
1681925302704,LTCS 172GS,A00,182437,Bronstein; Phoebe Malan,20,0,20,0
1681925303727,LTEA 138,A00,182457,Staff,19,0,40,21
1681925304749,LTEN 114,A01,182490,Staff,23,0,25,2
1681925305775,LTEN 130GS,A00,182491,Lyon; Antony J.,20,0,20,0
1681925306801,LTEN 169,A00,182493,Cuong; Marisol,19,0,25,6
1681925307824,LTEN 178,A00,182501,Staff,14,0,15,1
1681925308846,LTEN 181,A00,182515,Staff,20,0,25,5
1681925309884,LTEN 185GS,A00,197655,Forbes; Camille,20,0,20,0
1681925310914,LTSP 100B,A00,202208,Bessett; Ryan Matthew,24,0,25,1
1681925311937,LTWL 100,A00,182516,Myerston Santana; Jacobo,20,0,30,10
1681925312962,LTWR 100GS,A00,182518,Forbes; Camille,20,0,20,0
1681925313985,LTWR 102,A00,182522,Staff,15,0,15,0
1681925313985,LTWR 102,B00,182525,Staff,14,0,15,1
1681925315010,LTWR 115,A00,182526,Staff,11,0,15,4
1681925316033,MAE 8,A01,182528,Pham; Hieu Tan,67,0,70,3
1681925317062,MAE 11,A00,182529,Bahadori; Mohammad Yousef,92,0,100,8
1681925318085,MAE 20,A00,182530,Evdokimenko; Ekaterina,68,0,70,2
1681925319110,MAE 30A,A00,182532,Staff,44,0,45,1
1681925320137,MAE 101A,A00,182533,Bahadori; Mohammad Yousef,94,0,100,6
1681925321165,MAE 101C,A00,182538,Staff,62,0,70,8
1681925322189,MAE 104,A00,182539,Staff,44,0,50,6
1681925323212,MAE 131A,A00,182540,Ghazinejad; Maziar,40,0,45,5
1681925324236,MAE 143A,A00,182548,Bewley; Thomas R,43,0,50,7
1681925325258,MAE 150,A00,182549,Staff,28,0,40,12
1681925326285,MAE 160,A00,182550,Evdokimenko; Ekaterina,41,0,60,19
1681925327311,MATH 3C,A01,182725,Staff,24,0,30,6
1681925328338,MATH 10A,A01,182729,Staff,25,0,30,5
1681925328338,MATH 10A,B01,182732,Staff,25,0,30,5
1681925329361,MATH 10B,A01,182737,Staff,17,0,30,13
1681925329361,MATH 10B,A02,182738,Staff,26,0,30,4
1681925329361,MATH 10B,B01,182744,Staff,27,0,30,3
1681925329361,MATH 10B,B02,182745,Staff,27,0,30,3
1681925330384,MATH 18,A01,182750,Anzaldo; Leesa B,28,0,30,2
1681925330384,MATH 18,A02,182751,Anzaldo; Leesa B,28,0,30,2
1681925330384,MATH 18,A03,182753,Anzaldo; Leesa B,27,0,30,3
1681925330384,MATH 18,A04,182757,Anzaldo; Leesa B,29,0,30,1
1681925330384,MATH 18,B01,182761,Anzaldo; Leesa B,27,0,30,3
1681925330384,MATH 18,B02,182764,Anzaldo; Leesa B,26,0,30,4
1681925330384,MATH 18,B03,182765,Anzaldo; Leesa B,29,0,30,1
1681925330384,MATH 18,B04,182766,Anzaldo; Leesa B,30,0,30,0
1681925331413,MATH 20A,A01,182771,Suk; Andrew Hoon,28,0,30,2
1681925332438,MATH 20B,A01,182775,Bach; Quang Tran,30,0,30,0
1681925332438,MATH 20B,A02,182777,Bach; Quang Tran,29,0,30,1
1681925332438,MATH 20B,B01,182780,Bach; Quang Tran,26,0,30,4
1681925332438,MATH 20B,B02,182782,Bach; Quang Tran,30,0,30,0
1681925333465,MATH 20C,A01,182787,Staff,24,0,30,6
1681925333465,MATH 20C,A02,182790,Staff,29,0,30,1
1681925333465,MATH 20C,B01,182792,Staff,24,0,30,6
1681925333465,MATH 20C,B02,182796,Staff,26,0,30,4
1681925334488,MATH 20D,A01,182799,Staff,27,0,30,3
1681925334488,MATH 20D,A02,182802,Staff,29,0,30,1
1681925334488,MATH 20D,A03,182803,Staff,30,0,30,0
1681925335511,MATH 20E,A01,182809,Verstraete; Jacques Allan,22,0,30,8
1681925335511,MATH 20E,A02,182811,Verstraete; Jacques Allan,28,0,30,2
1681925335511,MATH 20E,B01,182814,Verstraete; Jacques Allan,22,0,30,8
1681925335511,MATH 20E,B02,182815,Verstraete; Jacques Allan,30,0,30,0
1681925336535,MATH 103A,A01,182820,Staff,5,0,30,25
1681925336535,MATH 103A,A02,182821,Staff,27,0,30,3
1681925336535,MATH 103A,A03,182822,Staff,23,0,30,7
1681925336535,MATH 103A,B01,182825,Staff,23,0,30,7
1681925336535,MATH 103A,B02,182826,Staff,30,0,30,0
1681925336535,MATH 103A,B03,182830,Staff,30,0,30,0
1681925337559,MATH 109,A01,182836,Chow; Bennett,23,0,30,7
1681925337559,MATH 109,A02,182838,Chow; Bennett,29,0,30,1
1681925337559,MATH 109,A03,182894,Chow; Bennett,29,0,30,1
1681925337559,MATH 109,B01,182908,Chow; Bennett,27,0,30,3
1681925337559,MATH 109,B02,182909,Chow; Bennett,30,0,30,0
1681925337559,MATH 109,B03,182910,Chow; Bennett,26,0,30,4
1681925338587,MATH 142A,A01,182925,Staff,7,0,30,23
1681925338587,MATH 142A,A02,182935,Staff,24,0,30,6
1681925338587,MATH 142A,A03,182967,Staff,26,0,30,4
1681925338587,MATH 142A,B01,183125,Staff,23,0,30,7
1681925338587,MATH 142A,B02,183157,Staff,28,0,30,2
1681925338587,MATH 142A,B03,183158,Staff,29,0,30,1
1681925339620,MATH 183,A01,183160,Arias-Castro; Ery,23,0,30,7
1681925339620,MATH 183,A02,183161,Arias-Castro; Ery,29,0,30,1
1681925339620,MATH 183,B01,183163,Arias-Castro; Ery,28,0,30,2
1681925339620,MATH 183,B02,183164,Arias-Castro; Ery,28,0,30,2
1681925340648,MATH 193A,A01,183167,Staff,0,0,35,35
1681925340648,MATH 193A,A02,183168,Staff,27,0,35,8
1681925340648,MATH 193A,A03,183169,Staff,34,0,35,1
1681925340648,MATH 193A,A04,183170,Staff,27,0,35,8
1681925341681,MGT 4,A01,202395,Anderson; John Charles,76,0,80,4
1681925342714,MGT 5,A00,202396,Houskeeper; Robert,79,0,90,11
1681925343741,MGT 103,A00,202397,Eberhard; Craig A,49,0,90,41
1681925344766,MGT 131A,A00,202398,Houskeeper; Robert,83,0,90,7
1681925345789,MGT 135,A00,202399,Anderson; John Charles,81,0,90,9
1681925346811,MGT 162R,A00,202403,Gneezy; Uri,136,0,200,64
1681925347834,MGT 172,A00,202404,Hedges; Kathleen,38,0,90,52
1681925348858,MGT 181,A00,202405,Dunn; Louis Jean,80,0,90,10
1681925349885,MMW 14,A01,183200,Staff,6,0,28,22
1681925349885,MMW 14,A02,183201,Staff,26,0,28,2
1681925349885,MMW 14,A03,183202,Staff,24,0,28,4
1681925349885,MMW 14,A04,183203,Staff,25,0,28,3
1681925349885,MMW 14,A05,183204,Staff,26,0,28,2
1681925349885,MMW 14,A06,183205,Staff,27,0,28,1
1681925349885,MMW 14,B01,183207,Staff,26,0,28,2
1681925349885,MMW 14,B02,183208,Staff,28,0,28,0
1681925349885,MMW 14,B03,183209,Staff,28,0,28,0
1681925349885,MMW 14,B04,183210,Staff,28,0,28,0
1681925349885,MMW 14,B05,183211,Staff,28,0,28,0
1681925349885,MMW 14,B06,183212,Staff,27,0,28,1
1681925350910,MMW 14GS,A00,183213,Zhiri; Oumelbanine,28,0,28,0
1681925351935,MMW 15GS,B00,183215,Rahimi; Babak,28,0,28,0
1681925352961,MMW 121,A01,183217,Patterson; Patrick H.,11,0,28,17
1681925352961,MMW 121,A02,183218,Patterson; Patrick H.,25,0,28,3
1681925353988,MUS 1A,A01,182554,Staff,4,0,35,31
1681925355011,MUS 5,A01,182558,Staff,17,0,35,18
1681925356034,MUS 6,A01,182562,Staff,22,0,35,13
1681925357061,MUS 8GS,A00,182563,Borgo; David Garcia,25,0,25,0
1681925358083,MUS 13,A01,182567,Staff,23,0,25,2
1681925359110,MUS 15,A01,182570,Staff,31,0,35,4
1681925359110,MUS 15,B01,182575,Staff,7,0,35,28
1681925360134,MUS 80,A00,182578,Staff,22,0,25,3
1681925360134,MUS 80,B00,182581,Staff,20,0,25,5
1681925361157,MUS 113,A00,182582,Staff,25,0,25,0
1681925362189,MUS 114,A00,182583,Staff,3,0,25,22
1681925363216,MUS 150GS,A01,182588,Borgo; David Garcia,25,0,25,0
1681925364243,PHIL 1,A00,182590,Staff,34,0,40,6
1681925365268,PHIL 10,A01,182596,Grush; Rick Scott,30,0,35,5
1681925365268,PHIL 10,A02,182597,Grush; Rick Scott,33,0,35,2
1681925366292,PHIL 15,A01,182601,Staff,31,0,35,4
1681925366292,PHIL 15,A02,182602,Staff,33,0,35,2
1681925367325,PHIL 27,A01,182604,Staff,30,0,35,5
1681925367325,PHIL 27,A02,182607,Staff,35,0,35,0
1681925368348,PHIL 32,A01,182609,Staff,35,0,35,0
1681925368348,PHIL 32,A02,182612,Staff,35,0,35,0
1681925369373,PHIL 130,A00,182614,Staff,61,0,70,9
1681925370402,PHIL 136,A00,182616,Cohen; Jonathan David,66,0,70,4
1681925371446,PHIL 155,A00,182617,Vargas; Manuel Rogelio,58,0,70,12
1681925372474,PHIL 163,A01,182620,Staff,15,0,20,5
1681925372474,PHIL 163,A02,182624,Staff,10,0,20,10
1681925373499,PHIL 164,A00,182627,Staff,29,0,40,11
1681925374525,PHIL 173,A00,182628,Staff,35,0,40,5
1681925375547,PHYS 1A,A00,183221,Staff,54,0,60,6
1681925376573,PHYS 1AL,001,183222,Staff,25,0,30,5
1681925376573,PHYS 1AL,002,183223,Staff,26,0,30,4
1681925377602,PHYS 1B,A00,183231,Staff,42,0,60,18
1681925378625,PHYS 1BL,001,183232,Staff,19,0,30,11
1681925378625,PHYS 1BL,002,183233,Staff,27,0,30,3
1681925379652,PHYS 1C,A00,183240,Staff,24,0,60,36
1681925380677,PHYS 1CL,001,183241,Staff,9,0,30,21
1681925380677,PHYS 1CL,002,183242,Staff,22,0,30,8
1681925381700,PHYS 2AR,A01,183250,Staff,43,0,50,7
1681925382724,PHYS 2B,A01,183252,Staff,104,0,115,11
1681925383746,PHYS 2BL,A01,183254,Staff,21,0,24,3
1681925383746,PHYS 2BL,A02,183255,Staff,21,0,24,3
1681925384777,PHYS 2C,A01,183522,Staff,102,0,115,13
1681925385811,PHYS 4A,A01,183524,Staff,49,0,50,1
1681925386837,POLI 5,A00,183525,Staff,44,0,50,6
1681925387868,POLI 12,A00,183540,Staff,45,0,50,5
1681925388895,POLI 13R,A00,183541,Forman; Fonna,41,0,50,9
1681925389923,POLI 30,A00,183542,Mignozzetti; Umberto,48,0,50,2
1681925390950,POLI 100A,A00,183543,Staff,45,0,50,5
1681925391977,POLI 100E,A00,223598,Staff,32,0,35,3
1681925393002,POLI 103A,A00,183564,Kousser; Thad,37,0,50,13
1681925394028,POLI 104B,A00,201329,Staff,28,0,35,7
1681925395050,POLI 113BR,A00,183576,Hoston; Germaine,23,0,50,27
1681925396079,POLI 114BR,A00,183588,Staff,27,0,30,3
1681925397105,POLI 117R,A00,183595,Forman; Fonna,4,0,20,16
1681925398132,POLI 120H,A00,183596,Fisk; David Lee,13,0,20,7
1681925399155,POLI 130AA,A00,183597,Staff,13,0,20,7
1681925400186,POLI 134AA,A00,183598,Staff,19,0,20,1
1681925401210,POLI 135,A00,183599,Fisk; David Lee,19,0,25,6
1681925402310,POLI 142P,A00,183623,Staff,37,0,40,3
1681925403333,POLI 144D,A00,183624,Staff,22,0,25,3
1681925404356,POLI 151,A00,183625,Staff,15,0,20,5
1681925405389,POLI 162,A00,183626,Mignozzetti; Umberto,17,0,20,3
1681925406412,PSYC 1,A00,253748,Staff,86,0,90,4
1681925407437,PSYC 2,A00,183627,Moranton; Nirelia Melbina-,24,0,35,11
1681925408476,PSYC 3,A00,183628,Staff,43,0,45,2
1681925410526,PSYC 60,A01,183631,Lowe; Angela Beth,35,0,40,5
1681925411552,PSYC 70,A01,253757,Staff,37,0,45,8
1681925412577,PSYC 101,A00,183632,Heyman; Gail D.,45,0,60,15
1681925413600,PSYC 105,A00,183848,Lowe; Angela Beth,47,0,60,13
1681925414622,PSYC 106,A00,183849,Dobkins; Karen R.,41,0,60,19
1681925415649,PSYC 108,A00,253750,Staff,18,0,60,42
1681925416674,PSYC 114,A01,184275,Winkielman; Piotr,0,8,30,30
1681925417699,PSYC 122,A00,183856,Moranton; Nirelia Melbina-,0,15,30,30
1681925418739,PSYC 124,A00,183865,Chapman; Eddie Nathaniel,48,0,80,32
1681925419769,PSYC 137,A00,183880,Staff,19,0,25,6
1681925421822,PSYC 154,A00,183910,Lacefield; Katharine I,0,21,90,90
1681925423881,PSYC 162,A00,183946,Wixted; John T,51,0,90,39
1681925424918,PSYC 172,A00,183947,Gorman; Michael R.,8,0,30,22
1681925425949,PSYC 178,A00,183963,Glaser; Dale,17,0,40,23
1681925426976,PSYC 181GS,A00,183964,Anagnostaras; Stephan,10,0,10,0
1681925427998,PSYC 186GS,A01,257660,Staff,10,0,10,0
1681925429028,PSYC 193,B00,253749,Staff,23,0,25,2
1681925431082,PSYC 193L,A01,184122,Staff,33,0,35,2
1681925431082,PSYC 193L,C01,184167,Winkielman; Piotr,14,0,30,16
1681925432110,RELI 188GS,A00,182629,Rahimi; Babak,20,0,20,0
1681925433144,SE 101A,A00,182646,Staff,26,0,30,4
1681925434176,SE 101C,A00,182650,Staff,17,0,20,3
1681925435206,SE 110A,A00,182651,Staff,28,0,28,0
1681925436233,SE 130A,A00,182652,Staff,38,0,40,2
1681925437255,SIO 46GS,A00,182636,Cook; Geoffrey W,25,0,28,3
1681925438277,SIO 109R,A00,194459,Staff,2,0,20,18
1681925439302,SIO 121GS,A00,182639,Cook; Geoffrey W,25,0,28,3
1681925440339,SIO 132,A01,182642,Staff,32,0,40,8
1681925441374,SIO 139,A00,182644,Kacev; David,36,0,40,4
1681925442397,SOCI 2,A01,258404,Staff,33,0,36,3
1681925442397,SOCI 2,A02,258405,Staff,35,0,36,1
1681925443426,SOCI 60,A01,258408,Staff,29,0,30,1
1681925443426,SOCI 60,A02,258413,Staff,30,0,30,0
1681925444448,SOCI 100,A01,258415,Staff,29,0,30,1
1681925444448,SOCI 100,A02,258416,Staff,28,0,30,2
1681925450599,SOCI 127,A00,258421,Staff,21,0,30,9
1681925451621,SOCI 132,A00,258422,Staff,45,0,50,5
1681925452655,SOCI 133,A00,258423,Staff,26,0,30,4
1681925453680,SOCI 138GS,A00,258424,Staff,15,0,15,0
1681925454709,SOCI 145,A00,258425,Staff,25,0,30,5
1681925455735,SOCI 148,A00,258426,Staff,24,0,30,6
1681925456760,SOCI 153,A00,199217,Staff,29,0,30,1
1681925457793,SOCI 160,A00,258427,Staff,28,0,30,2
1681925458816,SOCI 160E,A00,258435,Staff,56,0,60,4
1681925459842,SOCI 189GS,A00,258436,Staff,15,0,15,0
1681925460872,SOCI 190GS,A00,258437,Staff,15,0,15,0
1681925461896,SYN 2,001,182658,Staff,8,0,16,8
1681925461896,SYN 2,002,201439,Staff,14,0,16,2
1681925461896,SYN 2,003,201443,Staff,16,0,16,0
1681925462920,SYN 100,A01,182657,Staff,14,0,20,6
1681925463945,TDAC 1,A00,184381,Salovey; Todd,16,0,20,4
1681925463945,TDAC 1,B00,184385,Harting; Carla Kelso,19,0,20,1
1681925463945,TDAC 1,C00,184394,Staff,19,0,20,1
1681925465000,TDAC 101,A00,184483,Harting; Carla Kelso,19,0,20,1
1681925466056,TDDE 111,A00,184496,Staff,14,0,15,1
1681925467080,TDDE 131,A00,184504,Staff,20,0,20,0
1681925467080,TDDE 131,B00,184505,Staff,17,0,18,1
1681925467080,TDDE 131,C00,184534,Staff,49,0,50,1
1681925467080,TDDE 131,D00,184564,Staff,15,0,15,0
1681925467080,TDDE 131,E00,204725,Staff,19,0,20,1
1681925468119,TDGE 1,A01,184414,Salovey; Todd,36,0,50,14
1681925469143,TDGE 5,A01,184419,Staff,23,0,24,1
1681925470170,TDGE 10,A00,184428,Fulton; Julia,29,0,50,21
1681925471195,TDGE 124,A00,184565,Fulton; Julia,3,0,50,47
1681925472223,TDGE 125,B00,184567,Meyer; Ursula,9,0,25,16
1681925473246,TDHT 101,A00,184568,Staff,21,0,25,4
1681925473246,TDHT 101,B00,184569,Staff,20,0,20,0
1681925474273,TDHT 114,A00,184570,Staff,49,0,50,1
1681925475297,TDMV 1,A00,184437,Arcidiacono; Kristin,22,0,30,8
1681925475297,TDMV 1,B00,184448,Caligagan; Maria T.,23,0,30,7
1681925476330,TDMV 2,A00,184449,Weinberg; Sadie,27,0,30,3
1681925476330,TDMV 2,B00,184453,Arcidiacono; Kristin,29,0,30,1
1681925477351,TDMV 110,A00,184571,Weinberg; Sadie,30,0,30,0
1681925478374,TDMV 142,A00,184572,Caligagan; Tony,27,0,30,3
1681925478374,TDMV 142,B00,184573,Caligagan; Maria T.,26,0,30,4
1681925479402,TDTR 20,A00,184482,Jun; Grace Shin Hae,25,0,25,0
1681925480431,USP 2,A01,184290,Hinds; Juli Beth,24,0,25,1
1681925481461,USP 3,A01,184295,Staff,21,0,25,4
1681925482504,USP 4,A00,184304,McTague; Sarah,13,0,25,12
1681925483526,USP 100,A00,184315,Staff,16,0,25,9
1681925484550,USP 105,A00,184326,Staff,21,0,25,4
1681925485573,USP 151,A00,184327,Staff,19,0,25,6
1681925486594,USP 170,A00,184380,Hinds; Juli Beth,13,0,25,12
1681925487619,VIS 21B,A01,182660,Staff,28,0,31,3
1681925487619,VIS 21B,A02,182662,Staff,30,0,31,1
1681925488660,VIS 103D,A00,182663,Staff,74,0,75,1
1681925489697,VIS 105D,A00,182667,Li; Huai,14,0,22,8
1681925490724,VIS 122GS,A00,182668,Herbst; Matthew,20,0,20,0
1681925491759,VIS 128C,A00,182673,Staff,69,0,75,6
1681925492782,VIS 130,A00,182675,Staff,19,0,22,3
1681925493805,VIS 160A,A00,182678,Stalbaum; Brett,4,0,10,6
1681925495855,WCWP 10B,A00,201679,Staff,15,0,15,0
1681925495855,WCWP 10B,B00,201695,Staff,15,0,15,0
1681925496879,WCWP 100,A00,201716,Staff,12,0,15,3
1681925496879,WCWP 100,B00,201717,Staff,3,0,15,12
1681925498942,ANSC 105GS,A00,258289,Staff,0,0,0,0
1681925499966,ANSC 125GS,A00,258295,Staff,0,0,0,0
1681925500989,ANSC 150,A00,258267,Staff,30,0,40,10
1681925502014,ANSC 190GS,A00,258280,Staff,0,0,0,0
1681925503045,ANTH 1,A00,258264,Staff,38,0,40,2
1681925504069,ANTH 2,A01,258259,Staff,72,0,76,4
1681925505110,ANTH 23,A01,258228,Staff,36,0,40,4
1681925506204,ANTH 101,A01,258236,Staff,38,0,40,2
1681925507227,ANTH 102,A00,258272,Staff,59,0,60,1
1681925508250,ANTH 105,A00,258244,Staff,30,0,35,5
1681925509277,BENG 130,A00,253975,Staff,38,0,40,2
1681925510310,BIBC 102,A01,191866,Flagg; Matthew Paul,19,0,32,13
1681925510310,BIBC 102,A02,191867,Flagg; Matthew Paul,21,0,32,11
1681925510310,BIBC 102,A03,191868,Flagg; Matthew Paul,29,0,32,3
1681925510310,BIBC 102,A04,191936,Flagg; Matthew Paul,25,0,32,7
1681925510310,BIBC 102,A05,191937,Flagg; Matthew Paul,0,0,32,32
1681925511340,BICD 100,A01,191939,Cooper; Andrew Michael,28,0,32,4
1681925511340,BICD 100,A02,191940,Cooper; Andrew Michael,32,0,32,0
1681925511340,BICD 100,A03,191941,Cooper; Andrew Michael,32,0,32,0
1681925511340,BICD 100,A04,191942,Cooper; Andrew Michael,32,0,32,0
1681925511340,BICD 100,A05,191943,Cooper; Andrew Michael,32,0,32,0
1681925512367,BIEB 126,A01,191945,Cleland; Elsa Eleanor,0,1,32,32
1681925512367,BIEB 126,A02,191946,Cleland; Elsa Eleanor,27,0,32,5
1681925512367,BIEB 126,A03,191947,Cleland; Elsa Eleanor,29,0,32,3
1681925512367,BIEB 126,A04,191948,Cleland; Elsa Eleanor,20,0,32,12
1681925512367,BIEB 126,A05,191996,Cleland; Elsa Eleanor,28,0,32,4
1681925513399,BIEB 136GS,A00,191997,Shurin; Jonathan & Holway; David A.,0,0,0,5
1681925514424,BIEB 137GS,A01,191999,Shurin; Jonathan & Holway; David A.,0,0,0,4
1681925515452,BILD 1,A01,205385,Staff,31,0,32,1
1681925515452,BILD 1,A02,205386,Staff,30,0,32,2
1681925515452,BILD 1,A03,205387,Staff,31,0,32,1
1681925515452,BILD 1,A04,205388,Staff,26,0,32,6
1681925516476,BILD 2,A01,191774,Staff,28,0,32,4
1681925516476,BILD 2,A02,191775,Staff,30,0,32,2
1681925516476,BILD 2,A03,191777,Staff,30,0,32,2
1681925516476,BILD 2,A04,191856,Staff,31,0,32,1
1681925516476,BILD 2,A05,191857,Staff,32,0,32,0
1681925516476,BILD 2,A06,191858,Staff,32,0,32,0
1681925516476,BILD 2,A07,191859,Staff,31,0,32,1
1681925517497,BILD 3,A01,205391,Staff,29,0,32,3
1681925517497,BILD 3,A02,205393,Staff,32,0,32,0
1681925517497,BILD 3,A03,205394,Staff,27,0,32,5
1681925517497,BILD 3,A04,205395,Staff,32,0,32,0
1681925518520,BILD 20,A01,191861,Staff,32,0,32,0
1681925518520,BILD 20,A02,191862,Staff,32,0,32,0
1681925519543,BILD 30,A01,191864,Staff,31,0,32,1
1681925520566,BIMM 100,A01,192019,Staff,0,0,32,32
1681925520566,BIMM 100,A02,192020,Staff,19,0,32,13
1681925520566,BIMM 100,A03,192035,Staff,19,0,32,13
1681925521591,BIMM 110,A01,192037,Tat; John,0,0,32,32
1681925521591,BIMM 110,A02,192038,Tat; John,7,0,32,25
1681925522617,BIMM 120,A01,192040,Pickett; Brooke Elizabeth,0,0,32,32
1681925522617,BIMM 120,A02,192041,Pickett; Brooke Elizabeth,9,0,32,23
1681925522617,BIMM 120,A03,192042,Pickett; Brooke Elizabeth,15,0,32,17
1681925523647,BIPN 100,A01,192044,Armour; Jon Christopher,23,0,32,9
1681925523647,BIPN 100,A02,192059,Armour; Jon Christopher,30,0,32,2
1681925523647,BIPN 100,A03,192064,Armour; Jon Christopher,30,0,32,2
1681925523647,BIPN 100,A04,192073,Armour; Jon Christopher,27,0,32,5
1681925524677,BIPN 148,A01,205411,Leutgeb; Jill K.,15,0,32,17
1681925524677,BIPN 148,A02,205412,Leutgeb; Jill K.,31,0,32,1
1681925524677,BIPN 148,A03,205413,Leutgeb; Jill K.,30,0,32,2
1681925524677,BIPN 148,A04,205414,Leutgeb; Jill K.,30,0,32,2
1681925525710,BIPN 160,A01,192115,Marino; Marc J,16,0,32,16
1681925525710,BIPN 160,A02,192148,Marino; Marc J,27,0,32,5
1681925525710,BIPN 160,A03,192158,Marino; Marc J,31,0,32,1
1681925525710,BIPN 160,A04,192190,Marino; Marc J,32,0,32,0
1681925525710,BIPN 160,A05,192287,Marino; Marc J,32,0,32,0
1681925525710,BIPN 160,A06,192288,Marino; Marc J,32,0,32,0
1681925526736,BIPN 194,A00,206038,Staff,28,0,32,4
1681925527762,BISP 194,A00,192289,Leutgeb; Stefan,11,0,32,21
1681925527762,BISP 194,B00,245332,Nieh; James Charles,26,0,32,6
1681925528789,CAT 124,A01,202247,Staff,15,0,15,0
1681925529822,CAT 125,A00,202248,Staff,18,0,20,2
1681925529822,CAT 125,B00,202253,Staff,20,0,20,0
1681925529822,CAT 125,C00,202257,Staff,18,0,20,2
1681925530854,CAT 125GS,A01,202273,Bronstein; Phoebe Malan,20,0,20,0
1681925531879,CAT 125R,A00,202284,Staff,18,0,20,2
1681925531879,CAT 125R,C00,202286,Staff,5,0,20,15
1681925531879,CAT 125R,D00,202291,Staff,17,0,20,3
1681925531879,CAT 125R,E00,202295,Staff,13,0,20,7
1681925531879,CAT 125R,F00,202302,Staff,8,0,20,12
1681925532901,CENG 100,A00,204724,Opatkiewicz; Justin Paul,25,0,25,0
1681925533926,CGS 2A,A01,180420,Staff,31,0,36,5
1681925534956,CGS 101,A00,180421,Staff,16,0,20,4
1681925535979,CGS 112,A00,180422,Staff,9,0,16,7
1681925537004,CGS 113,A00,180423,Staff,18,0,20,2
1681925538035,CGS 137,A00,180424,Staff,12,0,12,0
1681925539063,CGS 147,A00,180425,Staff,10,0,10,0
1681925540097,CHEM 6A,A01,179556,Staff,94,0,100,6
1681925540097,CHEM 6A,A02,179558,Staff,0,0,0,0
1681925541123,CHEM 6B,A01,179560,Staff,100,0,100,0
1681925542146,CHEM 6C,A01,179565,Jazzar; Rodolphe,93,0,100,7
1681925543179,CHEM 7L,A01,179586,Schurmeier; Kimberly,10,0,24,14
1681925543179,CHEM 7L,A02,179587,Schurmeier; Kimberly,23,0,24,1
1681925543179,CHEM 7L,A03,179590,Schurmeier; Kimberly,22,0,24,2
1681925543179,CHEM 7L,A04,179591,Schurmeier; Kimberly,22,0,24,2
1681925543179,CHEM 7L,B01,179598,Schurmeier; Kimberly,16,0,24,8
1681925543179,CHEM 7L,B02,179599,Schurmeier; Kimberly,24,0,24,0
1681925543179,CHEM 7L,B03,179606,Schurmeier; Kimberly,23,0,24,1
1681925543179,CHEM 7L,B04,179607,Schurmeier; Kimberly,22,0,24,2
1681925544206,CHEM 11,A01,179609,Stallings; Dontarie M,87,0,100,13
1681925545233,CHEM 40A,A01,179621,Staff,40,0,50,10
1681925545233,CHEM 40A,A02,179622,Staff,46,0,50,4
1681925546256,CHEM 40B,A01,179630,Weizman; Haim,47,0,50,3
1681925546256,CHEM 40B,A02,179631,Weizman; Haim,44,0,50,6
1681925547288,CHEM 41A,A01,179660,Klosterman; Jeremy K,93,0,100,7
1681925548312,CHEM 43A,A01,179683,Klosterman; Jeremy K,0,0,24,24
1681925548312,CHEM 43A,A02,179688,Klosterman; Jeremy K,8,0,24,16
1681925548312,CHEM 43A,A03,179689,Klosterman; Jeremy K,18,0,24,6
1681925548312,CHEM 43A,A04,179691,Klosterman; Jeremy K,18,0,24,6
1681925549341,CHEM 114A,A01,179693,Stallings; Dontarie M,70,0,100,30
1681925550366,CHEM 143B,A01,179698,Weizman; Haim,16,0,24,8
1681925550366,CHEM 143B,A02,179700,Weizman; Haim,24,0,24,0
1681925551393,CHIN 169A,A00,179701,Wang; Xiao,20,0,20,0
1681925552428,COGS 2,A01,179750,Boyle; Mary E. T.,17,0,30,13
1681925553459,COGS 9,A01,179759,Jones; Cameron Robert,42,0,50,8
1681925554481,COGS 14A,A01,179854,Staff,15,0,50,35
1681925555505,COGS 14B,A01,179856,Staff,53,0,60,7
1681925556543,COGS 17,A01,179874,Staff,71,0,75,4
1681925557566,COGS 18,A01,179884,Staff,62,0,80,18
1681925558593,COGS 100,A01,179886,Staff,36,0,60,24
1681925559615,COGS 101B,A01,179892,Staff,0,1,30,30
1681925560638,COGS 101C,A01,179894,Staff,28,0,30,2
1681925561661,COGS 107A,A01,179896,Boyle; Mary E. T.,30,0,40,10
1681925562687,COGS 108,A01,179898,Simpkins; Charles Alexander,0,26,60,60
1681925563711,COGS 109,A01,179900,Staff,34,0,40,6
1681925564733,COGS 118A,A01,179946,Staff,6,0,40,34
1681925565756,COGS 153,A00,179978,Staff,0,3,30,30
1681925566790,COGS 156,A01,179981,Staff,23,0,30,7
1681925568835,COGS 172,A01,179987,Staff,13,0,30,17
1681925570897,COGS 186,A01,179991,Staff,12,0,30,18
1681925571920,COMM 10,A01,180001,Staff,13,0,25,12
1681925571920,COMM 10,A02,180004,Staff,20,0,25,5
1681925572944,COMM 100A,A01,180016,Staff,15,0,25,10
1681925572944,COMM 100A,A02,180020,Staff,24,0,25,1
1681925573968,COMM 101T,A00,180029,Halm; Gavin Patrick,22,0,35,13
1681925574994,COMM 106V,A00,180043,Staff,34,0,35,1
1681925576018,COMM 109P,A00,180044,Staff,30,0,35,5
1681925577043,COMM 113T,A00,180045,Havis; Allan,37,0,45,8
1681925578078,COMM 132,A00,180046,McKenna; Denise,23,0,30,7
1681925579108,COMM 143,A00,180047,Staff,18,0,30,12
1681925580132,COMM 190,A00,180048,Conner; Thomas Hartnell,18,0,23,5
1681925581157,CSE 8A,A50,180053,Cao; Yingjun,21,0,50,29
1681925581157,CSE 8A,B50,180180,Staff,50,0,50,0
1681925582184,CSE 11,A01,180190,Cao; Yingjun,23,0,50,27
1681925583211,CSE 20,A01,180192,Briones; Jor-el Thomas Caparas,22,0,30,8
1681925584235,CSE 21,A01,194538,Briones; Jor-el Thomas Caparas,50,0,60,10
1681925585258,CSE 30,A01,180324,Eldon; John,75,0,100,25
1681925586284,CSE 101,A01,201353,Staff,0,26,40,40
1681925587307,CSE 134B,A01,180326,Powell; Thomas Allan,74,0,100,26
1681925588342,CSE 140,A01,180328,Staff,34,0,75,41
1681925589367,CSE 140L,A01,180344,Eldon; John,57,0,100,43
1681925590394,CSE 150A,A01,180411,Staff,0,15,50,50
1681925591418,CSE 151A,A01,180414,Staff,0,8,50,50
1681925592440,CSE 175,A01,222521,Kumar; Rakesh,50,0,50,0
1681925593465,CSE 190,A00,201419,Staff,42,0,49,7
1681925594496,CSS 1,A01,194536,Staff,35,0,50,15
1681925595519,DSC 30,A01,202385,Staff,48,0,50,2
1681925596547,DSC 40A,A01,202387,Albuyeh; Rod,50,0,50,0
1681925597570,DSC 190,A01,202389,Silberman; Jack,21,0,21,0
1681925598592,DSGN 100,A01,179993,Staff,14,0,30,16
1681925599615,ECE 65,A50,180708,Staff,10,0,20,10
1681925599615,ECE 65,A51,180739,Staff,19,0,20,1
1681925600638,ECON 1,A01,180427,Famulari; Melissa,67,0,70,3
1681925601665,ECON 2,A01,180450,Levkoff; Steven B.,64,0,70,6
1681925602689,ECON 4,A01,203351,Anderson; John Charles,6,0,10,4
1681925603712,ECON 100A,A01,180472,Famulari; Melissa,59,0,70,11
1681925604737,ECON 120A,A01,180549,Staff,63,0,70,7
1681925605759,ECON 120B,A01,180655,Ma; Xinwei,41,0,70,29
1681925606786,ECON 129,A00,203333,Eckert; Fabian Paul,11,0,35,24
1681925607809,ECON 131,A00,180656,Staff,5,0,35,30
1681925608831,ECON 172B,A01,180672,Levkoff; Steven B.,31,0,35,4
1681925609933,ECON 178,A01,203342,Zhu; Ying,8,0,35,27
1681925610955,EDS 108GS,A00,202383,Wishard Guerra; Alison G.,20,0,20,0
1681925611977,EDS 111GS,A00,202347,Wishard Guerra; Alison G.,20,0,20,0
1681925613003,EDS 112,A01,202323,Staff,53,0,60,7
1681925614026,EDS 113,A00,202340,Staff,32,0,35,3
1681925615056,EDS 118,A00,201231,Staff,19,0,30,11
1681925616081,EDS 119,A00,204994,Staff,8,0,10,2
1681925617106,EDS 124BR,A00,202324,Eguchi; Emi,1,0,25,24
1681925618136,EDS 126,A01,203208,Jones; Makeba,26,0,30,4
1681925619164,EDS 135,A01,202333,Staff,17,0,20,3
1681925620189,EDS 180,A00,202311,Staff,47,0,50,3
1681925621217,ERC 190GS,A01,253747,Staff,28,0,28,0
1681925622245,ETHN 104,A00,180742,Staff,22,0,35,13
1681925623268,ETHN 118,A00,180745,Staff,27,0,35,8
1681925624294,ETHN 127,A00,180747,Staff,11,0,16,5
1681925625317,ETHN 137,A00,180880,Staff,11,0,12,1
1681925626340,ETHN 147,A00,180890,Staff,8,0,10,2
1681925627366,ETHN 154,A00,180891,Staff,7,0,8,1
1681925628392,ETHN 168,A00,180892,Staff,9,0,10,1
1681925629415,GLBH 20,A00,201051,Hannah; Seth Donal,0,4,0,1
1681925630438,GLBH 111,A01,209338,Burgos; Jose L.,0,0,0,0
1681925631462,GLBH 150,A00,258300,Staff,0,3,0,0
1681925632486,GLBH 181,A00,201207,Staff,11,0,40,29
1681925633514,HIEU 109,A00,180898,Staff,19,0,20,1
1681925634545,HIEU 111,A00,180899,Staff,0,2,20,20
1681925635578,HIEU 124,A00,180900,Staff,17,0,20,3
1681925636600,HILA 122,A00,180901,Staff,18,0,20,2
1681925637622,HILA 132,A00,180902,Vitz; Matthew,0,0,20,20
1681925638650,HILD 10,A01,180896,Staff,14,0,20,6
1681925639674,HILD 30GS,A00,180897,Edington; Claire Ellen,0,0,0,0
1681925640700,HISC 105,A00,180903,Staff,20,0,20,0
1681925641723,HISC 117,A00,180904,Staff,10,0,20,10
1681925642748,HIUS 108B,A00,181005,Staff,18,0,20,2
1681925643776,HIUS 113,A00,181093,Staff,0,0,20,20
1681925644804,HUM 3,A01,181190,Patterson; Patrick H.,38,0,50,12
1681925644804,HUM 3,B01,181195,Staff,46,0,50,4
1681925645826,HUM 3GS,A00,181196,Herbst; Matthew,0,0,0,0
1681925646849,HUM 4,A01,181227,West; Geoffrey Scott,33,0,50,17
1681925646849,HUM 4,B01,181282,Staff,41,0,50,9
1681925647872,HUM 4GS,A00,181377,Lyon; Antony J.,0,0,0,0
1681925648901,HUM 5,A01,181536,Zavodny; Tatiana Sophia,26,0,50,24
1681925648901,HUM 5,B01,181908,Staff,35,0,50,15
1681925649927,INTL 190,A00,181909,Segui; Alan S,0,0,0,8
1681925649927,INTL 190,B00,181961,Segui; Alan S,0,0,0,7
1681925650952,JAPN 20AR,A01,182113,Ross; Kayoko F,15,0,20,5
1681925651976,LATI 50,A01,202391,Martin-Cabrera; Luis,18,0,30,12
1681925651976,LATI 50,A02,202392,Martin-Cabrera; Luis,26,0,30,4
1681925652999,LATI 180,A00,202393,Kokinis; Troy Andreas,24,0,25,1
1681925654034,LIFR 1A,A00,182119,Staff,14,0,14,0
1681925655109,LIFR 1AX,A00,182324,Staff,14,0,14,0
1681925656131,LIFR 1B,A00,182259,Staff,12,0,14,2
1681925657153,LIFR 1BX,A00,182273,Staff,12,0,14,2
1681925658176,LIGN 8,A00,182330,Staff,131,0,150,19
1681925659205,LIGN 9GS,A00,182362,Staff,17,0,20,3
1681925660228,LIGN 119,A00,204992,Takahashi; Maho,11,0,15,4
1681925661252,LIGN 130,A01,182384,Staff,47,0,50,3
1681925662283,LIGN 149GS,A00,182390,Staff,17,0,20,3
1681925663305,LIGN 170,A00,182404,Staff,23,0,30,7
1681925664327,LISP 1D,A00,182281,Staff,7,0,14,7
1681925664327,LISP 1D,B00,182287,Staff,13,0,14,1
1681925664327,LISP 1D,C00,182295,Staff,10,0,14,4
1681925664327,LISP 1D,D00,182301,Staff,14,0,14,0
1681925665350,LISP 1DX,A00,182309,Staff,19,0,28,9
1681925665350,LISP 1DX,B00,182316,Staff,25,0,28,3
1681925666377,LTAF 120GS,A00,182412,Zhiri; Oumelbanine,20,0,20,0
1681925667400,LTCS 172GS,A00,182437,Bronstein; Phoebe Malan,20,0,20,0
1681925668431,LTEA 138,A00,182457,Staff,19,0,40,21
1681925669452,LTEN 114,A01,182490,Staff,23,0,25,2
1681925670475,LTEN 130GS,A00,182491,Lyon; Antony J.,20,0,20,0
1681925671501,LTEN 169,A00,182493,Cuong; Marisol,19,0,25,6
1681925672522,LTEN 178,A00,182501,Staff,14,0,15,1
1681925673557,LTEN 181,A00,182515,Staff,20,0,25,5
1681925674581,LTEN 185GS,A00,197655,Forbes; Camille,20,0,20,0
1681925675607,LTSP 100B,A00,202208,Bessett; Ryan Matthew,24,0,25,1
1681925676630,LTWL 100,A00,182516,Myerston Santana; Jacobo,20,0,30,10
1681925677661,LTWR 100GS,A00,182518,Forbes; Camille,20,0,20,0
1681925678684,LTWR 102,A00,182522,Staff,15,0,15,0
1681925678684,LTWR 102,B00,182525,Staff,14,0,15,1
1681925679723,LTWR 115,A00,182526,Staff,11,0,15,4
1681925680747,MAE 8,A01,182528,Pham; Hieu Tan,67,0,70,3
1681925681773,MAE 11,A00,182529,Bahadori; Mohammad Yousef,92,0,100,8
1681925682796,MAE 20,A00,182530,Evdokimenko; Ekaterina,68,0,70,2
1681925683827,MAE 30A,A00,182532,Staff,44,0,45,1
1681925684871,MAE 101A,A00,182533,Bahadori; Mohammad Yousef,94,0,100,6
1681925685897,MAE 101C,A00,182538,Staff,62,0,70,8
1681925686923,MAE 104,A00,182539,Staff,44,0,50,6
1681925687947,MAE 131A,A00,182540,Ghazinejad; Maziar,40,0,45,5
1681925688978,MAE 143A,A00,182548,Bewley; Thomas R,43,0,50,7
1681925690003,MAE 150,A00,182549,Staff,28,0,40,12
1681925691028,MAE 160,A00,182550,Evdokimenko; Ekaterina,41,0,60,19
1681925692051,MATH 3C,A01,182725,Staff,24,0,30,6
1681925693074,MATH 10A,A01,182729,Staff,25,0,30,5
1681925693074,MATH 10A,B01,182732,Staff,25,0,30,5
1681925694096,MATH 10B,A01,182737,Staff,17,0,30,13
1681925694096,MATH 10B,A02,182738,Staff,26,0,30,4
1681925694096,MATH 10B,B01,182744,Staff,27,0,30,3
1681925694096,MATH 10B,B02,182745,Staff,27,0,30,3
1681925695126,MATH 18,A01,182750,Anzaldo; Leesa B,28,0,30,2
1681925695126,MATH 18,A02,182751,Anzaldo; Leesa B,28,0,30,2
1681925695126,MATH 18,A03,182753,Anzaldo; Leesa B,27,0,30,3
1681925695126,MATH 18,A04,182757,Anzaldo; Leesa B,29,0,30,1
1681925695126,MATH 18,B01,182761,Anzaldo; Leesa B,27,0,30,3
1681925695126,MATH 18,B02,182764,Anzaldo; Leesa B,26,0,30,4
1681925695126,MATH 18,B03,182765,Anzaldo; Leesa B,29,0,30,1
1681925695126,MATH 18,B04,182766,Anzaldo; Leesa B,30,0,30,0
1681925696153,MATH 20A,A01,182771,Suk; Andrew Hoon,28,0,30,2
1681925697177,MATH 20B,A01,182775,Bach; Quang Tran,30,0,30,0
1681925697177,MATH 20B,A02,182777,Bach; Quang Tran,29,0,30,1
1681925697177,MATH 20B,B01,182780,Bach; Quang Tran,26,0,30,4
1681925697177,MATH 20B,B02,182782,Bach; Quang Tran,30,0,30,0
1681925698201,MATH 20C,A01,182787,Staff,24,0,30,6
1681925698201,MATH 20C,A02,182790,Staff,29,0,30,1
1681925698201,MATH 20C,B01,182792,Staff,24,0,30,6
1681925698201,MATH 20C,B02,182796,Staff,26,0,30,4
1681925699232,MATH 20D,A01,182799,Staff,27,0,30,3
1681925699232,MATH 20D,A02,182802,Staff,29,0,30,1
1681925699232,MATH 20D,A03,182803,Staff,30,0,30,0
1681925700256,MATH 20E,A01,182809,Verstraete; Jacques Allan,22,0,30,8
1681925700256,MATH 20E,A02,182811,Verstraete; Jacques Allan,28,0,30,2
1681925700256,MATH 20E,B01,182814,Verstraete; Jacques Allan,22,0,30,8
1681925700256,MATH 20E,B02,182815,Verstraete; Jacques Allan,30,0,30,0
1681925701279,MATH 103A,A01,182820,Staff,5,0,30,25
1681925701279,MATH 103A,A02,182821,Staff,27,0,30,3
1681925701279,MATH 103A,A03,182822,Staff,23,0,30,7
1681925701279,MATH 103A,B01,182825,Staff,23,0,30,7
1681925701279,MATH 103A,B02,182826,Staff,30,0,30,0
1681925701279,MATH 103A,B03,182830,Staff,30,0,30,0
1681925702306,MATH 109,A01,182836,Chow; Bennett,23,0,30,7
1681925702306,MATH 109,A02,182838,Chow; Bennett,29,0,30,1
1681925702306,MATH 109,A03,182894,Chow; Bennett,29,0,30,1
1681925702306,MATH 109,B01,182908,Chow; Bennett,27,0,30,3
1681925702306,MATH 109,B02,182909,Chow; Bennett,30,0,30,0
1681925702306,MATH 109,B03,182910,Chow; Bennett,26,0,30,4
1681925703330,MATH 142A,A01,182925,Staff,7,0,30,23
1681925703330,MATH 142A,A02,182935,Staff,23,0,30,7
1681925703330,MATH 142A,A03,182967,Staff,26,0,30,4
1681925703330,MATH 142A,B01,183125,Staff,23,0,30,7
1681925703330,MATH 142A,B02,183157,Staff,27,0,30,3
1681925703330,MATH 142A,B03,183158,Staff,29,0,30,1
1681925704364,MATH 183,A01,183160,Arias-Castro; Ery,23,0,30,7
1681925704364,MATH 183,A02,183161,Arias-Castro; Ery,29,0,30,1
1681925704364,MATH 183,B01,183163,Arias-Castro; Ery,28,0,30,2
1681925704364,MATH 183,B02,183164,Arias-Castro; Ery,28,0,30,2
1681925705390,MATH 193A,A01,183167,Staff,0,0,35,35
1681925705390,MATH 193A,A02,183168,Staff,27,0,35,8
1681925705390,MATH 193A,A03,183169,Staff,34,0,35,1
1681925705390,MATH 193A,A04,183170,Staff,27,0,35,8
1681925706420,MGT 4,A01,202395,Anderson; John Charles,76,0,80,4
1681925707442,MGT 5,A00,202396,Houskeeper; Robert,79,0,90,11
1681925708463,MGT 103,A00,202397,Eberhard; Craig A,49,0,90,41
1681925709492,MGT 131A,A00,202398,Houskeeper; Robert,83,0,90,7
1681925710515,MGT 135,A00,202399,Anderson; John Charles,81,0,90,9
1681925711538,MGT 162R,A00,202403,Gneezy; Uri,136,0,200,64
1681925712561,MGT 172,A00,202404,Hedges; Kathleen,38,0,90,52
1681925713659,MGT 181,A00,202405,Dunn; Louis Jean,80,0,90,10
1681925714691,MMW 14,A01,183200,Staff,6,0,28,22
1681925714691,MMW 14,A02,183201,Staff,25,0,28,3
1681925714691,MMW 14,A03,183202,Staff,24,0,28,4
1681925714691,MMW 14,A04,183203,Staff,25,0,28,3
1681925714691,MMW 14,A05,183204,Staff,26,0,28,2
1681925714691,MMW 14,A06,183205,Staff,27,0,28,1
1681925714691,MMW 14,B01,183207,Staff,26,0,28,2
1681925714691,MMW 14,B02,183208,Staff,28,0,28,0
1681925714691,MMW 14,B03,183209,Staff,28,0,28,0
1681925714691,MMW 14,B04,183210,Staff,28,0,28,0
1681925714691,MMW 14,B05,183211,Staff,28,0,28,0
1681925714691,MMW 14,B06,183212,Staff,27,0,28,1
1681925715716,MMW 14GS,A00,183213,Zhiri; Oumelbanine,28,0,28,0
1681925716741,MMW 15GS,B00,183215,Rahimi; Babak,28,0,28,0
1681925717770,MMW 121,A01,183217,Patterson; Patrick H.,11,0,28,17
1681925717770,MMW 121,A02,183218,Patterson; Patrick H.,25,0,28,3
1681925718794,MUS 1A,A01,182554,Staff,4,0,35,31
1681925719817,MUS 5,A01,182558,Staff,17,0,35,18
1681925720843,MUS 6,A01,182562,Staff,22,0,35,13
1681925721866,MUS 8GS,A00,182563,Borgo; David Garcia,25,0,25,0
1681925722890,MUS 13,A01,182567,Staff,23,0,25,2
1681925723914,MUS 15,A01,182570,Staff,31,0,35,4
1681925723914,MUS 15,B01,182575,Staff,7,0,35,28
1681925724942,MUS 80,A00,182578,Staff,22,0,25,3
1681925724942,MUS 80,B00,182581,Staff,20,0,25,5
1681925725966,MUS 113,A00,182582,Staff,25,0,25,0
1681925726992,MUS 114,A00,182583,Staff,3,0,25,22
1681925728015,MUS 150GS,A01,182588,Borgo; David Garcia,25,0,25,0
1681925729045,PHIL 1,A00,182590,Staff,34,0,40,6
1681925730075,PHIL 10,A01,182596,Grush; Rick Scott,30,0,35,5
1681925730075,PHIL 10,A02,182597,Grush; Rick Scott,33,0,35,2
1681925731097,PHIL 15,A01,182601,Staff,31,0,35,4
1681925731097,PHIL 15,A02,182602,Staff,33,0,35,2
1681925732136,PHIL 27,A01,182604,Staff,30,0,35,5
1681925732136,PHIL 27,A02,182607,Staff,35,0,35,0
1681925733162,PHIL 32,A01,182609,Staff,35,0,35,0
1681925733162,PHIL 32,A02,182612,Staff,35,0,35,0
1681925734185,PHIL 130,A00,182614,Staff,61,0,70,9
1681925735211,PHIL 136,A00,182616,Cohen; Jonathan David,66,0,70,4
1681925736233,PHIL 155,A00,182617,Vargas; Manuel Rogelio,58,0,70,12
1681925737256,PHIL 163,A01,182620,Staff,15,0,20,5
1681925737256,PHIL 163,A02,182624,Staff,10,0,20,10
1681925738281,PHIL 164,A00,182627,Staff,29,0,40,11
1681925739306,PHIL 173,A00,182628,Staff,35,0,40,5
1681925740329,PHYS 1A,A00,183221,Staff,54,0,60,6
1681925741352,PHYS 1AL,001,183222,Staff,25,0,30,5
1681925741352,PHYS 1AL,002,183223,Staff,26,0,30,4
1681925742374,PHYS 1B,A00,183231,Staff,42,0,60,18
1681925743400,PHYS 1BL,001,183232,Staff,19,0,30,11
1681925743400,PHYS 1BL,002,183233,Staff,27,0,30,3
1681925744423,PHYS 1C,A00,183240,Staff,24,0,60,36
1681925745460,PHYS 1CL,001,183241,Staff,9,0,30,21
1681925745460,PHYS 1CL,002,183242,Staff,22,0,30,8
1681925746483,PHYS 2AR,A01,183250,Staff,42,0,50,8
1681925747505,PHYS 2B,A01,183252,Staff,104,0,115,11
1681925748532,PHYS 2BL,A01,183254,Staff,21,0,24,3
1681925748532,PHYS 2BL,A02,183255,Staff,21,0,24,3
1681925749554,PHYS 2C,A01,183522,Staff,102,0,115,13
1681925750582,PHYS 4A,A01,183524,Staff,49,0,50,1
1681925751609,POLI 5,A00,183525,Staff,44,0,50,6
1681925752633,POLI 12,A00,183540,Staff,45,0,50,5
1681925753655,POLI 13R,A00,183541,Forman; Fonna,41,0,50,9
1681925754680,POLI 30,A00,183542,Mignozzetti; Umberto,48,0,50,2
1681925755704,POLI 100A,A00,183543,Staff,44,0,50,6
1681925756728,POLI 100E,A00,223598,Staff,32,0,35,3
1681925757751,POLI 103A,A00,183564,Kousser; Thad,37,0,50,13
1681925758777,POLI 104B,A00,201329,Staff,28,0,35,7
1681925759801,POLI 113BR,A00,183576,Hoston; Germaine,23,0,50,27
1681925762439,POLI 114BR,A00,183588,Staff,27,0,30,3
1681925763481,POLI 117R,A00,183595,Forman; Fonna,4,0,20,16
1681925764512,POLI 120H,A00,183596,Fisk; David Lee,13,0,20,7
1681925765537,POLI 130AA,A00,183597,Staff,13,0,20,7
1681925766559,POLI 134AA,A00,183598,Staff,19,0,20,1
1681925767589,POLI 135,A00,183599,Fisk; David Lee,19,0,25,6
1681925768614,POLI 142P,A00,183623,Staff,37,0,40,3
1681925769637,POLI 144D,A00,183624,Staff,22,0,25,3
1681925770663,POLI 151,A00,183625,Staff,15,0,20,5
1681925771692,POLI 162,A00,183626,Mignozzetti; Umberto,17,0,20,3
1681925772715,PSYC 1,A00,253748,Staff,86,0,90,4
1681925773737,PSYC 2,A00,183627,Moranton; Nirelia Melbina-,24,0,35,11
1681925774760,PSYC 3,A00,183628,Staff,43,0,45,2
1681925776813,PSYC 60,A01,183631,Lowe; Angela Beth,35,0,40,5
1681925777839,PSYC 70,A01,253757,Staff,37,0,45,8
1681925778861,PSYC 101,A00,183632,Heyman; Gail D.,44,0,60,16
1681925779883,PSYC 105,A00,183848,Lowe; Angela Beth,46,0,60,14
1681925780907,PSYC 106,A00,183849,Dobkins; Karen R.,40,0,60,20
1681925781930,PSYC 108,A00,253750,Staff,18,0,60,42
1681925782953,PSYC 114,A01,184275,Winkielman; Piotr,0,8,30,30
1681925783986,PSYC 122,A00,183856,Moranton; Nirelia Melbina-,0,15,30,30
1681925785009,PSYC 124,A00,183865,Chapman; Eddie Nathaniel,48,0,80,32
1681925786031,PSYC 137,A00,183880,Staff,19,0,25,6
1681925788079,PSYC 154,A00,183910,Lacefield; Katharine I,0,22,90,90
1681925790136,PSYC 162,A00,183946,Wixted; John T,50,0,90,40
1681925791159,PSYC 172,A00,183947,Gorman; Michael R.,8,0,30,22
1681925792195,PSYC 178,A00,183963,Glaser; Dale,17,0,40,23
1681925793230,PSYC 181GS,A00,183964,Anagnostaras; Stephan,10,0,10,0
1681925794255,PSYC 186GS,A01,257660,Staff,10,0,10,0
1681925795278,PSYC 193,B00,253749,Staff,23,0,25,2
1681925797335,PSYC 193L,A01,184122,Staff,33,0,35,2
1681925797335,PSYC 193L,C01,184167,Winkielman; Piotr,14,0,30,16
1681925798358,RELI 188GS,A00,182629,Rahimi; Babak,20,0,20,0
1681925799382,SE 101A,A00,182646,Staff,26,0,30,4
1681925800406,SE 101C,A00,182650,Staff,17,0,20,3
1681925801428,SE 110A,A00,182651,Staff,28,0,28,0
1681925802453,SE 130A,A00,182652,Staff,38,0,40,2
1681925803477,SIO 46GS,A00,182636,Cook; Geoffrey W,25,0,28,3
1681925804511,SIO 109R,A00,194459,Staff,2,0,20,18
1681925805535,SIO 121GS,A00,182639,Cook; Geoffrey W,25,0,28,3
1681925806559,SIO 132,A01,182642,Staff,32,0,40,8
1681925807582,SIO 139,A00,182644,Kacev; David,36,0,40,4
1681925808616,SOCI 2,A01,258404,Staff,33,0,36,3
1681925808616,SOCI 2,A02,258405,Staff,35,0,36,1
1681925809644,SOCI 60,A01,258408,Staff,29,0,30,1
1681925809644,SOCI 60,A02,258413,Staff,30,0,30,0
1681925810689,SOCI 100,A01,258415,Staff,29,0,30,1
1681925810689,SOCI 100,A02,258416,Staff,28,0,30,2
1681925816830,SOCI 127,A00,258421,Staff,21,0,30,9
1681925817852,SOCI 132,A00,258422,Staff,45,0,50,5
1681925818945,SOCI 133,A00,258423,Staff,26,0,30,4
1681925819969,SOCI 138GS,A00,258424,Staff,15,0,15,0
1681925820993,SOCI 145,A00,258425,Staff,25,0,30,5
1681925822019,SOCI 148,A00,258426,Staff,24,0,30,6
1681925823046,SOCI 153,A00,199217,Staff,29,0,30,1
1681925824072,SOCI 160,A00,258427,Staff,28,0,30,2
1681925825098,SOCI 160E,A00,258435,Staff,56,0,60,4
1681925826124,SOCI 189GS,A00,258436,Staff,15,0,15,0
1681925827149,SOCI 190GS,A00,258437,Staff,15,0,15,0
1681925828175,SYN 2,001,182658,Staff,8,0,16,8
1681925828175,SYN 2,002,201439,Staff,14,0,16,2
1681925828175,SYN 2,003,201443,Staff,16,0,16,0
1681925829198,SYN 100,A01,182657,Staff,14,0,20,6
1681925830222,TDAC 1,A00,184381,Salovey; Todd,16,0,20,4
1681925830222,TDAC 1,B00,184385,Harting; Carla Kelso,19,0,20,1
1681925830222,TDAC 1,C00,184394,Staff,19,0,20,1
1681925831246,TDAC 101,A00,184483,Harting; Carla Kelso,19,0,20,1
1681925832274,TDDE 111,A00,184496,Staff,14,0,15,1
1681925833297,TDDE 131,A00,184504,Staff,20,0,20,0
1681925833297,TDDE 131,B00,184505,Staff,17,0,18,1
1681925833297,TDDE 131,C00,184534,Staff,49,0,50,1
1681925833297,TDDE 131,D00,184564,Staff,15,0,15,0
1681925833297,TDDE 131,E00,204725,Staff,19,0,20,1
1681925834319,TDGE 1,A01,184414,Salovey; Todd,36,0,50,14
1681925835344,TDGE 5,A01,184419,Staff,23,0,24,1
1681925836369,TDGE 10,A00,184428,Fulton; Julia,29,0,50,21
1681925837396,TDGE 124,A00,184565,Fulton; Julia,3,0,50,47
1681925838418,TDGE 125,B00,184567,Meyer; Ursula,9,0,25,16
1681925839444,TDHT 101,A00,184568,Staff,21,0,25,4
1681925839444,TDHT 101,B00,184569,Staff,20,0,20,0
1681925840469,TDHT 114,A00,184570,Staff,49,0,50,1
1681925841491,TDMV 1,A00,184437,Arcidiacono; Kristin,22,0,30,8
1681925841491,TDMV 1,B00,184448,Caligagan; Maria T.,23,0,30,7
1681925842518,TDMV 2,A00,184449,Weinberg; Sadie,27,0,30,3
1681925842518,TDMV 2,B00,184453,Arcidiacono; Kristin,29,0,30,1
1681925843543,TDMV 110,A00,184571,Weinberg; Sadie,30,0,30,0
1681925844572,TDMV 142,A00,184572,Caligagan; Tony,27,0,30,3
1681925844572,TDMV 142,B00,184573,Caligagan; Maria T.,26,0,30,4
1681925845598,TDTR 20,A00,184482,Jun; Grace Shin Hae,25,0,25,0
1681925846621,USP 2,A01,184290,Hinds; Juli Beth,24,0,25,1
1681925847647,USP 3,A01,184295,Staff,21,0,25,4
1681925848670,USP 4,A00,184304,McTague; Sarah,13,0,25,12
1681925849695,USP 100,A00,184315,Staff,16,0,25,9
1681925850718,USP 105,A00,184326,Staff,21,0,25,4
1681925851741,USP 151,A00,184327,Staff,19,0,25,6
1681925852772,USP 170,A00,184380,Hinds; Juli Beth,13,0,25,12
1681925853794,VIS 21B,A01,182660,Staff,28,0,31,3
1681925853794,VIS 21B,A02,182662,Staff,30,0,31,1
1681925854817,VIS 103D,A00,182663,Staff,74,0,75,1
1681925855850,VIS 105D,A00,182667,Li; Huai,14,0,22,8
1681925856872,VIS 122GS,A00,182668,Herbst; Matthew,20,0,20,0
1681925857894,VIS 128C,A00,182673,Staff,69,0,75,6
1681925858925,VIS 130,A00,182675,Staff,19,0,22,3
1681925859950,VIS 160A,A00,182678,Stalbaum; Brett,4,0,10,6
1681925862004,WCWP 10B,A00,201679,Staff,15,0,15,0
1681925862004,WCWP 10B,B00,201695,Staff,15,0,15,0
1681925863029,WCWP 100,A00,201716,Staff,12,0,15,3
1681925863029,WCWP 100,B00,201717,Staff,3,0,15,12
1681925865084,ANSC 105GS,A00,258289,Staff,0,0,0,0
1681925866109,ANSC 125GS,A00,258295,Staff,0,0,0,0
1681925867135,ANSC 150,A00,258267,Staff,29,0,40,11
1681925868160,ANSC 190GS,A00,258280,Staff,0,0,0,0
1681925869192,ANTH 1,A00,258264,Staff,38,0,40,2
1681925870216,ANTH 2,A01,258259,Staff,72,0,76,4
1681925871249,ANTH 23,A01,258228,Staff,36,0,40,4
1681925872272,ANTH 101,A01,258236,Staff,38,0,40,2
1681925873294,ANTH 102,A00,258272,Staff,59,0,60,1
1681925874322,ANTH 105,A00,258244,Staff,30,0,35,5
1681925875353,BENG 130,A00,253975,Staff,38,0,40,2
1681925876379,BIBC 102,A01,191866,Flagg; Matthew Paul,19,0,32,13
1681925876379,BIBC 102,A02,191867,Flagg; Matthew Paul,21,0,32,11
1681925876379,BIBC 102,A03,191868,Flagg; Matthew Paul,29,0,32,3
1681925876379,BIBC 102,A04,191936,Flagg; Matthew Paul,25,0,32,7
1681925876379,BIBC 102,A05,191937,Flagg; Matthew Paul,0,0,32,32
1681925877411,BICD 100,A01,191939,Cooper; Andrew Michael,28,0,32,4
1681925877411,BICD 100,A02,191940,Cooper; Andrew Michael,32,0,32,0
1681925877411,BICD 100,A03,191941,Cooper; Andrew Michael,32,0,32,0
1681925877411,BICD 100,A04,191942,Cooper; Andrew Michael,32,0,32,0
1681925877411,BICD 100,A05,191943,Cooper; Andrew Michael,32,0,32,0
1681925878441,BIEB 126,A01,191945,Cleland; Elsa Eleanor,0,1,32,32
1681925878441,BIEB 126,A02,191946,Cleland; Elsa Eleanor,27,0,32,5
1681925878441,BIEB 126,A03,191947,Cleland; Elsa Eleanor,29,0,32,3
1681925878441,BIEB 126,A04,191948,Cleland; Elsa Eleanor,19,0,32,13
1681925878441,BIEB 126,A05,191996,Cleland; Elsa Eleanor,28,0,32,4
1681925879467,BIEB 136GS,A00,191997,Shurin; Jonathan & Holway; David A.,0,0,0,5
1681925880493,BIEB 137GS,A01,191999,Shurin; Jonathan & Holway; David A.,0,0,0,4
1681925881521,BILD 1,A01,205385,Staff,31,0,32,1
1681925881521,BILD 1,A02,205386,Staff,30,0,32,2
1681925881521,BILD 1,A03,205387,Staff,31,0,32,1
1681925881521,BILD 1,A04,205388,Staff,26,0,32,6
1681925882543,BILD 2,A01,191774,Staff,28,0,32,4
1681925882543,BILD 2,A02,191775,Staff,30,0,32,2
1681925882543,BILD 2,A03,191777,Staff,30,0,32,2
1681925882543,BILD 2,A04,191856,Staff,30,0,32,2
1681925882543,BILD 2,A05,191857,Staff,32,0,32,0
1681925882543,BILD 2,A06,191858,Staff,32,0,32,0
1681925882543,BILD 2,A07,191859,Staff,31,0,32,1
1681925883566,BILD 3,A01,205391,Staff,29,0,32,3
1681925883566,BILD 3,A02,205393,Staff,32,0,32,0
1681925883566,BILD 3,A03,205394,Staff,27,0,32,5
1681925883566,BILD 3,A04,205395,Staff,32,0,32,0
1681925884591,BILD 20,A01,191861,Staff,32,0,32,0
1681925884591,BILD 20,A02,191862,Staff,32,0,32,0
1681925885625,BILD 30,A01,191864,Staff,31,0,32,1
1681925886651,BIMM 100,A01,192019,Staff,0,0,32,32
1681925886651,BIMM 100,A02,192020,Staff,19,0,32,13
1681925886651,BIMM 100,A03,192035,Staff,19,0,32,13
1681925887681,BIMM 110,A01,192037,Tat; John,0,0,32,32
1681925887681,BIMM 110,A02,192038,Tat; John,7,0,32,25
1681925888710,BIMM 120,A01,192040,Pickett; Brooke Elizabeth,0,0,32,32
1681925888710,BIMM 120,A02,192041,Pickett; Brooke Elizabeth,9,0,32,23
1681925888710,BIMM 120,A03,192042,Pickett; Brooke Elizabeth,15,0,32,17
1681925889738,BIPN 100,A01,192044,Armour; Jon Christopher,23,0,32,9
1681925889738,BIPN 100,A02,192059,Armour; Jon Christopher,30,0,32,2
1681925889738,BIPN 100,A03,192064,Armour; Jon Christopher,30,0,32,2
1681925889738,BIPN 100,A04,192073,Armour; Jon Christopher,27,0,32,5
1681925890761,BIPN 148,A01,205411,Leutgeb; Jill K.,15,0,32,17
1681925890761,BIPN 148,A02,205412,Leutgeb; Jill K.,31,0,32,1
1681925890761,BIPN 148,A03,205413,Leutgeb; Jill K.,30,0,32,2
1681925890761,BIPN 148,A04,205414,Leutgeb; Jill K.,30,0,32,2
1681925891802,BIPN 160,A01,192115,Marino; Marc J,16,0,32,16
1681925891802,BIPN 160,A02,192148,Marino; Marc J,27,0,32,5
1681925891802,BIPN 160,A03,192158,Marino; Marc J,31,0,32,1
1681925891802,BIPN 160,A04,192190,Marino; Marc J,32,0,32,0
1681925891802,BIPN 160,A05,192287,Marino; Marc J,32,0,32,0
1681925891802,BIPN 160,A06,192288,Marino; Marc J,32,0,32,0
1681925892824,BIPN 194,A00,206038,Staff,28,0,32,4
1681925893848,BISP 194,A00,192289,Leutgeb; Stefan,11,0,32,21
1681925893848,BISP 194,B00,245332,Nieh; James Charles,26,0,32,6
1681925894875,CAT 124,A01,202247,Staff,15,0,15,0
1681925895904,CAT 125,A00,202248,Staff,18,0,20,2
1681925895904,CAT 125,B00,202253,Staff,20,0,20,0
1681925895904,CAT 125,C00,202257,Staff,18,0,20,2
1681925896927,CAT 125GS,A01,202273,Bronstein; Phoebe Malan,20,0,20,0
1681925897955,CAT 125R,A00,202284,Staff,18,0,20,2
1681925897955,CAT 125R,C00,202286,Staff,5,0,20,15
1681925897955,CAT 125R,D00,202291,Staff,17,0,20,3
1681925897955,CAT 125R,E00,202295,Staff,13,0,20,7
1681925897955,CAT 125R,F00,202302,Staff,8,0,20,12
1681925898980,CENG 100,A00,204724,Opatkiewicz; Justin Paul,25,0,25,0
1681925900004,CGS 2A,A01,180420,Staff,31,0,36,5
1681925901035,CGS 101,A00,180421,Staff,16,0,20,4
1681925902057,CGS 112,A00,180422,Staff,9,0,16,7
1681925903080,CGS 113,A00,180423,Staff,18,0,20,2
1681925904107,CGS 137,A00,180424,Staff,12,0,12,0
1681925905131,CGS 147,A00,180425,Staff,10,0,10,0
1681925906154,CHEM 6A,A01,179556,Staff,94,0,100,6
1681925906154,CHEM 6A,A02,179558,Staff,0,0,0,0
1681925907185,CHEM 6B,A01,179560,Staff,100,0,100,0
1681925908210,CHEM 6C,A01,179565,Jazzar; Rodolphe,93,0,100,7
1681925909234,CHEM 7L,A01,179586,Schurmeier; Kimberly,10,0,24,14
1681925909234,CHEM 7L,A02,179587,Schurmeier; Kimberly,23,0,24,1
1681925909234,CHEM 7L,A03,179590,Schurmeier; Kimberly,22,0,24,2
1681925909234,CHEM 7L,A04,179591,Schurmeier; Kimberly,22,0,24,2
1681925909234,CHEM 7L,B01,179598,Schurmeier; Kimberly,16,0,24,8
1681925909234,CHEM 7L,B02,179599,Schurmeier; Kimberly,24,0,24,0
1681925909234,CHEM 7L,B03,179606,Schurmeier; Kimberly,23,0,24,1
1681925909234,CHEM 7L,B04,179607,Schurmeier; Kimberly,22,0,24,2
1681925910258,CHEM 11,A01,179609,Stallings; Dontarie M,87,0,100,13
1681925911285,CHEM 40A,A01,179621,Staff,40,0,50,10
1681925911285,CHEM 40A,A02,179622,Staff,46,0,50,4
1681925912311,CHEM 40B,A01,179630,Weizman; Haim,47,0,50,3
1681925912311,CHEM 40B,A02,179631,Weizman; Haim,44,0,50,6
1681925913334,CHEM 41A,A01,179660,Klosterman; Jeremy K,93,0,100,7
1681925914362,CHEM 43A,A01,179683,Klosterman; Jeremy K,0,0,24,24
1681925914362,CHEM 43A,A02,179688,Klosterman; Jeremy K,8,0,24,16
1681925914362,CHEM 43A,A03,179689,Klosterman; Jeremy K,18,0,24,6
1681925914362,CHEM 43A,A04,179691,Klosterman; Jeremy K,18,0,24,6
1681925915389,CHEM 114A,A01,179693,Stallings; Dontarie M,70,0,100,30
1681925916413,CHEM 143B,A01,179698,Weizman; Haim,16,0,24,8
1681925916413,CHEM 143B,A02,179700,Weizman; Haim,24,0,24,0
1681925917436,CHIN 169A,A00,179701,Wang; Xiao,20,0,20,0
1681925918459,COGS 2,A01,179750,Boyle; Mary E. T.,17,0,30,13
1681925919481,COGS 9,A01,179759,Jones; Cameron Robert,41,0,50,9
1681925920505,COGS 14A,A01,179854,Staff,15,0,50,35
1681925921529,COGS 14B,A01,179856,Staff,53,0,60,7
1681925922626,COGS 17,A01,179874,Staff,71,0,75,4
1681925923655,COGS 18,A01,179884,Staff,62,0,80,18
1681925924678,COGS 100,A01,179886,Staff,36,0,60,24
1681925925704,COGS 101B,A01,179892,Staff,0,1,30,30
1681925926727,COGS 101C,A01,179894,Staff,28,0,30,2
1681925927755,COGS 107A,A01,179896,Boyle; Mary E. T.,30,0,40,10
1681925928785,COGS 108,A01,179898,Simpkins; Charles Alexander,0,27,60,60
1681925929808,COGS 109,A01,179900,Staff,34,0,40,6
1681925930831,COGS 118A,A01,179946,Staff,6,0,40,34
1681925931854,COGS 153,A00,179978,Staff,0,3,30,30
1681925932881,COGS 156,A01,179981,Staff,23,0,30,7
1681925934940,COGS 172,A01,179987,Staff,13,0,30,17
1681925936989,COGS 186,A01,179991,Staff,12,0,30,18
1681925938015,COMM 10,A01,180001,Staff,12,0,25,13
1681925938015,COMM 10,A02,180004,Staff,20,0,25,5
1681925939058,COMM 100A,A01,180016,Staff,15,0,25,10
1681925939058,COMM 100A,A02,180020,Staff,24,0,25,1
1681925940084,COMM 101T,A00,180029,Halm; Gavin Patrick,22,0,35,13
1681925941107,COMM 106V,A00,180043,Staff,34,0,35,1
1681925942133,COMM 109P,A00,180044,Staff,30,0,35,5
1681925943159,COMM 113T,A00,180045,Havis; Allan,37,0,45,8
1681925944184,COMM 132,A00,180046,McKenna; Denise,23,0,30,7
1681925945210,COMM 143,A00,180047,Staff,18,0,30,12
1681925946234,COMM 190,A00,180048,Conner; Thomas Hartnell,18,0,23,5
1681925947257,CSE 8A,A50,180053,Cao; Yingjun,21,0,50,29
1681925947257,CSE 8A,B50,180180,Staff,50,0,50,0
1681925948282,CSE 11,A01,180190,Cao; Yingjun,22,0,50,28
1681925949307,CSE 20,A01,180192,Briones; Jor-el Thomas Caparas,22,0,30,8
1681925950330,CSE 21,A01,194538,Briones; Jor-el Thomas Caparas,50,0,60,10
1681925951355,CSE 30,A01,180324,Eldon; John,75,0,100,25
1681925952386,CSE 101,A01,201353,Staff,0,26,40,40
1681925953419,CSE 134B,A01,180326,Powell; Thomas Allan,74,0,100,26
1681925954452,CSE 140,A01,180328,Staff,33,0,75,42
1681925955480,CSE 140L,A01,180344,Eldon; John,56,0,100,44
1681925956504,CSE 150A,A01,180411,Staff,0,15,50,50
1681925957526,CSE 151A,A01,180414,Staff,0,8,50,50
1681925958549,CSE 175,A01,222521,Kumar; Rakesh,50,0,50,0
1681925959571,CSE 190,A00,201419,Staff,42,0,49,7
1681925960594,CSS 1,A01,194536,Staff,35,0,50,15
1681925961627,DSC 30,A01,202385,Staff,48,0,50,2
1681925962650,DSC 40A,A01,202387,Albuyeh; Rod,50,0,50,0
1681925963677,DSC 190,A01,202389,Silberman; Jack,21,0,21,0
1681925964701,DSGN 100,A01,179993,Staff,14,0,30,16
1681925965725,ECE 65,A50,180708,Staff,10,0,20,10
1681925965725,ECE 65,A51,180739,Staff,19,0,20,1
1681925966759,ECON 1,A01,180427,Famulari; Melissa,67,0,70,3
1681925967781,ECON 2,A01,180450,Levkoff; Steven B.,64,0,70,6
1681925968810,ECON 4,A01,203351,Anderson; John Charles,6,0,10,4
1681925969844,ECON 100A,A01,180472,Famulari; Melissa,59,0,70,11
1681925970866,ECON 120A,A01,180549,Staff,63,0,70,7
1681925971894,ECON 120B,A01,180655,Ma; Xinwei,41,0,70,29
1681925972916,ECON 129,A00,203333,Eckert; Fabian Paul,11,0,35,24
1681925973942,ECON 131,A00,180656,Staff,5,0,35,30
1681925974965,ECON 172B,A01,180672,Levkoff; Steven B.,31,0,35,4
1681925975988,ECON 178,A01,203342,Zhu; Ying,8,0,35,27
1681925977013,EDS 108GS,A00,202383,Wishard Guerra; Alison G.,20,0,20,0
1681925978035,EDS 111GS,A00,202347,Wishard Guerra; Alison G.,20,0,20,0
1681925979061,EDS 112,A01,202323,Staff,53,0,60,7
1681925980086,EDS 113,A00,202340,Staff,32,0,35,3
1681925981116,EDS 118,A00,201231,Staff,19,0,30,11
1681925982137,EDS 119,A00,204994,Staff,8,0,10,2
1681925983162,EDS 124BR,A00,202324,Eguchi; Emi,1,0,25,24
1681925984185,EDS 126,A01,203208,Jones; Makeba,26,0,30,4
1681925985211,EDS 135,A01,202333,Staff,17,0,20,3
1681925986243,EDS 180,A00,202311,Staff,47,0,50,3
1681925987269,ERC 190GS,A01,253747,Staff,28,0,28,0
1681925988297,ETHN 104,A00,180742,Staff,22,0,35,13
1681925989320,ETHN 118,A00,180745,Staff,27,0,35,8
1681925990355,ETHN 127,A00,180747,Staff,11,0,16,5
1681925991380,ETHN 137,A00,180880,Staff,11,0,12,1
1681925992403,ETHN 147,A00,180890,Staff,8,0,10,2
1681925993436,ETHN 154,A00,180891,Staff,7,0,8,1
1681926004645,ETHN 168,A00,180892,Staff,9,0,10,1
1681926005669,GLBH 20,A00,201051,Hannah; Seth Donal,0,4,0,1
1681926006691,GLBH 111,A01,209338,Burgos; Jose L.,0,0,0,0
1681926007726,GLBH 150,A00,258300,Staff,0,3,0,0
1681926008751,GLBH 181,A00,201207,Staff,11,0,40,29
1681926009774,HIEU 109,A00,180898,Staff,19,0,20,1
1681926010814,HIEU 111,A00,180899,Staff,0,2,20,20
1681926011840,HIEU 124,A00,180900,Staff,17,0,20,3
1681926012864,HILA 122,A00,180901,Staff,18,0,20,2
1681926013889,HILA 132,A00,180902,Vitz; Matthew,0,0,20,20
1681926014911,HILD 10,A01,180896,Staff,14,0,20,6
1681926015942,HILD 30GS,A00,180897,Edington; Claire Ellen,0,0,0,0
1681926016967,HISC 105,A00,180903,Staff,20,0,20,0
1681926018001,HISC 117,A00,180904,Staff,10,0,20,10
1681926019026,HIUS 108B,A00,181005,Staff,18,0,20,2
1681926020049,HIUS 113,A00,181093,Staff,1,0,20,19
1681926021072,HUM 3,A01,181190,Patterson; Patrick H.,37,0,50,13
1681926021072,HUM 3,B01,181195,Staff,46,0,50,4
1681926022102,HUM 3GS,A00,181196,Herbst; Matthew,0,0,0,0
1681926023134,HUM 4,A01,181227,West; Geoffrey Scott,33,0,50,17
1681926023134,HUM 4,B01,181282,Staff,41,0,50,9
1681926024160,HUM 4GS,A00,181377,Lyon; Antony J.,0,0,0,0
1681926025182,HUM 5,A01,181536,Zavodny; Tatiana Sophia,26,0,50,24
1681926025182,HUM 5,B01,181908,Staff,35,0,50,15
1681926026219,INTL 190,A00,181909,Segui; Alan S,0,0,0,8
1681926026219,INTL 190,B00,181961,Segui; Alan S,0,0,0,7
1681926027242,JAPN 20AR,A01,182113,Ross; Kayoko F,15,0,20,5
1681926028277,LATI 50,A01,202391,Martin-Cabrera; Luis,18,0,30,12
1681926028277,LATI 50,A02,202392,Martin-Cabrera; Luis,26,0,30,4
1681926029300,LATI 180,A00,202393,Kokinis; Troy Andreas,24,0,25,1
1681926030323,LIFR 1A,A00,182119,Staff,14,0,14,0
1681926031349,LIFR 1AX,A00,182324,Staff,14,0,14,0
1681926032394,LIFR 1B,A00,182259,Staff,12,0,14,2
1681926033417,LIFR 1BX,A00,182273,Staff,12,0,14,2
1681926034439,LIGN 8,A00,182330,Staff,131,0,150,19
1681926035465,LIGN 9GS,A00,182362,Staff,17,0,20,3
1681926036566,LIGN 119,A00,204992,Takahashi; Maho,11,0,15,4
1681926037595,LIGN 130,A01,182384,Staff,47,0,50,3
1681926038619,LIGN 149GS,A00,182390,Staff,17,0,20,3
1681926039642,LIGN 170,A00,182404,Staff,23,0,30,7
1681926040665,LISP 1D,A00,182281,Staff,7,0,14,7
1681926040665,LISP 1D,B00,182287,Staff,13,0,14,1
1681926040665,LISP 1D,C00,182295,Staff,10,0,14,4
1681926040665,LISP 1D,D00,182301,Staff,14,0,14,0
1681926041693,LISP 1DX,A00,182309,Staff,19,0,28,9
1681926041693,LISP 1DX,B00,182316,Staff,25,0,28,3
1681926042720,LTAF 120GS,A00,182412,Zhiri; Oumelbanine,20,0,20,0
1681926043744,LTCS 172GS,A00,182437,Bronstein; Phoebe Malan,20,0,20,0
1681926044765,LTEA 138,A00,182457,Staff,19,0,40,21
1681926045787,LTEN 114,A01,182490,Staff,23,0,25,2
1681926046825,LTEN 130GS,A00,182491,Lyon; Antony J.,20,0,20,0
1681926047848,LTEN 169,A00,182493,Cuong; Marisol,19,0,25,6
1681926048871,LTEN 178,A00,182501,Staff,14,0,15,1
1681926049901,LTEN 181,A00,182515,Staff,20,0,25,5
1681926050924,LTEN 185GS,A00,197655,Forbes; Camille,20,0,20,0
1681926051948,LTSP 100B,A00,202208,Bessett; Ryan Matthew,24,0,25,1
1681926052973,LTWL 100,A00,182516,Myerston Santana; Jacobo,20,0,30,10
1681926053995,LTWR 100GS,A00,182518,Forbes; Camille,20,0,20,0
1681926055033,LTWR 102,A00,182522,Staff,15,0,15,0
1681926055033,LTWR 102,B00,182525,Staff,14,0,15,1
1681926056059,LTWR 115,A00,182526,Staff,11,0,15,4
1681926057085,MAE 8,A01,182528,Pham; Hieu Tan,67,0,70,3
1681926058111,MAE 11,A00,182529,Bahadori; Mohammad Yousef,92,0,100,8
1681926059134,MAE 20,A00,182530,Evdokimenko; Ekaterina,68,0,70,2
1681926060162,MAE 30A,A00,182532,Staff,44,0,45,1
1681926061489,MAE 101A,A00,182533,Bahadori; Mohammad Yousef,94,0,100,6
1681926062512,MAE 101C,A00,182538,Staff,62,0,70,8
1681926063536,MAE 104,A00,182539,Staff,44,0,50,6
1681926064569,MAE 131A,A00,182540,Ghazinejad; Maziar,40,0,45,5
1681926065595,MAE 143A,A00,182548,Bewley; Thomas R,43,0,50,7
1681926066628,MAE 150,A00,182549,Staff,28,0,40,12
1681926067653,MAE 160,A00,182550,Evdokimenko; Ekaterina,41,0,60,19
1681926068689,MATH 3C,A01,182725,Staff,24,0,30,6
1681926069713,MATH 10A,A01,182729,Staff,25,0,30,5
1681926069713,MATH 10A,B01,182732,Staff,25,0,30,5
1681926070738,MATH 10B,A01,182737,Staff,17,0,30,13
1681926070738,MATH 10B,A02,182738,Staff,26,0,30,4
1681926070738,MATH 10B,B01,182744,Staff,26,0,30,4
1681926070738,MATH 10B,B02,182745,Staff,27,0,30,3
1681926071769,MATH 18,A01,182750,Anzaldo; Leesa B,28,0,30,2
1681926071769,MATH 18,A02,182751,Anzaldo; Leesa B,28,0,30,2
1681926071769,MATH 18,A03,182753,Anzaldo; Leesa B,27,0,30,3
1681926071769,MATH 18,A04,182757,Anzaldo; Leesa B,29,0,30,1
1681926071769,MATH 18,B01,182761,Anzaldo; Leesa B,27,0,30,3
1681926071769,MATH 18,B02,182764,Anzaldo; Leesa B,26,0,30,4
1681926071769,MATH 18,B03,182765,Anzaldo; Leesa B,29,0,30,1
1681926071769,MATH 18,B04,182766,Anzaldo; Leesa B,30,0,30,0
1681926072792,MATH 20A,A01,182771,Suk; Andrew Hoon,28,0,30,2
1681926073816,MATH 20B,A01,182775,Bach; Quang Tran,30,0,30,0
1681926073816,MATH 20B,A02,182777,Bach; Quang Tran,29,0,30,1
1681926073816,MATH 20B,B01,182780,Bach; Quang Tran,26,0,30,4
1681926073816,MATH 20B,B02,182782,Bach; Quang Tran,30,0,30,0
1681926074843,MATH 20C,A01,182787,Staff,24,0,30,6
1681926074843,MATH 20C,A02,182790,Staff,29,0,30,1
1681926074843,MATH 20C,B01,182792,Staff,24,0,30,6
1681926074843,MATH 20C,B02,182796,Staff,26,0,30,4
1681926075866,MATH 20D,A01,182799,Staff,27,0,30,3
1681926075866,MATH 20D,A02,182802,Staff,29,0,30,1
1681926075866,MATH 20D,A03,182803,Staff,30,0,30,0
1681926076888,MATH 20E,A01,182809,Verstraete; Jacques Allan,22,0,30,8
1681926076888,MATH 20E,A02,182811,Verstraete; Jacques Allan,28,0,30,2
1681926076888,MATH 20E,B01,182814,Verstraete; Jacques Allan,22,0,30,8
1681926076888,MATH 20E,B02,182815,Verstraete; Jacques Allan,30,0,30,0
1681926077916,MATH 103A,A01,182820,Staff,5,0,30,25
1681926077916,MATH 103A,A02,182821,Staff,27,0,30,3
1681926077916,MATH 103A,A03,182822,Staff,23,0,30,7
1681926077916,MATH 103A,B01,182825,Staff,23,0,30,7
1681926077916,MATH 103A,B02,182826,Staff,30,0,30,0
1681926077916,MATH 103A,B03,182830,Staff,30,0,30,0
1681926078969,MATH 109,A01,182836,Chow; Bennett,23,0,30,7
1681926078969,MATH 109,A02,182838,Chow; Bennett,29,0,30,1
1681926078969,MATH 109,A03,182894,Chow; Bennett,29,0,30,1
1681926078969,MATH 109,B01,182908,Chow; Bennett,27,0,30,3
1681926078969,MATH 109,B02,182909,Chow; Bennett,30,0,30,0
1681926078969,MATH 109,B03,182910,Chow; Bennett,26,0,30,4
1681926079994,MATH 142A,A01,182925,Staff,7,0,30,23
1681926079994,MATH 142A,A02,182935,Staff,23,0,30,7
1681926079994,MATH 142A,A03,182967,Staff,26,0,30,4
1681926079994,MATH 142A,B01,183125,Staff,23,0,30,7
1681926079994,MATH 142A,B02,183157,Staff,27,0,30,3
1681926079994,MATH 142A,B03,183158,Staff,29,0,30,1
1681926081018,MATH 183,A01,183160,Arias-Castro; Ery,23,0,30,7
1681926081018,MATH 183,A02,183161,Arias-Castro; Ery,29,0,30,1
1681926081018,MATH 183,B01,183163,Arias-Castro; Ery,28,0,30,2
1681926081018,MATH 183,B02,183164,Arias-Castro; Ery,28,0,30,2
1681926082045,MATH 193A,A01,183167,Staff,0,0,35,35
1681926082045,MATH 193A,A02,183168,Staff,27,0,35,8
1681926082045,MATH 193A,A03,183169,Staff,34,0,35,1
1681926082045,MATH 193A,A04,183170,Staff,27,0,35,8
1681926083076,MGT 4,A01,202395,Anderson; John Charles,76,0,80,4
1681926084099,MGT 5,A00,202396,Houskeeper; Robert,79,0,90,11
1681926085130,MGT 103,A00,202397,Eberhard; Craig A,49,0,90,41
1681926086155,MGT 131A,A00,202398,Houskeeper; Robert,83,0,90,7
1681926087178,MGT 135,A00,202399,Anderson; John Charles,81,0,90,9
1681926088209,MGT 162R,A00,202403,Gneezy; Uri,135,0,200,65
1681926089231,MGT 172,A00,202404,Hedges; Kathleen,35,0,90,55
1681926090253,MGT 181,A00,202405,Dunn; Louis Jean,80,0,90,10
1681926091275,MMW 14,A01,183200,Staff,6,0,28,22
1681926091275,MMW 14,A02,183201,Staff,25,0,28,3
1681926091275,MMW 14,A03,183202,Staff,24,0,28,4
1681926091275,MMW 14,A04,183203,Staff,25,0,28,3
1681926091275,MMW 14,A05,183204,Staff,26,0,28,2
1681926091275,MMW 14,A06,183205,Staff,27,0,28,1
1681926091275,MMW 14,B01,183207,Staff,26,0,28,2
1681926091275,MMW 14,B02,183208,Staff,28,0,28,0
1681926091275,MMW 14,B03,183209,Staff,28,0,28,0
1681926091275,MMW 14,B04,183210,Staff,28,0,28,0
1681926091275,MMW 14,B05,183211,Staff,28,0,28,0
1681926091275,MMW 14,B06,183212,Staff,27,0,28,1
1681926092311,MMW 14GS,A00,183213,Zhiri; Oumelbanine,28,0,28,0
1681926093333,MMW 15GS,B00,183215,Rahimi; Babak,28,0,28,0
1681926094360,MMW 121,A01,183217,Patterson; Patrick H.,11,0,28,17
1681926094360,MMW 121,A02,183218,Patterson; Patrick H.,25,0,28,3
1681926095383,MUS 1A,A01,182554,Staff,4,0,35,31
1681926096427,MUS 5,A01,182558,Staff,17,0,35,18
1681926097450,MUS 6,A01,182562,Staff,22,0,35,13
1681926098479,MUS 8GS,A00,182563,Borgo; David Garcia,25,0,25,0
1681926099507,MUS 13,A01,182567,Staff,23,0,25,2
1681926100533,MUS 15,A01,182570,Staff,31,0,35,4
1681926100533,MUS 15,B01,182575,Staff,7,0,35,28
1681926101558,MUS 80,A00,182578,Staff,22,0,25,3
1681926101558,MUS 80,B00,182581,Staff,20,0,25,5
1681926102589,MUS 113,A00,182582,Staff,25,0,25,0
1681926103620,MUS 114,A00,182583,Staff,3,0,25,22
1681926104641,MUS 150GS,A01,182588,Borgo; David Garcia,25,0,25,0
1681926105667,PHIL 1,A00,182590,Staff,34,0,40,6
1681926106692,PHIL 10,A01,182596,Grush; Rick Scott,30,0,35,5
1681926106692,PHIL 10,A02,182597,Grush; Rick Scott,33,0,35,2
1681926107721,PHIL 15,A01,182601,Staff,31,0,35,4
1681926107721,PHIL 15,A02,182602,Staff,33,0,35,2
1681926108743,PHIL 27,A01,182604,Staff,30,0,35,5
1681926108743,PHIL 27,A02,182607,Staff,35,0,35,0
1681926109765,PHIL 32,A01,182609,Staff,35,0,35,0
1681926109765,PHIL 32,A02,182612,Staff,35,0,35,0
1681926110792,PHIL 130,A00,182614,Staff,61,0,70,9
1681926111824,PHIL 136,A00,182616,Cohen; Jonathan David,66,0,70,4
1681926112846,PHIL 155,A00,182617,Vargas; Manuel Rogelio,58,0,70,12
1681926113877,PHIL 163,A01,182620,Staff,15,0,20,5
1681926113877,PHIL 163,A02,182624,Staff,10,0,20,10
1681926114900,PHIL 164,A00,182627,Staff,29,0,40,11
1681926115930,PHIL 173,A00,182628,Staff,35,0,40,5
1681926116954,PHYS 1A,A00,183221,Staff,54,0,60,6
1681926117979,PHYS 1AL,001,183222,Staff,25,0,30,5
1681926117979,PHYS 1AL,002,183223,Staff,26,0,30,4
1681926119009,PHYS 1B,A00,183231,Staff,42,0,60,18
1681926120035,PHYS 1BL,001,183232,Staff,19,0,30,11
1681926120035,PHYS 1BL,002,183233,Staff,27,0,30,3
1681926121066,PHYS 1C,A00,183240,Staff,23,0,60,37
1681926122092,PHYS 1CL,001,183241,Staff,9,0,30,21
1681926122092,PHYS 1CL,002,183242,Staff,22,0,30,8
1681926123115,PHYS 2AR,A01,183250,Staff,42,0,50,8
1681926124144,PHYS 2B,A01,183252,Staff,104,0,115,11
1681926125175,PHYS 2BL,A01,183254,Staff,21,0,24,3
1681926125175,PHYS 2BL,A02,183255,Staff,21,0,24,3
1681926126197,PHYS 2C,A01,183522,Staff,102,0,115,13
1681926127228,PHYS 4A,A01,183524,Staff,49,0,50,1
1681926128253,POLI 5,A00,183525,Staff,44,0,50,6
1681926129275,POLI 12,A00,183540,Staff,45,0,50,5
1681926130305,POLI 13R,A00,183541,Forman; Fonna,41,0,50,9
1681926131330,POLI 30,A00,183542,Mignozzetti; Umberto,48,0,50,2
1681926132355,POLI 100A,A00,183543,Staff,44,0,50,6
1681926133382,POLI 100E,A00,223598,Staff,32,0,35,3
1681926134404,POLI 103A,A00,183564,Kousser; Thad,36,0,50,14
1681926135433,POLI 104B,A00,201329,Staff,28,0,35,7
1681926136455,POLI 113BR,A00,183576,Hoston; Germaine,23,0,50,27
1681926137479,POLI 114BR,A00,183588,Staff,27,0,30,3
1681926138508,POLI 117R,A00,183595,Forman; Fonna,4,0,20,16
1681926139536,POLI 120H,A00,183596,Fisk; David Lee,13,0,20,7
1681926140639,POLI 130AA,A00,183597,Staff,13,0,20,7
1681926141662,POLI 134AA,A00,183598,Staff,19,0,20,1
1681926142686,POLI 135,A00,183599,Fisk; David Lee,19,0,25,6
1681926143707,POLI 142P,A00,183623,Staff,37,0,40,3
1681926144737,POLI 144D,A00,183624,Staff,22,0,25,3
1681926145761,POLI 151,A00,183625,Staff,15,0,20,5
1681926146788,POLI 162,A00,183626,Mignozzetti; Umberto,17,0,20,3
1681926147814,PSYC 1,A00,253748,Staff,86,0,90,4
1681926148839,PSYC 2,A00,183627,Moranton; Nirelia Melbina-,24,0,35,11
1681926149870,PSYC 3,A00,183628,Staff,43,0,45,2
1681926151918,PSYC 60,A01,183631,Lowe; Angela Beth,35,0,40,5
1681926152945,PSYC 70,A01,253757,Staff,37,0,45,8
1681926153973,PSYC 101,A00,183632,Heyman; Gail D.,44,0,60,16
1681926154997,PSYC 105,A00,183848,Lowe; Angela Beth,46,0,60,14
1681926156024,PSYC 106,A00,183849,Dobkins; Karen R.,40,0,60,20
1681926157050,PSYC 108,A00,253750,Staff,17,0,60,43
1681926158073,PSYC 114,A01,184275,Winkielman; Piotr,0,8,30,30
1681926159102,PSYC 122,A00,183856,Moranton; Nirelia Melbina-,0,16,30,30
1681926160127,PSYC 124,A00,183865,Chapman; Eddie Nathaniel,48,0,80,32
1681926161153,PSYC 137,A00,183880,Staff,19,0,25,6
1681926163201,PSYC 154,A00,183910,Lacefield; Katharine I,0,22,90,90
1681926165263,PSYC 162,A00,183946,Wixted; John T,47,0,90,43
1681926166291,PSYC 172,A00,183947,Gorman; Michael R.,8,0,30,22
1681926167323,PSYC 178,A00,183963,Glaser; Dale,16,0,40,24
1681926168349,PSYC 181GS,A00,183964,Anagnostaras; Stephan,10,0,10,0
1681926169372,PSYC 186GS,A01,257660,Staff,10,0,10,0
1681926170398,PSYC 193,B00,253749,Staff,23,0,25,2
1681926172448,PSYC 193L,A01,184122,Staff,33,0,35,2
1681926172448,PSYC 193L,C01,184167,Winkielman; Piotr,14,0,30,16
1681926173477,RELI 188GS,A00,182629,Rahimi; Babak,20,0,20,0
1681926174500,SE 101A,A00,182646,Staff,26,0,30,4
1681926175523,SE 101C,A00,182650,Staff,17,0,20,3
1681926176546,SE 110A,A00,182651,Staff,28,0,28,0
1681926177573,SE 130A,A00,182652,Staff,38,0,40,2
1681926178611,SIO 46GS,A00,182636,Cook; Geoffrey W,25,0,28,3
1681926179632,SIO 109R,A00,194459,Staff,1,0,20,19
1681926180658,SIO 121GS,A00,182639,Cook; Geoffrey W,25,0,28,3
1681926181680,SIO 132,A01,182642,Staff,32,0,40,8
1681926182706,SIO 139,A00,182644,Kacev; David,36,0,40,4
1681926183729,SOCI 2,A01,258404,Staff,33,0,36,3
1681926183729,SOCI 2,A02,258405,Staff,35,0,36,1
1681926184757,SOCI 60,A01,258408,Staff,29,0,30,1
1681926184757,SOCI 60,A02,258413,Staff,30,0,30,0
1681926185790,SOCI 100,A01,258415,Staff,29,0,30,1
1681926185790,SOCI 100,A02,258416,Staff,28,0,30,2
1681926191943,SOCI 127,A00,258421,Staff,21,0,30,9
1681926192965,SOCI 132,A00,258422,Staff,44,0,50,6
1681926193988,SOCI 133,A00,258423,Staff,26,0,30,4
1681926195012,SOCI 138GS,A00,258424,Staff,15,0,15,0
1681926196037,SOCI 145,A00,258425,Staff,25,0,30,5
1681926197060,SOCI 148,A00,258426,Staff,24,0,30,6
1681926198086,SOCI 153,A00,199217,Staff,29,0,30,1
1681926199111,SOCI 160,A00,258427,Staff,28,0,30,2
1681926200134,SOCI 160E,A00,258435,Staff,56,0,60,4
1681926201169,SOCI 189GS,A00,258436,Staff,15,0,15,0
1681926202194,SOCI 190GS,A00,258437,Staff,15,0,15,0
1681926203217,SYN 2,001,182658,Staff,8,0,16,8
1681926203217,SYN 2,002,201439,Staff,14,0,16,2
1681926203217,SYN 2,003,201443,Staff,16,0,16,0
1681926204238,SYN 100,A01,182657,Staff,14,0,20,6
1681926205264,TDAC 1,A00,184381,Salovey; Todd,16,0,20,4
1681926205264,TDAC 1,B00,184385,Harting; Carla Kelso,19,0,20,1
1681926205264,TDAC 1,C00,184394,Staff,19,0,20,1
1681926206290,TDAC 101,A00,184483,Harting; Carla Kelso,19,0,20,1
1681926207316,TDDE 111,A00,184496,Staff,14,0,15,1
1681926208340,TDDE 131,A00,184504,Staff,20,0,20,0
1681926208340,TDDE 131,B00,184505,Staff,17,0,18,1
1681926208340,TDDE 131,C00,184534,Staff,49,0,50,1
1681926208340,TDDE 131,D00,184564,Staff,15,0,15,0
1681926208340,TDDE 131,E00,204725,Staff,19,0,20,1
1681926209373,TDGE 1,A01,184414,Salovey; Todd,36,0,50,14
1681926210395,TDGE 5,A01,184419,Staff,23,0,24,1
1681926211424,TDGE 10,A00,184428,Fulton; Julia,29,0,50,21
1681926212459,TDGE 124,A00,184565,Fulton; Julia,2,0,50,48
1681926213481,TDGE 125,B00,184567,Meyer; Ursula,9,0,25,16
1681926214506,TDHT 101,A00,184568,Staff,21,0,25,4
1681926214506,TDHT 101,B00,184569,Staff,20,0,20,0
1681926215527,TDHT 114,A00,184570,Staff,49,0,50,1
1681926216570,TDMV 1,A00,184437,Arcidiacono; Kristin,22,0,30,8
1681926216570,TDMV 1,B00,184448,Caligagan; Maria T.,23,0,30,7
1681926217593,TDMV 2,A00,184449,Weinberg; Sadie,27,0,30,3
1681926217593,TDMV 2,B00,184453,Arcidiacono; Kristin,29,0,30,1
1681926218617,TDMV 110,A00,184571,Weinberg; Sadie,30,0,30,0
1681926219639,TDMV 142,A00,184572,Caligagan; Tony,27,0,30,3
1681926219639,TDMV 142,B00,184573,Caligagan; Maria T.,26,0,30,4
1681926220677,TDTR 20,A00,184482,Jun; Grace Shin Hae,25,0,25,0
1681926221702,USP 2,A01,184290,Hinds; Juli Beth,24,0,25,1
1681926222728,USP 3,A01,184295,Staff,21,0,25,4
1681926223754,USP 4,A00,184304,McTague; Sarah,13,0,25,12
1681926224780,USP 100,A00,184315,Staff,16,0,25,9
1681926225804,USP 105,A00,184326,Staff,21,0,25,4
1681926226828,USP 151,A00,184327,Staff,19,0,25,6
1681926227851,USP 170,A00,184380,Hinds; Juli Beth,13,0,25,12
1681926228874,VIS 21B,A01,182660,Staff,28,0,31,3
1681926228874,VIS 21B,A02,182662,Staff,30,0,31,1
1681926229899,VIS 103D,A00,182663,Staff,74,0,75,1
1681926230923,VIS 105D,A00,182667,Li; Huai,14,0,22,8
1681926231948,VIS 122GS,A00,182668,Herbst; Matthew,20,0,20,0
1681926232972,VIS 128C,A00,182673,Staff,69,0,75,6
1681926233994,VIS 130,A00,182675,Staff,19,0,22,3
1681926235016,VIS 160A,A00,182678,Stalbaum; Brett,4,0,10,6
1681926237070,WCWP 10B,A00,201679,Staff,15,0,15,0
1681926237070,WCWP 10B,B00,201695,Staff,15,0,15,0
1681926238095,WCWP 100,A00,201716,Staff,12,0,15,3
1681926238095,WCWP 100,B00,201717,Staff,3,0,15,12
1681926240190,ANSC 105GS,A00,258289,Staff,0,0,0,0
1681926241227,ANSC 125GS,A00,258295,Staff,0,0,0,0
1681926242263,ANSC 150,A00,258267,Staff,29,0,40,11
1681926243292,ANSC 190GS,A00,258280,Staff,0,0,0,0
1681926244429,ANTH 1,A00,258264,Staff,38,0,40,2
1681926245452,ANTH 2,A01,258259,Staff,72,0,76,4
1681926246478,ANTH 23,A01,258228,Staff,36,0,40,4
1681926247504,ANTH 101,A01,258236,Staff,38,0,40,2
1681926248529,ANTH 102,A00,258272,Staff,59,0,60,1
1681926249552,ANTH 105,A00,258244,Staff,30,0,35,5
1681926250576,BENG 130,A00,253975,Staff,38,0,40,2
1681926251598,BIBC 102,A01,191866,Flagg; Matthew Paul,19,0,32,13
1681926251598,BIBC 102,A02,191867,Flagg; Matthew Paul,21,0,32,11
1681926251598,BIBC 102,A03,191868,Flagg; Matthew Paul,29,0,32,3
1681926251598,BIBC 102,A04,191936,Flagg; Matthew Paul,24,0,32,8
1681926251598,BIBC 102,A05,191937,Flagg; Matthew Paul,0,0,32,32
1681926252622,BICD 100,A01,191939,Cooper; Andrew Michael,28,0,32,4
1681926252622,BICD 100,A02,191940,Cooper; Andrew Michael,32,0,32,0
1681926252622,BICD 100,A03,191941,Cooper; Andrew Michael,32,0,32,0
1681926252622,BICD 100,A04,191942,Cooper; Andrew Michael,32,0,32,0
1681926252622,BICD 100,A05,191943,Cooper; Andrew Michael,32,0,32,0
1681926253650,BIEB 126,A01,191945,Cleland; Elsa Eleanor,0,1,32,32
1681926253650,BIEB 126,A02,191946,Cleland; Elsa Eleanor,27,0,32,5
1681926253650,BIEB 126,A03,191947,Cleland; Elsa Eleanor,29,0,32,3
1681926253650,BIEB 126,A04,191948,Cleland; Elsa Eleanor,19,0,32,13
1681926253650,BIEB 126,A05,191996,Cleland; Elsa Eleanor,28,0,32,4
1681926254673,BIEB 136GS,A00,191997,Shurin; Jonathan & Holway; David A.,0,0,0,5
1681926255699,BIEB 137GS,A01,191999,Shurin; Jonathan & Holway; David A.,0,0,0,4
1681926256726,BILD 1,A01,205385,Staff,31,0,32,1
1681926256726,BILD 1,A02,205386,Staff,30,0,32,2
1681926256726,BILD 1,A03,205387,Staff,31,0,32,1
1681926256726,BILD 1,A04,205388,Staff,26,0,32,6
1681926257749,BILD 2,A01,191774,Staff,28,0,32,4
1681926257749,BILD 2,A02,191775,Staff,30,0,32,2
1681926257749,BILD 2,A03,191777,Staff,30,0,32,2
1681926257749,BILD 2,A04,191856,Staff,30,0,32,2
1681926257749,BILD 2,A05,191857,Staff,32,0,32,0
1681926257749,BILD 2,A06,191858,Staff,32,0,32,0
1681926257749,BILD 2,A07,191859,Staff,31,0,32,1
1681926258772,BILD 3,A01,205391,Staff,29,0,32,3
1681926258772,BILD 3,A02,205393,Staff,32,0,32,0
1681926258772,BILD 3,A03,205394,Staff,27,0,32,5
1681926258772,BILD 3,A04,205395,Staff,32,0,32,0
1681926259795,BILD 20,A01,191861,Staff,32,0,32,0
1681926259795,BILD 20,A02,191862,Staff,32,0,32,0
1681926260819,BILD 30,A01,191864,Staff,31,0,32,1
1681926261844,BIMM 100,A01,192019,Staff,0,0,32,32
1681926261844,BIMM 100,A02,192020,Staff,19,0,32,13
1681926261844,BIMM 100,A03,192035,Staff,18,0,32,14
1681926262867,BIMM 110,A01,192037,Tat; John,0,0,32,32
1681926262867,BIMM 110,A02,192038,Tat; John,6,0,32,26
1681926263890,BIMM 120,A01,192040,Pickett; Brooke Elizabeth,0,0,32,32
1681926263890,BIMM 120,A02,192041,Pickett; Brooke Elizabeth,9,0,32,23
1681926263890,BIMM 120,A03,192042,Pickett; Brooke Elizabeth,14,0,32,18
1681926264915,BIPN 100,A01,192044,Armour; Jon Christopher,23,0,32,9
1681926264915,BIPN 100,A02,192059,Armour; Jon Christopher,30,0,32,2
1681926264915,BIPN 100,A03,192064,Armour; Jon Christopher,30,0,32,2
1681926264915,BIPN 100,A04,192073,Armour; Jon Christopher,27,0,32,5
1681926265950,BIPN 148,A01,205411,Leutgeb; Jill K.,15,0,32,17
1681926265950,BIPN 148,A02,205412,Leutgeb; Jill K.,31,0,32,1
1681926265950,BIPN 148,A03,205413,Leutgeb; Jill K.,30,0,32,2
1681926265950,BIPN 148,A04,205414,Leutgeb; Jill K.,30,0,32,2
1681926266974,BIPN 160,A01,192115,Marino; Marc J,16,0,32,16
1681926266974,BIPN 160,A02,192148,Marino; Marc J,27,0,32,5
1681926266974,BIPN 160,A03,192158,Marino; Marc J,31,0,32,1
1681926266974,BIPN 160,A04,192190,Marino; Marc J,32,0,32,0
1681926266974,BIPN 160,A05,192287,Marino; Marc J,32,0,32,0
1681926266974,BIPN 160,A06,192288,Marino; Marc J,32,0,32,0
1681926268003,BIPN 194,A00,206038,Staff,28,0,32,4
1681926269025,BISP 194,A00,192289,Leutgeb; Stefan,11,0,32,21
1681926269025,BISP 194,B00,245332,Nieh; James Charles,26,0,32,6
1681926270047,CAT 124,A01,202247,Staff,15,0,15,0
1681926271074,CAT 125,A00,202248,Staff,18,0,20,2
1681926271074,CAT 125,B00,202253,Staff,20,0,20,0
1681926271074,CAT 125,C00,202257,Staff,18,0,20,2
1681926272107,CAT 125GS,A01,202273,Bronstein; Phoebe Malan,20,0,20,0
1681926273131,CAT 125R,A00,202284,Staff,18,0,20,2
1681926273131,CAT 125R,C00,202286,Staff,5,0,20,15
1681926273131,CAT 125R,D00,202291,Staff,17,0,20,3
1681926273131,CAT 125R,E00,202295,Staff,13,0,20,7
1681926273131,CAT 125R,F00,202302,Staff,8,0,20,12
1681926274153,CENG 100,A00,204724,Opatkiewicz; Justin Paul,25,0,25,0
1681926275184,CGS 2A,A01,180420,Staff,31,0,36,5
1681926276206,CGS 101,A00,180421,Staff,16,0,20,4
1681926277231,CGS 112,A00,180422,Staff,9,0,16,7
1681926278254,CGS 113,A00,180423,Staff,18,0,20,2
1681926279281,CGS 137,A00,180424,Staff,12,0,12,0
1681926280303,CGS 147,A00,180425,Staff,10,0,10,0
1681926281350,CHEM 6A,A01,179556,Staff,94,0,100,6
1681926281350,CHEM 6A,A02,179558,Staff,0,0,0,0
1681926282374,CHEM 6B,A01,179560,Staff,100,0,100,0
1681926283398,CHEM 6C,A01,179565,Jazzar; Rodolphe,93,0,100,7
1681926284434,CHEM 7L,A01,179586,Schurmeier; Kimberly,10,0,24,14
1681926284434,CHEM 7L,A02,179587,Schurmeier; Kimberly,23,0,24,1
1681926284434,CHEM 7L,A03,179590,Schurmeier; Kimberly,22,0,24,2
1681926284434,CHEM 7L,A04,179591,Schurmeier; Kimberly,22,0,24,2
1681926284434,CHEM 7L,B01,179598,Schurmeier; Kimberly,16,0,24,8
1681926284434,CHEM 7L,B02,179599,Schurmeier; Kimberly,24,0,24,0
1681926284434,CHEM 7L,B03,179606,Schurmeier; Kimberly,23,0,24,1
1681926284434,CHEM 7L,B04,179607,Schurmeier; Kimberly,22,0,24,2
1681926285461,CHEM 11,A01,179609,Stallings; Dontarie M,87,0,100,13
1681926286489,CHEM 40A,A01,179621,Staff,40,0,50,10
1681926286489,CHEM 40A,A02,179622,Staff,46,0,50,4
1681926287516,CHEM 40B,A01,179630,Weizman; Haim,47,0,50,3
1681926287516,CHEM 40B,A02,179631,Weizman; Haim,44,0,50,6
1681926288538,CHEM 41A,A01,179660,Klosterman; Jeremy K,93,0,100,7
1681926289562,CHEM 43A,A01,179683,Klosterman; Jeremy K,0,0,24,24
1681926289562,CHEM 43A,A02,179688,Klosterman; Jeremy K,8,0,24,16
1681926289562,CHEM 43A,A03,179689,Klosterman; Jeremy K,18,0,24,6
1681926289562,CHEM 43A,A04,179691,Klosterman; Jeremy K,18,0,24,6
1681926290584,CHEM 114A,A01,179693,Stallings; Dontarie M,69,0,100,31
1681926291613,CHEM 143B,A01,179698,Weizman; Haim,16,0,24,8
1681926291613,CHEM 143B,A02,179700,Weizman; Haim,24,0,24,0
1681926292640,CHIN 169A,A00,179701,Wang; Xiao,20,0,20,0
1681926293663,COGS 2,A01,179750,Boyle; Mary E. T.,17,0,30,13
1681926294685,COGS 9,A01,179759,Jones; Cameron Robert,41,0,50,9
1681926295711,COGS 14A,A01,179854,Staff,15,0,50,35
1681926296734,COGS 14B,A01,179856,Staff,53,0,60,7
1681926297762,COGS 17,A01,179874,Staff,71,0,75,4
1681926298797,COGS 18,A01,179884,Staff,62,0,80,18
1681926299838,COGS 100,A01,179886,Staff,36,0,60,24
1681926300860,COGS 101B,A01,179892,Staff,0,1,30,30
1681926301883,COGS 101C,A01,179894,Staff,28,0,30,2
1681926302906,COGS 107A,A01,179896,Boyle; Mary E. T.,30,0,40,10
1681926303930,COGS 108,A01,179898,Simpkins; Charles Alexander,0,27,60,60
1681926304954,COGS 109,A01,179900,Staff,34,0,40,6
1681926305976,COGS 118A,A01,179946,Staff,6,0,40,34
1681926307003,COGS 153,A00,179978,Staff,0,4,30,30
1681926308028,COGS 156,A01,179981,Staff,22,0,30,8
1681926310078,COGS 172,A01,179987,Staff,12,0,30,18
1681926312127,COGS 186,A01,179991,Staff,12,0,30,18
1681926313149,COMM 10,A01,180001,Staff,12,0,25,13
1681926313149,COMM 10,A02,180004,Staff,20,0,25,5
1681926314174,COMM 100A,A01,180016,Staff,15,0,25,10
1681926314174,COMM 100A,A02,180020,Staff,24,0,25,1
1681926315203,COMM 101T,A00,180029,Halm; Gavin Patrick,22,0,35,13
1681926316235,COMM 106V,A00,180043,Staff,34,0,35,1
1681926317258,COMM 109P,A00,180044,Staff,30,0,35,5
1681926318284,COMM 113T,A00,180045,Havis; Allan,37,0,45,8
1681926319307,COMM 132,A00,180046,McKenna; Denise,23,0,30,7
1681926320336,COMM 143,A00,180047,Staff,18,0,30,12
1681926321375,COMM 190,A00,180048,Conner; Thomas Hartnell,18,0,23,5
1681926322403,CSE 8A,A50,180053,Cao; Yingjun,21,0,50,29
1681926322403,CSE 8A,B50,180180,Staff,50,0,50,0
1681926323435,CSE 11,A01,180190,Cao; Yingjun,22,0,50,28
1681926324457,CSE 20,A01,180192,Briones; Jor-el Thomas Caparas,22,0,30,8
1681926325489,CSE 21,A01,194538,Briones; Jor-el Thomas Caparas,50,0,60,10
1681926326514,CSE 30,A01,180324,Eldon; John,74,0,100,26
1681926327544,CSE 101,A01,201353,Staff,0,26,40,40
1681926328573,CSE 134B,A01,180326,Powell; Thomas Allan,73,0,100,27
1681926329598,CSE 140,A01,180328,Staff,32,0,75,43
1681926330625,CSE 140L,A01,180344,Eldon; John,55,0,100,45
1681926331648,CSE 150A,A01,180411,Staff,0,15,50,50
1681926332679,CSE 151A,A01,180414,Staff,0,9,50,50
1681926333703,CSE 175,A01,222521,Kumar; Rakesh,50,0,50,0
1681926334737,CSE 190,A00,201419,Staff,42,0,49,7
1681926335759,CSS 1,A01,194536,Staff,34,0,50,16
1681926336782,DSC 30,A01,202385,Staff,48,0,50,2
1681926337808,DSC 40A,A01,202387,Albuyeh; Rod,50,0,50,0
1681926338830,DSC 190,A01,202389,Silberman; Jack,21,0,21,0
1681926339855,DSGN 100,A01,179993,Staff,14,0,30,16
1681926340878,ECE 65,A50,180708,Staff,10,0,20,10
1681926340878,ECE 65,A51,180739,Staff,19,0,20,1
1681926341905,ECON 1,A01,180427,Famulari; Melissa,67,0,70,3
1681926342929,ECON 2,A01,180450,Levkoff; Steven B.,64,0,70,6
1681926343954,ECON 4,A01,203351,Anderson; John Charles,6,0,10,4
1681926344985,ECON 100A,A01,180472,Famulari; Melissa,59,0,70,11
1681926346012,ECON 120A,A01,180549,Staff,63,0,70,7
1681926347038,ECON 120B,A01,180655,Ma; Xinwei,41,0,70,29
1681926348139,ECON 129,A00,203333,Eckert; Fabian Paul,11,0,35,24
1681926349162,ECON 131,A00,180656,Staff,5,0,35,30
1681926350186,ECON 172B,A01,180672,Levkoff; Steven B.,31,0,35,4
1681926351218,ECON 178,A01,203342,Zhu; Ying,8,0,35,27
1681926352245,EDS 108GS,A00,202383,Wishard Guerra; Alison G.,20,0,20,0
1681926353267,EDS 111GS,A00,202347,Wishard Guerra; Alison G.,20,0,20,0
1681926354294,EDS 112,A01,202323,Staff,53,0,60,7
1681926355323,EDS 113,A00,202340,Staff,32,0,35,3
1681926356348,EDS 118,A00,201231,Staff,19,0,30,11
1681926357372,EDS 119,A00,204994,Staff,8,0,10,2
1681926358399,EDS 124BR,A00,202324,Eguchi; Emi,1,0,25,24
1681926359459,EDS 126,A01,203208,Jones; Makeba,26,0,30,4
1681926360480,EDS 135,A01,202333,Staff,17,0,20,3
1681926361506,EDS 180,A00,202311,Staff,47,0,50,3
1681926362528,ERC 190GS,A01,253747,Staff,28,0,28,0
1681926363556,ETHN 104,A00,180742,Staff,22,0,35,13
1681926364581,ETHN 118,A00,180745,Staff,27,0,35,8
1681926365611,ETHN 127,A00,180747,Staff,10,0,16,6
1681926366636,ETHN 137,A00,180880,Staff,11,0,12,1
1681926367660,ETHN 147,A00,180890,Staff,8,0,10,2
1681926368682,ETHN 154,A00,180891,Staff,7,0,8,1
1681926369705,ETHN 168,A00,180892,Staff,9,0,10,1
1681926370728,GLBH 20,A00,201051,Hannah; Seth Donal,0,5,0,1
1681926371752,GLBH 111,A01,209338,Burgos; Jose L.,0,0,0,0
1681926372777,GLBH 150,A00,258300,Staff,0,3,0,0
1681926373807,GLBH 181,A00,201207,Staff,10,0,40,30
1681926374833,HIEU 109,A00,180898,Staff,19,0,20,1
1681926375858,HIEU 111,A00,180899,Staff,0,2,20,20
1681926376893,HIEU 124,A00,180900,Staff,17,0,20,3
1681926377916,HILA 122,A00,180901,Staff,18,0,20,2
1681926378942,HILA 132,A00,180902,Vitz; Matthew,0,0,20,20
1681926379979,HILD 10,A01,180896,Staff,14,0,20,6
1681926381011,HILD 30GS,A00,180897,Edington; Claire Ellen,0,0,0,0
1681926382034,HISC 105,A00,180903,Staff,20,0,20,0
1681926383058,HISC 117,A00,180904,Staff,10,0,20,10
1681926384082,HIUS 108B,A00,181005,Staff,18,0,20,2
1681926385109,HIUS 113,A00,181093,Staff,1,0,20,19
1681926386137,HUM 3,A01,181190,Patterson; Patrick H.,37,0,50,13
1681926386137,HUM 3,B01,181195,Staff,46,0,50,4
1681926387158,HUM 3GS,A00,181196,Herbst; Matthew,0,0,0,0
1681926388181,HUM 4,A01,181227,West; Geoffrey Scott,33,0,50,17
1681926388181,HUM 4,B01,181282,Staff,41,0,50,9
1681926389209,HUM 4GS,A00,181377,Lyon; Antony J.,0,0,0,0
1681926390261,HUM 5,A01,181536,Zavodny; Tatiana Sophia,26,0,50,24
1681926390261,HUM 5,B01,181908,Staff,35,0,50,15
1681926391288,INTL 190,A00,181909,Segui; Alan S,0,0,0,8
1681926391288,INTL 190,B00,181961,Segui; Alan S,0,0,0,7
1681926392313,JAPN 20AR,A01,182113,Ross; Kayoko F,15,0,20,5
1681926393341,LATI 50,A01,202391,Martin-Cabrera; Luis,18,0,30,12
1681926393341,LATI 50,A02,202392,Martin-Cabrera; Luis,26,0,30,4
1681926394368,LATI 180,A00,202393,Kokinis; Troy Andreas,24,0,25,1
1681926395394,LIFR 1A,A00,182119,Staff,14,0,14,0
1681926396419,LIFR 1AX,A00,182324,Staff,14,0,14,0
1681926397442,LIFR 1B,A00,182259,Staff,12,0,14,2
1681926398466,LIFR 1BX,A00,182273,Staff,12,0,14,2
1681926399489,LIGN 8,A00,182330,Staff,131,0,150,19
1681926400512,LIGN 9GS,A00,182362,Staff,16,0,20,4
1681926401534,LIGN 119,A00,204992,Takahashi; Maho,11,0,15,4
1681926402560,LIGN 130,A01,182384,Staff,47,0,50,3
1681926403591,LIGN 149GS,A00,182390,Staff,16,0,20,4
1681926404620,LIGN 170,A00,182404,Staff,23,0,30,7
1681926405643,LISP 1D,A00,182281,Staff,7,0,14,7
1681926405643,LISP 1D,B00,182287,Staff,13,0,14,1
1681926405643,LISP 1D,C00,182295,Staff,10,0,14,4
1681926405643,LISP 1D,D00,182301,Staff,14,0,14,0
1681926406666,LISP 1DX,A00,182309,Staff,19,0,28,9
1681926406666,LISP 1DX,B00,182316,Staff,25,0,28,3
1681926407698,LTAF 120GS,A00,182412,Zhiri; Oumelbanine,20,0,20,0
1681926408720,LTCS 172GS,A00,182437,Bronstein; Phoebe Malan,20,0,20,0
1681926409752,LTEA 138,A00,182457,Staff,19,0,40,21
1681926410773,LTEN 114,A01,182490,Staff,23,0,25,2
1681926411795,LTEN 130GS,A00,182491,Lyon; Antony J.,20,0,20,0
1681926412826,LTEN 169,A00,182493,Cuong; Marisol,19,0,25,6
1681926413849,LTEN 178,A00,182501,Staff,14,0,15,1
1681926414875,LTEN 181,A00,182515,Staff,20,0,25,5
1681926415901,LTEN 185GS,A00,197655,Forbes; Camille,20,0,20,0
1681926416929,LTSP 100B,A00,202208,Bessett; Ryan Matthew,24,0,25,1
1681926417955,LTWL 100,A00,182516,Myerston Santana; Jacobo,20,0,30,10
1681926418985,LTWR 100GS,A00,182518,Forbes; Camille,20,0,20,0
1681926420012,LTWR 102,A00,182522,Staff,15,0,15,0
1681926420012,LTWR 102,B00,182525,Staff,14,0,15,1
1681926421034,LTWR 115,A00,182526,Staff,11,0,15,4
1681926422059,MAE 8,A01,182528,Pham; Hieu Tan,67,0,70,3
1681926423085,MAE 11,A00,182529,Bahadori; Mohammad Yousef,92,0,100,8
1681926424115,MAE 20,A00,182530,Evdokimenko; Ekaterina,68,0,70,2
1681926425145,MAE 30A,A00,182532,Staff,44,0,45,1
1681926426168,MAE 101A,A00,182533,Bahadori; Mohammad Yousef,94,0,100,6
1681926427194,MAE 101C,A00,182538,Staff,62,0,70,8
1681926428218,MAE 104,A00,182539,Staff,44,0,50,6
1681926429244,MAE 131A,A00,182540,Ghazinejad; Maziar,40,0,45,5
1681926430265,MAE 143A,A00,182548,Bewley; Thomas R,43,0,50,7
1681926431293,MAE 150,A00,182549,Staff,28,0,40,12
1681926432317,MAE 160,A00,182550,Evdokimenko; Ekaterina,41,0,60,19
1681926433342,MATH 3C,A01,182725,Staff,24,0,30,6
1681926434364,MATH 10A,A01,182729,Staff,25,0,30,5
1681926434364,MATH 10A,B01,182732,Staff,25,0,30,5
1681926435394,MATH 10B,A01,182737,Staff,17,0,30,13
1681926435394,MATH 10B,A02,182738,Staff,26,0,30,4
1681926435394,MATH 10B,B01,182744,Staff,26,0,30,4
1681926435394,MATH 10B,B02,182745,Staff,27,0,30,3
1681926436453,MATH 18,A01,182750,Anzaldo; Leesa B,28,0,30,2
1681926436453,MATH 18,A02,182751,Anzaldo; Leesa B,28,0,30,2
1681926436453,MATH 18,A03,182753,Anzaldo; Leesa B,27,0,30,3
1681926436453,MATH 18,A04,182757,Anzaldo; Leesa B,29,0,30,1
1681926436453,MATH 18,B01,182761,Anzaldo; Leesa B,27,0,30,3
1681926436453,MATH 18,B02,182764,Anzaldo; Leesa B,26,0,30,4
1681926436453,MATH 18,B03,182765,Anzaldo; Leesa B,29,0,30,1
1681926436453,MATH 18,B04,182766,Anzaldo; Leesa B,30,0,30,0
1681926437476,MATH 20A,A01,182771,Suk; Andrew Hoon,28,0,30,2
1681926438498,MATH 20B,A01,182775,Bach; Quang Tran,30,0,30,0
1681926438498,MATH 20B,A02,182777,Bach; Quang Tran,29,0,30,1
1681926438498,MATH 20B,B01,182780,Bach; Quang Tran,26,0,30,4
1681926438498,MATH 20B,B02,182782,Bach; Quang Tran,30,0,30,0
1681926439521,MATH 20C,A01,182787,Staff,24,0,30,6
1681926439521,MATH 20C,A02,182790,Staff,29,0,30,1
1681926439521,MATH 20C,B01,182792,Staff,24,0,30,6
1681926439521,MATH 20C,B02,182796,Staff,26,0,30,4
1681926440545,MATH 20D,A01,182799,Staff,27,0,30,3
1681926440545,MATH 20D,A02,182802,Staff,29,0,30,1
1681926440545,MATH 20D,A03,182803,Staff,30,0,30,0
1681926441572,MATH 20E,A01,182809,Verstraete; Jacques Allan,22,0,30,8
1681926441572,MATH 20E,A02,182811,Verstraete; Jacques Allan,28,0,30,2
1681926441572,MATH 20E,B01,182814,Verstraete; Jacques Allan,22,0,30,8
1681926441572,MATH 20E,B02,182815,Verstraete; Jacques Allan,30,0,30,0
1681926442597,MATH 103A,A01,182820,Staff,5,0,30,25
1681926442597,MATH 103A,A02,182821,Staff,27,0,30,3
1681926442597,MATH 103A,A03,182822,Staff,22,0,30,8
1681926442597,MATH 103A,B01,182825,Staff,23,0,30,7
1681926442597,MATH 103A,B02,182826,Staff,30,0,30,0
1681926442597,MATH 103A,B03,182830,Staff,30,0,30,0
1681926443633,MATH 109,A01,182836,Chow; Bennett,23,0,30,7
1681926443633,MATH 109,A02,182838,Chow; Bennett,29,0,30,1
1681926443633,MATH 109,A03,182894,Chow; Bennett,29,0,30,1
1681926443633,MATH 109,B01,182908,Chow; Bennett,27,0,30,3
1681926443633,MATH 109,B02,182909,Chow; Bennett,30,0,30,0
1681926443633,MATH 109,B03,182910,Chow; Bennett,26,0,30,4
1681926444665,MATH 142A,A01,182925,Staff,7,0,30,23
1681926444665,MATH 142A,A02,182935,Staff,23,0,30,7
1681926444665,MATH 142A,A03,182967,Staff,26,0,30,4
1681926444665,MATH 142A,B01,183125,Staff,23,0,30,7
1681926444665,MATH 142A,B02,183157,Staff,27,0,30,3
1681926444665,MATH 142A,B03,183158,Staff,29,0,30,1
1681926445690,MATH 183,A01,183160,Arias-Castro; Ery,23,0,30,7
1681926445690,MATH 183,A02,183161,Arias-Castro; Ery,29,0,30,1
1681926445690,MATH 183,B01,183163,Arias-Castro; Ery,28,0,30,2
1681926445690,MATH 183,B02,183164,Arias-Castro; Ery,28,0,30,2
1681926446712,MATH 193A,A01,183167,Staff,0,0,35,35
1681926446712,MATH 193A,A02,183168,Staff,27,0,35,8
1681926446712,MATH 193A,A03,183169,Staff,34,0,35,1
1681926446712,MATH 193A,A04,183170,Staff,27,0,35,8
1681926447736,MGT 4,A01,202395,Anderson; John Charles,76,0,80,4
1681926448766,MGT 5,A00,202396,Houskeeper; Robert,79,0,90,11
1681926449789,MGT 103,A00,202397,Eberhard; Craig A,49,0,90,41
1681926450830,MGT 131A,A00,202398,Houskeeper; Robert,82,0,90,8
1681926451936,MGT 135,A00,202399,Anderson; John Charles,81,0,90,9
1681926452970,MGT 162R,A00,202403,Gneezy; Uri,135,0,200,65
1681926453993,MGT 172,A00,202404,Hedges; Kathleen,35,0,90,55
1681926455018,MGT 181,A00,202405,Dunn; Louis Jean,80,0,90,10
1681926456047,MMW 14,A01,183200,Staff,5,0,28,23
1681926456047,MMW 14,A02,183201,Staff,25,0,28,3
1681926456047,MMW 14,A03,183202,Staff,24,0,28,4
1681926456047,MMW 14,A04,183203,Staff,25,0,28,3
1681926456047,MMW 14,A05,183204,Staff,26,0,28,2
1681926456047,MMW 14,A06,183205,Staff,27,0,28,1
1681926456047,MMW 14,B01,183207,Staff,26,0,28,2
1681926456047,MMW 14,B02,183208,Staff,28,0,28,0
1681926456047,MMW 14,B03,183209,Staff,28,0,28,0
1681926456047,MMW 14,B04,183210,Staff,28,0,28,0
1681926456047,MMW 14,B05,183211,Staff,28,0,28,0
1681926456047,MMW 14,B06,183212,Staff,27,0,28,1
1681926457089,MMW 14GS,A00,183213,Zhiri; Oumelbanine,28,0,28,0
1681926458119,MMW 15GS,B00,183215,Rahimi; Babak,28,0,28,0
1681926459145,MMW 121,A01,183217,Patterson; Patrick H.,10,0,28,18
1681926459145,MMW 121,A02,183218,Patterson; Patrick H.,24,0,28,4
1681926460167,MUS 1A,A01,182554,Staff,4,0,35,31
1681926461197,MUS 5,A01,182558,Staff,17,0,35,18
1681926462221,MUS 6,A01,182562,Staff,22,0,35,13
1681926463247,MUS 8GS,A00,182563,Borgo; David Garcia,25,0,25,0
1681926464270,MUS 13,A01,182567,Staff,23,0,25,2
1681926465296,MUS 15,A01,182570,Staff,31,0,35,4
1681926465296,MUS 15,B01,182575,Staff,7,0,35,28
1681926466319,MUS 80,A00,182578,Staff,22,0,25,3
1681926466319,MUS 80,B00,182581,Staff,20,0,25,5
1681926467341,MUS 113,A00,182582,Staff,25,0,25,0
1681926468364,MUS 114,A00,182583,Staff,3,0,25,22
1681926469389,MUS 150GS,A01,182588,Borgo; David Garcia,25,0,25,0
1681926470418,PHIL 1,A00,182590,Staff,34,0,40,6
1681926471448,PHIL 10,A01,182596,Grush; Rick Scott,30,0,35,5
1681926471448,PHIL 10,A02,182597,Grush; Rick Scott,33,0,35,2
1681926472473,PHIL 15,A01,182601,Staff,31,0,35,4
1681926472473,PHIL 15,A02,182602,Staff,33,0,35,2
1681926473496,PHIL 27,A01,182604,Staff,30,0,35,5
1681926473496,PHIL 27,A02,182607,Staff,35,0,35,0
1681926474519,PHIL 32,A01,182609,Staff,35,0,35,0
1681926474519,PHIL 32,A02,182612,Staff,35,0,35,0
1681926475556,PHIL 130,A00,182614,Staff,61,0,70,9
1681926476579,PHIL 136,A00,182616,Cohen; Jonathan David,66,0,70,4
1681926477605,PHIL 155,A00,182617,Vargas; Manuel Rogelio,58,0,70,12
1681926478641,PHIL 163,A01,182620,Staff,15,0,20,5
1681926478641,PHIL 163,A02,182624,Staff,10,0,20,10
1681926479663,PHIL 164,A00,182627,Staff,29,0,40,11
1681926480686,PHIL 173,A00,182628,Staff,35,0,40,5
1681926481735,PHYS 1A,A00,183221,Staff,54,0,60,6
1681926482759,PHYS 1AL,001,183222,Staff,25,0,30,5
1681926482759,PHYS 1AL,002,183223,Staff,26,0,30,4
1681926483785,PHYS 1B,A00,183231,Staff,42,0,60,18
1681926484811,PHYS 1BL,001,183232,Staff,19,0,30,11
1681926484811,PHYS 1BL,002,183233,Staff,27,0,30,3
1681926485837,PHYS 1C,A00,183240,Staff,23,0,60,37
1681926486861,PHYS 1CL,001,183241,Staff,9,0,30,21
1681926486861,PHYS 1CL,002,183242,Staff,22,0,30,8
1681926487893,PHYS 2AR,A01,183250,Staff,42,0,50,8
1681926488923,PHYS 2B,A01,183252,Staff,104,0,115,11
1681926489947,PHYS 2BL,A01,183254,Staff,21,0,24,3
1681926489947,PHYS 2BL,A02,183255,Staff,21,0,24,3
1681926490970,PHYS 2C,A01,183522,Staff,102,0,115,13
1681926491996,PHYS 4A,A01,183524,Staff,49,0,50,1
1681926493027,POLI 5,A00,183525,Staff,44,0,50,6
1681926494050,POLI 12,A00,183540,Staff,45,0,50,5
1681926495075,POLI 13R,A00,183541,Forman; Fonna,41,0,50,9
1681926496105,POLI 30,A00,183542,Mignozzetti; Umberto,48,0,50,2
1681926497130,POLI 100A,A00,183543,Staff,44,0,50,6
1681926498162,POLI 100E,A00,223598,Staff,32,0,35,3
1681926499185,POLI 103A,A00,183564,Kousser; Thad,36,0,50,14
1681926500207,POLI 104B,A00,201329,Staff,28,0,35,7
1681926501230,POLI 113BR,A00,183576,Hoston; Germaine,23,0,50,27
1681926502253,POLI 114BR,A00,183588,Staff,27,0,30,3
1681926503276,POLI 117R,A00,183595,Forman; Fonna,4,0,20,16
1681926504300,POLI 120H,A00,183596,Fisk; David Lee,13,0,20,7
1681926505328,POLI 130AA,A00,183597,Staff,13,0,20,7
1681926506351,POLI 134AA,A00,183598,Staff,19,0,20,1
1681926507378,POLI 135,A00,183599,Fisk; David Lee,19,0,25,6
1681926508412,POLI 142P,A00,183623,Staff,37,0,40,3
1681926509441,POLI 144D,A00,183624,Staff,22,0,25,3
1681926510465,POLI 151,A00,183625,Staff,15,0,20,5
1681926511486,POLI 162,A00,183626,Mignozzetti; Umberto,17,0,20,3
1681926512518,PSYC 1,A00,253748,Staff,86,0,90,4
1681926513543,PSYC 2,A00,183627,Moranton; Nirelia Melbina-,24,0,35,11
1681926514566,PSYC 3,A00,183628,Staff,43,0,45,2
1681926516614,PSYC 60,A01,183631,Lowe; Angela Beth,35,0,40,5
1681926517640,PSYC 70,A01,253757,Staff,37,0,45,8
1681926518666,PSYC 101,A00,183632,Heyman; Gail D.,44,0,60,16
1681926519696,PSYC 105,A00,183848,Lowe; Angela Beth,46,0,60,14
1681926520718,PSYC 106,A00,183849,Dobkins; Karen R.,40,0,60,20
1681926521744,PSYC 108,A00,253750,Staff,17,0,60,43
1681926522774,PSYC 114,A01,184275,Winkielman; Piotr,0,8,30,30
1681926523797,PSYC 122,A00,183856,Moranton; Nirelia Melbina-,0,16,30,30
1681926524820,PSYC 124,A00,183865,Chapman; Eddie Nathaniel,47,0,80,33
1681926525844,PSYC 137,A00,183880,Staff,19,0,25,6
1681926527910,PSYC 154,A00,183910,Lacefield; Katharine I,0,22,90,90
1681926529958,PSYC 162,A00,183946,Wixted; John T,47,0,90,43
1681926530981,PSYC 172,A00,183947,Gorman; Michael R.,8,0,30,22
1681926532005,PSYC 178,A00,183963,Glaser; Dale,16,0,40,24
1681926533030,PSYC 181GS,A00,183964,Anagnostaras; Stephan,10,0,10,0
1681926534055,PSYC 186GS,A01,257660,Staff,10,0,10,0
1681926535085,PSYC 193,B00,253749,Staff,23,0,25,2
1681926537142,PSYC 193L,A01,184122,Staff,33,0,35,2
1681926537142,PSYC 193L,C01,184167,Winkielman; Piotr,14,0,30,16
1681926538174,RELI 188GS,A00,182629,Rahimi; Babak,20,0,20,0
1681926539197,SE 101A,A00,182646,Staff,26,0,30,4
1681926540224,SE 101C,A00,182650,Staff,15,0,20,5
1681926541321,SE 110A,A00,182651,Staff,28,0,28,0
1681926542346,SE 130A,A00,182652,Staff,38,0,40,2
1681926543372,SIO 46GS,A00,182636,Cook; Geoffrey W,25,0,28,3
1681926544398,SIO 109R,A00,194459,Staff,1,0,20,19
1681926545427,SIO 121GS,A00,182639,Cook; Geoffrey W,25,0,28,3
1681926546455,SIO 132,A01,182642,Staff,32,0,40,8
1681926547481,SIO 139,A00,182644,Kacev; David,36,0,40,4
1681926548504,SOCI 2,A01,258404,Staff,33,0,36,3
1681926548504,SOCI 2,A02,258405,Staff,35,0,36,1
1681926549529,SOCI 60,A01,258408,Staff,29,0,30,1
1681926549529,SOCI 60,A02,258413,Staff,30,0,30,0
1681926550551,SOCI 100,A01,258415,Staff,29,0,30,1
1681926550551,SOCI 100,A02,258416,Staff,28,0,30,2
1681926556792,SOCI 127,A00,258421,Staff,21,0,30,9
1681926557818,SOCI 132,A00,258422,Staff,44,0,50,6
1681926558842,SOCI 133,A00,258423,Staff,26,0,30,4
1681926559865,SOCI 138GS,A00,258424,Staff,15,0,15,0
1681926560888,SOCI 145,A00,258425,Staff,25,0,30,5
1681926561911,SOCI 148,A00,258426,Staff,24,0,30,6
1681926562934,SOCI 153,A00,199217,Staff,29,0,30,1
1681926563957,SOCI 160,A00,258427,Staff,28,0,30,2
1681926564982,SOCI 160E,A00,258435,Staff,56,0,60,4
1681926566005,SOCI 189GS,A00,258436,Staff,15,0,15,0
1681926567028,SOCI 190GS,A00,258437,Staff,15,0,15,0
1681926568054,SYN 2,001,182658,Staff,8,0,16,8
1681926568054,SYN 2,002,201439,Staff,14,0,16,2
1681926568054,SYN 2,003,201443,Staff,16,0,16,0
1681926569079,SYN 100,A01,182657,Staff,14,0,20,6
1681926570102,TDAC 1,A00,184381,Salovey; Todd,16,0,20,4
1681926570102,TDAC 1,B00,184385,Harting; Carla Kelso,19,0,20,1
1681926570102,TDAC 1,C00,184394,Staff,19,0,20,1
1681926571125,TDAC 101,A00,184483,Harting; Carla Kelso,19,0,20,1
1681926572147,TDDE 111,A00,184496,Staff,14,0,15,1
1681926573175,TDDE 131,A00,184504,Staff,20,0,20,0
1681926573175,TDDE 131,B00,184505,Staff,17,0,18,1
1681926573175,TDDE 131,C00,184534,Staff,49,0,50,1
1681926573175,TDDE 131,D00,184564,Staff,15,0,15,0
1681926573175,TDDE 131,E00,204725,Staff,19,0,20,1
1681926574204,TDGE 1,A01,184414,Salovey; Todd,36,0,50,14
1681926575226,TDGE 5,A01,184419,Staff,23,0,24,1
1681926576250,TDGE 10,A00,184428,Fulton; Julia,28,0,50,22
1681926577281,TDGE 124,A00,184565,Fulton; Julia,2,0,50,48
1681926578309,TDGE 125,B00,184567,Meyer; Ursula,9,0,25,16
1681926579331,TDHT 101,A00,184568,Staff,21,0,25,4
1681926579331,TDHT 101,B00,184569,Staff,20,0,20,0
1681926580354,TDHT 114,A00,184570,Staff,49,0,50,1
1681926581378,TDMV 1,A00,184437,Arcidiacono; Kristin,22,0,30,8
1681926581378,TDMV 1,B00,184448,Caligagan; Maria T.,23,0,30,7
1681926582406,TDMV 2,A00,184449,Weinberg; Sadie,27,0,30,3
1681926582406,TDMV 2,B00,184453,Arcidiacono; Kristin,29,0,30,1
1681926583439,TDMV 110,A00,184571,Weinberg; Sadie,30,0,30,0
1681926584461,TDMV 142,A00,184572,Caligagan; Tony,27,0,30,3
1681926584461,TDMV 142,B00,184573,Caligagan; Maria T.,26,0,30,4
1681926585483,TDTR 20,A00,184482,Jun; Grace Shin Hae,25,0,25,0
1681926586512,USP 2,A01,184290,Hinds; Juli Beth,24,0,25,1
1681926587543,USP 3,A01,184295,Staff,21,0,25,4
1681926588566,USP 4,A00,184304,McTague; Sarah,13,0,25,12
1681926589588,USP 100,A00,184315,Staff,16,0,25,9
1681926590612,USP 105,A00,184326,Staff,21,0,25,4
1681926591634,USP 151,A00,184327,Staff,19,0,25,6
1681926592657,USP 170,A00,184380,Hinds; Juli Beth,13,0,25,12
1681926593685,VIS 21B,A01,182660,Staff,28,0,31,3
1681926593685,VIS 21B,A02,182662,Staff,30,0,31,1
1681926594710,VIS 103D,A00,182663,Staff,74,0,75,1
1681926595734,VIS 105D,A00,182667,Li; Huai,14,0,22,8
1681926596767,VIS 122GS,A00,182668,Herbst; Matthew,20,0,20,0
1681926597792,VIS 128C,A00,182673,Staff,69,0,75,6
1681926598817,VIS 130,A00,182675,Staff,19,0,22,3
1681926599857,VIS 160A,A00,182678,Stalbaum; Brett,4,0,10,6
1681926601907,WCWP 10B,A00,201679,Staff,15,0,15,0
1681926601907,WCWP 10B,B00,201695,Staff,15,0,15,0
1681926602949,WCWP 100,A00,201716,Staff,12,0,15,3
1681926602949,WCWP 100,B00,201717,Staff,3,0,15,12
1681926605011,ANSC 105GS,A00,258289,Staff,0,0,0,0
1681926606034,ANSC 125GS,A00,258295,Staff,0,0,0,0
1681926607057,ANSC 150,A00,258267,Staff,28,0,40,12
1681926608081,ANSC 190GS,A00,258280,Staff,0,0,0,0
1681926609110,ANTH 1,A00,258264,Staff,38,0,40,2
1681926610132,ANTH 2,A01,258259,Staff,72,0,76,4
1681926611156,ANTH 23,A01,258228,Staff,36,0,40,4
1681926612185,ANTH 101,A01,258236,Staff,38,0,40,2
1681926613208,ANTH 102,A00,258272,Staff,59,0,60,1
1681926614238,ANTH 105,A00,258244,Staff,30,0,35,5
1681926615264,BENG 130,A00,253975,Staff,38,0,40,2
1681926616297,BIBC 102,A01,191866,Flagg; Matthew Paul,19,0,32,13
1681926616297,BIBC 102,A02,191867,Flagg; Matthew Paul,21,0,32,11
1681926616297,BIBC 102,A03,191868,Flagg; Matthew Paul,29,0,32,3
1681926616297,BIBC 102,A04,191936,Flagg; Matthew Paul,24,0,32,8
1681926616297,BIBC 102,A05,191937,Flagg; Matthew Paul,0,0,32,32
1681926617324,BICD 100,A01,191939,Cooper; Andrew Michael,28,0,32,4
1681926617324,BICD 100,A02,191940,Cooper; Andrew Michael,32,0,32,0
1681926617324,BICD 100,A03,191941,Cooper; Andrew Michael,32,0,32,0
1681926617324,BICD 100,A04,191942,Cooper; Andrew Michael,32,0,32,0
1681926617324,BICD 100,A05,191943,Cooper; Andrew Michael,32,0,32,0
1681926618351,BIEB 126,A01,191945,Cleland; Elsa Eleanor,0,1,32,32
1681926618351,BIEB 126,A02,191946,Cleland; Elsa Eleanor,27,0,32,5
1681926618351,BIEB 126,A03,191947,Cleland; Elsa Eleanor,29,0,32,3
1681926618351,BIEB 126,A04,191948,Cleland; Elsa Eleanor,19,0,32,13
1681926618351,BIEB 126,A05,191996,Cleland; Elsa Eleanor,28,0,32,4
1681926619381,BIEB 136GS,A00,191997,Shurin; Jonathan & Holway; David A.,0,0,0,7
1681926620418,BIEB 137GS,A01,191999,Shurin; Jonathan & Holway; David A.,0,0,0,6
1681926621442,BILD 1,A01,205385,Staff,31,0,32,1
1681926621442,BILD 1,A02,205386,Staff,30,0,32,2
1681926621442,BILD 1,A03,205387,Staff,31,0,32,1
1681926621442,BILD 1,A04,205388,Staff,26,0,32,6
1681926622475,BILD 2,A01,191774,Staff,28,0,32,4
1681926622475,BILD 2,A02,191775,Staff,30,0,32,2
1681926622475,BILD 2,A03,191777,Staff,30,0,32,2
1681926622475,BILD 2,A04,191856,Staff,30,0,32,2
1681926622475,BILD 2,A05,191857,Staff,32,0,32,0
1681926622475,BILD 2,A06,191858,Staff,32,0,32,0
1681926622475,BILD 2,A07,191859,Staff,31,0,32,1
1681926623497,BILD 3,A01,205391,Staff,29,0,32,3
1681926623497,BILD 3,A02,205393,Staff,32,0,32,0
1681926623497,BILD 3,A03,205394,Staff,27,0,32,5
1681926623497,BILD 3,A04,205395,Staff,32,0,32,0
1681926624530,BILD 20,A01,191861,Staff,32,0,32,0
1681926624530,BILD 20,A02,191862,Staff,32,0,32,0
1681926625554,BILD 30,A01,191864,Staff,31,0,32,1
1681926626575,BIMM 100,A01,192019,Staff,0,0,32,32
1681926626575,BIMM 100,A02,192020,Staff,19,0,32,13
1681926626575,BIMM 100,A03,192035,Staff,18,0,32,14
1681926627597,BIMM 110,A01,192037,Tat; John,0,0,32,32
1681926627597,BIMM 110,A02,192038,Tat; John,6,0,32,26
1681926628635,BIMM 120,A01,192040,Pickett; Brooke Elizabeth,0,0,32,32
1681926628635,BIMM 120,A02,192041,Pickett; Brooke Elizabeth,9,0,32,23
1681926628635,BIMM 120,A03,192042,Pickett; Brooke Elizabeth,14,0,32,18
1681926629660,BIPN 100,A01,192044,Armour; Jon Christopher,23,0,32,9
1681926629660,BIPN 100,A02,192059,Armour; Jon Christopher,30,0,32,2
1681926629660,BIPN 100,A03,192064,Armour; Jon Christopher,30,0,32,2
1681926629660,BIPN 100,A04,192073,Armour; Jon Christopher,27,0,32,5
1681926630682,BIPN 148,A01,205411,Leutgeb; Jill K.,15,0,32,17
1681926630682,BIPN 148,A02,205412,Leutgeb; Jill K.,31,0,32,1
1681926630682,BIPN 148,A03,205413,Leutgeb; Jill K.,30,0,32,2
1681926630682,BIPN 148,A04,205414,Leutgeb; Jill K.,30,0,32,2
1681926631704,BIPN 160,A01,192115,Marino; Marc J,16,0,32,16
1681926631704,BIPN 160,A02,192148,Marino; Marc J,27,0,32,5
1681926631704,BIPN 160,A03,192158,Marino; Marc J,31,0,32,1
1681926631704,BIPN 160,A04,192190,Marino; Marc J,32,0,32,0
1681926631704,BIPN 160,A05,192287,Marino; Marc J,32,0,32,0
1681926631704,BIPN 160,A06,192288,Marino; Marc J,32,0,32,0
1681926632727,BIPN 194,A00,206038,Staff,28,0,32,4
1681926633761,BISP 194,A00,192289,Leutgeb; Stefan,11,0,32,21
1681926633761,BISP 194,B00,245332,Nieh; James Charles,26,0,32,6
1681926634784,CAT 124,A01,202247,Staff,15,0,15,0
1681926635806,CAT 125,A00,202248,Staff,18,0,20,2
1681926635806,CAT 125,B00,202253,Staff,20,0,20,0
1681926635806,CAT 125,C00,202257,Staff,18,0,20,2
1681926636832,CAT 125GS,A01,202273,Bronstein; Phoebe Malan,20,0,20,0
1681926637858,CAT 125R,A00,202284,Staff,18,0,20,2
1681926637858,CAT 125R,C00,202286,Staff,5,0,20,15
1681926637858,CAT 125R,D00,202291,Staff,17,0,20,3
1681926637858,CAT 125R,E00,202295,Staff,13,0,20,7
1681926637858,CAT 125R,F00,202302,Staff,7,0,20,13
1681926638888,CENG 100,A00,204724,Opatkiewicz; Justin Paul,25,0,25,0
1681926639914,CGS 2A,A01,180420,Staff,30,0,36,6
1681926640938,CGS 101,A00,180421,Staff,16,0,20,4
1681926641962,CGS 112,A00,180422,Staff,9,0,16,7
1681926642984,CGS 113,A00,180423,Staff,18,0,20,2
1681926644014,CGS 137,A00,180424,Staff,12,0,12,0
1681926645038,CGS 147,A00,180425,Staff,10,0,10,0
1681926646061,CHEM 6A,A01,179556,Staff,94,0,100,6
1681926646061,CHEM 6A,A02,179558,Staff,0,0,0,0
1681926647086,CHEM 6B,A01,179560,Staff,100,0,100,0
1681926648116,CHEM 6C,A01,179565,Jazzar; Rodolphe,93,0,100,7
1681926649141,CHEM 7L,A01,179586,Schurmeier; Kimberly,10,0,24,14
1681926649141,CHEM 7L,A02,179587,Schurmeier; Kimberly,23,0,24,1
1681926649141,CHEM 7L,A03,179590,Schurmeier; Kimberly,22,0,24,2
1681926649141,CHEM 7L,A04,179591,Schurmeier; Kimberly,22,0,24,2
1681926649141,CHEM 7L,B01,179598,Schurmeier; Kimberly,16,0,24,8
1681926649141,CHEM 7L,B02,179599,Schurmeier; Kimberly,24,0,24,0
1681926649141,CHEM 7L,B03,179606,Schurmeier; Kimberly,23,0,24,1
1681926649141,CHEM 7L,B04,179607,Schurmeier; Kimberly,22,0,24,2
1681926650168,CHEM 11,A01,179609,Stallings; Dontarie M,87,0,100,13
1681926651204,CHEM 40A,A01,179621,Staff,40,0,50,10
1681926651204,CHEM 40A,A02,179622,Staff,46,0,50,4
1681926652230,CHEM 40B,A01,179630,Weizman; Haim,47,0,50,3
1681926652230,CHEM 40B,A02,179631,Weizman; Haim,44,0,50,6
1681926653257,CHEM 41A,A01,179660,Klosterman; Jeremy K,93,0,100,7
1681926654285,CHEM 43A,A01,179683,Klosterman; Jeremy K,0,0,24,24
1681926654285,CHEM 43A,A02,179688,Klosterman; Jeremy K,8,0,24,16
1681926654285,CHEM 43A,A03,179689,Klosterman; Jeremy K,18,0,24,6
1681926654285,CHEM 43A,A04,179691,Klosterman; Jeremy K,18,0,24,6
1681926655318,CHEM 114A,A01,179693,Stallings; Dontarie M,69,0,100,31
1681926656343,CHEM 143B,A01,179698,Weizman; Haim,16,0,24,8
1681926656343,CHEM 143B,A02,179700,Weizman; Haim,24,0,24,0
1681926657366,CHIN 169A,A00,179701,Wang; Xiao,20,0,20,0
1681926658389,COGS 2,A01,179750,Boyle; Mary E. T.,17,0,30,13
1681926659482,COGS 9,A01,179759,Jones; Cameron Robert,41,0,50,9
1681926660523,COGS 14A,A01,179854,Staff,15,0,50,35
1681926661548,COGS 14B,A01,179856,Staff,53,0,60,7
1681926662575,COGS 17,A01,179874,Staff,71,0,75,4
1681926663602,COGS 18,A01,179884,Staff,62,0,80,18
1681926664625,COGS 100,A01,179886,Staff,36,0,60,24
1681926665646,COGS 101B,A01,179892,Staff,0,2,30,30
1681926666671,COGS 101C,A01,179894,Staff,28,0,30,2
1681926667696,COGS 107A,A01,179896,Boyle; Mary E. T.,30,0,40,10
1681926668735,COGS 108,A01,179898,Simpkins; Charles Alexander,0,27,60,60
1681926669760,COGS 109,A01,179900,Staff,34,0,40,6
1681926670782,COGS 118A,A01,179946,Staff,6,0,40,34
1681926671806,COGS 153,A00,179978,Staff,0,4,30,30
1681926672831,COGS 156,A01,179981,Staff,21,0,30,9
1681926674882,COGS 172,A01,179987,Staff,12,0,30,18
1681926676939,COGS 186,A01,179991,Staff,12,0,30,18
1681926677963,COMM 10,A01,180001,Staff,12,0,25,13
1681926677963,COMM 10,A02,180004,Staff,20,0,25,5
1681926679001,COMM 100A,A01,180016,Staff,15,0,25,10
1681926679001,COMM 100A,A02,180020,Staff,24,0,25,1
1681926680023,COMM 101T,A00,180029,Halm; Gavin Patrick,22,0,35,13
1681926681046,COMM 106V,A00,180043,Staff,34,0,35,1
1681926682068,COMM 109P,A00,180044,Staff,30,0,35,5
1681926683102,COMM 113T,A00,180045,Havis; Allan,37,0,45,8
1681926684130,COMM 132,A00,180046,McKenna; Denise,23,0,30,7
1681926685162,COMM 143,A00,180047,Staff,18,0,30,12
1681926686192,COMM 190,A00,180048,Conner; Thomas Hartnell,18,0,23,5
1681926687226,CSE 8A,A50,180053,Cao; Yingjun,21,0,50,29
1681926687226,CSE 8A,B50,180180,Staff,50,0,50,0
1681926688248,CSE 11,A01,180190,Cao; Yingjun,21,0,50,29
1681926689283,CSE 20,A01,180192,Briones; Jor-el Thomas Caparas,22,0,30,8
1681926690313,CSE 21,A01,194538,Briones; Jor-el Thomas Caparas,50,0,60,10
1681926691337,CSE 30,A01,180324,Eldon; John,74,0,100,26
1681926692361,CSE 101,A01,201353,Staff,0,26,40,40
1681926693474,CSE 134B,A01,180326,Powell; Thomas Allan,73,0,100,27
1681926694506,CSE 140,A01,180328,Staff,30,0,75,45
1681926695532,CSE 140L,A01,180344,Eldon; John,53,0,100,47
1681926696564,CSE 150A,A01,180411,Staff,0,15,50,50
1681926697586,CSE 151A,A01,180414,Staff,0,9,50,50
1681926698608,CSE 175,A01,222521,Kumar; Rakesh,50,0,50,0
1681926699680,CSE 190,A00,201419,Staff,42,0,49,7
1681926700707,CSS 1,A01,194536,Staff,34,0,50,16
1681926701729,DSC 30,A01,202385,Staff,48,0,50,2
1681926702753,DSC 40A,A01,202387,Albuyeh; Rod,50,0,50,0
1681926703778,DSC 190,A01,202389,Silberman; Jack,21,0,21,0
1681926704809,DSGN 100,A01,179993,Staff,14,0,30,16
1681926705831,ECE 65,A50,180708,Staff,10,0,20,10
1681926705831,ECE 65,A51,180739,Staff,19,0,20,1
1681926706854,ECON 1,A01,180427,Famulari; Melissa,67,0,70,3
1681926707880,ECON 2,A01,180450,Levkoff; Steven B.,64,0,70,6
1681926708903,ECON 4,A01,203351,Anderson; John Charles,6,0,10,4
1681926709925,ECON 100A,A01,180472,Famulari; Melissa,59,0,70,11
1681926710949,ECON 120A,A01,180549,Staff,63,0,70,7
1681926711976,ECON 120B,A01,180655,Ma; Xinwei,41,0,70,29
1681926713002,ECON 129,A00,203333,Eckert; Fabian Paul,11,0,35,24
1681926714032,ECON 131,A00,180656,Staff,4,0,35,31
1681926715054,ECON 172B,A01,180672,Levkoff; Steven B.,31,0,35,4
1681926716076,ECON 178,A01,203342,Zhu; Ying,8,0,35,27
1681926717099,EDS 108GS,A00,202383,Wishard Guerra; Alison G.,20,0,20,0
1681926718121,EDS 111GS,A00,202347,Wishard Guerra; Alison G.,20,0,20,0
1681926719153,EDS 112,A01,202323,Staff,53,0,60,7
1681926720176,EDS 113,A00,202340,Staff,32,0,35,3
1681926721199,EDS 118,A00,201231,Staff,19,0,30,11
1681926722226,EDS 119,A00,204994,Staff,8,0,10,2
1681926723253,EDS 124BR,A00,202324,Eguchi; Emi,1,0,25,24
1681926724275,EDS 126,A01,203208,Jones; Makeba,26,0,30,4
1681926725312,EDS 135,A01,202333,Staff,17,0,20,3
1681926726347,EDS 180,A00,202311,Staff,47,0,50,3
1681926727372,ERC 190GS,A01,253747,Staff,28,0,28,0
1681926728399,ETHN 104,A00,180742,Staff,22,0,35,13
1681926729421,ETHN 118,A00,180745,Staff,27,0,35,8
1681926730455,ETHN 127,A00,180747,Staff,9,0,16,7
1681926731478,ETHN 137,A00,180880,Staff,11,0,12,1
1681926732502,ETHN 147,A00,180890,Staff,8,0,10,2
1681926733527,ETHN 154,A00,180891,Staff,6,0,8,2
1681926734551,ETHN 168,A00,180892,Staff,9,0,10,1
1681926735573,GLBH 20,A00,201051,Hannah; Seth Donal,0,5,0,1
1681926736595,GLBH 111,A01,209338,Burgos; Jose L.,0,0,0,0
1681926737618,GLBH 150,A00,258300,Staff,0,3,0,0
1681926738642,GLBH 181,A00,201207,Staff,10,0,40,30
1681926739663,HIEU 109,A00,180898,Staff,19,0,20,1
1681926740687,HIEU 111,A00,180899,Staff,0,2,20,20
1681926741716,HIEU 124,A00,180900,Staff,17,0,20,3
1681926742745,HILA 122,A00,180901,Staff,18,0,20,2
1681926743774,HILA 132,A00,180902,Vitz; Matthew,0,0,20,20
1681926744808,HILD 10,A01,180896,Staff,14,0,20,6
1681926745833,HILD 30GS,A00,180897,Edington; Claire Ellen,0,0,0,0
1681926746859,HISC 105,A00,180903,Staff,20,0,20,0
1681926747882,HISC 117,A00,180904,Staff,10,0,20,10
1681926748993,HIUS 108B,A00,181005,Staff,18,0,20,2
1681926750018,HIUS 113,A00,181093,Staff,1,0,20,19
1681926751040,HUM 3,A01,181190,Patterson; Patrick H.,37,0,50,13
1681926751040,HUM 3,B01,181195,Staff,46,0,50,4
1681926752065,HUM 3GS,A00,181196,Herbst; Matthew,0,0,0,0
1681926753089,HUM 4,A01,181227,West; Geoffrey Scott,33,0,50,17
1681926753089,HUM 4,B01,181282,Staff,41,0,50,9
1681926754114,HUM 4GS,A00,181377,Lyon; Antony J.,0,0,0,0
1681926755140,HUM 5,A01,181536,Zavodny; Tatiana Sophia,26,0,50,24
1681926755140,HUM 5,B01,181908,Staff,35,0,50,15
1681926756168,INTL 190,A00,181909,Segui; Alan S,0,0,0,8
1681926756168,INTL 190,B00,181961,Segui; Alan S,0,0,0,7
1681926757199,JAPN 20AR,A01,182113,Ross; Kayoko F,15,0,20,5
1681926758221,LATI 50,A01,202391,Martin-Cabrera; Luis,18,0,30,12
1681926758221,LATI 50,A02,202392,Martin-Cabrera; Luis,26,0,30,4
1681926759243,LATI 180,A00,202393,Kokinis; Troy Andreas,24,0,25,1
1681926760272,LIFR 1A,A00,182119,Staff,13,0,14,1
1681926761294,LIFR 1AX,A00,182324,Staff,13,0,14,1
1681926762318,LIFR 1B,A00,182259,Staff,12,0,14,2
1681926763428,LIFR 1BX,A00,182273,Staff,12,0,14,2
1681926764450,LIGN 8,A00,182330,Staff,130,0,150,20
1681926765474,LIGN 9GS,A00,182362,Staff,16,0,20,4
1681926766496,LIGN 119,A00,204992,Takahashi; Maho,11,0,15,4
1681926767520,LIGN 130,A01,182384,Staff,47,0,50,3
1681926768542,LIGN 149GS,A00,182390,Staff,16,0,20,4
1681926769568,LIGN 170,A00,182404,Staff,23,0,30,7
1681926770592,LISP 1D,A00,182281,Staff,7,0,14,7
1681926770592,LISP 1D,B00,182287,Staff,13,0,14,1
1681926770592,LISP 1D,C00,182295,Staff,10,0,14,4
1681926770592,LISP 1D,D00,182301,Staff,14,0,14,0
1681926771615,LISP 1DX,A00,182309,Staff,19,0,28,9
1681926771615,LISP 1DX,B00,182316,Staff,25,0,28,3
1681926772641,LTAF 120GS,A00,182412,Zhiri; Oumelbanine,20,0,20,0
1681926773664,LTCS 172GS,A00,182437,Bronstein; Phoebe Malan,20,0,20,0
1681926774687,LTEA 138,A00,182457,Staff,19,0,40,21
1681926775717,LTEN 114,A01,182490,Staff,23,0,25,2
1681926776741,LTEN 130GS,A00,182491,Lyon; Antony J.,20,0,20,0
1681926777764,LTEN 169,A00,182493,Cuong; Marisol,19,0,25,6
1681926778786,LTEN 178,A00,182501,Staff,14,0,15,1
1681926779808,LTEN 181,A00,182515,Staff,20,0,25,5
1681926780841,LTEN 185GS,A00,197655,Forbes; Camille,20,0,20,0
1681926781865,LTSP 100B,A00,202208,Bessett; Ryan Matthew,24,0,25,1
1681926782901,LTWL 100,A00,182516,Myerston Santana; Jacobo,20,0,30,10
1681926783928,LTWR 100GS,A00,182518,Forbes; Camille,20,0,20,0
1681926784954,LTWR 102,A00,182522,Staff,15,0,15,0
1681926784954,LTWR 102,B00,182525,Staff,14,0,15,1
1681926785979,LTWR 115,A00,182526,Staff,11,0,15,4
1681926787006,MAE 8,A01,182528,Pham; Hieu Tan,67,0,70,3
1681926788036,MAE 11,A00,182529,Bahadori; Mohammad Yousef,92,0,100,8
1681926789059,MAE 20,A00,182530,Evdokimenko; Ekaterina,68,0,70,2
1681926790088,MAE 30A,A00,182532,Staff,44,0,45,1
1681926791119,MAE 101A,A00,182533,Bahadori; Mohammad Yousef,94,0,100,6
1681926792142,MAE 101C,A00,182538,Staff,62,0,70,8
1681926793166,MAE 104,A00,182539,Staff,44,0,50,6
1681926794196,MAE 131A,A00,182540,Ghazinejad; Maziar,40,0,45,5
1681926795223,MAE 143A,A00,182548,Bewley; Thomas R,43,0,50,7
1681926796248,MAE 150,A00,182549,Staff,28,0,40,12
1681926797274,MAE 160,A00,182550,Evdokimenko; Ekaterina,41,0,60,19
1681926798306,MATH 3C,A01,182725,Staff,24,0,30,6
1681926799329,MATH 10A,A01,182729,Staff,25,0,30,5
1681926799329,MATH 10A,B01,182732,Staff,25,0,30,5
1681926800352,MATH 10B,A01,182737,Staff,17,0,30,13
1681926800352,MATH 10B,A02,182738,Staff,26,0,30,4
1681926800352,MATH 10B,B01,182744,Staff,25,0,30,5
1681926800352,MATH 10B,B02,182745,Staff,27,0,30,3
1681926801380,MATH 18,A01,182750,Anzaldo; Leesa B,28,0,30,2
1681926801380,MATH 18,A02,182751,Anzaldo; Leesa B,28,0,30,2
1681926801380,MATH 18,A03,182753,Anzaldo; Leesa B,27,0,30,3
1681926801380,MATH 18,A04,182757,Anzaldo; Leesa B,29,0,30,1
1681926801380,MATH 18,B01,182761,Anzaldo; Leesa B,27,0,30,3
1681926801380,MATH 18,B02,182764,Anzaldo; Leesa B,26,0,30,4
1681926801380,MATH 18,B03,182765,Anzaldo; Leesa B,29,0,30,1
1681926801380,MATH 18,B04,182766,Anzaldo; Leesa B,30,0,30,0
1681926802403,MATH 20A,A01,182771,Suk; Andrew Hoon,28,0,30,2
1681926803438,MATH 20B,A01,182775,Bach; Quang Tran,30,0,30,0
1681926803438,MATH 20B,A02,182777,Bach; Quang Tran,29,0,30,1
1681926803438,MATH 20B,B01,182780,Bach; Quang Tran,26,0,30,4
1681926803438,MATH 20B,B02,182782,Bach; Quang Tran,30,0,30,0
1681926804466,MATH 20C,A01,182787,Staff,24,0,30,6
1681926804466,MATH 20C,A02,182790,Staff,29,0,30,1
1681926804466,MATH 20C,B01,182792,Staff,24,0,30,6
1681926804466,MATH 20C,B02,182796,Staff,26,0,30,4
1681926805501,MATH 20D,A01,182799,Staff,27,0,30,3
1681926805501,MATH 20D,A02,182802,Staff,29,0,30,1
1681926805501,MATH 20D,A03,182803,Staff,30,0,30,0
1681926806536,MATH 20E,A01,182809,Verstraete; Jacques Allan,22,0,30,8
1681926806536,MATH 20E,A02,182811,Verstraete; Jacques Allan,28,0,30,2
1681926806536,MATH 20E,B01,182814,Verstraete; Jacques Allan,22,0,30,8
1681926806536,MATH 20E,B02,182815,Verstraete; Jacques Allan,30,0,30,0
1681926807558,MATH 103A,A01,182820,Staff,4,0,30,26
1681926807558,MATH 103A,A02,182821,Staff,27,0,30,3
1681926807558,MATH 103A,A03,182822,Staff,22,0,30,8
1681926807558,MATH 103A,B01,182825,Staff,22,0,30,8
1681926807558,MATH 103A,B02,182826,Staff,30,0,30,0
1681926807558,MATH 103A,B03,182830,Staff,30,0,30,0
1681926808582,MATH 109,A01,182836,Chow; Bennett,23,0,30,7
1681926808582,MATH 109,A02,182838,Chow; Bennett,29,0,30,1
1681926808582,MATH 109,A03,182894,Chow; Bennett,29,0,30,1
1681926808582,MATH 109,B01,182908,Chow; Bennett,27,0,30,3
1681926808582,MATH 109,B02,182909,Chow; Bennett,30,0,30,0
1681926808582,MATH 109,B03,182910,Chow; Bennett,26,0,30,4
1681926809604,MATH 142A,A01,182925,Staff,7,0,30,23
1681926809604,MATH 142A,A02,182935,Staff,23,0,30,7
1681926809604,MATH 142A,A03,182967,Staff,26,0,30,4
1681926809604,MATH 142A,B01,183125,Staff,23,0,30,7
1681926809604,MATH 142A,B02,183157,Staff,27,0,30,3
1681926809604,MATH 142A,B03,183158,Staff,29,0,30,1
1681926810628,MATH 183,A01,183160,Arias-Castro; Ery,22,0,30,8
1681926810628,MATH 183,A02,183161,Arias-Castro; Ery,29,0,30,1
1681926810628,MATH 183,B01,183163,Arias-Castro; Ery,28,0,30,2
1681926810628,MATH 183,B02,183164,Arias-Castro; Ery,28,0,30,2
1681926811655,MATH 193A,A01,183167,Staff,0,0,35,35
1681926811655,MATH 193A,A02,183168,Staff,27,0,35,8
1681926811655,MATH 193A,A03,183169,Staff,34,0,35,1
1681926811655,MATH 193A,A04,183170,Staff,27,0,35,8
1681926812687,MGT 4,A01,202395,Anderson; John Charles,76,0,80,4
1681926813712,MGT 5,A00,202396,Houskeeper; Robert,79,0,90,11
1681926814741,MGT 103,A00,202397,Eberhard; Craig A,49,0,90,41
1681926815766,MGT 131A,A00,202398,Houskeeper; Robert,82,0,90,8
1681926816789,MGT 135,A00,202399,Anderson; John Charles,81,0,90,9
1681926817820,MGT 162R,A00,202403,Gneezy; Uri,130,0,200,70
1681926818863,MGT 172,A00,202404,Hedges; Kathleen,34,0,90,56
1681926819886,MGT 181,A00,202405,Dunn; Louis Jean,80,0,90,10
1681926820923,MMW 14,A01,183200,Staff,5,0,28,23
1681926820923,MMW 14,A02,183201,Staff,25,0,28,3
1681926820923,MMW 14,A03,183202,Staff,24,0,28,4
1681926820923,MMW 14,A04,183203,Staff,25,0,28,3
1681926820923,MMW 14,A05,183204,Staff,26,0,28,2
1681926820923,MMW 14,A06,183205,Staff,27,0,28,1
1681926820923,MMW 14,B01,183207,Staff,26,0,28,2
1681926820923,MMW 14,B02,183208,Staff,28,0,28,0
1681926820923,MMW 14,B03,183209,Staff,28,0,28,0
1681926820923,MMW 14,B04,183210,Staff,28,0,28,0
1681926820923,MMW 14,B05,183211,Staff,28,0,28,0
1681926820923,MMW 14,B06,183212,Staff,27,0,28,1
1681926821946,MMW 14GS,A00,183213,Zhiri; Oumelbanine,28,0,28,0
1681926822984,MMW 15GS,B00,183215,Rahimi; Babak,28,0,28,0
1681926824008,MMW 121,A01,183217,Patterson; Patrick H.,10,0,28,18
1681926824008,MMW 121,A02,183218,Patterson; Patrick H.,24,0,28,4
1681926825043,MUS 1A,A01,182554,Staff,4,0,35,31
1681926826070,MUS 5,A01,182558,Staff,17,0,35,18
1681926827106,MUS 6,A01,182562,Staff,22,0,35,13
1681926828147,MUS 8GS,A00,182563,Borgo; David Garcia,25,0,25,0
1681926829176,MUS 13,A01,182567,Staff,23,0,25,2
1681926830199,MUS 15,A01,182570,Staff,31,0,35,4
1681926830199,MUS 15,B01,182575,Staff,7,0,35,28
1681926831223,MUS 80,A00,182578,Staff,22,0,25,3
1681926831223,MUS 80,B00,182581,Staff,20,0,25,5
1681926832249,MUS 113,A00,182582,Staff,25,0,25,0
1681926833272,MUS 114,A00,182583,Staff,2,0,25,23
1681926834296,MUS 150GS,A01,182588,Borgo; David Garcia,25,0,25,0
1681926835318,PHIL 1,A00,182590,Staff,34,0,40,6
1681926836344,PHIL 10,A01,182596,Grush; Rick Scott,30,0,35,5
1681926836344,PHIL 10,A02,182597,Grush; Rick Scott,33,0,35,2
1681926837369,PHIL 15,A01,182601,Staff,31,0,35,4
1681926837369,PHIL 15,A02,182602,Staff,33,0,35,2
1681926838396,PHIL 27,A01,182604,Staff,30,0,35,5
1681926838396,PHIL 27,A02,182607,Staff,35,0,35,0
1681926839420,PHIL 32,A01,182609,Staff,35,0,35,0
1681926839420,PHIL 32,A02,182612,Staff,35,0,35,0
1681926840446,PHIL 130,A00,182614,Staff,60,0,70,10
1681926841469,PHIL 136,A00,182616,Cohen; Jonathan David,66,0,70,4
1681926842492,PHIL 155,A00,182617,Vargas; Manuel Rogelio,58,0,70,12
1681926843517,PHIL 163,A01,182620,Staff,15,0,20,5
1681926843517,PHIL 163,A02,182624,Staff,10,0,20,10
1681926844541,PHIL 164,A00,182627,Staff,29,0,40,11
1681926845563,PHIL 173,A00,182628,Staff,35,0,40,5
1681926846586,PHYS 1A,A00,183221,Staff,54,0,60,6
1681926847615,PHYS 1AL,001,183222,Staff,25,0,30,5
1681926847615,PHYS 1AL,002,183223,Staff,26,0,30,4
1681926848642,PHYS 1B,A00,183231,Staff,42,0,60,18
1681926849682,PHYS 1BL,001,183232,Staff,19,0,30,11
1681926849682,PHYS 1BL,002,183233,Staff,27,0,30,3
1681926850708,PHYS 1C,A00,183240,Staff,23,0,60,37
1681926851730,PHYS 1CL,001,183241,Staff,9,0,30,21
1681926851730,PHYS 1CL,002,183242,Staff,22,0,30,8
1681926852756,PHYS 2AR,A01,183250,Staff,42,0,50,8
1681926853781,PHYS 2B,A01,183252,Staff,104,0,115,11
1681926854806,PHYS 2BL,A01,183254,Staff,21,0,24,3
1681926854806,PHYS 2BL,A02,183255,Staff,21,0,24,3
1681926855832,PHYS 2C,A01,183522,Staff,102,0,115,13
1681926856866,PHYS 4A,A01,183524,Staff,49,0,50,1
1681926857894,POLI 5,A00,183525,Staff,44,0,50,6
1681926858915,POLI 12,A00,183540,Staff,45,0,50,5
1681926859939,POLI 13R,A00,183541,Forman; Fonna,41,0,50,9
1681926860961,POLI 30,A00,183542,Mignozzetti; Umberto,48,0,50,2
1681926861990,POLI 100A,A00,183543,Staff,44,0,50,6
1681926863020,POLI 100E,A00,223598,Staff,32,0,35,3
1681926864045,POLI 103A,A00,183564,Kousser; Thad,36,0,50,14
1681926865067,POLI 104B,A00,201329,Staff,28,0,35,7
1681926866102,POLI 113BR,A00,183576,Hoston; Germaine,23,0,50,27
1681926867204,POLI 114BR,A00,183588,Staff,27,0,30,3
1681926868235,POLI 117R,A00,183595,Forman; Fonna,4,0,20,16
1681926869269,POLI 120H,A00,183596,Fisk; David Lee,13,0,20,7
1681926870293,POLI 130AA,A00,183597,Staff,13,0,20,7
1681926871315,POLI 134AA,A00,183598,Staff,19,0,20,1
1681926872341,POLI 135,A00,183599,Fisk; David Lee,19,0,25,6
1681926873367,POLI 142P,A00,183623,Staff,37,0,40,3
1681926874389,POLI 144D,A00,183624,Staff,22,0,25,3
1681926875415,POLI 151,A00,183625,Staff,15,0,20,5
1681926876441,POLI 162,A00,183626,Mignozzetti; Umberto,17,0,20,3
1681926877470,PSYC 1,A00,253748,Staff,86,0,90,4
1681926878495,PSYC 2,A00,183627,Moranton; Nirelia Melbina-,24,0,35,11
1681926879517,PSYC 3,A00,183628,Staff,43,0,45,2
1681926881564,PSYC 60,A01,183631,Lowe; Angela Beth,35,0,40,5
1681926882586,PSYC 70,A01,253757,Staff,37,0,45,8
1681926883618,PSYC 101,A00,183632,Heyman; Gail D.,43,0,60,17
1681926884649,PSYC 105,A00,183848,Lowe; Angela Beth,46,0,60,14
1681926885673,PSYC 106,A00,183849,Dobkins; Karen R.,39,0,60,21
1681926886704,PSYC 108,A00,253750,Staff,15,0,60,45
1681926887726,PSYC 114,A01,184275,Winkielman; Piotr,0,8,30,30
1681926888750,PSYC 122,A00,183856,Moranton; Nirelia Melbina-,0,16,30,30
1681926889779,PSYC 124,A00,183865,Chapman; Eddie Nathaniel,46,0,80,34
1681926890802,PSYC 137,A00,183880,Staff,18,0,25,7
1681926892850,PSYC 154,A00,183910,Lacefield; Katharine I,0,24,90,90
1681926894901,PSYC 162,A00,183946,Wixted; John T,44,0,90,46
1681926895923,PSYC 172,A00,183947,Gorman; Michael R.,8,0,30,22
1681926896947,PSYC 178,A00,183963,Glaser; Dale,16,0,40,24
1681926897986,PSYC 181GS,A00,183964,Anagnostaras; Stephan,10,0,10,0
1681926899008,PSYC 186GS,A01,257660,Staff,10,0,10,0
1681926900035,PSYC 193,B00,253749,Staff,22,0,25,3
1681926902107,PSYC 193L,A01,184122,Staff,33,0,35,2
1681926902107,PSYC 193L,C01,184167,Winkielman; Piotr,14,0,30,16
1681926903130,RELI 188GS,A00,182629,Rahimi; Babak,20,0,20,0
1681926904153,SE 101A,A00,182646,Staff,26,0,30,4
1681926905178,SE 101C,A00,182650,Staff,14,0,20,6
1681926906200,SE 110A,A00,182651,Staff,28,0,28,0
1681926907224,SE 130A,A00,182652,Staff,38,0,40,2
1681926908246,SIO 46GS,A00,182636,Cook; Geoffrey W,25,0,28,3
1681926909278,SIO 109R,A00,194459,Staff,1,0,20,19
1681926910308,SIO 121GS,A00,182639,Cook; Geoffrey W,25,0,28,3
1681926911337,SIO 132,A01,182642,Staff,32,0,40,8
1681926912361,SIO 139,A00,182644,Kacev; David,36,0,40,4
1681926913388,SOCI 2,A01,258404,Staff,33,0,36,3
1681926913388,SOCI 2,A02,258405,Staff,35,0,36,1
1681926914411,SOCI 60,A01,258408,Staff,29,0,30,1
1681926914411,SOCI 60,A02,258413,Staff,30,0,30,0
1681926915440,SOCI 100,A01,258415,Staff,29,0,30,1
1681926915440,SOCI 100,A02,258416,Staff,28,0,30,2
1681926921591,SOCI 127,A00,258421,Staff,21,0,30,9
1681926922614,SOCI 132,A00,258422,Staff,44,0,50,6
1681926923637,SOCI 133,A00,258423,Staff,26,0,30,4
1681926924670,SOCI 138GS,A00,258424,Staff,15,0,15,0
1681926925693,SOCI 145,A00,258425,Staff,25,0,30,5
1681926926715,SOCI 148,A00,258426,Staff,24,0,30,6
1681926927739,SOCI 153,A00,199217,Staff,29,0,30,1
1681926928767,SOCI 160,A00,258427,Staff,28,0,30,2
1681926929792,SOCI 160E,A00,258435,Staff,56,0,60,4
1681926930816,SOCI 189GS,A00,258436,Staff,15,0,15,0
1681926931843,SOCI 190GS,A00,258437,Staff,15,0,15,0
1681926932869,SYN 2,001,182658,Staff,8,0,16,8
1681926932869,SYN 2,002,201439,Staff,14,0,16,2
1681926932869,SYN 2,003,201443,Staff,16,0,16,0
1681926933892,SYN 100,A01,182657,Staff,13,0,20,7
1681926934928,TDAC 1,A00,184381,Salovey; Todd,16,0,20,4
1681926934928,TDAC 1,B00,184385,Harting; Carla Kelso,19,0,20,1
1681926934928,TDAC 1,C00,184394,Staff,18,0,20,2
1681926935952,TDAC 101,A00,184483,Harting; Carla Kelso,19,0,20,1
1681926936979,TDDE 111,A00,184496,Staff,14,0,15,1
1681926938013,TDDE 131,A00,184504,Staff,20,0,20,0
1681926938013,TDDE 131,B00,184505,Staff,17,0,18,1
1681926938013,TDDE 131,C00,184534,Staff,49,0,50,1
1681926938013,TDDE 131,D00,184564,Staff,15,0,15,0
1681926938013,TDDE 131,E00,204725,Staff,19,0,20,1
1681926939045,TDGE 1,A01,184414,Salovey; Todd,36,0,50,14
1681926940068,TDGE 5,A01,184419,Staff,23,0,24,1
1681926941093,TDGE 10,A00,184428,Fulton; Julia,28,0,50,22
1681926942126,TDGE 124,A00,184565,Fulton; Julia,0,0,50,50
1681926943150,TDGE 125,B00,184567,Meyer; Ursula,9,0,25,16
1681926944172,TDHT 101,A00,184568,Staff,21,0,25,4
1681926944172,TDHT 101,B00,184569,Staff,20,0,20,0
1681926945201,TDHT 114,A00,184570,Staff,49,0,50,1
1681926946226,TDMV 1,A00,184437,Arcidiacono; Kristin,21,0,30,9
1681926946226,TDMV 1,B00,184448,Caligagan; Maria T.,23,0,30,7
1681926947252,TDMV 2,A00,184449,Weinberg; Sadie,27,0,30,3
1681926947252,TDMV 2,B00,184453,Arcidiacono; Kristin,29,0,30,1
1681926948275,TDMV 110,A00,184571,Weinberg; Sadie,30,0,30,0
1681926949299,TDMV 142,A00,184572,Caligagan; Tony,27,0,30,3
1681926949299,TDMV 142,B00,184573,Caligagan; Maria T.,26,0,30,4
1681926950327,TDTR 20,A00,184482,Jun; Grace Shin Hae,25,0,25,0
1681926951354,USP 2,A01,184290,Hinds; Juli Beth,24,0,25,1
1681926952377,USP 3,A01,184295,Staff,21,0,25,4
1681926953409,USP 4,A00,184304,McTague; Sarah,13,0,25,12
1681926954435,USP 100,A00,184315,Staff,16,0,25,9
1681926955459,USP 105,A00,184326,Staff,21,0,25,4
1681926956484,USP 151,A00,184327,Staff,18,0,25,7
1681926957510,USP 170,A00,184380,Hinds; Juli Beth,13,0,25,12
1681926958542,VIS 21B,A01,182660,Staff,28,0,31,3
1681926958542,VIS 21B,A02,182662,Staff,30,0,31,1
1681926959567,VIS 103D,A00,182663,Staff,74,0,75,1
1681926960590,VIS 105D,A00,182667,Li; Huai,14,0,22,8
1681926961614,VIS 122GS,A00,182668,Herbst; Matthew,20,0,20,0
1681926962641,VIS 128C,A00,182673,Staff,69,0,75,6
1681926963663,VIS 130,A00,182675,Staff,19,0,22,3
1681926964686,VIS 160A,A00,182678,Stalbaum; Brett,4,0,10,6
1681926966736,WCWP 10B,A00,201679,Staff,15,0,15,0
1681926966736,WCWP 10B,B00,201695,Staff,15,0,15,0
1681926967773,WCWP 100,A00,201716,Staff,12,0,15,3
1681926967773,WCWP 100,B00,201717,Staff,2,0,15,13
1681926969868,ANSC 105GS,A00,258289,Staff,0,0,0,0
1681926970971,ANSC 125GS,A00,258295,Staff,0,0,0,0
1681926971997,ANSC 150,A00,258267,Staff,28,0,40,12
1681926973020,ANSC 190GS,A00,258280,Staff,0,0,0,0
1681926974044,ANTH 1,A00,258264,Staff,38,0,40,2
1681926975068,ANTH 2,A01,258259,Staff,72,0,76,4
1681926976093,ANTH 23,A01,258228,Staff,36,0,40,4
1681926977121,ANTH 101,A01,258236,Staff,38,0,40,2
1681926978144,ANTH 102,A00,258272,Staff,59,0,60,1
1681926979169,ANTH 105,A00,258244,Staff,30,0,35,5
1681926980196,BENG 130,A00,253975,Staff,38,0,40,2
1681926981237,BIBC 102,A01,191866,Flagg; Matthew Paul,19,0,32,13
1681926981237,BIBC 102,A02,191867,Flagg; Matthew Paul,21,0,32,11
1681926981237,BIBC 102,A03,191868,Flagg; Matthew Paul,29,0,32,3
1681926981237,BIBC 102,A04,191936,Flagg; Matthew Paul,24,0,32,8
1681926981237,BIBC 102,A05,191937,Flagg; Matthew Paul,0,0,32,32
1681926982266,BICD 100,A01,191939,Cooper; Andrew Michael,28,0,32,4
1681926982266,BICD 100,A02,191940,Cooper; Andrew Michael,32,0,32,0
1681926982266,BICD 100,A03,191941,Cooper; Andrew Michael,32,0,32,0
1681926982266,BICD 100,A04,191942,Cooper; Andrew Michael,32,0,32,0
1681926982266,BICD 100,A05,191943,Cooper; Andrew Michael,32,0,32,0
1681926983290,BIEB 126,A01,191945,Cleland; Elsa Eleanor,0,1,32,32
1681926983290,BIEB 126,A02,191946,Cleland; Elsa Eleanor,27,0,32,5
1681926983290,BIEB 126,A03,191947,Cleland; Elsa Eleanor,29,0,32,3
1681926983290,BIEB 126,A04,191948,Cleland; Elsa Eleanor,19,0,32,13
1681926983290,BIEB 126,A05,191996,Cleland; Elsa Eleanor,28,0,32,4
1681926984314,BIEB 136GS,A00,191997,Shurin; Jonathan & Holway; David A.,0,0,0,7
1681926985337,BIEB 137GS,A01,191999,Shurin; Jonathan & Holway; David A.,0,0,0,6
1681926986360,BILD 1,A01,205385,Staff,30,0,32,2
1681926986360,BILD 1,A02,205386,Staff,30,0,32,2
1681926986360,BILD 1,A03,205387,Staff,31,0,32,1
1681926986360,BILD 1,A04,205388,Staff,26,0,32,6
1681926987383,BILD 2,A01,191774,Staff,27,0,32,5
1681926987383,BILD 2,A02,191775,Staff,30,0,32,2
1681926987383,BILD 2,A03,191777,Staff,30,0,32,2
1681926987383,BILD 2,A04,191856,Staff,30,0,32,2
1681926987383,BILD 2,A05,191857,Staff,32,0,32,0
1681926987383,BILD 2,A06,191858,Staff,32,0,32,0
1681926987383,BILD 2,A07,191859,Staff,31,0,32,1
1681926988418,BILD 3,A01,205391,Staff,28,0,32,4
1681926988418,BILD 3,A02,205393,Staff,32,0,32,0
1681926988418,BILD 3,A03,205394,Staff,27,0,32,5
1681926988418,BILD 3,A04,205395,Staff,32,0,32,0
1681926989440,BILD 20,A01,191861,Staff,32,0,32,0
1681926989440,BILD 20,A02,191862,Staff,32,0,32,0
1681926990464,BILD 30,A01,191864,Staff,31,0,32,1
1681926991494,BIMM 100,A01,192019,Staff,0,0,32,32
1681926991494,BIMM 100,A02,192020,Staff,18,0,32,14
1681926991494,BIMM 100,A03,192035,Staff,18,0,32,14
1681926992520,BIMM 110,A01,192037,Tat; John,0,0,32,32
1681926992520,BIMM 110,A02,192038,Tat; John,5,0,32,27
1681926993544,BIMM 120,A01,192040,Pickett; Brooke Elizabeth,0,0,32,32
1681926993544,BIMM 120,A02,192041,Pickett; Brooke Elizabeth,9,0,32,23
1681926993544,BIMM 120,A03,192042,Pickett; Brooke Elizabeth,14,0,32,18
1681926994568,BIPN 100,A01,192044,Armour; Jon Christopher,23,0,32,9
1681926994568,BIPN 100,A02,192059,Armour; Jon Christopher,30,0,32,2
1681926994568,BIPN 100,A03,192064,Armour; Jon Christopher,30,0,32,2
1681926994568,BIPN 100,A04,192073,Armour; Jon Christopher,27,0,32,5
1681926995591,BIPN 148,A01,205411,Leutgeb; Jill K.,15,0,32,17
1681926995591,BIPN 148,A02,205412,Leutgeb; Jill K.,31,0,32,1
1681926995591,BIPN 148,A03,205413,Leutgeb; Jill K.,30,0,32,2
1681926995591,BIPN 148,A04,205414,Leutgeb; Jill K.,30,0,32,2
1681926996618,BIPN 160,A01,192115,Marino; Marc J,15,0,32,17
1681926996618,BIPN 160,A02,192148,Marino; Marc J,27,0,32,5
1681926996618,BIPN 160,A03,192158,Marino; Marc J,31,0,32,1
1681926996618,BIPN 160,A04,192190,Marino; Marc J,32,0,32,0
1681926996618,BIPN 160,A05,192287,Marino; Marc J,32,0,32,0
1681926996618,BIPN 160,A06,192288,Marino; Marc J,32,0,32,0
1681926997641,BIPN 194,A00,206038,Staff,28,0,32,4
1681926998669,BISP 194,A00,192289,Leutgeb; Stefan,11,0,32,21
1681926998669,BISP 194,B00,245332,Nieh; James Charles,26,0,32,6
1681926999695,CAT 124,A01,202247,Staff,15,0,15,0
1681927000721,CAT 125,A00,202248,Staff,18,0,20,2
1681927000721,CAT 125,B00,202253,Staff,20,0,20,0
1681927000721,CAT 125,C00,202257,Staff,18,0,20,2
1681927001743,CAT 125GS,A01,202273,Bronstein; Phoebe Malan,20,0,20,0
1681927002784,CAT 125R,A00,202284,Staff,18,0,20,2
1681927002784,CAT 125R,C00,202286,Staff,5,0,20,15
1681927002784,CAT 125R,D00,202291,Staff,17,0,20,3
1681927002784,CAT 125R,E00,202295,Staff,13,0,20,7
1681927002784,CAT 125R,F00,202302,Staff,7,0,20,13
1681927003810,CENG 100,A00,204724,Opatkiewicz; Justin Paul,25,0,25,0
1681927004838,CGS 2A,A01,180420,Staff,30,0,36,6
1681927005869,CGS 101,A00,180421,Staff,16,0,20,4
1681927006891,CGS 112,A00,180422,Staff,9,0,16,7
1681927007913,CGS 113,A00,180423,Staff,18,0,20,2
1681927008937,CGS 137,A00,180424,Staff,12,0,12,0
1681927009962,CGS 147,A00,180425,Staff,10,0,10,0
1681927010995,CHEM 6A,A01,179556,Staff,94,0,100,6
1681927010995,CHEM 6A,A02,179558,Staff,0,0,0,0
1681927012018,CHEM 6B,A01,179560,Staff,100,0,100,0
1681927013041,CHEM 6C,A01,179565,Jazzar; Rodolphe,93,0,100,7
1681927014069,CHEM 7L,A01,179586,Schurmeier; Kimberly,10,0,24,14
1681927014069,CHEM 7L,A02,179587,Schurmeier; Kimberly,23,0,24,1
1681927014069,CHEM 7L,A03,179590,Schurmeier; Kimberly,22,0,24,2
1681927014069,CHEM 7L,A04,179591,Schurmeier; Kimberly,22,0,24,2
1681927014069,CHEM 7L,B01,179598,Schurmeier; Kimberly,16,0,24,8
1681927014069,CHEM 7L,B02,179599,Schurmeier; Kimberly,24,0,24,0
1681927014069,CHEM 7L,B03,179606,Schurmeier; Kimberly,23,0,24,1
1681927014069,CHEM 7L,B04,179607,Schurmeier; Kimberly,22,0,24,2
1681927015094,CHEM 11,A01,179609,Stallings; Dontarie M,87,0,100,13
1681927016120,CHEM 40A,A01,179621,Staff,40,0,50,10
1681927016120,CHEM 40A,A02,179622,Staff,46,0,50,4
1681927017146,CHEM 40B,A01,179630,Weizman; Haim,47,0,50,3
1681927017146,CHEM 40B,A02,179631,Weizman; Haim,44,0,50,6
1681927018182,CHEM 41A,A01,179660,Klosterman; Jeremy K,93,0,100,7
1681927019230,CHEM 43A,A01,179683,Klosterman; Jeremy K,0,0,24,24
1681927019230,CHEM 43A,A02,179688,Klosterman; Jeremy K,8,0,24,16
1681927019230,CHEM 43A,A03,179689,Klosterman; Jeremy K,18,0,24,6
1681927019230,CHEM 43A,A04,179691,Klosterman; Jeremy K,18,0,24,6
1681927020254,CHEM 114A,A01,179693,Stallings; Dontarie M,69,0,100,31
1681927021278,CHEM 143B,A01,179698,Weizman; Haim,16,0,24,8
1681927021278,CHEM 143B,A02,179700,Weizman; Haim,24,0,24,0
1681927022302,CHIN 169A,A00,179701,Wang; Xiao,20,0,20,0
1681927023327,COGS 2,A01,179750,Boyle; Mary E. T.,17,0,30,13
1681927024355,COGS 9,A01,179759,Jones; Cameron Robert,41,0,50,9
1681927025380,COGS 14A,A01,179854,Staff,14,0,50,36
1681927026402,COGS 14B,A01,179856,Staff,53,0,60,7
1681927027425,COGS 17,A01,179874,Staff,71,0,75,4
1681927028449,COGS 18,A01,179884,Staff,60,0,80,20
1681927029471,COGS 100,A01,179886,Staff,35,0,60,25
1681927030498,COGS 101B,A01,179892,Staff,0,2,30,30
1681927031524,COGS 101C,A01,179894,Staff,28,0,30,2
1681927032546,COGS 107A,A01,179896,Boyle; Mary E. T.,30,0,40,10
1681927033572,COGS 108,A01,179898,Simpkins; Charles Alexander,0,27,60,60
1681927034595,COGS 109,A01,179900,Staff,34,0,40,6
1681927035626,COGS 118A,A01,179946,Staff,6,0,40,34
1681927036655,COGS 153,A00,179978,Staff,0,4,30,30
1681927037678,COGS 156,A01,179981,Staff,21,0,30,9
1681927039723,COGS 172,A01,179987,Staff,11,0,30,19
1681927041784,COGS 186,A01,179991,Staff,12,0,30,18
1681927042809,COMM 10,A01,180001,Staff,12,0,25,13
1681927042809,COMM 10,A02,180004,Staff,20,0,25,5
1681927043837,COMM 100A,A01,180016,Staff,15,0,25,10
1681927043837,COMM 100A,A02,180020,Staff,24,0,25,1
1681927044862,COMM 101T,A00,180029,Halm; Gavin Patrick,22,0,35,13
1681927045886,COMM 106V,A00,180043,Staff,34,0,35,1
1681927046913,COMM 109P,A00,180044,Staff,30,0,35,5
1681927047940,COMM 113T,A00,180045,Havis; Allan,37,0,45,8
1681927048962,COMM 132,A00,180046,McKenna; Denise,23,0,30,7
1681927049984,COMM 143,A00,180047,Staff,18,0,30,12
1681927051010,COMM 190,A00,180048,Conner; Thomas Hartnell,18,0,23,5
1681927052038,CSE 8A,A50,180053,Cao; Yingjun,21,0,50,29
1681927052038,CSE 8A,B50,180180,Staff,50,0,50,0
1681927053065,CSE 11,A01,180190,Cao; Yingjun,21,0,50,29
1681927054094,CSE 20,A01,180192,Briones; Jor-el Thomas Caparas,22,0,30,8
1681927055124,CSE 21,A01,194538,Briones; Jor-el Thomas Caparas,50,0,60,10
1681927056150,CSE 30,A01,180324,Eldon; John,74,0,100,26
1681927057173,CSE 101,A01,201353,Staff,0,27,40,40
1681927058199,CSE 134B,A01,180326,Powell; Thomas Allan,73,0,100,27
1681927059226,CSE 140,A01,180328,Staff,30,0,75,45
1681927060252,CSE 140L,A01,180344,Eldon; John,53,0,100,47
1681927061274,CSE 150A,A01,180411,Staff,0,16,50,50
1681927062296,CSE 151A,A01,180414,Staff,0,10,50,50
1681927063318,CSE 175,A01,222521,Kumar; Rakesh,50,0,50,0
1681927064348,CSE 190,A00,201419,Staff,42,0,49,7
1681927065375,CSS 1,A01,194536,Staff,34,0,50,16
1681927066401,DSC 30,A01,202385,Staff,48,0,50,2
1681927067423,DSC 40A,A01,202387,Albuyeh; Rod,50,0,50,0
1681927068449,DSC 190,A01,202389,Silberman; Jack,21,0,21,0
1681927069473,DSGN 100,A01,179993,Staff,14,0,30,16
1681927070495,ECE 65,A50,180708,Staff,10,0,20,10
1681927070495,ECE 65,A51,180739,Staff,19,0,20,1
1681927071524,ECON 1,A01,180427,Famulari; Melissa,67,0,70,3
1681927072547,ECON 2,A01,180450,Levkoff; Steven B.,64,0,70,6
1681927073574,ECON 4,A01,203351,Anderson; John Charles,6,0,10,4
1681927074672,ECON 100A,A01,180472,Famulari; Melissa,59,0,70,11
1681927075694,ECON 120A,A01,180549,Staff,63,0,70,7
1681927076728,ECON 120B,A01,180655,Ma; Xinwei,41,0,70,29
1681927077760,ECON 129,A00,203333,Eckert; Fabian Paul,11,0,35,24
1681927078787,ECON 131,A00,180656,Staff,4,0,35,31
1681927079819,ECON 172B,A01,180672,Levkoff; Steven B.,31,0,35,4
1681927080841,ECON 178,A01,203342,Zhu; Ying,6,0,35,29
1681927081863,EDS 108GS,A00,202383,Wishard Guerra; Alison G.,20,0,20,0
1681927082901,EDS 111GS,A00,202347,Wishard Guerra; Alison G.,20,0,20,0
1681927083926,EDS 112,A01,202323,Staff,53,0,60,7
1681927084949,EDS 113,A00,202340,Staff,32,0,35,3
1681927085974,EDS 118,A00,201231,Staff,19,0,30,11
1681927086997,EDS 119,A00,204994,Staff,8,0,10,2
1681927088022,EDS 124BR,A00,202324,Eguchi; Emi,0,0,25,25
1681927089053,EDS 126,A01,203208,Jones; Makeba,26,0,30,4
1681927090076,EDS 135,A01,202333,Staff,17,0,20,3
1681927091100,EDS 180,A00,202311,Staff,47,0,50,3
1681927092124,ERC 190GS,A01,253747,Staff,28,0,28,0
1681927093147,ETHN 104,A00,180742,Staff,22,0,35,13
1681927094170,ETHN 118,A00,180745,Staff,27,0,35,8
1681927095191,ETHN 127,A00,180747,Staff,9,0,16,7
1681927096215,ETHN 137,A00,180880,Staff,11,0,12,1
1681927097238,ETHN 147,A00,180890,Staff,8,0,10,2
1681927098261,ETHN 154,A00,180891,Staff,6,0,8,2
1681927099283,ETHN 168,A00,180892,Staff,9,0,10,1
1681927100306,GLBH 20,A00,201051,Hannah; Seth Donal,0,5,0,1
1681927101336,GLBH 111,A01,209338,Burgos; Jose L.,0,0,0,0
1681927102362,GLBH 150,A00,258300,Staff,0,3,0,0
1681927103384,GLBH 181,A00,201207,Staff,10,0,40,30
1681927104410,HIEU 109,A00,180898,Staff,19,0,20,1
1681927105436,HIEU 111,A00,180899,Staff,0,2,20,20
1681927106458,HIEU 124,A00,180900,Staff,17,0,20,3
1681927107493,HILA 122,A00,180901,Staff,17,0,20,3
1681927108526,HILA 132,A00,180902,Vitz; Matthew,0,1,20,20
1681927109547,HILD 10,A01,180896,Staff,14,0,20,6
1681927110572,HILD 30GS,A00,180897,Edington; Claire Ellen,0,0,0,0
1681927111595,HISC 105,A00,180903,Staff,20,0,20,0
1681927112618,HISC 117,A00,180904,Staff,10,0,20,10
1681927113640,HIUS 108B,A00,181005,Staff,18,0,20,2
1681927114665,HIUS 113,A00,181093,Staff,0,0,20,20
1681927115687,HUM 3,A01,181190,Patterson; Patrick H.,36,0,50,14
1681927115687,HUM 3,B01,181195,Staff,46,0,50,4
1681927116713,HUM 3GS,A00,181196,Herbst; Matthew,0,0,0,0
1681927117750,HUM 4,A01,181227,West; Geoffrey Scott,33,0,50,17
1681927117750,HUM 4,B01,181282,Staff,41,0,50,9
1681927118779,HUM 4GS,A00,181377,Lyon; Antony J.,0,0,0,0
1681927119803,HUM 5,A01,181536,Zavodny; Tatiana Sophia,26,0,50,24
1681927119803,HUM 5,B01,181908,Staff,35,0,50,15
1681927120825,INTL 190,A00,181909,Segui; Alan S,0,0,0,8
1681927120825,INTL 190,B00,181961,Segui; Alan S,0,0,0,7
1681927121852,JAPN 20AR,A01,182113,Ross; Kayoko F,15,0,20,5
1681927122881,LATI 50,A01,202391,Martin-Cabrera; Luis,18,0,30,12
1681927122881,LATI 50,A02,202392,Martin-Cabrera; Luis,26,0,30,4
1681927123907,LATI 180,A00,202393,Kokinis; Troy Andreas,24,0,25,1
1681927124931,LIFR 1A,A00,182119,Staff,13,0,14,1
1681927125956,LIFR 1AX,A00,182324,Staff,13,0,14,1
1681927126987,LIFR 1B,A00,182259,Staff,12,0,14,2
1681927128009,LIFR 1BX,A00,182273,Staff,12,0,14,2
1681927129033,LIGN 8,A00,182330,Staff,130,0,150,20
1681927130055,LIGN 9GS,A00,182362,Staff,15,0,20,5
1681927131079,LIGN 119,A00,204992,Takahashi; Maho,11,0,15,4
1681927132119,LIGN 130,A01,182384,Staff,47,0,50,3
1681927133144,LIGN 149GS,A00,182390,Staff,15,0,20,5
1681927134169,LIGN 170,A00,182404,Staff,23,0,30,7
1681927135191,LISP 1D,A00,182281,Staff,7,0,14,7
1681927135191,LISP 1D,B00,182287,Staff,13,0,14,1
1681927135191,LISP 1D,C00,182295,Staff,10,0,14,4
1681927135191,LISP 1D,D00,182301,Staff,14,0,14,0
1681927136214,LISP 1DX,A00,182309,Staff,19,0,28,9
1681927136214,LISP 1DX,B00,182316,Staff,25,0,28,3
1681927137236,LTAF 120GS,A00,182412,Zhiri; Oumelbanine,20,0,20,0
1681927138265,LTCS 172GS,A00,182437,Bronstein; Phoebe Malan,20,0,20,0
1681927139287,LTEA 138,A00,182457,Staff,19,0,40,21
1681927140312,LTEN 114,A01,182490,Staff,23,0,25,2
1681927141334,LTEN 130GS,A00,182491,Lyon; Antony J.,20,0,20,0
1681927142357,LTEN 169,A00,182493,Cuong; Marisol,18,0,25,7
1681927143382,LTEN 178,A00,182501,Staff,14,0,15,1
1681927144420,LTEN 181,A00,182515,Staff,20,0,25,5
1681927145446,LTEN 185GS,A00,197655,Forbes; Camille,20,0,20,0
1681927146472,LTSP 100B,A00,202208,Bessett; Ryan Matthew,24,0,25,1
1681927147496,LTWL 100,A00,182516,Myerston Santana; Jacobo,20,0,30,10
1681927148534,LTWR 100GS,A00,182518,Forbes; Camille,20,0,20,0
1681927149558,LTWR 102,A00,182522,Staff,15,0,15,0
1681927149558,LTWR 102,B00,182525,Staff,14,0,15,1
1681927150580,LTWR 115,A00,182526,Staff,10,0,15,5
1681927151603,MAE 8,A01,182528,Pham; Hieu Tan,67,0,70,3
1681927152625,MAE 11,A00,182529,Bahadori; Mohammad Yousef,92,0,100,8
1681927153646,MAE 20,A00,182530,Evdokimenko; Ekaterina,68,0,70,2
1681927154673,MAE 30A,A00,182532,Staff,44,0,45,1
1681927155699,MAE 101A,A00,182533,Bahadori; Mohammad Yousef,94,0,100,6
1681927156722,MAE 101C,A00,182538,Staff,62,0,70,8
1681927157744,MAE 104,A00,182539,Staff,44,0,50,6
1681927158778,MAE 131A,A00,182540,Ghazinejad; Maziar,40,0,45,5
1681927159805,MAE 143A,A00,182548,Bewley; Thomas R,43,0,50,7
1681927160831,MAE 150,A00,182549,Staff,28,0,40,12
1681927161858,MAE 160,A00,182550,Evdokimenko; Ekaterina,41,0,60,19
1681927162887,MATH 3C,A01,182725,Staff,24,0,30,6
1681927163909,MATH 10A,A01,182729,Staff,25,0,30,5
1681927163909,MATH 10A,B01,182732,Staff,25,0,30,5
1681927164933,MATH 10B,A01,182737,Staff,17,0,30,13
1681927164933,MATH 10B,A02,182738,Staff,26,0,30,4
1681927164933,MATH 10B,B01,182744,Staff,25,0,30,5
1681927164933,MATH 10B,B02,182745,Staff,27,0,30,3
1681927165957,MATH 18,A01,182750,Anzaldo; Leesa B,28,0,30,2
1681927165957,MATH 18,A02,182751,Anzaldo; Leesa B,28,0,30,2
1681927165957,MATH 18,A03,182753,Anzaldo; Leesa B,27,0,30,3
1681927165957,MATH 18,A04,182757,Anzaldo; Leesa B,29,0,30,1
1681927165957,MATH 18,B01,182761,Anzaldo; Leesa B,27,0,30,3
1681927165957,MATH 18,B02,182764,Anzaldo; Leesa B,26,0,30,4
1681927165957,MATH 18,B03,182765,Anzaldo; Leesa B,29,0,30,1
1681927165957,MATH 18,B04,182766,Anzaldo; Leesa B,30,0,30,0
1681927166993,MATH 20A,A01,182771,Suk; Andrew Hoon,28,0,30,2
1681927168016,MATH 20B,A01,182775,Bach; Quang Tran,30,0,30,0
1681927168016,MATH 20B,A02,182777,Bach; Quang Tran,29,0,30,1
1681927168016,MATH 20B,B01,182780,Bach; Quang Tran,26,0,30,4
1681927168016,MATH 20B,B02,182782,Bach; Quang Tran,30,0,30,0
1681927169049,MATH 20C,A01,182787,Staff,24,0,30,6
1681927169049,MATH 20C,A02,182790,Staff,29,0,30,1
1681927169049,MATH 20C,B01,182792,Staff,23,0,30,7
1681927169049,MATH 20C,B02,182796,Staff,26,0,30,4
1681927170073,MATH 20D,A01,182799,Staff,27,0,30,3
1681927170073,MATH 20D,A02,182802,Staff,29,0,30,1
1681927170073,MATH 20D,A03,182803,Staff,30,0,30,0
1681927171099,MATH 20E,A01,182809,Verstraete; Jacques Allan,22,0,30,8
1681927171099,MATH 20E,A02,182811,Verstraete; Jacques Allan,28,0,30,2
1681927171099,MATH 20E,B01,182814,Verstraete; Jacques Allan,22,0,30,8
1681927171099,MATH 20E,B02,182815,Verstraete; Jacques Allan,30,0,30,0
1681927172127,MATH 103A,A01,182820,Staff,4,0,30,26
1681927172127,MATH 103A,A02,182821,Staff,27,0,30,3
1681927172127,MATH 103A,A03,182822,Staff,22,0,30,8
1681927172127,MATH 103A,B01,182825,Staff,22,0,30,8
1681927172127,MATH 103A,B02,182826,Staff,30,0,30,0
1681927172127,MATH 103A,B03,182830,Staff,30,0,30,0
1681927173157,MATH 109,A01,182836,Chow; Bennett,23,0,30,7
1681927173157,MATH 109,A02,182838,Chow; Bennett,29,0,30,1
1681927173157,MATH 109,A03,182894,Chow; Bennett,29,0,30,1
1681927173157,MATH 109,B01,182908,Chow; Bennett,27,0,30,3
1681927173157,MATH 109,B02,182909,Chow; Bennett,30,0,30,0
1681927173157,MATH 109,B03,182910,Chow; Bennett,26,0,30,4
1681927174181,MATH 142A,A01,182925,Staff,6,0,30,24
1681927174181,MATH 142A,A02,182935,Staff,23,0,30,7
1681927174181,MATH 142A,A03,182967,Staff,26,0,30,4
1681927174181,MATH 142A,B01,183125,Staff,23,0,30,7
1681927174181,MATH 142A,B02,183157,Staff,27,0,30,3
1681927174181,MATH 142A,B03,183158,Staff,29,0,30,1
1681927175217,MATH 183,A01,183160,Arias-Castro; Ery,23,0,30,7
1681927175217,MATH 183,A02,183161,Arias-Castro; Ery,29,0,30,1
1681927175217,MATH 183,B01,183163,Arias-Castro; Ery,28,0,30,2
1681927175217,MATH 183,B02,183164,Arias-Castro; Ery,28,0,30,2
1681927176243,MATH 193A,A01,183167,Staff,0,0,35,35
1681927176243,MATH 193A,A02,183168,Staff,27,0,35,8
1681927176243,MATH 193A,A03,183169,Staff,34,0,35,1
1681927176243,MATH 193A,A04,183170,Staff,27,0,35,8
1681927177270,MGT 4,A01,202395,Anderson; John Charles,76,0,80,4
1681927178377,MGT 5,A00,202396,Houskeeper; Robert,79,0,90,11
1681927179411,MGT 103,A00,202397,Eberhard; Craig A,49,0,90,41
1681927180433,MGT 131A,A00,202398,Houskeeper; Robert,82,0,90,8
1681927181458,MGT 135,A00,202399,Anderson; John Charles,81,0,90,9
1681927182481,MGT 162R,A00,202403,Gneezy; Uri,130,0,200,70
1681927183508,MGT 172,A00,202404,Hedges; Kathleen,34,0,90,56
1681927184530,MGT 181,A00,202405,Dunn; Louis Jean,79,0,90,11
1681927185557,MMW 14,A01,183200,Staff,5,0,28,23
1681927185557,MMW 14,A02,183201,Staff,25,0,28,3
1681927185557,MMW 14,A03,183202,Staff,24,0,28,4
1681927185557,MMW 14,A04,183203,Staff,25,0,28,3
1681927185557,MMW 14,A05,183204,Staff,26,0,28,2
1681927185557,MMW 14,A06,183205,Staff,27,0,28,1
1681927185557,MMW 14,B01,183207,Staff,26,0,28,2
1681927185557,MMW 14,B02,183208,Staff,28,0,28,0
1681927185557,MMW 14,B03,183209,Staff,28,0,28,0
1681927185557,MMW 14,B04,183210,Staff,28,0,28,0
1681927185557,MMW 14,B05,183211,Staff,28,0,28,0
1681927185557,MMW 14,B06,183212,Staff,27,0,28,1
1681927186584,MMW 14GS,A00,183213,Zhiri; Oumelbanine,28,0,28,0
1681927187606,MMW 15GS,B00,183215,Rahimi; Babak,28,0,28,0
1681927188633,MMW 121,A01,183217,Patterson; Patrick H.,9,0,28,19
1681927188633,MMW 121,A02,183218,Patterson; Patrick H.,24,0,28,4
1681927189657,MUS 1A,A01,182554,Staff,4,0,35,31
1681927190683,MUS 5,A01,182558,Staff,17,0,35,18
1681927191727,MUS 6,A01,182562,Staff,22,0,35,13
1681927192763,MUS 8GS,A00,182563,Borgo; David Garcia,25,0,25,0
1681927193786,MUS 13,A01,182567,Staff,23,0,25,2
1681927194824,MUS 15,A01,182570,Staff,31,0,35,4
1681927194824,MUS 15,B01,182575,Staff,7,0,35,28
1681927195853,MUS 80,A00,182578,Staff,22,0,25,3
1681927195853,MUS 80,B00,182581,Staff,20,0,25,5
1681927196876,MUS 113,A00,182582,Staff,25,0,25,0
1681927197905,MUS 114,A00,182583,Staff,2,0,25,23
1681927198928,MUS 150GS,A01,182588,Borgo; David Garcia,25,0,25,0
1681927199954,PHIL 1,A00,182590,Staff,34,0,40,6
1681927200978,PHIL 10,A01,182596,Grush; Rick Scott,30,0,35,5
1681927200978,PHIL 10,A02,182597,Grush; Rick Scott,33,0,35,2
1681927202014,PHIL 15,A01,182601,Staff,31,0,35,4
1681927202014,PHIL 15,A02,182602,Staff,33,0,35,2
1681927203036,PHIL 27,A01,182604,Staff,30,0,35,5
1681927203036,PHIL 27,A02,182607,Staff,35,0,35,0
1681927204060,PHIL 32,A01,182609,Staff,35,0,35,0
1681927204060,PHIL 32,A02,182612,Staff,35,0,35,0
1681927205088,PHIL 130,A00,182614,Staff,60,0,70,10
1681927206113,PHIL 136,A00,182616,Cohen; Jonathan David,66,0,70,4
1681927207146,PHIL 155,A00,182617,Vargas; Manuel Rogelio,58,0,70,12
1681927208170,PHIL 163,A01,182620,Staff,15,0,20,5
1681927208170,PHIL 163,A02,182624,Staff,10,0,20,10
1681927209197,PHIL 164,A00,182627,Staff,29,0,40,11
1681927210220,PHIL 173,A00,182628,Staff,35,0,40,5
1681927211248,PHYS 1A,A00,183221,Staff,54,0,60,6
1681927212272,PHYS 1AL,001,183222,Staff,25,0,30,5
1681927212272,PHYS 1AL,002,183223,Staff,26,0,30,4
1681927213297,PHYS 1B,A00,183231,Staff,42,0,60,18
1681927214320,PHYS 1BL,001,183232,Staff,19,0,30,11
1681927214320,PHYS 1BL,002,183233,Staff,27,0,30,3
1681927215348,PHYS 1C,A00,183240,Staff,23,0,60,37
1681927216372,PHYS 1CL,001,183241,Staff,9,0,30,21
1681927216372,PHYS 1CL,002,183242,Staff,22,0,30,8
1681927217397,PHYS 2AR,A01,183250,Staff,42,0,50,8
1681927218431,PHYS 2B,A01,183252,Staff,103,0,115,12
1681927219460,PHYS 2BL,A01,183254,Staff,21,0,24,3
1681927219460,PHYS 2BL,A02,183255,Staff,21,0,24,3
1681927220486,PHYS 2C,A01,183522,Staff,102,0,115,13
1681927221508,PHYS 4A,A01,183524,Staff,49,0,50,1
1681927222535,POLI 5,A00,183525,Staff,44,0,50,6
1681927223563,POLI 12,A00,183540,Staff,45,0,50,5
1681927224586,POLI 13R,A00,183541,Forman; Fonna,41,0,50,9
1681927225614,POLI 30,A00,183542,Mignozzetti; Umberto,48,0,50,2
1681927226641,POLI 100A,A00,183543,Staff,44,0,50,6
1681927227664,POLI 100E,A00,223598,Staff,32,0,35,3
1681927228688,POLI 103A,A00,183564,Kousser; Thad,36,0,50,14
1681927229711,POLI 104B,A00,201329,Staff,28,0,35,7
1681927230734,POLI 113BR,A00,183576,Hoston; Germaine,23,0,50,27
1681927231759,POLI 114BR,A00,183588,Staff,27,0,30,3
1681927232783,POLI 117R,A00,183595,Forman; Fonna,4,0,20,16
1681927233808,POLI 120H,A00,183596,Fisk; David Lee,13,0,20,7
1681927234835,POLI 130AA,A00,183597,Staff,13,0,20,7
1681927235859,POLI 134AA,A00,183598,Staff,19,0,20,1
1681927236886,POLI 135,A00,183599,Fisk; David Lee,19,0,25,6
1681927237918,POLI 142P,A00,183623,Staff,37,0,40,3
1681927238951,POLI 144D,A00,183624,Staff,22,0,25,3
1681927239975,POLI 151,A00,183625,Staff,15,0,20,5
1681927240997,POLI 162,A00,183626,Mignozzetti; Umberto,17,0,20,3
1681927242020,PSYC 1,A00,253748,Staff,86,0,90,4
1681927243053,PSYC 2,A00,183627,Moranton; Nirelia Melbina-,24,0,35,11
1681927244077,PSYC 3,A00,183628,Staff,43,0,45,2
1681927246129,PSYC 60,A01,183631,Lowe; Angela Beth,35,0,40,5
1681927247155,PSYC 70,A01,253757,Staff,37,0,45,8
1681927248186,PSYC 101,A00,183632,Heyman; Gail D.,43,0,60,17
1681927249220,PSYC 105,A00,183848,Lowe; Angela Beth,46,0,60,14
1681927250248,PSYC 106,A00,183849,Dobkins; Karen R.,39,0,60,21
1681927251282,PSYC 108,A00,253750,Staff,14,0,60,46
1681927252306,PSYC 114,A01,184275,Winkielman; Piotr,0,8,30,30
1681927253332,PSYC 122,A00,183856,Moranton; Nirelia Melbina-,0,16,30,30
1681927254354,PSYC 124,A00,183865,Chapman; Eddie Nathaniel,46,0,80,34
1681927255382,PSYC 137,A00,183880,Staff,18,0,25,7
1681927257429,PSYC 154,A00,183910,Lacefield; Katharine I,0,24,90,90
1681927259477,PSYC 162,A00,183946,Wixted; John T,44,0,90,46
1681927260504,PSYC 172,A00,183947,Gorman; Michael R.,8,0,30,22
1681927261531,PSYC 178,A00,183963,Glaser; Dale,16,0,40,24
1681927262561,PSYC 181GS,A00,183964,Anagnostaras; Stephan,10,0,10,0
1681927263588,PSYC 186GS,A01,257660,Staff,10,0,10,0
1681927264629,PSYC 193,B00,253749,Staff,22,0,25,3
1681927266682,PSYC 193L,A01,184122,Staff,33,0,35,2
1681927266682,PSYC 193L,C01,184167,Winkielman; Piotr,14,0,30,16
1681927267720,RELI 188GS,A00,182629,Rahimi; Babak,20,0,20,0
1681927268745,SE 101A,A00,182646,Staff,26,0,30,4
1681927269770,SE 101C,A00,182650,Staff,14,0,20,6
1681927270800,SE 110A,A00,182651,Staff,28,0,28,0
1681927271832,SE 130A,A00,182652,Staff,38,0,40,2
1681927272862,SIO 46GS,A00,182636,Cook; Geoffrey W,25,0,28,3
1681927273888,SIO 109R,A00,194459,Staff,1,0,20,19
1681927274912,SIO 121GS,A00,182639,Cook; Geoffrey W,25,0,28,3
1681927275935,SIO 132,A01,182642,Staff,32,0,40,8
1681927276958,SIO 139,A00,182644,Kacev; David,36,0,40,4
1681927277982,SOCI 2,A01,258404,Staff,33,0,36,3
1681927277982,SOCI 2,A02,258405,Staff,35,0,36,1
1681927279005,SOCI 60,A01,258408,Staff,29,0,30,1
1681927279005,SOCI 60,A02,258413,Staff,30,0,30,0
1681927280028,SOCI 100,A01,258415,Staff,29,0,30,1
1681927280028,SOCI 100,A02,258416,Staff,28,0,30,2
1681927286296,SOCI 127,A00,258421,Staff,19,0,30,11
1681927287320,SOCI 132,A00,258422,Staff,44,0,50,6
1681927288342,SOCI 133,A00,258423,Staff,26,0,30,4
1681927289364,SOCI 138GS,A00,258424,Staff,15,0,15,0
1681927290395,SOCI 145,A00,258425,Staff,25,0,30,5
1681927291421,SOCI 148,A00,258426,Staff,24,0,30,6
1681927292444,SOCI 153,A00,199217,Staff,29,0,30,1
1681927293470,SOCI 160,A00,258427,Staff,27,0,30,3
1681927294518,SOCI 160E,A00,258435,Staff,56,0,60,4
1681927295541,SOCI 189GS,A00,258436,Staff,15,0,15,0
1681927296564,SOCI 190GS,A00,258437,Staff,15,0,15,0
1681927297586,SYN 2,001,182658,Staff,8,0,16,8
1681927297586,SYN 2,002,201439,Staff,14,0,16,2
1681927297586,SYN 2,003,201443,Staff,16,0,16,0
1681927298614,SYN 100,A01,182657,Staff,13,0,20,7
1681927299644,TDAC 1,A00,184381,Salovey; Todd,16,0,20,4
1681927299644,TDAC 1,B00,184385,Harting; Carla Kelso,19,0,20,1
1681927299644,TDAC 1,C00,184394,Staff,18,0,20,2
1681927300667,TDAC 101,A00,184483,Harting; Carla Kelso,19,0,20,1
1681927301693,TDDE 111,A00,184496,Staff,14,0,15,1
1681927302720,TDDE 131,A00,184504,Staff,20,0,20,0
1681927302720,TDDE 131,B00,184505,Staff,17,0,18,1
1681927302720,TDDE 131,C00,184534,Staff,49,0,50,1
1681927302720,TDDE 131,D00,184564,Staff,15,0,15,0
1681927302720,TDDE 131,E00,204725,Staff,18,0,20,2
1681927303751,TDGE 1,A01,184414,Salovey; Todd,36,0,50,14
1681927304777,TDGE 5,A01,184419,Staff,23,0,24,1
1681927305802,TDGE 10,A00,184428,Fulton; Julia,28,0,50,22
1681927306825,TDGE 124,A00,184565,Fulton; Julia,0,0,50,50
1681927307852,TDGE 125,B00,184567,Meyer; Ursula,9,0,25,16
1681927308877,TDHT 101,A00,184568,Staff,21,0,25,4
1681927308877,TDHT 101,B00,184569,Staff,20,0,20,0
1681927309899,TDHT 114,A00,184570,Staff,49,0,50,1
1681927310930,TDMV 1,A00,184437,Arcidiacono; Kristin,21,0,30,9
1681927310930,TDMV 1,B00,184448,Caligagan; Maria T.,23,0,30,7
1681927311955,TDMV 2,A00,184449,Weinberg; Sadie,27,0,30,3
1681927311955,TDMV 2,B00,184453,Arcidiacono; Kristin,29,0,30,1
1681927312978,TDMV 110,A00,184571,Weinberg; Sadie,30,0,30,0
1681927314009,TDMV 142,A00,184572,Caligagan; Tony,26,0,30,4
1681927314009,TDMV 142,B00,184573,Caligagan; Maria T.,26,0,30,4
1681927315036,TDTR 20,A00,184482,Jun; Grace Shin Hae,25,0,25,0
1681927316058,USP 2,A01,184290,Hinds; Juli Beth,24,0,25,1
1681927317099,USP 3,A01,184295,Staff,21,0,25,4
1681927318122,USP 4,A00,184304,McTague; Sarah,13,0,25,12
1681927319153,USP 100,A00,184315,Staff,16,0,25,9
1681927320179,USP 105,A00,184326,Staff,21,0,25,4
1681927321221,USP 151,A00,184327,Staff,18,0,25,7
1681927322247,USP 170,A00,184380,Hinds; Juli Beth,13,0,25,12
1681927323272,VIS 21B,A01,182660,Staff,28,0,31,3
1681927323272,VIS 21B,A02,182662,Staff,30,0,31,1
1681927324296,VIS 103D,A00,182663,Staff,74,0,75,1
1681927325322,VIS 105D,A00,182667,Li; Huai,14,0,22,8
1681927326351,VIS 122GS,A00,182668,Herbst; Matthew,20,0,20,0
1681927327382,VIS 128C,A00,182673,Staff,69,0,75,6
1681927328406,VIS 130,A00,182675,Staff,19,0,22,3
1681927329432,VIS 160A,A00,182678,Stalbaum; Brett,4,0,10,6
1681927331491,WCWP 10B,A00,201679,Staff,15,0,15,0
1681927331491,WCWP 10B,B00,201695,Staff,15,0,15,0
1681927332514,WCWP 100,A00,201716,Staff,12,0,15,3
1681927332514,WCWP 100,B00,201717,Staff,1,0,15,14
1681927334575,ANSC 105GS,A00,258289,Staff,0,0,0,0
1681927335602,ANSC 125GS,A00,258295,Staff,0,0,0,0
1681927336630,ANSC 150,A00,258267,Staff,28,0,40,12
1681927337661,ANSC 190GS,A00,258280,Staff,0,0,0,0
1681927338684,ANTH 1,A00,258264,Staff,38,0,40,2
1681927339713,ANTH 2,A01,258259,Staff,72,0,76,4
1681927340750,ANTH 23,A01,258228,Staff,36,0,40,4
1681927341792,ANTH 101,A01,258236,Staff,38,0,40,2
1681927342818,ANTH 102,A00,258272,Staff,59,0,60,1
1681927343843,ANTH 105,A00,258244,Staff,30,0,35,5
1681927344878,BENG 130,A00,253975,Staff,38,0,40,2
1681927345906,BIBC 102,A01,191866,Flagg; Matthew Paul,18,0,32,14
1681927345906,BIBC 102,A02,191867,Flagg; Matthew Paul,21,0,32,11
1681927345906,BIBC 102,A03,191868,Flagg; Matthew Paul,29,0,32,3
1681927345906,BIBC 102,A04,191936,Flagg; Matthew Paul,24,0,32,8
1681927345906,BIBC 102,A05,191937,Flagg; Matthew Paul,0,0,32,32
1681927346939,BICD 100,A01,191939,Cooper; Andrew Michael,27,0,32,5
1681927346939,BICD 100,A02,191940,Cooper; Andrew Michael,32,0,32,0
1681927346939,BICD 100,A03,191941,Cooper; Andrew Michael,32,0,32,0
1681927346939,BICD 100,A04,191942,Cooper; Andrew Michael,32,0,32,0
1681927346939,BICD 100,A05,191943,Cooper; Andrew Michael,32,0,32,0
1681927347961,BIEB 126,A01,191945,Cleland; Elsa Eleanor,0,2,32,32
1681927347961,BIEB 126,A02,191946,Cleland; Elsa Eleanor,27,0,32,5
1681927347961,BIEB 126,A03,191947,Cleland; Elsa Eleanor,29,0,32,3
1681927347961,BIEB 126,A04,191948,Cleland; Elsa Eleanor,17,0,32,15
1681927347961,BIEB 126,A05,191996,Cleland; Elsa Eleanor,28,0,32,4
1681927348986,BIEB 136GS,A00,191997,Shurin; Jonathan & Holway; David A.,0,0,0,7
1681927350010,BIEB 137GS,A01,191999,Shurin; Jonathan & Holway; David A.,0,0,0,6
1681927351034,BILD 1,A01,205385,Staff,30,0,32,2
1681927351034,BILD 1,A02,205386,Staff,30,0,32,2
1681927351034,BILD 1,A03,205387,Staff,31,0,32,1
1681927351034,BILD 1,A04,205388,Staff,26,0,32,6
1681927352058,BILD 2,A01,191774,Staff,27,0,32,5
1681927352058,BILD 2,A02,191775,Staff,30,0,32,2
1681927352058,BILD 2,A03,191777,Staff,30,0,32,2
1681927352058,BILD 2,A04,191856,Staff,30,0,32,2
1681927352058,BILD 2,A05,191857,Staff,31,0,32,1
1681927352058,BILD 2,A06,191858,Staff,32,0,32,0
1681927352058,BILD 2,A07,191859,Staff,31,0,32,1
1681927353090,BILD 3,A01,205391,Staff,28,0,32,4
1681927353090,BILD 3,A02,205393,Staff,32,0,32,0
1681927353090,BILD 3,A03,205394,Staff,27,0,32,5
1681927353090,BILD 3,A04,205395,Staff,32,0,32,0
1681927354132,BILD 20,A01,191861,Staff,32,0,32,0
1681927354132,BILD 20,A02,191862,Staff,32,0,32,0
1681927355159,BILD 30,A01,191864,Staff,31,0,32,1
1681927356187,BIMM 100,A01,192019,Staff,0,0,32,32
1681927356187,BIMM 100,A02,192020,Staff,18,0,32,14
1681927356187,BIMM 100,A03,192035,Staff,18,0,32,14
1681927357218,BIMM 110,A01,192037,Tat; John,0,0,32,32
1681927357218,BIMM 110,A02,192038,Tat; John,5,0,32,27
1681927358255,BIMM 120,A01,192040,Pickett; Brooke Elizabeth,0,0,32,32
1681927358255,BIMM 120,A02,192041,Pickett; Brooke Elizabeth,9,0,32,23
1681927358255,BIMM 120,A03,192042,Pickett; Brooke Elizabeth,14,0,32,18
1681927359284,BIPN 100,A01,192044,Armour; Jon Christopher,22,0,32,10
1681927359284,BIPN 100,A02,192059,Armour; Jon Christopher,30,0,32,2
1681927359284,BIPN 100,A03,192064,Armour; Jon Christopher,30,0,32,2
1681927359284,BIPN 100,A04,192073,Armour; Jon Christopher,26,0,32,6
1681927360315,BIPN 148,A01,205411,Leutgeb; Jill K.,15,0,32,17
1681927360315,BIPN 148,A02,205412,Leutgeb; Jill K.,31,0,32,1
1681927360315,BIPN 148,A03,205413,Leutgeb; Jill K.,30,0,32,2
1681927360315,BIPN 148,A04,205414,Leutgeb; Jill K.,30,0,32,2
1681927361341,BIPN 160,A01,192115,Marino; Marc J,15,0,32,17
1681927361341,BIPN 160,A02,192148,Marino; Marc J,27,0,32,5
1681927361341,BIPN 160,A03,192158,Marino; Marc J,31,0,32,1
1681927361341,BIPN 160,A04,192190,Marino; Marc J,32,0,32,0
1681927361341,BIPN 160,A05,192287,Marino; Marc J,32,0,32,0
1681927361341,BIPN 160,A06,192288,Marino; Marc J,32,0,32,0
1681927362369,BIPN 194,A00,206038,Staff,28,0,32,4
1681927363392,BISP 194,A00,192289,Leutgeb; Stefan,11,0,32,21
1681927363392,BISP 194,B00,245332,Nieh; James Charles,26,0,32,6
1681927364430,CAT 124,A01,202247,Staff,15,0,15,0
1681927365464,CAT 125,A00,202248,Staff,18,0,20,2
1681927365464,CAT 125,B00,202253,Staff,20,0,20,0
1681927365464,CAT 125,C00,202257,Staff,18,0,20,2
1681927366489,CAT 125GS,A01,202273,Bronstein; Phoebe Malan,20,0,20,0
1681927367529,CAT 125R,A00,202284,Staff,18,0,20,2
1681927367529,CAT 125R,C00,202286,Staff,5,0,20,15
1681927367529,CAT 125R,D00,202291,Staff,17,0,20,3
1681927367529,CAT 125R,E00,202295,Staff,13,0,20,7
1681927367529,CAT 125R,F00,202302,Staff,7,0,20,13
1681927368555,CENG 100,A00,204724,Opatkiewicz; Justin Paul,25,0,25,0
1681927369586,CGS 2A,A01,180420,Staff,30,0,36,6
1681927370609,CGS 101,A00,180421,Staff,16,0,20,4
1681927371632,CGS 112,A00,180422,Staff,9,0,16,7
1681927372663,CGS 113,A00,180423,Staff,18,0,20,2
1681927373689,CGS 137,A00,180424,Staff,12,0,12,0
1681927374712,CGS 147,A00,180425,Staff,10,0,10,0
1681927375737,CHEM 6A,A01,179556,Staff,93,0,100,7
1681927375737,CHEM 6A,A02,179558,Staff,0,0,0,0
1681927376762,CHEM 6B,A01,179560,Staff,100,0,100,0
1681927377788,CHEM 6C,A01,179565,Jazzar; Rodolphe,93,0,100,7
1681927378820,CHEM 7L,A01,179586,Schurmeier; Kimberly,10,0,24,14
1681927378820,CHEM 7L,A02,179587,Schurmeier; Kimberly,23,0,24,1
1681927378820,CHEM 7L,A03,179590,Schurmeier; Kimberly,22,0,24,2
1681927378820,CHEM 7L,A04,179591,Schurmeier; Kimberly,22,0,24,2
1681927378820,CHEM 7L,B01,179598,Schurmeier; Kimberly,16,0,24,8
1681927378820,CHEM 7L,B02,179599,Schurmeier; Kimberly,24,0,24,0
1681927378820,CHEM 7L,B03,179606,Schurmeier; Kimberly,23,0,24,1
1681927378820,CHEM 7L,B04,179607,Schurmeier; Kimberly,22,0,24,2
1681927379845,CHEM 11,A01,179609,Stallings; Dontarie M,87,0,100,13
1681927380880,CHEM 40A,A01,179621,Staff,40,0,50,10
1681927380880,CHEM 40A,A02,179622,Staff,46,0,50,4
1681927381903,CHEM 40B,A01,179630,Weizman; Haim,47,0,50,3
1681927381903,CHEM 40B,A02,179631,Weizman; Haim,44,0,50,6
1681927382926,CHEM 41A,A01,179660,Klosterman; Jeremy K,93,0,100,7
1681927383952,CHEM 43A,A01,179683,Klosterman; Jeremy K,0,0,24,24
1681927383952,CHEM 43A,A02,179688,Klosterman; Jeremy K,8,0,24,16
1681927383952,CHEM 43A,A03,179689,Klosterman; Jeremy K,18,0,24,6
1681927383952,CHEM 43A,A04,179691,Klosterman; Jeremy K,18,0,24,6
1681927384974,CHEM 114A,A01,179693,Stallings; Dontarie M,69,0,100,31
1681927386079,CHEM 143B,A01,179698,Weizman; Haim,16,0,24,8
1681927386079,CHEM 143B,A02,179700,Weizman; Haim,24,0,24,0
1681927387114,CHIN 169A,A00,179701,Wang; Xiao,20,0,20,0
1681927388143,COGS 2,A01,179750,Boyle; Mary E. T.,17,0,30,13
1681927389167,COGS 9,A01,179759,Jones; Cameron Robert,41,0,50,9
1681927390200,COGS 14A,A01,179854,Staff,14,0,50,36
1681927391223,COGS 14B,A01,179856,Staff,53,0,60,7
1681927392247,COGS 17,A01,179874,Staff,71,0,75,4
1681927393276,COGS 18,A01,179884,Staff,60,0,80,20
1681927394309,COGS 100,A01,179886,Staff,35,0,60,25
1681927395334,COGS 101B,A01,179892,Staff,0,2,30,30
1681927396369,COGS 101C,A01,179894,Staff,28,0,30,2
1681927397393,COGS 107A,A01,179896,Boyle; Mary E. T.,30,0,40,10
1681927398416,COGS 108,A01,179898,Simpkins; Charles Alexander,0,29,60,60
1681927399444,COGS 109,A01,179900,Staff,33,0,40,7
1681927400467,COGS 118A,A01,179946,Staff,5,0,40,35
1681927401490,COGS 153,A00,179978,Staff,0,4,30,30
1681927402516,COGS 156,A01,179981,Staff,21,0,30,9
1681927404601,COGS 172,A01,179987,Staff,11,0,30,19
1681927406655,COGS 186,A01,179991,Staff,12,0,30,18
1681927407678,COMM 10,A01,180001,Staff,12,0,25,13
1681927407678,COMM 10,A02,180004,Staff,20,0,25,5
1681927408712,COMM 100A,A01,180016,Staff,15,0,25,10
1681927408712,COMM 100A,A02,180020,Staff,24,0,25,1
1681927409735,COMM 101T,A00,180029,Halm; Gavin Patrick,22,0,35,13
1681927410761,COMM 106V,A00,180043,Staff,34,0,35,1
1681927411784,COMM 109P,A00,180044,Staff,30,0,35,5
1681927412808,COMM 113T,A00,180045,Havis; Allan,37,0,45,8
1681927413844,COMM 132,A00,180046,McKenna; Denise,23,0,30,7
1681927414866,COMM 143,A00,180047,Staff,18,0,30,12
1681927415890,COMM 190,A00,180048,Conner; Thomas Hartnell,18,0,23,5
1681927416918,CSE 8A,A50,180053,Cao; Yingjun,21,0,50,29
1681927416918,CSE 8A,B50,180180,Staff,50,0,50,0
1681927417944,CSE 11,A01,180190,Cao; Yingjun,21,0,50,29
1681927418970,CSE 20,A01,180192,Briones; Jor-el Thomas Caparas,22,0,30,8
1681927420008,CSE 21,A01,194538,Briones; Jor-el Thomas Caparas,50,0,60,10
1681927421046,CSE 30,A01,180324,Eldon; John,74,0,100,26
1681927422073,CSE 101,A01,201353,Staff,0,27,40,40
1681927423105,CSE 134B,A01,180326,Powell; Thomas Allan,73,0,100,27
1681927424128,CSE 140,A01,180328,Staff,28,0,75,47
1681927425158,CSE 140L,A01,180344,Eldon; John,52,0,100,48
1681927426184,CSE 150A,A01,180411,Staff,0,17,50,50
1681927427247,CSE 151A,A01,180414,Staff,0,11,50,50
1681927428274,CSE 175,A01,222521,Kumar; Rakesh,50,0,50,0
1681927429301,CSE 190,A00,201419,Staff,42,0,49,7
1681927430327,CSS 1,A01,194536,Staff,34,0,50,16
1681927431351,DSC 30,A01,202385,Staff,48,0,50,2
1681927432387,DSC 40A,A01,202387,Albuyeh; Rod,50,0,50,0
1681927433412,DSC 190,A01,202389,Silberman; Jack,21,0,21,0
1681927434434,DSGN 100,A01,179993,Staff,13,0,30,17
1681927435457,ECE 65,A50,180708,Staff,10,0,20,10
1681927435457,ECE 65,A51,180739,Staff,19,0,20,1
1681927436487,ECON 1,A01,180427,Famulari; Melissa,67,0,70,3
1681927437513,ECON 2,A01,180450,Levkoff; Steven B.,64,0,70,6
1681927438536,ECON 4,A01,203351,Anderson; John Charles,6,0,10,4
1681927439559,ECON 100A,A01,180472,Famulari; Melissa,59,0,70,11
1681927440581,ECON 120A,A01,180549,Staff,62,0,70,8
1681927441611,ECON 120B,A01,180655,Ma; Xinwei,41,0,70,29
1681927442636,ECON 129,A00,203333,Eckert; Fabian Paul,11,0,35,24
1681927443666,ECON 131,A00,180656,Staff,3,0,35,32
1681927444693,ECON 172B,A01,180672,Levkoff; Steven B.,31,0,35,4
1681927445716,ECON 178,A01,203342,Zhu; Ying,5,0,35,30
1681927446740,EDS 108GS,A00,202383,Wishard Guerra; Alison G.,20,0,20,0
1681927447766,EDS 111GS,A00,202347,Wishard Guerra; Alison G.,20,0,20,0
1681927448789,EDS 112,A01,202323,Staff,53,0,60,7
1681927449812,EDS 113,A00,202340,Staff,32,0,35,3
1681927450836,EDS 118,A00,201231,Staff,19,0,30,11
1681927451860,EDS 119,A00,204994,Staff,8,0,10,2
1681927452885,EDS 124BR,A00,202324,Eguchi; Emi,0,0,25,25
1681927453908,EDS 126,A01,203208,Jones; Makeba,26,0,30,4
1681927454933,EDS 135,A01,202333,Staff,17,0,20,3
1681927455958,EDS 180,A00,202311,Staff,47,0,50,3
1681927456985,ERC 190GS,A01,253747,Staff,28,0,28,0
1681927458010,ETHN 104,A00,180742,Staff,22,0,35,13
1681927459035,ETHN 118,A00,180745,Staff,27,0,35,8
1681927460059,ETHN 127,A00,180747,Staff,8,0,16,8
1681927461082,ETHN 137,A00,180880,Staff,11,0,12,1
1681927462108,ETHN 147,A00,180890,Staff,8,0,10,2
1681927463133,ETHN 154,A00,180891,Staff,6,0,8,2
1681927464180,ETHN 168,A00,180892,Staff,9,0,10,1
1681927465210,GLBH 20,A00,201051,Hannah; Seth Donal,0,5,0,1
1681927466233,GLBH 111,A01,209338,Burgos; Jose L.,0,0,0,0
1681927467256,GLBH 150,A00,258300,Staff,0,3,0,0
1681927468281,GLBH 181,A00,201207,Staff,10,0,40,30
1681927469306,HIEU 109,A00,180898,Staff,19,0,20,1
1681927470333,HIEU 111,A00,180899,Staff,0,2,20,20
1681927471358,HIEU 124,A00,180900,Staff,17,0,20,3
1681927472392,HILA 122,A00,180901,Staff,17,0,20,3
1681927473417,HILA 132,A00,180902,Vitz; Matthew,0,1,20,20
1681927474443,HILD 10,A01,180896,Staff,14,0,20,6
1681927475464,HILD 30GS,A00,180897,Edington; Claire Ellen,0,0,0,0
1681927476486,HISC 105,A00,180903,Staff,20,0,20,0
1681927477522,HISC 117,A00,180904,Staff,10,0,20,10
1681927478547,HIUS 108B,A00,181005,Staff,18,0,20,2
1681927479571,HIUS 113,A00,181093,Staff,0,0,20,20
1681927480595,HUM 3,A01,181190,Patterson; Patrick H.,36,0,50,14
1681927480595,HUM 3,B01,181195,Staff,46,0,50,4
1681927481619,HUM 3GS,A00,181196,Herbst; Matthew,0,0,0,0
1681927482650,HUM 4,A01,181227,West; Geoffrey Scott,33,0,50,17
1681927482650,HUM 4,B01,181282,Staff,41,0,50,9
1681927483675,HUM 4GS,A00,181377,Lyon; Antony J.,0,0,0,0
1681927484702,HUM 5,A01,181536,Zavodny; Tatiana Sophia,25,0,50,25
1681927484702,HUM 5,B01,181908,Staff,35,0,50,15
1681927485726,INTL 190,A00,181909,Segui; Alan S,0,0,0,8
1681927485726,INTL 190,B00,181961,Segui; Alan S,0,0,0,7
1681927486753,JAPN 20AR,A01,182113,Ross; Kayoko F,15,0,20,5
1681927487781,LATI 50,A01,202391,Martin-Cabrera; Luis,18,0,30,12
1681927487781,LATI 50,A02,202392,Martin-Cabrera; Luis,26,0,30,4
1681927488804,LATI 180,A00,202393,Kokinis; Troy Andreas,24,0,25,1
1681927489900,LIFR 1A,A00,182119,Staff,13,0,14,1
1681927490926,LIFR 1AX,A00,182324,Staff,13,0,14,1
1681927491949,LIFR 1B,A00,182259,Staff,12,0,14,2
1681927492976,LIFR 1BX,A00,182273,Staff,12,0,14,2
1681927494003,LIGN 8,A00,182330,Staff,130,0,150,20
1681927495025,LIGN 9GS,A00,182362,Staff,15,0,20,5
1681927496060,LIGN 119,A00,204992,Takahashi; Maho,11,0,15,4
1681927497088,LIGN 130,A01,182384,Staff,47,0,50,3
1681927498114,LIGN 149GS,A00,182390,Staff,15,0,20,5
1681927499145,LIGN 170,A00,182404,Staff,23,0,30,7
1681927500170,LISP 1D,A00,182281,Staff,7,0,14,7
1681927500170,LISP 1D,B00,182287,Staff,13,0,14,1
1681927500170,LISP 1D,C00,182295,Staff,10,0,14,4
1681927500170,LISP 1D,D00,182301,Staff,14,0,14,0
1681927501202,LISP 1DX,A00,182309,Staff,19,0,28,9
1681927501202,LISP 1DX,B00,182316,Staff,25,0,28,3
1681927502227,LTAF 120GS,A00,182412,Zhiri; Oumelbanine,20,0,20,0
1681927503254,LTCS 172GS,A00,182437,Bronstein; Phoebe Malan,20,0,20,0
1681927504278,LTEA 138,A00,182457,Staff,19,0,40,21
1681927505300,LTEN 114,A01,182490,Staff,23,0,25,2
1681927506330,LTEN 130GS,A00,182491,Lyon; Antony J.,20,0,20,0
1681927507355,LTEN 169,A00,182493,Cuong; Marisol,18,0,25,7
1681927508377,LTEN 178,A00,182501,Staff,14,0,15,1
1681927509401,LTEN 181,A00,182515,Staff,19,0,25,6
1681927510436,LTEN 185GS,A00,197655,Forbes; Camille,20,0,20,0
1681927511461,LTSP 100B,A00,202208,Bessett; Ryan Matthew,24,0,25,1
1681927512483,LTWL 100,A00,182516,Myerston Santana; Jacobo,20,0,30,10
1681927513525,LTWR 100GS,A00,182518,Forbes; Camille,20,0,20,0
1681927514550,LTWR 102,A00,182522,Staff,15,0,15,0
1681927514550,LTWR 102,B00,182525,Staff,14,0,15,1
1681927515584,LTWR 115,A00,182526,Staff,10,0,15,5
1681927516610,MAE 8,A01,182528,Pham; Hieu Tan,67,0,70,3
1681927517640,MAE 11,A00,182529,Bahadori; Mohammad Yousef,92,0,100,8
1681927518663,MAE 20,A00,182530,Evdokimenko; Ekaterina,68,0,70,2
1681927519686,MAE 30A,A00,182532,Staff,44,0,45,1
1681927520715,MAE 101A,A00,182533,Bahadori; Mohammad Yousef,94,0,100,6
1681927521741,MAE 101C,A00,182538,Staff,62,0,70,8
1681927522766,MAE 104,A00,182539,Staff,44,0,50,6
1681927523790,MAE 131A,A00,182540,Ghazinejad; Maziar,40,0,45,5
1681927524818,MAE 143A,A00,182548,Bewley; Thomas R,43,0,50,7
1681927525842,MAE 150,A00,182549,Staff,28,0,40,12
1681927526866,MAE 160,A00,182550,Evdokimenko; Ekaterina,41,0,60,19
1681927527910,MATH 3C,A01,182725,Staff,24,0,30,6
1681927528937,MATH 10A,A01,182729,Staff,25,0,30,5
1681927528937,MATH 10A,B01,182732,Staff,25,0,30,5
1681927529960,MATH 10B,A01,182737,Staff,17,0,30,13
1681927529960,MATH 10B,A02,182738,Staff,26,0,30,4
1681927529960,MATH 10B,B01,182744,Staff,25,0,30,5
1681927529960,MATH 10B,B02,182745,Staff,27,0,30,3
1681927531003,MATH 18,A01,182750,Anzaldo; Leesa B,28,0,30,2
1681927531003,MATH 18,A02,182751,Anzaldo; Leesa B,28,0,30,2
1681927531003,MATH 18,A03,182753,Anzaldo; Leesa B,27,0,30,3
1681927531003,MATH 18,A04,182757,Anzaldo; Leesa B,29,0,30,1
1681927531003,MATH 18,B01,182761,Anzaldo; Leesa B,27,0,30,3
1681927531003,MATH 18,B02,182764,Anzaldo; Leesa B,26,0,30,4
1681927531003,MATH 18,B03,182765,Anzaldo; Leesa B,29,0,30,1
1681927531003,MATH 18,B04,182766,Anzaldo; Leesa B,30,0,30,0
1681927532029,MATH 20A,A01,182771,Suk; Andrew Hoon,28,0,30,2
1681927533056,MATH 20B,A01,182775,Bach; Quang Tran,30,0,30,0
1681927533056,MATH 20B,A02,182777,Bach; Quang Tran,29,0,30,1
1681927533056,MATH 20B,B01,182780,Bach; Quang Tran,26,0,30,4
1681927533056,MATH 20B,B02,182782,Bach; Quang Tran,30,0,30,0
1681927534084,MATH 20C,A01,182787,Staff,24,0,30,6
1681927534084,MATH 20C,A02,182790,Staff,29,0,30,1
1681927534084,MATH 20C,B01,182792,Staff,23,0,30,7
1681927534084,MATH 20C,B02,182796,Staff,26,0,30,4
1681927535107,MATH 20D,A01,182799,Staff,27,0,30,3
1681927535107,MATH 20D,A02,182802,Staff,29,0,30,1
1681927535107,MATH 20D,A03,182803,Staff,30,0,30,0
1681927536133,MATH 20E,A01,182809,Verstraete; Jacques Allan,21,0,30,9
1681927536133,MATH 20E,A02,182811,Verstraete; Jacques Allan,28,0,30,2
1681927536133,MATH 20E,B01,182814,Verstraete; Jacques Allan,22,0,30,8
1681927536133,MATH 20E,B02,182815,Verstraete; Jacques Allan,30,0,30,0
1681927537161,MATH 103A,A01,182820,Staff,3,0,30,27
1681927537161,MATH 103A,A02,182821,Staff,27,0,30,3
1681927537161,MATH 103A,A03,182822,Staff,22,0,30,8
1681927537161,MATH 103A,B01,182825,Staff,22,0,30,8
1681927537161,MATH 103A,B02,182826,Staff,30,0,30,0
1681927537161,MATH 103A,B03,182830,Staff,30,0,30,0
1681927538190,MATH 109,A01,182836,Chow; Bennett,23,0,30,7
1681927538190,MATH 109,A02,182838,Chow; Bennett,29,0,30,1
1681927538190,MATH 109,A03,182894,Chow; Bennett,29,0,30,1
1681927538190,MATH 109,B01,182908,Chow; Bennett,27,0,30,3
1681927538190,MATH 109,B02,182909,Chow; Bennett,30,0,30,0
1681927538190,MATH 109,B03,182910,Chow; Bennett,26,0,30,4
1681927539226,MATH 142A,A01,182925,Staff,5,0,30,25
1681927539226,MATH 142A,A02,182935,Staff,23,0,30,7
1681927539226,MATH 142A,A03,182967,Staff,26,0,30,4
1681927539226,MATH 142A,B01,183125,Staff,23,0,30,7
1681927539226,MATH 142A,B02,183157,Staff,27,0,30,3
1681927539226,MATH 142A,B03,183158,Staff,29,0,30,1
1681927540251,MATH 183,A01,183160,Arias-Castro; Ery,23,0,30,7
1681927540251,MATH 183,A02,183161,Arias-Castro; Ery,29,0,30,1
1681927540251,MATH 183,B01,183163,Arias-Castro; Ery,28,0,30,2
1681927540251,MATH 183,B02,183164,Arias-Castro; Ery,28,0,30,2
1681927541276,MATH 193A,A01,183167,Staff,0,0,35,35
1681927541276,MATH 193A,A02,183168,Staff,27,0,35,8
1681927541276,MATH 193A,A03,183169,Staff,34,0,35,1
1681927541276,MATH 193A,A04,183170,Staff,27,0,35,8
1681927542301,MGT 4,A01,202395,Anderson; John Charles,76,0,80,4
1681927543339,MGT 5,A00,202396,Houskeeper; Robert,79,0,90,11
1681927544363,MGT 103,A00,202397,Eberhard; Craig A,49,0,90,41
1681927545400,MGT 131A,A00,202398,Houskeeper; Robert,82,0,90,8
1681927546438,MGT 135,A00,202399,Anderson; John Charles,81,0,90,9
1681927547467,MGT 162R,A00,202403,Gneezy; Uri,129,0,200,71
1681927548490,MGT 172,A00,202404,Hedges; Kathleen,34,0,90,56
1681927549517,MGT 181,A00,202405,Dunn; Louis Jean,79,0,90,11
1681927550547,MMW 14,A01,183200,Staff,5,0,28,23
1681927550547,MMW 14,A02,183201,Staff,25,0,28,3
1681927550547,MMW 14,A03,183202,Staff,24,0,28,4
1681927550547,MMW 14,A04,183203,Staff,25,0,28,3
1681927550547,MMW 14,A05,183204,Staff,26,0,28,2
1681927550547,MMW 14,A06,183205,Staff,27,0,28,1
1681927550547,MMW 14,B01,183207,Staff,26,0,28,2
1681927550547,MMW 14,B02,183208,Staff,28,0,28,0
1681927550547,MMW 14,B03,183209,Staff,28,0,28,0
1681927550547,MMW 14,B04,183210,Staff,28,0,28,0
1681927550547,MMW 14,B05,183211,Staff,28,0,28,0
1681927550547,MMW 14,B06,183212,Staff,27,0,28,1
1681927551572,MMW 14GS,A00,183213,Zhiri; Oumelbanine,28,0,28,0
1681927552594,MMW 15GS,B00,183215,Rahimi; Babak,28,0,28,0
1681927553616,MMW 121,A01,183217,Patterson; Patrick H.,9,0,28,19
1681927553616,MMW 121,A02,183218,Patterson; Patrick H.,24,0,28,4
1681927554645,MUS 1A,A01,182554,Staff,3,0,35,32
1681927555670,MUS 5,A01,182558,Staff,17,0,35,18
1681927556692,MUS 6,A01,182562,Staff,22,0,35,13
1681927557719,MUS 8GS,A00,182563,Borgo; David Garcia,25,0,25,0
1681927558751,MUS 13,A01,182567,Staff,23,0,25,2
1681927559775,MUS 15,A01,182570,Staff,31,0,35,4
1681927559775,MUS 15,B01,182575,Staff,7,0,35,28
1681927560797,MUS 80,A00,182578,Staff,22,0,25,3
1681927560797,MUS 80,B00,182581,Staff,20,0,25,5
1681927561819,MUS 113,A00,182582,Staff,25,0,25,0
1681927562842,MUS 114,A00,182583,Staff,2,0,25,23
1681927563870,MUS 150GS,A01,182588,Borgo; David Garcia,25,0,25,0
1681927564896,PHIL 1,A00,182590,Staff,34,0,40,6
1681927565924,PHIL 10,A01,182596,Grush; Rick Scott,30,0,35,5
1681927565924,PHIL 10,A02,182597,Grush; Rick Scott,33,0,35,2
1681927566947,PHIL 15,A01,182601,Staff,31,0,35,4
1681927566947,PHIL 15,A02,182602,Staff,33,0,35,2
1681927567975,PHIL 27,A01,182604,Staff,29,0,35,6
1681927567975,PHIL 27,A02,182607,Staff,35,0,35,0
1681927568998,PHIL 32,A01,182609,Staff,35,0,35,0
1681927568998,PHIL 32,A02,182612,Staff,35,0,35,0
1681927570025,PHIL 130,A00,182614,Staff,60,0,70,10
1681927571051,PHIL 136,A00,182616,Cohen; Jonathan David,66,0,70,4
1681927572079,PHIL 155,A00,182617,Vargas; Manuel Rogelio,58,0,70,12
1681927573109,PHIL 163,A01,182620,Staff,15,0,20,5
1681927573109,PHIL 163,A02,182624,Staff,10,0,20,10
1681927574150,PHIL 164,A00,182627,Staff,29,0,40,11
1681927575176,PHIL 173,A00,182628,Staff,35,0,40,5
1681927576208,PHYS 1A,A00,183221,Staff,53,0,60,7
1681927577239,PHYS 1AL,001,183222,Staff,25,0,30,5
1681927577239,PHYS 1AL,002,183223,Staff,25,0,30,5
1681927578264,PHYS 1B,A00,183231,Staff,41,0,60,19
1681927579287,PHYS 1BL,001,183232,Staff,18,0,30,12
1681927579287,PHYS 1BL,002,183233,Staff,27,0,30,3
1681927580314,PHYS 1C,A00,183240,Staff,23,0,60,37
1681927581337,PHYS 1CL,001,183241,Staff,9,0,30,21
1681927581337,PHYS 1CL,002,183242,Staff,22,0,30,8
1681927582362,PHYS 2AR,A01,183250,Staff,41,0,50,9
1681927583387,PHYS 2B,A01,183252,Staff,103,0,115,12
1681927584414,PHYS 2BL,A01,183254,Staff,21,0,24,3
1681927584414,PHYS 2BL,A02,183255,Staff,21,0,24,3
1681927585439,PHYS 2C,A01,183522,Staff,101,0,115,14
1681927586463,PHYS 4A,A01,183524,Staff,49,0,50,1
1681927587498,POLI 5,A00,183525,Staff,44,0,50,6
1681927588521,POLI 12,A00,183540,Staff,45,0,50,5
1681927589546,POLI 13R,A00,183541,Forman; Fonna,41,0,50,9
1681927590573,POLI 30,A00,183542,Mignozzetti; Umberto,48,0,50,2
1681927591595,POLI 100A,A00,183543,Staff,44,0,50,6
1681927592618,POLI 100E,A00,223598,Staff,32,0,35,3
1681927593721,POLI 103A,A00,183564,Kousser; Thad,35,0,50,15
1681927594754,POLI 104B,A00,201329,Staff,28,0,35,7
1681927595781,POLI 113BR,A00,183576,Hoston; Germaine,23,0,50,27
1681927596810,POLI 114BR,A00,183588,Staff,27,0,30,3
1681927597834,POLI 117R,A00,183595,Forman; Fonna,4,0,20,16
1681927598862,POLI 120H,A00,183596,Fisk; David Lee,14,0,20,6
1681927599887,POLI 130AA,A00,183597,Staff,13,0,20,7
1681927600918,POLI 134AA,A00,183598,Staff,19,0,20,1
1681927601945,POLI 135,A00,183599,Fisk; David Lee,19,0,25,6
1681927602967,POLI 142P,A00,183623,Staff,37,0,40,3
1681927603991,POLI 144D,A00,183624,Staff,22,0,25,3
1681927605019,POLI 151,A00,183625,Staff,15,0,20,5
1681927606063,POLI 162,A00,183626,Mignozzetti; Umberto,17,0,20,3
1681927607088,PSYC 1,A00,253748,Staff,86,0,90,4
1681927608117,PSYC 2,A00,183627,Moranton; Nirelia Melbina-,24,0,35,11
1681927609147,PSYC 3,A00,183628,Staff,43,0,45,2
1681927611202,PSYC 60,A01,183631,Lowe; Angela Beth,35,0,40,5
1681927612226,PSYC 70,A01,253757,Staff,37,0,45,8
1681927613249,PSYC 101,A00,183632,Heyman; Gail D.,43,0,60,17
1681927614281,PSYC 105,A00,183848,Lowe; Angela Beth,46,0,60,14
1681927615306,PSYC 106,A00,183849,Dobkins; Karen R.,39,0,60,21
1681927616338,PSYC 108,A00,253750,Staff,14,0,60,46
1681927617362,PSYC 114,A01,184275,Winkielman; Piotr,0,8,30,30
1681927618388,PSYC 122,A00,183856,Moranton; Nirelia Melbina-,0,16,30,30
1681927619411,PSYC 124,A00,183865,Chapman; Eddie Nathaniel,45,0,80,35
1681927620437,PSYC 137,A00,183880,Staff,18,0,25,7
1681927622498,PSYC 154,A00,183910,Lacefield; Katharine I,0,24,90,90
1681927624550,PSYC 162,A00,183946,Wixted; John T,44,0,90,46
1681927625574,PSYC 172,A00,183947,Gorman; Michael R.,6,0,30,24
1681927626596,PSYC 178,A00,183963,Glaser; Dale,16,0,40,24
1681927627630,PSYC 181GS,A00,183964,Anagnostaras; Stephan,10,0,10,0
1681927628652,PSYC 186GS,A01,257660,Staff,10,0,10,0
1681927629679,PSYC 193,B00,253749,Staff,22,0,25,3
1681927631740,PSYC 193L,A01,184122,Staff,33,0,35,2
1681927631740,PSYC 193L,C01,184167,Winkielman; Piotr,14,0,30,16
1681927632772,RELI 188GS,A00,182629,Rahimi; Babak,20,0,20,0
1681927633795,SE 101A,A00,182646,Staff,26,0,30,4
1681927634817,SE 101C,A00,182650,Staff,13,0,20,7
1681927635842,SE 110A,A00,182651,Staff,28,0,28,0
1681927636868,SE 130A,A00,182652,Staff,38,0,40,2
1681927637898,SIO 46GS,A00,182636,Cook; Geoffrey W,25,0,28,3
1681927638928,SIO 109R,A00,194459,Staff,1,0,20,19
1681927639961,SIO 121GS,A00,182639,Cook; Geoffrey W,25,0,28,3
1681927640991,SIO 132,A01,182642,Staff,30,0,40,10
1681927642014,SIO 139,A00,182644,Kacev; David,36,0,40,4
1681927643042,SOCI 2,A01,258404,Staff,33,0,36,3
1681927643042,SOCI 2,A02,258405,Staff,35,0,36,1
1681927644070,SOCI 60,A01,258408,Staff,29,0,30,1
1681927644070,SOCI 60,A02,258413,Staff,30,0,30,0
1681927645100,SOCI 100,A01,258415,Staff,29,0,30,1
1681927645100,SOCI 100,A02,258416,Staff,28,0,30,2
1681927651250,SOCI 127,A00,258421,Staff,19,0,30,11
1681927652274,SOCI 132,A00,258422,Staff,44,0,50,6
1681927653300,SOCI 133,A00,258423,Staff,26,0,30,4
1681927654327,SOCI 138GS,A00,258424,Staff,15,0,15,0
1681927655372,SOCI 145,A00,258425,Staff,25,0,30,5
1681927656397,SOCI 148,A00,258426,Staff,24,0,30,6
1681927657424,SOCI 153,A00,199217,Staff,29,0,30,1
1681927658461,SOCI 160,A00,258427,Staff,27,0,30,3
1681927659486,SOCI 160E,A00,258435,Staff,56,0,60,4
1681927660512,SOCI 189GS,A00,258436,Staff,15,0,15,0
1681927661536,SOCI 190GS,A00,258437,Staff,15,0,15,0
1681927662560,SYN 2,001,182658,Staff,8,0,16,8
1681927662560,SYN 2,002,201439,Staff,14,0,16,2
1681927662560,SYN 2,003,201443,Staff,16,0,16,0
1681927663584,SYN 100,A01,182657,Staff,13,0,20,7
1681927664613,TDAC 1,A00,184381,Salovey; Todd,16,0,20,4
1681927664613,TDAC 1,B00,184385,Harting; Carla Kelso,19,0,20,1
1681927664613,TDAC 1,C00,184394,Staff,18,0,20,2
1681927665639,TDAC 101,A00,184483,Harting; Carla Kelso,19,0,20,1
1681927666668,TDDE 111,A00,184496,Staff,14,0,15,1
1681927667694,TDDE 131,A00,184504,Staff,20,0,20,0
1681927667694,TDDE 131,B00,184505,Staff,17,0,18,1
1681927667694,TDDE 131,C00,184534,Staff,49,0,50,1
1681927667694,TDDE 131,D00,184564,Staff,15,0,15,0
1681927667694,TDDE 131,E00,204725,Staff,18,0,20,2
1681927668727,TDGE 1,A01,184414,Salovey; Todd,36,0,50,14
1681927669753,TDGE 5,A01,184419,Staff,23,0,24,1
1681927670789,TDGE 10,A00,184428,Fulton; Julia,28,0,50,22
1681927671812,TDGE 124,A00,184565,Fulton; Julia,0,0,50,50
1681927672838,TDGE 125,B00,184567,Meyer; Ursula,9,0,25,16
1681927673865,TDHT 101,A00,184568,Staff,21,0,25,4
1681927673865,TDHT 101,B00,184569,Staff,20,0,20,0
1681927674897,TDHT 114,A00,184570,Staff,49,0,50,1
1681927675921,TDMV 1,A00,184437,Arcidiacono; Kristin,21,0,30,9
1681927675921,TDMV 1,B00,184448,Caligagan; Maria T.,23,0,30,7
1681927676944,TDMV 2,A00,184449,Weinberg; Sadie,27,0,30,3
1681927676944,TDMV 2,B00,184453,Arcidiacono; Kristin,29,0,30,1
1681927677973,TDMV 110,A00,184571,Weinberg; Sadie,30,0,30,0
1681927678996,TDMV 142,A00,184572,Caligagan; Tony,26,0,30,4
1681927678996,TDMV 142,B00,184573,Caligagan; Maria T.,26,0,30,4
1681927680022,TDTR 20,A00,184482,Jun; Grace Shin Hae,25,0,25,0
1681927681045,USP 2,A01,184290,Hinds; Juli Beth,24,0,25,1
1681927682083,USP 3,A01,184295,Staff,21,0,25,4
1681927683108,USP 4,A00,184304,McTague; Sarah,13,0,25,12
1681927684138,USP 100,A00,184315,Staff,16,0,25,9
1681927685164,USP 105,A00,184326,Staff,21,0,25,4
1681927686191,USP 151,A00,184327,Staff,18,0,25,7
1681927687229,USP 170,A00,184380,Hinds; Juli Beth,13,0,25,12
1681927688262,VIS 21B,A01,182660,Staff,28,0,31,3
1681927688262,VIS 21B,A02,182662,Staff,30,0,31,1
1681927689289,VIS 103D,A00,182663,Staff,74,0,75,1
1681927690312,VIS 105D,A00,182667,Li; Huai,14,0,22,8
1681927691341,VIS 122GS,A00,182668,Herbst; Matthew,20,0,20,0
1681927692384,VIS 128C,A00,182673,Staff,69,0,75,6
1681927693407,VIS 130,A00,182675,Staff,19,0,22,3
1681927694431,VIS 160A,A00,182678,Stalbaum; Brett,4,0,10,6
1681927696483,WCWP 10B,A00,201679,Staff,15,0,15,0
1681927696483,WCWP 10B,B00,201695,Staff,15,0,15,0
1681927697577,WCWP 100,A00,201716,Staff,12,0,15,3
1681927697577,WCWP 100,B00,201717,Staff,1,0,15,14
1681927699671,ANSC 105GS,A00,258289,Staff,0,0,0,0
1681927700696,ANSC 125GS,A00,258295,Staff,0,0,0,0
1681927701719,ANSC 150,A00,258267,Staff,28,0,40,12
1681927702743,ANSC 190GS,A00,258280,Staff,0,0,0,0
1681927703767,ANTH 1,A00,258264,Staff,38,0,40,2
1681927704793,ANTH 2,A01,258259,Staff,72,0,76,4
1681927705829,ANTH 23,A01,258228,Staff,36,0,40,4
1681927706858,ANTH 101,A01,258236,Staff,38,0,40,2
1681927707889,ANTH 102,A00,258272,Staff,59,0,60,1
1681927708924,ANTH 105,A00,258244,Staff,29,0,35,6
1681927709970,BENG 130,A00,253975,Staff,38,0,40,2
1681927710997,BIBC 102,A01,191866,Flagg; Matthew Paul,18,0,32,14
1681927710997,BIBC 102,A02,191867,Flagg; Matthew Paul,21,0,32,11
1681927710997,BIBC 102,A03,191868,Flagg; Matthew Paul,29,0,32,3
1681927710997,BIBC 102,A04,191936,Flagg; Matthew Paul,23,0,32,9
1681927710997,BIBC 102,A05,191937,Flagg; Matthew Paul,0,0,32,32
1681927712019,BICD 100,A01,191939,Cooper; Andrew Michael,27,0,32,5
1681927712019,BICD 100,A02,191940,Cooper; Andrew Michael,32,0,32,0
1681927712019,BICD 100,A03,191941,Cooper; Andrew Michael,32,0,32,0
1681927712019,BICD 100,A04,191942,Cooper; Andrew Michael,32,0,32,0
1681927712019,BICD 100,A05,191943,Cooper; Andrew Michael,32,0,32,0
1681927713042,BIEB 126,A01,191945,Cleland; Elsa Eleanor,0,2,32,32
1681927713042,BIEB 126,A02,191946,Cleland; Elsa Eleanor,27,0,32,5
1681927713042,BIEB 126,A03,191947,Cleland; Elsa Eleanor,29,0,32,3
1681927713042,BIEB 126,A04,191948,Cleland; Elsa Eleanor,17,0,32,15
1681927713042,BIEB 126,A05,191996,Cleland; Elsa Eleanor,28,0,32,4
1681927714070,BIEB 136GS,A00,191997,Shurin; Jonathan & Holway; David A.,0,0,0,7
1681927715094,BIEB 137GS,A01,191999,Shurin; Jonathan & Holway; David A.,0,0,0,6
1681927716126,BILD 1,A01,205385,Staff,30,0,32,2
1681927716126,BILD 1,A02,205386,Staff,30,0,32,2
1681927716126,BILD 1,A03,205387,Staff,31,0,32,1
1681927716126,BILD 1,A04,205388,Staff,26,0,32,6
1681927717149,BILD 2,A01,191774,Staff,27,0,32,5
1681927717149,BILD 2,A02,191775,Staff,30,0,32,2
1681927717149,BILD 2,A03,191777,Staff,30,0,32,2
1681927717149,BILD 2,A04,191856,Staff,30,0,32,2
1681927717149,BILD 2,A05,191857,Staff,31,0,32,1
1681927717149,BILD 2,A06,191858,Staff,32,0,32,0
1681927717149,BILD 2,A07,191859,Staff,31,0,32,1
1681927718173,BILD 3,A01,205391,Staff,28,0,32,4
1681927718173,BILD 3,A02,205393,Staff,32,0,32,0
1681927718173,BILD 3,A03,205394,Staff,27,0,32,5
1681927718173,BILD 3,A04,205395,Staff,32,0,32,0
1681927719199,BILD 20,A01,191861,Staff,32,0,32,0
1681927719199,BILD 20,A02,191862,Staff,32,0,32,0
1681927720223,BILD 30,A01,191864,Staff,31,0,32,1
1681927721248,BIMM 100,A01,192019,Staff,0,0,32,32
1681927721248,BIMM 100,A02,192020,Staff,18,0,32,14
1681927721248,BIMM 100,A03,192035,Staff,18,0,32,14
1681927722274,BIMM 110,A01,192037,Tat; John,0,0,32,32
1681927722274,BIMM 110,A02,192038,Tat; John,5,0,32,27
1681927723299,BIMM 120,A01,192040,Pickett; Brooke Elizabeth,0,0,32,32
1681927723299,BIMM 120,A02,192041,Pickett; Brooke Elizabeth,9,0,32,23
1681927723299,BIMM 120,A03,192042,Pickett; Brooke Elizabeth,14,0,32,18
1681927724326,BIPN 100,A01,192044,Armour; Jon Christopher,23,0,32,9
1681927724326,BIPN 100,A02,192059,Armour; Jon Christopher,30,0,32,2
1681927724326,BIPN 100,A03,192064,Armour; Jon Christopher,30,0,32,2
1681927724326,BIPN 100,A04,192073,Armour; Jon Christopher,26,0,32,6
1681927725359,BIPN 148,A01,205411,Leutgeb; Jill K.,15,0,32,17
1681927725359,BIPN 148,A02,205412,Leutgeb; Jill K.,31,0,32,1
1681927725359,BIPN 148,A03,205413,Leutgeb; Jill K.,30,0,32,2
1681927725359,BIPN 148,A04,205414,Leutgeb; Jill K.,30,0,32,2
1681927726388,BIPN 160,A01,192115,Marino; Marc J,15,0,32,17
1681927726388,BIPN 160,A02,192148,Marino; Marc J,27,0,32,5
1681927726388,BIPN 160,A03,192158,Marino; Marc J,31,0,32,1
1681927726388,BIPN 160,A04,192190,Marino; Marc J,32,0,32,0
1681927726388,BIPN 160,A05,192287,Marino; Marc J,32,0,32,0
1681927726388,BIPN 160,A06,192288,Marino; Marc J,32,0,32,0
1681927727421,BIPN 194,A00,206038,Leutgeb; Stefan,28,0,32,4
1681927728447,BISP 194,A00,192289,Leutgeb; Stefan,11,0,32,21
1681927728447,BISP 194,B00,245332,Nieh; James Charles,26,0,32,6
1681927729469,CAT 124,A01,202247,Staff,15,0,15,0
1681927730501,CAT 125,A00,202248,Staff,18,0,20,2
1681927730501,CAT 125,B00,202253,Staff,20,0,20,0
1681927730501,CAT 125,C00,202257,Staff,18,0,20,2
1681927731528,CAT 125GS,A01,202273,Bronstein; Phoebe Malan,20,0,20,0
1681927732558,CAT 125R,A00,202284,Staff,18,0,20,2
1681927732558,CAT 125R,C00,202286,Staff,5,0,20,15
1681927732558,CAT 125R,D00,202291,Staff,17,0,20,3
1681927732558,CAT 125R,E00,202295,Staff,13,0,20,7
1681927732558,CAT 125R,F00,202302,Staff,7,0,20,13
1681927733591,CENG 100,A00,204724,Opatkiewicz; Justin Paul,25,0,25,0
1681927734613,CGS 2A,A01,180420,Staff,30,0,36,6
1681927735636,CGS 101,A00,180421,Staff,16,0,20,4
1681927736662,CGS 112,A00,180422,Staff,9,0,16,7
1681927737689,CGS 113,A00,180423,Staff,18,0,20,2
1681927738725,CGS 137,A00,180424,Staff,12,0,12,0
1681927739754,CGS 147,A00,180425,Staff,10,0,10,0
1681927740781,CHEM 6A,A01,179556,Staff,93,0,100,7
1681927740781,CHEM 6A,A02,179558,Staff,0,0,0,0
1681927741803,CHEM 6B,A01,179560,Staff,100,0,100,0
1681927742827,CHEM 6C,A01,179565,Jazzar; Rodolphe,93,0,100,7
1681927743856,CHEM 7L,A01,179586,Schurmeier; Kimberly,10,0,24,14
1681927743856,CHEM 7L,A02,179587,Schurmeier; Kimberly,23,0,24,1
1681927743856,CHEM 7L,A03,179590,Schurmeier; Kimberly,22,0,24,2
1681927743856,CHEM 7L,A04,179591,Schurmeier; Kimberly,22,0,24,2
1681927743856,CHEM 7L,B01,179598,Schurmeier; Kimberly,16,0,24,8
1681927743856,CHEM 7L,B02,179599,Schurmeier; Kimberly,24,0,24,0
1681927743856,CHEM 7L,B03,179606,Schurmeier; Kimberly,23,0,24,1
1681927743856,CHEM 7L,B04,179607,Schurmeier; Kimberly,22,0,24,2
1681927744882,CHEM 11,A01,179609,Stallings; Dontarie M,87,0,100,13
1681927745905,CHEM 40A,A01,179621,Staff,40,0,50,10
1681927745905,CHEM 40A,A02,179622,Staff,46,0,50,4
1681927746932,CHEM 40B,A01,179630,Weizman; Haim,47,0,50,3
1681927746932,CHEM 40B,A02,179631,Weizman; Haim,44,0,50,6
1681927747956,CHEM 41A,A01,179660,Klosterman; Jeremy K,93,0,100,7
1681927748984,CHEM 43A,A01,179683,Klosterman; Jeremy K,0,0,24,24
1681927748984,CHEM 43A,A02,179688,Klosterman; Jeremy K,8,0,24,16
1681927748984,CHEM 43A,A03,179689,Klosterman; Jeremy K,18,0,24,6
1681927748984,CHEM 43A,A04,179691,Klosterman; Jeremy K,18,0,24,6
1681927750010,CHEM 114A,A01,179693,Stallings; Dontarie M,69,0,100,31
1681927751039,CHEM 143B,A01,179698,Weizman; Haim,16,0,24,8
1681927751039,CHEM 143B,A02,179700,Weizman; Haim,24,0,24,0
1681927752062,CHIN 169A,A00,179701,Wang; Xiao,20,0,20,0
1681927753086,COGS 2,A01,179750,Boyle; Mary E. T.,17,0,30,13
1681927754123,COGS 9,A01,179759,Jones; Cameron Robert,41,0,50,9
1681927755148,COGS 14A,A01,179854,Staff,14,0,50,36
1681927756175,COGS 14B,A01,179856,Staff,52,0,60,8
1681927757198,COGS 17,A01,179874,Staff,71,0,75,4
1681927758238,COGS 18,A01,179884,Staff,59,0,80,21
1681927759266,COGS 100,A01,179886,Staff,34,0,60,26
1681927760291,COGS 101B,A01,179892,Staff,0,2,30,30
1681927761321,COGS 101C,A01,179894,Staff,28,0,30,2
1681927762344,COGS 107A,A01,179896,Boyle; Mary E. T.,29,0,40,11
1681927763377,COGS 108,A01,179898,Simpkins; Charles Alexander,0,29,60,60
1681927764399,COGS 109,A01,179900,Staff,33,0,40,7
1681927765422,COGS 118A,A01,179946,Staff,5,0,40,35
1681927766457,COGS 153,A00,179978,Staff,0,5,30,30
1681927767479,COGS 156,A01,179981,Staff,21,0,30,9
1681927769528,COGS 172,A01,179987,Staff,11,0,30,19
1681927771577,COGS 186,A01,179991,Staff,12,0,30,18
1681927772603,COMM 10,A01,180001,Staff,12,0,25,13
1681927772603,COMM 10,A02,180004,Staff,20,0,25,5
1681927773637,COMM 100A,A01,180016,Staff,14,0,25,11
1681927773637,COMM 100A,A02,180020,Staff,24,0,25,1
1681927774664,COMM 101T,A00,180029,Halm; Gavin Patrick,22,0,35,13
1681927775688,COMM 106V,A00,180043,Staff,34,0,35,1
1681927776714,COMM 109P,A00,180044,Staff,30,0,35,5
1681927777739,COMM 113T,A00,180045,Havis; Allan,37,0,45,8
1681927778762,COMM 132,A00,180046,McKenna; Denise,23,0,30,7
1681927779798,COMM 143,A00,180047,Staff,18,0,30,12
1681927780821,COMM 190,A00,180048,Conner; Thomas Hartnell,18,0,23,5
1681927781850,CSE 8A,A50,180053,Cao; Yingjun,21,0,50,29
1681927781850,CSE 8A,B50,180180,Staff,50,0,50,0
1681927782874,CSE 11,A01,180190,Cao; Yingjun,21,0,50,29
1681927783897,CSE 20,A01,180192,Briones; Jor-el Thomas Caparas,21,0,30,9
1681927784920,CSE 21,A01,194538,Briones; Jor-el Thomas Caparas,50,0,60,10
1681927785953,CSE 30,A01,180324,Eldon; John,74,0,100,26
1681927786976,CSE 101,A01,201353,Staff,0,26,40,40
1681927787998,CSE 134B,A01,180326,Powell; Thomas Allan,73,0,100,27
1681927789022,CSE 140,A01,180328,Staff,28,0,75,47
1681927790045,CSE 140L,A01,180344,Eldon; John,52,0,100,48
1681927791074,CSE 150A,A01,180411,Staff,0,18,50,50
1681927792099,CSE 151A,A01,180414,Staff,0,12,50,50
1681927793136,CSE 175,A01,222521,Kumar; Rakesh,50,0,50,0
1681927794159,CSE 190,A00,201419,Staff,42,0,49,7
1681927795186,CSS 1,A01,194536,Staff,34,0,50,16
1681927796216,DSC 30,A01,202385,Staff,48,0,50,2
1681927797246,DSC 40A,A01,202387,Albuyeh; Rod,50,0,50,0
1681927798273,DSC 190,A01,202389,Silberman; Jack,21,0,21,0
1681927799313,DSGN 100,A01,179993,Staff,13,0,30,17
1681927800336,ECE 65,A50,180708,Staff,10,0,20,10
1681927800336,ECE 65,A51,180739,Staff,19,0,20,1
1681927801446,ECON 1,A01,180427,Famulari; Melissa,67,0,70,3
1681927802473,ECON 2,A01,180450,Levkoff; Steven B.,64,0,70,6
1681927803508,ECON 4,A01,203351,Anderson; John Charles,6,0,10,4
1681927804533,ECON 100A,A01,180472,Famulari; Melissa,59,0,70,11
1681927805559,ECON 120A,A01,180549,Staff,62,0,70,8
1681927806587,ECON 120B,A01,180655,Ma; Xinwei,41,0,70,29
1681927807609,ECON 129,A00,203333,Eckert; Fabian Paul,11,0,35,24
1681927808634,ECON 131,A00,180656,Staff,3,0,35,32
1681927809660,ECON 172B,A01,180672,Levkoff; Steven B.,31,0,35,4
1681927810693,ECON 178,A01,203342,Zhu; Ying,5,0,35,30
1681927811727,EDS 108GS,A00,202383,Wishard Guerra; Alison G.,20,0,20,0
1681927812751,EDS 111GS,A00,202347,Wishard Guerra; Alison G.,20,0,20,0
1681927813788,EDS 112,A01,202323,Staff,53,0,60,7
1681927814821,EDS 113,A00,202340,Staff,32,0,35,3
1681927815844,EDS 118,A00,201231,Staff,19,0,30,11
1681927816873,EDS 119,A00,204994,Staff,8,0,10,2
1681927817896,EDS 124BR,A00,202324,Eguchi; Emi,0,0,25,25
1681927818919,EDS 126,A01,203208,Jones; Makeba,26,0,30,4
1681927819945,EDS 135,A01,202333,Staff,17,0,20,3
1681927820967,EDS 180,A00,202311,Staff,47,0,50,3
1681927821994,ERC 190GS,A01,253747,Staff,28,0,28,0
1681927823017,ETHN 104,A00,180742,Staff,22,0,35,13
1681927824068,ETHN 118,A00,180745,Staff,27,0,35,8
1681927825101,ETHN 127,A00,180747,Staff,8,0,16,8
1681927826125,ETHN 137,A00,180880,Staff,11,0,12,1
1681927827154,ETHN 147,A00,180890,Staff,8,0,10,2
1681927828178,ETHN 154,A00,180891,Staff,6,0,8,2
1681927829216,ETHN 168,A00,180892,Staff,9,0,10,1
1681927830251,GLBH 20,A00,201051,Hannah; Seth Donal,0,5,0,1
1681927831277,GLBH 111,A01,209338,Burgos; Jose L.,0,0,0,0
1681927832314,GLBH 150,A00,258300,Staff,0,3,0,0
1681927833343,GLBH 181,A00,201207,Staff,10,0,40,30
1681927834368,HIEU 109,A00,180898,Staff,19,0,20,1
1681927835398,HIEU 111,A00,180899,Staff,0,2,20,20
1681927836427,HIEU 124,A00,180900,Staff,17,0,20,3
1681927837453,HILA 122,A00,180901,Staff,17,0,20,3
1681927838482,HILA 132,A00,180902,Vitz; Matthew,0,1,20,20
1681927839508,HILD 10,A01,180896,Staff,14,0,20,6
1681927840532,HILD 30GS,A00,180897,Edington; Claire Ellen,0,0,0,0
1681927841567,HISC 105,A00,180903,Staff,20,0,20,0
1681927842591,HISC 117,A00,180904,Staff,10,0,20,10
1681927843613,HIUS 108B,A00,181005,Staff,18,0,20,2
1681927844640,HIUS 113,A00,181093,Staff,0,0,20,20
1681927845666,HUM 3,A01,181190,Patterson; Patrick H.,36,0,50,14
1681927845666,HUM 3,B01,181195,Staff,46,0,50,4
1681927846698,HUM 3GS,A00,181196,Herbst; Matthew,0,0,0,0
1681927847721,HUM 4,A01,181227,West; Geoffrey Scott,33,0,50,17
1681927847721,HUM 4,B01,181282,Staff,41,0,50,9
1681927848744,HUM 4GS,A00,181377,Lyon; Antony J.,0,0,0,0
1681927849767,HUM 5,A01,181536,Zavodny; Tatiana Sophia,25,0,50,25
1681927849767,HUM 5,B01,181908,Staff,35,0,50,15
1681927850803,INTL 190,A00,181909,Segui; Alan S,0,0,0,8
1681927850803,INTL 190,B00,181961,Segui; Alan S,0,0,0,7
1681927851829,JAPN 20AR,A01,182113,Ross; Kayoko F,15,0,20,5
1681927852855,LATI 50,A01,202391,Martin-Cabrera; Luis,18,0,30,12
1681927852855,LATI 50,A02,202392,Martin-Cabrera; Luis,26,0,30,4
1681927853881,LATI 180,A00,202393,Kokinis; Troy Andreas,24,0,25,1
1681927854910,LIFR 1A,A00,182119,Staff,13,0,14,1
1681927855933,LIFR 1AX,A00,182324,Staff,13,0,14,1
1681927856966,LIFR 1B,A00,182259,Staff,12,0,14,2
1681927857988,LIFR 1BX,A00,182273,Staff,12,0,14,2
1681927859016,LIGN 8,A00,182330,Staff,130,0,150,20
1681927860060,LIGN 9GS,A00,182362,Staff,15,0,20,5
1681927861093,LIGN 119,A00,204992,Takahashi; Maho,11,0,15,4
1681927862120,LIGN 130,A01,182384,Staff,47,0,50,3
1681927863143,LIGN 149GS,A00,182390,Staff,15,0,20,5
1681927864180,LIGN 170,A00,182404,Staff,23,0,30,7
1681927865203,LISP 1D,A00,182281,Staff,7,0,14,7
1681927865203,LISP 1D,B00,182287,Staff,13,0,14,1
1681927865203,LISP 1D,C00,182295,Staff,10,0,14,4
1681927865203,LISP 1D,D00,182301,Staff,14,0,14,0
1681927866229,LISP 1DX,A00,182309,Staff,19,0,28,9
1681927866229,LISP 1DX,B00,182316,Staff,25,0,28,3
1681927867257,LTAF 120GS,A00,182412,Zhiri; Oumelbanine,20,0,20,0
1681927868283,LTCS 172GS,A00,182437,Bronstein; Phoebe Malan,20,0,20,0
1681927869306,LTEA 138,A00,182457,Staff,18,0,40,22
1681927870340,LTEN 114,A01,182490,Staff,23,0,25,2
1681927871363,LTEN 130GS,A00,182491,Lyon; Antony J.,20,0,20,0
1681927872386,LTEN 169,A00,182493,Cuong; Marisol,18,0,25,7
1681927873413,LTEN 178,A00,182501,Staff,14,0,15,1
1681927874438,LTEN 181,A00,182515,Staff,19,0,25,6
1681927875464,LTEN 185GS,A00,197655,Forbes; Camille,20,0,20,0
1681927876504,LTSP 100B,A00,202208,Bessett; Ryan Matthew,24,0,25,1
1681927877529,LTWL 100,A00,182516,Myerston Santana; Jacobo,20,0,30,10
1681927878561,LTWR 100GS,A00,182518,Forbes; Camille,20,0,20,0
1681927879584,LTWR 102,A00,182522,Staff,15,0,15,0
1681927879584,LTWR 102,B00,182525,Staff,14,0,15,1
1681927880614,LTWR 115,A00,182526,Staff,10,0,15,5
1681927881641,MAE 8,A01,182528,Pham; Hieu Tan,67,0,70,3
1681927882665,MAE 11,A00,182529,Bahadori; Mohammad Yousef,92,0,100,8
1681927883697,MAE 20,A00,182530,Evdokimenko; Ekaterina,68,0,70,2
1681927884720,MAE 30A,A00,182532,Staff,44,0,45,1
1681927885743,MAE 101A,A00,182533,Bahadori; Mohammad Yousef,94,0,100,6
1681927886771,MAE 101C,A00,182538,Staff,62,0,70,8
1681927887798,MAE 104,A00,182539,Staff,44,0,50,6
1681927888842,MAE 131A,A00,182540,Ghazinejad; Maziar,40,0,45,5
1681927889876,MAE 143A,A00,182548,Bewley; Thomas R,43,0,50,7
1681927890903,MAE 150,A00,182549,Staff,28,0,40,12
1681927891928,MAE 160,A00,182550,Evdokimenko; Ekaterina,41,0,60,19
1681927892950,MATH 3C,A01,182725,Staff,24,0,30,6
1681927893975,MATH 10A,A01,182729,Staff,24,0,30,6
1681927893975,MATH 10A,B01,182732,Staff,25,0,30,5
1681927894999,MATH 10B,A01,182737,Staff,17,0,30,13
1681927894999,MATH 10B,A02,182738,Staff,26,0,30,4
1681927894999,MATH 10B,B01,182744,Staff,25,0,30,5
1681927894999,MATH 10B,B02,182745,Staff,27,0,30,3
1681927896027,MATH 18,A01,182750,Anzaldo; Leesa B,28,0,30,2
1681927896027,MATH 18,A02,182751,Anzaldo; Leesa B,28,0,30,2
1681927896027,MATH 18,A03,182753,Anzaldo; Leesa B,27,0,30,3
1681927896027,MATH 18,A04,182757,Anzaldo; Leesa B,29,0,30,1
1681927896027,MATH 18,B01,182761,Anzaldo; Leesa B,27,0,30,3
1681927896027,MATH 18,B02,182764,Anzaldo; Leesa B,26,0,30,4
1681927896027,MATH 18,B03,182765,Anzaldo; Leesa B,29,0,30,1
1681927896027,MATH 18,B04,182766,Anzaldo; Leesa B,30,0,30,0
1681927897053,MATH 20A,A01,182771,Suk; Andrew Hoon,28,0,30,2
1681927898077,MATH 20B,A01,182775,Bach; Quang Tran,30,0,30,0
1681927898077,MATH 20B,A02,182777,Bach; Quang Tran,29,0,30,1
1681927898077,MATH 20B,B01,182780,Bach; Quang Tran,26,0,30,4
1681927898077,MATH 20B,B02,182782,Bach; Quang Tran,30,0,30,0
1681927899106,MATH 20C,A01,182787,Staff,24,0,30,6
1681927899106,MATH 20C,A02,182790,Staff,29,0,30,1
1681927899106,MATH 20C,B01,182792,Staff,23,0,30,7
1681927899106,MATH 20C,B02,182796,Staff,26,0,30,4
1681927900140,MATH 20D,A01,182799,Staff,27,0,30,3
1681927900140,MATH 20D,A02,182802,Staff,29,0,30,1
1681927900140,MATH 20D,A03,182803,Staff,30,0,30,0
1681927901163,MATH 20E,A01,182809,Verstraete; Jacques Allan,21,0,30,9
1681927901163,MATH 20E,A02,182811,Verstraete; Jacques Allan,28,0,30,2
1681927901163,MATH 20E,B01,182814,Verstraete; Jacques Allan,22,0,30,8
1681927901163,MATH 20E,B02,182815,Verstraete; Jacques Allan,29,0,30,1
1681927902199,MATH 103A,A01,182820,Staff,3,0,30,27
1681927902199,MATH 103A,A02,182821,Staff,27,0,30,3
1681927902199,MATH 103A,A03,182822,Staff,22,0,30,8
1681927902199,MATH 103A,B01,182825,Staff,22,0,30,8
1681927902199,MATH 103A,B02,182826,Staff,30,0,30,0
1681927902199,MATH 103A,B03,182830,Staff,30,0,30,0
1681927903242,MATH 109,A01,182836,Chow; Bennett,23,0,30,7
1681927903242,MATH 109,A02,182838,Chow; Bennett,29,0,30,1
1681927903242,MATH 109,A03,182894,Chow; Bennett,29,0,30,1
1681927903242,MATH 109,B01,182908,Chow; Bennett,27,0,30,3
1681927903242,MATH 109,B02,182909,Chow; Bennett,30,0,30,0
1681927903242,MATH 109,B03,182910,Chow; Bennett,26,0,30,4
1681927904332,MATH 142A,A01,182925,Staff,5,0,30,25
1681927904332,MATH 142A,A02,182935,Staff,23,0,30,7
1681927904332,MATH 142A,A03,182967,Staff,26,0,30,4
1681927904332,MATH 142A,B01,183125,Staff,23,0,30,7
1681927904332,MATH 142A,B02,183157,Staff,27,0,30,3
1681927904332,MATH 142A,B03,183158,Staff,29,0,30,1
1681927905455,MATH 183,A01,183160,Arias-Castro; Ery,23,0,30,7
1681927905455,MATH 183,A02,183161,Arias-Castro; Ery,29,0,30,1
1681927905455,MATH 183,B01,183163,Arias-Castro; Ery,28,0,30,2
1681927905455,MATH 183,B02,183164,Arias-Castro; Ery,28,0,30,2
1681927906488,MATH 193A,A01,183167,Staff,0,0,35,35
1681927906488,MATH 193A,A02,183168,Staff,27,0,35,8
1681927906488,MATH 193A,A03,183169,Staff,34,0,35,1
1681927906488,MATH 193A,A04,183170,Staff,27,0,35,8
1681927907524,MGT 4,A01,202395,Anderson; John Charles,76,0,80,4
1681927908557,MGT 5,A00,202396,Houskeeper; Robert,79,0,90,11
1681927909587,MGT 103,A00,202397,Eberhard; Craig A,49,0,90,41
1681927910614,MGT 131A,A00,202398,Houskeeper; Robert,82,0,90,8
1681927911640,MGT 135,A00,202399,Anderson; John Charles,81,0,90,9
1681927912676,MGT 162R,A00,202403,Gneezy; Uri,127,0,200,73
1681927913714,MGT 172,A00,202404,Hedges; Kathleen,33,0,90,57
1681927914751,MGT 181,A00,202405,Dunn; Louis Jean,79,0,90,11
1681927915774,MMW 14,A01,183200,Staff,5,0,28,23
1681927915774,MMW 14,A02,183201,Staff,25,0,28,3
1681927915774,MMW 14,A03,183202,Staff,24,0,28,4
1681927915774,MMW 14,A04,183203,Staff,25,0,28,3
1681927915774,MMW 14,A05,183204,Staff,26,0,28,2
1681927915774,MMW 14,A06,183205,Staff,27,0,28,1
1681927915774,MMW 14,B01,183207,Staff,26,0,28,2
1681927915774,MMW 14,B02,183208,Staff,28,0,28,0
1681927915774,MMW 14,B03,183209,Staff,28,0,28,0
1681927915774,MMW 14,B04,183210,Staff,28,0,28,0
1681927915774,MMW 14,B05,183211,Staff,28,0,28,0
1681927915774,MMW 14,B06,183212,Staff,27,0,28,1
1681927916807,MMW 14GS,A00,183213,Zhiri; Oumelbanine,28,0,28,0
1681927917839,MMW 15GS,B00,183215,Rahimi; Babak,28,0,28,0
1681927918863,MMW 121,A01,183217,Patterson; Patrick H.,9,0,28,19
1681927918863,MMW 121,A02,183218,Patterson; Patrick H.,24,0,28,4
1681927919888,MUS 1A,A01,182554,Staff,3,0,35,32
1681927920911,MUS 5,A01,182558,Staff,17,0,35,18
1681927921934,MUS 6,A01,182562,Staff,22,0,35,13
1681927922956,MUS 8GS,A00,182563,Borgo; David Garcia,25,0,25,0
1681927923980,MUS 13,A01,182567,Staff,23,0,25,2
1681927925007,MUS 15,A01,182570,Staff,31,0,35,4
1681927925007,MUS 15,B01,182575,Staff,7,0,35,28
1681927926030,MUS 80,A00,182578,Staff,22,0,25,3
1681927926030,MUS 80,B00,182581,Staff,20,0,25,5
1681927927057,MUS 113,A00,182582,Staff,25,0,25,0
1681927928085,MUS 114,A00,182583,Staff,2,0,25,23
1681927929120,MUS 150GS,A01,182588,Borgo; David Garcia,25,0,25,0
1681927930151,PHIL 1,A00,182590,Staff,34,0,40,6
1681927931175,PHIL 10,A01,182596,Grush; Rick Scott,30,0,35,5
1681927931175,PHIL 10,A02,182597,Grush; Rick Scott,33,0,35,2
1681927932198,PHIL 15,A01,182601,Staff,31,0,35,4
1681927932198,PHIL 15,A02,182602,Staff,33,0,35,2
1681927933224,PHIL 27,A01,182604,Staff,28,0,35,7
1681927933224,PHIL 27,A02,182607,Staff,35,0,35,0
1681927934249,PHIL 32,A01,182609,Staff,35,0,35,0
1681927934249,PHIL 32,A02,182612,Staff,35,0,35,0
1681927935275,PHIL 130,A00,182614,Staff,59,0,70,11
1681927936302,PHIL 136,A00,182616,Cohen; Jonathan David,66,0,70,4
1681927937332,PHIL 155,A00,182617,Vargas; Manuel Rogelio,58,0,70,12
1681927938356,PHIL 163,A01,182620,Staff,15,0,20,5
1681927938356,PHIL 163,A02,182624,Staff,10,0,20,10
1681927939388,PHIL 164,A00,182627,Staff,29,0,40,11
1681927940413,PHIL 173,A00,182628,Staff,35,0,40,5
1681927941449,PHYS 1A,A00,183221,Staff,53,0,60,7
1681927942483,PHYS 1AL,001,183222,Staff,24,0,30,6
1681927942483,PHYS 1AL,002,183223,Staff,25,0,30,5
1681927943510,PHYS 1B,A00,183231,Staff,41,0,60,19
1681927944535,PHYS 1BL,001,183232,Staff,17,0,30,13
1681927944535,PHYS 1BL,002,183233,Staff,27,0,30,3
1681927945572,PHYS 1C,A00,183240,Staff,22,0,60,38
1681927946603,PHYS 1CL,001,183241,Staff,9,0,30,21
1681927946603,PHYS 1CL,002,183242,Staff,22,0,30,8
1681927947641,PHYS 2AR,A01,183250,Staff,40,0,50,10
1681927948677,PHYS 2B,A01,183252,Staff,103,0,115,12
1681927949699,PHYS 2BL,A01,183254,Staff,21,0,24,3
1681927949699,PHYS 2BL,A02,183255,Staff,21,0,24,3
1681927950731,PHYS 2C,A01,183522,Staff,101,0,115,14
1681927951759,PHYS 4A,A01,183524,Staff,49,0,50,1
1681927952784,POLI 5,A00,183525,Staff,44,0,50,6
1681927953824,POLI 12,A00,183540,Staff,45,0,50,5
1681927954848,POLI 13R,A00,183541,Forman; Fonna,41,0,50,9
1681927955877,POLI 30,A00,183542,Mignozzetti; Umberto,48,0,50,2
1681927956903,POLI 100A,A00,183543,Staff,44,0,50,6
1681927957926,POLI 100E,A00,223598,Staff,32,0,35,3
1681927958954,POLI 103A,A00,183564,Kousser; Thad,35,0,50,15
1681927959980,POLI 104B,A00,201329,Staff,28,0,35,7
1681927961009,POLI 113BR,A00,183576,Hoston; Germaine,22,0,50,28
1681927962033,POLI 114BR,A00,183588,Staff,27,0,30,3
1681927963058,POLI 117R,A00,183595,Forman; Fonna,4,0,20,16
1681927964089,POLI 120H,A00,183596,Fisk; David Lee,14,0,20,6
1681927965121,POLI 130AA,A00,183597,Staff,13,0,20,7
1681927966147,POLI 134AA,A00,183598,Staff,19,0,20,1
1681927967173,POLI 135,A00,183599,Fisk; David Lee,19,0,25,6
1681927968206,POLI 142P,A00,183623,Staff,37,0,40,3
1681927969238,POLI 144D,A00,183624,Staff,22,0,25,3
1681927970264,POLI 151,A00,183625,Staff,15,0,20,5
1681927971287,POLI 162,A00,183626,Mignozzetti; Umberto,17,0,20,3
1681927972321,PSYC 1,A00,253748,Staff,86,0,90,4
1681927973344,PSYC 2,A00,183627,Moranton; Nirelia Melbina-,24,0,35,11
1681927974374,PSYC 3,A00,183628,Staff,43,0,45,2
1681927976427,PSYC 60,A01,183631,Lowe; Angela Beth,35,0,40,5
1681927977450,PSYC 70,A01,253757,Staff,37,0,45,8
1681927978473,PSYC 101,A00,183632,Heyman; Gail D.,43,0,60,17
1681927979496,PSYC 105,A00,183848,Lowe; Angela Beth,46,0,60,14
1681927980523,PSYC 106,A00,183849,Dobkins; Karen R.,39,0,60,21
1681927981550,PSYC 108,A00,253750,Staff,14,0,60,46
1681927982573,PSYC 114,A01,184275,Winkielman; Piotr,0,8,30,30
1681927983597,PSYC 122,A00,183856,Moranton; Nirelia Melbina-,0,16,30,30
1681927984618,PSYC 124,A00,183865,Chapman; Eddie Nathaniel,44,0,80,36
1681927985640,PSYC 137,A00,183880,Staff,17,0,25,8
1681927987737,PSYC 154,A00,183910,Lacefield; Katharine I,0,25,90,90
1681927989787,PSYC 162,A00,183946,Wixted; John T,42,0,90,48
1681927990812,PSYC 172,A00,183947,Gorman; Michael R.,6,0,30,24
1681927991841,PSYC 178,A00,183963,Glaser; Dale,15,0,40,25
1681927992873,PSYC 181GS,A00,183964,Anagnostaras; Stephan,10,0,10,0
1681927993904,PSYC 186GS,A01,257660,Staff,10,0,10,0
1681927994927,PSYC 193,B00,253749,Staff,22,0,25,3
1681927996994,PSYC 193L,A01,184122,Staff,33,0,35,2
1681927996994,PSYC 193L,C01,184167,Winkielman; Piotr,14,0,30,16
1681927998019,RELI 188GS,A00,182629,Rahimi; Babak,20,0,20,0
1681927999041,SE 101A,A00,182646,Staff,26,0,30,4
1681928000068,SE 101C,A00,182650,Staff,12,0,20,8
1681928001097,SE 110A,A00,182651,Staff,28,0,28,0
1681928002126,SE 130A,A00,182652,Staff,38,0,40,2
1681928003152,SIO 46GS,A00,182636,Cook; Geoffrey W,25,0,28,3
1681928004187,SIO 109R,A00,194459,Staff,1,0,20,19
1681928005212,SIO 121GS,A00,182639,Cook; Geoffrey W,25,0,28,3
1681928006245,SIO 132,A01,182642,Staff,30,0,40,10
1681928007272,SIO 139,A00,182644,Kacev; David,36,0,40,4
1681928008296,SOCI 2,A01,258404,Staff,33,0,36,3
1681928008296,SOCI 2,A02,258405,Staff,35,0,36,1
1681928009398,SOCI 60,A01,258408,Staff,29,0,30,1
1681928009398,SOCI 60,A02,258413,Staff,30,0,30,0
1681928010439,SOCI 100,A01,258415,Staff,29,0,30,1
1681928010439,SOCI 100,A02,258416,Staff,28,0,30,2
1681928016599,SOCI 127,A00,258421,Staff,19,0,30,11
1681928017622,SOCI 132,A00,258422,Staff,44,0,50,6
1681928018647,SOCI 133,A00,258423,Staff,26,0,30,4
1681928019673,SOCI 138GS,A00,258424,Staff,15,0,15,0
1681928020699,SOCI 145,A00,258425,Staff,24,0,30,6
1681928021728,SOCI 148,A00,258426,Staff,24,0,30,6
1681928022758,SOCI 153,A00,199217,Staff,29,0,30,1
1681928023781,SOCI 160,A00,258427,Staff,27,0,30,3
1681928024808,SOCI 160E,A00,258435,Staff,56,0,60,4
1681928025836,SOCI 189GS,A00,258436,Staff,15,0,15,0
1681928026869,SOCI 190GS,A00,258437,Staff,15,0,15,0
1681928027892,SYN 2,001,182658,Staff,8,0,16,8
1681928027892,SYN 2,002,201439,Staff,14,0,16,2
1681928027892,SYN 2,003,201443,Staff,16,0,16,0
1681928028931,SYN 100,A01,182657,Staff,13,0,20,7
1681928029965,TDAC 1,A00,184381,Salovey; Todd,16,0,20,4
1681928029965,TDAC 1,B00,184385,Harting; Carla Kelso,19,0,20,1
1681928029965,TDAC 1,C00,184394,Staff,18,0,20,2
1681928030987,TDAC 101,A00,184483,Harting; Carla Kelso,19,0,20,1
1681928032013,TDDE 111,A00,184496,Staff,14,0,15,1
1681928033047,TDDE 131,A00,184504,Staff,20,0,20,0
1681928033047,TDDE 131,B00,184505,Staff,17,0,18,1
1681928033047,TDDE 131,C00,184534,Staff,49,0,50,1
1681928033047,TDDE 131,D00,184564,Staff,15,0,15,0
1681928033047,TDDE 131,E00,204725,Staff,18,0,20,2
1681928034084,TDGE 1,A01,184414,Salovey; Todd,36,0,50,14
1681928035116,TDGE 5,A01,184419,Staff,23,0,24,1
1681928036151,TDGE 10,A00,184428,Fulton; Julia,28,0,50,22
1681928037174,TDGE 124,A00,184565,Fulton; Julia,0,0,50,50
1681928038198,TDGE 125,B00,184567,Meyer; Ursula,9,0,25,16
1681928039225,TDHT 101,A00,184568,Staff,21,0,25,4
1681928039225,TDHT 101,B00,184569,Staff,20,0,20,0
1681928040247,TDHT 114,A00,184570,Staff,49,0,50,1
1681928041282,TDMV 1,A00,184437,Arcidiacono; Kristin,21,0,30,9
1681928041282,TDMV 1,B00,184448,Caligagan; Maria T.,23,0,30,7
1681928042305,TDMV 2,A00,184449,Weinberg; Sadie,27,0,30,3
1681928042305,TDMV 2,B00,184453,Arcidiacono; Kristin,29,0,30,1
1681928043342,TDMV 110,A00,184571,Weinberg; Sadie,30,0,30,0
1681928044371,TDMV 142,A00,184572,Caligagan; Tony,26,0,30,4
1681928044371,TDMV 142,B00,184573,Caligagan; Maria T.,26,0,30,4
1681928045395,TDTR 20,A00,184482,Jun; Grace Shin Hae,25,0,25,0
1681928046431,USP 2,A01,184290,Hinds; Juli Beth,24,0,25,1
1681928047457,USP 3,A01,184295,Staff,21,0,25,4
1681928048479,USP 4,A00,184304,McTague; Sarah,13,0,25,12
1681928049517,USP 100,A00,184315,Staff,16,0,25,9
1681928050540,USP 105,A00,184326,Staff,21,0,25,4
1681928051562,USP 151,A00,184327,Staff,18,0,25,7
1681928052585,USP 170,A00,184380,Hinds; Juli Beth,13,0,25,12
1681928053619,VIS 21B,A01,182660,Staff,28,0,31,3
1681928053619,VIS 21B,A02,182662,Staff,30,0,31,1
1681928054643,VIS 103D,A00,182663,Staff,74,0,75,1
1681928055675,VIS 105D,A00,182667,Li; Huai,14,0,22,8
1681928056699,VIS 122GS,A00,182668,Herbst; Matthew,20,0,20,0
1681928057722,VIS 128C,A00,182673,Staff,69,0,75,6
1681928058759,VIS 130,A00,182675,Staff,19,0,22,3
1681928059802,VIS 160A,A00,182678,Stalbaum; Brett,4,0,10,6
1681928061874,WCWP 10B,A00,201679,Staff,15,0,15,0
1681928061874,WCWP 10B,B00,201695,Staff,15,0,15,0
1681928062898,WCWP 100,A00,201716,Staff,12,0,15,3
1681928062898,WCWP 100,B00,201717,Staff,0,0,15,15
1681928065007,ANSC 105GS,A00,258289,Staff,0,0,0,0
1681928066032,ANSC 125GS,A00,258295,Staff,0,0,0,0
1681928067076,ANSC 150,A00,258267,Staff,28,0,40,12
1681928068115,ANSC 190GS,A00,258280,Staff,0,0,0,0
1681928069143,ANTH 1,A00,258264,Staff,38,0,40,2
1681928070169,ANTH 2,A01,258259,Staff,72,0,76,4
1681928071196,ANTH 23,A01,258228,Staff,36,0,40,4
1681928072224,ANTH 101,A01,258236,Staff,38,0,40,2
1681928073252,ANTH 102,A00,258272,Staff,59,0,60,1
1681928074275,ANTH 105,A00,258244,Staff,29,0,35,6
1681928075313,BENG 130,A00,253975,Staff,37,0,40,3
1681928076346,BIBC 102,A01,191866,Flagg; Matthew Paul,17,0,32,15
1681928076346,BIBC 102,A02,191867,Flagg; Matthew Paul,21,0,32,11
1681928076346,BIBC 102,A03,191868,Flagg; Matthew Paul,29,0,32,3
1681928076346,BIBC 102,A04,191936,Flagg; Matthew Paul,22,0,32,10
1681928076346,BIBC 102,A05,191937,Flagg; Matthew Paul,0,0,32,32
1681928077375,BICD 100,A01,191939,Cooper; Andrew Michael,27,0,32,5
1681928077375,BICD 100,A02,191940,Cooper; Andrew Michael,32,0,32,0
1681928077375,BICD 100,A03,191941,Cooper; Andrew Michael,32,0,32,0
1681928077375,BICD 100,A04,191942,Cooper; Andrew Michael,32,0,32,0
1681928077375,BICD 100,A05,191943,Cooper; Andrew Michael,32,0,32,0
1681928078407,BIEB 126,A01,191945,Cleland; Elsa Eleanor,0,2,32,32
1681928078407,BIEB 126,A02,191946,Cleland; Elsa Eleanor,26,0,32,6
1681928078407,BIEB 126,A03,191947,Cleland; Elsa Eleanor,29,0,32,3
1681928078407,BIEB 126,A04,191948,Cleland; Elsa Eleanor,17,0,32,15
1681928078407,BIEB 126,A05,191996,Cleland; Elsa Eleanor,28,0,32,4
1681928079431,BIEB 136GS,A00,191997,Shurin; Jonathan & Holway; David A.,0,0,0,8
1681928080458,BIEB 137GS,A01,191999,Shurin; Jonathan & Holway; David A.,0,0,0,7
1681928081489,BILD 1,A01,205385,Staff,30,0,32,2
1681928081489,BILD 1,A02,205386,Staff,30,0,32,2
1681928081489,BILD 1,A03,205387,Staff,31,0,32,1
1681928081489,BILD 1,A04,205388,Staff,26,0,32,6
1681928082514,BILD 2,A01,191774,Staff,27,0,32,5
1681928082514,BILD 2,A02,191775,Staff,30,0,32,2
1681928082514,BILD 2,A03,191777,Staff,30,0,32,2
1681928082514,BILD 2,A04,191856,Staff,30,0,32,2
1681928082514,BILD 2,A05,191857,Staff,31,0,32,1
1681928082514,BILD 2,A06,191858,Staff,32,0,32,0
1681928082514,BILD 2,A07,191859,Staff,31,0,32,1
1681928083542,BILD 3,A01,205391,Staff,28,0,32,4
1681928083542,BILD 3,A02,205393,Staff,32,0,32,0
1681928083542,BILD 3,A03,205394,Staff,27,0,32,5
1681928083542,BILD 3,A04,205395,Staff,32,0,32,0
1681928084568,BILD 20,A01,191861,Staff,32,0,32,0
1681928084568,BILD 20,A02,191862,Staff,32,0,32,0
1681928085602,BILD 30,A01,191864,Staff,31,0,32,1
1681928086631,BIMM 100,A01,192019,Staff,0,0,32,32
1681928086631,BIMM 100,A02,192020,Staff,18,0,32,14
1681928086631,BIMM 100,A03,192035,Staff,18,0,32,14
1681928087658,BIMM 110,A01,192037,Tat; John,0,0,32,32
1681928087658,BIMM 110,A02,192038,Tat; John,5,0,32,27
1681928088690,BIMM 120,A01,192040,Pickett; Brooke Elizabeth,0,0,32,32
1681928088690,BIMM 120,A02,192041,Pickett; Brooke Elizabeth,9,0,32,23
1681928088690,BIMM 120,A03,192042,Pickett; Brooke Elizabeth,14,0,32,18
1681928089724,BIPN 100,A01,192044,Armour; Jon Christopher,23,0,32,9
1681928089724,BIPN 100,A02,192059,Armour; Jon Christopher,30,0,32,2
1681928089724,BIPN 100,A03,192064,Armour; Jon Christopher,30,0,32,2
1681928089724,BIPN 100,A04,192073,Armour; Jon Christopher,26,0,32,6
1681928090756,BIPN 148,A01,205411,Leutgeb; Jill K.,15,0,32,17
1681928090756,BIPN 148,A02,205412,Leutgeb; Jill K.,31,0,32,1
1681928090756,BIPN 148,A03,205413,Leutgeb; Jill K.,30,0,32,2
1681928090756,BIPN 148,A04,205414,Leutgeb; Jill K.,30,0,32,2
1681928091780,BIPN 160,A01,192115,Marino; Marc J,15,0,32,17
1681928091780,BIPN 160,A02,192148,Marino; Marc J,27,0,32,5
1681928091780,BIPN 160,A03,192158,Marino; Marc J,31,0,32,1
1681928091780,BIPN 160,A04,192190,Marino; Marc J,32,0,32,0
1681928091780,BIPN 160,A05,192287,Marino; Marc J,32,0,32,0
1681928091780,BIPN 160,A06,192288,Marino; Marc J,32,0,32,0
1681928092808,BIPN 194,A00,206038,Staff,28,0,32,4
1681928093834,BISP 194,A00,192289,Leutgeb; Stefan,11,0,32,21
1681928093834,BISP 194,B00,245332,Nieh; James Charles,26,0,32,6
1681928094858,CAT 124,A01,202247,Staff,15,0,15,0
1681928095882,CAT 125,A00,202248,Staff,18,0,20,2
1681928095882,CAT 125,B00,202253,Staff,20,0,20,0
1681928095882,CAT 125,C00,202257,Staff,18,0,20,2
1681928096906,CAT 125GS,A01,202273,Bronstein; Phoebe Malan,20,0,20,0
1681928097954,CAT 125R,A00,202284,Staff,17,0,20,3
1681928097954,CAT 125R,C00,202286,Staff,5,0,20,15
1681928097954,CAT 125R,D00,202291,Staff,17,0,20,3
1681928097954,CAT 125R,E00,202295,Staff,13,0,20,7
1681928097954,CAT 125R,F00,202302,Staff,7,0,20,13
1681928098978,CENG 100,A00,204724,Opatkiewicz; Justin Paul,25,0,25,0
1681928100011,CGS 2A,A01,180420,Staff,30,0,36,6
1681928101038,CGS 101,A00,180421,Staff,16,0,20,4
1681928102071,CGS 112,A00,180422,Staff,9,0,16,7
1681928103098,CGS 113,A00,180423,Staff,18,0,20,2
1681928104121,CGS 137,A00,180424,Staff,12,0,12,0
1681928105144,CGS 147,A00,180425,Staff,10,0,10,0
1681928106171,CHEM 6A,A01,179556,Staff,93,0,100,7
1681928106171,CHEM 6A,A02,179558,Staff,0,0,0,0
1681928107195,CHEM 6B,A01,179560,Staff,100,0,100,0
1681928108236,CHEM 6C,A01,179565,Jazzar; Rodolphe,93,0,100,7
1681928109263,CHEM 7L,A01,179586,Schurmeier; Kimberly,10,0,24,14
1681928109263,CHEM 7L,A02,179587,Schurmeier; Kimberly,23,0,24,1
1681928109263,CHEM 7L,A03,179590,Schurmeier; Kimberly,22,0,24,2
1681928109263,CHEM 7L,A04,179591,Schurmeier; Kimberly,22,0,24,2
1681928109263,CHEM 7L,B01,179598,Schurmeier; Kimberly,16,0,24,8
1681928109263,CHEM 7L,B02,179599,Schurmeier; Kimberly,24,0,24,0
1681928109263,CHEM 7L,B03,179606,Schurmeier; Kimberly,23,0,24,1
1681928109263,CHEM 7L,B04,179607,Schurmeier; Kimberly,22,0,24,2
1681928110307,CHEM 11,A01,179609,Stallings; Dontarie M,87,0,100,13
1681928111330,CHEM 40A,A01,179621,Staff,40,0,50,10
1681928111330,CHEM 40A,A02,179622,Staff,46,0,50,4
1681928112358,CHEM 40B,A01,179630,Weizman; Haim,47,0,50,3
1681928112358,CHEM 40B,A02,179631,Weizman; Haim,44,0,50,6
1681928113454,CHEM 41A,A01,179660,Klosterman; Jeremy K,93,0,100,7
1681928114481,CHEM 43A,A01,179683,Klosterman; Jeremy K,0,0,24,24
1681928114481,CHEM 43A,A02,179688,Klosterman; Jeremy K,8,0,24,16
1681928114481,CHEM 43A,A03,179689,Klosterman; Jeremy K,18,0,24,6
1681928114481,CHEM 43A,A04,179691,Klosterman; Jeremy K,18,0,24,6
1681928115510,CHEM 114A,A01,179693,Stallings; Dontarie M,69,0,100,31
1681928116542,CHEM 143B,A01,179698,Weizman; Haim,16,0,24,8
1681928116542,CHEM 143B,A02,179700,Weizman; Haim,24,0,24,0
1681928117564,CHIN 169A,A00,179701,Wang; Xiao,20,0,20,0
1681928118587,COGS 2,A01,179750,Boyle; Mary E. T.,17,0,30,13
1681928119620,COGS 9,A01,179759,Jones; Cameron Robert,41,0,50,9
1681928120644,COGS 14A,A01,179854,Staff,14,0,50,36
1681928121674,COGS 14B,A01,179856,Staff,52,0,60,8
1681928122699,COGS 17,A01,179874,Staff,71,0,75,4
1681928123726,COGS 18,A01,179884,Staff,59,0,80,21
1681928124751,COGS 100,A01,179886,Staff,33,0,60,27
1681928125785,COGS 101B,A01,179892,Staff,0,2,30,30
1681928126809,COGS 101C,A01,179894,Staff,28,0,30,2
1681928127832,COGS 107A,A01,179896,Boyle; Mary E. T.,29,0,40,11
1681928128855,COGS 108,A01,179898,Simpkins; Charles Alexander,0,30,60,60
1681928129885,COGS 109,A01,179900,Staff,32,0,40,8
1681928130922,COGS 118A,A01,179946,Staff,5,0,40,35
1681928131954,COGS 153,A00,179978,Staff,0,6,30,30
1681928132978,COGS 156,A01,179981,Staff,21,0,30,9
1681928135029,COGS 172,A01,179987,Staff,10,0,30,20
1681928137078,COGS 186,A01,179991,Staff,11,0,30,19
1681928138111,COMM 10,A01,180001,Staff,12,0,25,13
1681928138111,COMM 10,A02,180004,Staff,20,0,25,5
1681928139136,COMM 100A,A01,180016,Staff,13,0,25,12
1681928139136,COMM 100A,A02,180020,Staff,24,0,25,1
1681928140162,COMM 101T,A00,180029,Halm; Gavin Patrick,21,0,35,14
1681928141185,COMM 106V,A00,180043,Staff,34,0,35,1
1681928142214,COMM 109P,A00,180044,Staff,30,0,35,5
1681928143252,COMM 113T,A00,180045,Havis; Allan,37,0,45,8
1681928144274,COMM 132,A00,180046,McKenna; Denise,22,0,30,8
1681928145296,COMM 143,A00,180047,Staff,16,0,30,14
1681928146325,COMM 190,A00,180048,Conner; Thomas Hartnell,18,0,23,5
1681928147352,CSE 8A,A50,180053,Cao; Yingjun,21,0,50,29
1681928147352,CSE 8A,B50,180180,Staff,50,0,50,0
1681928148375,CSE 11,A01,180190,Cao; Yingjun,21,0,50,29
1681928149398,CSE 20,A01,180192,Briones; Jor-el Thomas Caparas,21,0,30,9
1681928150420,CSE 21,A01,194538,Briones; Jor-el Thomas Caparas,50,0,60,10
1681928151444,CSE 30,A01,180324,Eldon; John,74,0,100,26
1681928152492,CSE 101,A01,201353,Staff,0,26,40,40
1681928153526,CSE 134B,A01,180326,Powell; Thomas Allan,73,0,100,27
1681928154548,CSE 140,A01,180328,Staff,26,0,75,49
1681928155572,CSE 140L,A01,180344,Eldon; John,50,0,100,50
1681928156596,CSE 150A,A01,180411,Staff,0,18,50,50
1681928157621,CSE 151A,A01,180414,Staff,0,12,50,50
1681928158647,CSE 175,A01,222521,Kumar; Rakesh,50,0,50,0
1681928159671,CSE 190,A00,201419,Staff,42,0,49,7
1681928160693,CSS 1,A01,194536,Staff,34,0,50,16
1681928161720,DSC 30,A01,202385,Staff,48,0,50,2
1681928162745,DSC 40A,A01,202387,Albuyeh; Rod,50,0,50,0
1681928163771,DSC 190,A01,202389,Silberman; Jack,21,0,21,0
1681928164793,DSGN 100,A01,179993,Staff,13,0,30,17
1681928165820,ECE 65,A50,180708,Staff,10,0,20,10
1681928165820,ECE 65,A51,180739,Staff,19,0,20,1
1681928166843,ECON 1,A01,180427,Famulari; Melissa,67,0,70,3
1681928167867,ECON 2,A01,180450,Levkoff; Steven B.,64,0,70,6
1681928168889,ECON 4,A01,203351,Anderson; John Charles,6,0,10,4
1681928169916,ECON 100A,A01,180472,Famulari; Melissa,59,0,70,11
1681928170944,ECON 120A,A01,180549,Staff,62,0,70,8
1681928171968,ECON 120B,A01,180655,Ma; Xinwei,41,0,70,29
1681928172994,ECON 129,A00,203333,Eckert; Fabian Paul,11,0,35,24
1681928174021,ECON 131,A00,180656,Staff,3,0,35,32
1681928175053,ECON 172B,A01,180672,Levkoff; Steven B.,31,0,35,4
1681928176077,ECON 178,A01,203342,Zhu; Ying,5,0,35,30
1681928177101,EDS 108GS,A00,202383,Wishard Guerra; Alison G.,20,0,20,0
1681928178125,EDS 111GS,A00,202347,Wishard Guerra; Alison G.,20,0,20,0
1681928179148,EDS 112,A01,202323,Staff,53,0,60,7
1681928180176,EDS 113,A00,202340,Staff,32,0,35,3
1681928181209,EDS 118,A00,201231,Staff,19,0,30,11
1681928182240,EDS 119,A00,204994,Staff,8,0,10,2
1681928183265,EDS 124BR,A00,202324,Eguchi; Emi,0,0,25,25
1681928184298,EDS 126,A01,203208,Jones; Makeba,26,0,30,4
1681928185322,EDS 135,A01,202333,Staff,17,0,20,3
1681928186346,EDS 180,A00,202311,Staff,47,0,50,3
1681928187380,ERC 190GS,A01,253747,Staff,28,0,28,0
1681928188411,ETHN 104,A00,180742,Staff,22,0,35,13
1681928189433,ETHN 118,A00,180745,Staff,27,0,35,8
1681928190457,ETHN 127,A00,180747,Staff,8,0,16,8
1681928191498,ETHN 137,A00,180880,Staff,11,0,12,1
1681928192531,ETHN 147,A00,180890,Staff,8,0,10,2
1681928193557,ETHN 154,A00,180891,Staff,6,0,8,2
1681928194588,ETHN 168,A00,180892,Staff,9,0,10,1
1681928195610,GLBH 20,A00,201051,Hannah; Seth Donal,0,5,0,1
1681928196633,GLBH 111,A01,209338,Burgos; Jose L.,0,0,0,0
1681928197659,GLBH 150,A00,258300,Staff,0,4,0,0
1681928198691,GLBH 181,A00,201207,Staff,9,0,40,31
1681928199719,HIEU 109,A00,180898,Staff,19,0,20,1
1681928200745,HIEU 111,A00,180899,Staff,0,2,20,20
1681928201775,HIEU 124,A00,180900,Staff,17,0,20,3
1681928202811,HILA 122,A00,180901,Staff,17,0,20,3
1681928203837,HILA 132,A00,180902,Vitz; Matthew,0,1,20,20
1681928204867,HILD 10,A01,180896,Staff,14,0,20,6
1681928205892,HILD 30GS,A00,180897,Edington; Claire Ellen,0,0,0,0
1681928206915,HISC 105,A00,180903,Staff,20,0,20,0
1681928207947,HISC 117,A00,180904,Staff,10,0,20,10
1681928208970,HIUS 108B,A00,181005,Staff,18,0,20,2
1681928209993,HIUS 113,A00,181093,Staff,0,0,20,20
1681928211025,HUM 3,A01,181190,Patterson; Patrick H.,35,0,50,15
1681928211025,HUM 3,B01,181195,Staff,46,0,50,4
1681928212050,HUM 3GS,A00,181196,Herbst; Matthew,0,0,0,0
1681928213082,HUM 4,A01,181227,West; Geoffrey Scott,33,0,50,17
1681928213082,HUM 4,B01,181282,Staff,41,0,50,9
1681928214118,HUM 4GS,A00,181377,Lyon; Antony J.,0,0,0,0
1681928215149,HUM 5,A01,181536,Zavodny; Tatiana Sophia,25,0,50,25
1681928215149,HUM 5,B01,181908,Staff,35,0,50,15
1681928216174,INTL 190,A00,181909,Segui; Alan S,0,0,0,8
1681928216174,INTL 190,B00,181961,Segui; Alan S,0,0,0,7
1681928217277,JAPN 20AR,A01,182113,Ross; Kayoko F,15,0,20,5
1681928218312,LATI 50,A01,202391,Martin-Cabrera; Luis,18,0,30,12
1681928218312,LATI 50,A02,202392,Martin-Cabrera; Luis,26,0,30,4
1681928219337,LATI 180,A00,202393,Kokinis; Troy Andreas,24,0,25,1
1681928220361,LIFR 1A,A00,182119,Staff,13,0,14,1
1681928221395,LIFR 1AX,A00,182324,Staff,13,0,14,1
1681928222434,LIFR 1B,A00,182259,Staff,12,0,14,2
1681928223458,LIFR 1BX,A00,182273,Staff,12,0,14,2
1681928224483,LIGN 8,A00,182330,Staff,130,0,150,20
1681928225518,LIGN 9GS,A00,182362,Staff,15,0,20,5
1681928226545,LIGN 119,A00,204992,Takahashi; Maho,11,0,15,4
1681928227579,LIGN 130,A01,182384,Staff,47,0,50,3
1681928228611,LIGN 149GS,A00,182390,Staff,15,0,20,5
1681928229639,LIGN 170,A00,182404,Staff,23,0,30,7
1681928230662,LISP 1D,A00,182281,Staff,7,0,14,7
1681928230662,LISP 1D,B00,182287,Staff,13,0,14,1
1681928230662,LISP 1D,C00,182295,Staff,10,0,14,4
1681928230662,LISP 1D,D00,182301,Staff,14,0,14,0
1681928231688,LISP 1DX,A00,182309,Staff,19,0,28,9
1681928231688,LISP 1DX,B00,182316,Staff,25,0,28,3
1681928232710,LTAF 120GS,A00,182412,Zhiri; Oumelbanine,20,0,20,0
1681928233733,LTCS 172GS,A00,182437,Bronstein; Phoebe Malan,20,0,20,0
1681928234757,LTEA 138,A00,182457,Staff,18,0,40,22
1681928235785,LTEN 114,A01,182490,Staff,23,0,25,2
1681928236808,LTEN 130GS,A00,182491,Lyon; Antony J.,20,0,20,0
1681928237831,LTEN 169,A00,182493,Cuong; Marisol,18,0,25,7
1681928238867,LTEN 178,A00,182501,Staff,14,0,15,1
1681928239892,LTEN 181,A00,182515,Staff,19,0,25,6
1681928240915,LTEN 185GS,A00,197655,Forbes; Camille,20,0,20,0
1681928241938,LTSP 100B,A00,202208,Bessett; Ryan Matthew,24,0,25,1
1681928242963,LTWL 100,A00,182516,Myerston Santana; Jacobo,20,0,30,10
1681928243986,LTWR 100GS,A00,182518,Forbes; Camille,20,0,20,0
1681928245010,LTWR 102,A00,182522,Staff,15,0,15,0
1681928245010,LTWR 102,B00,182525,Staff,14,0,15,1
1681928246038,LTWR 115,A00,182526,Staff,10,0,15,5
1681928247062,MAE 8,A01,182528,Pham; Hieu Tan,67,0,70,3
1681928248084,MAE 11,A00,182529,Bahadori; Mohammad Yousef,92,0,100,8
1681928249107,MAE 20,A00,182530,Evdokimenko; Ekaterina,68,0,70,2
1681928250134,MAE 30A,A00,182532,Staff,44,0,45,1
1681928251157,MAE 101A,A00,182533,Bahadori; Mohammad Yousef,94,0,100,6
1681928252180,MAE 101C,A00,182538,Staff,62,0,70,8
1681928253202,MAE 104,A00,182539,Staff,44,0,50,6
1681928254225,MAE 131A,A00,182540,Ghazinejad; Maziar,40,0,45,5
1681928255251,MAE 143A,A00,182548,Bewley; Thomas R,43,0,50,7
1681928256278,MAE 150,A00,182549,Staff,28,0,40,12
1681928257305,MAE 160,A00,182550,Evdokimenko; Ekaterina,41,0,60,19
1681928258330,MATH 3C,A01,182725,Staff,24,0,30,6
1681928259360,MATH 10A,A01,182729,Staff,24,0,30,6
1681928259360,MATH 10A,B01,182732,Staff,25,0,30,5
1681928260392,MATH 10B,A01,182737,Staff,17,0,30,13
1681928260392,MATH 10B,A02,182738,Staff,26,0,30,4
1681928260392,MATH 10B,B01,182744,Staff,25,0,30,5
1681928260392,MATH 10B,B02,182745,Staff,27,0,30,3
1681928261422,MATH 18,A01,182750,Anzaldo; Leesa B,28,0,30,2
1681928261422,MATH 18,A02,182751,Anzaldo; Leesa B,28,0,30,2
1681928261422,MATH 18,A03,182753,Anzaldo; Leesa B,27,0,30,3
1681928261422,MATH 18,A04,182757,Anzaldo; Leesa B,29,0,30,1
1681928261422,MATH 18,B01,182761,Anzaldo; Leesa B,27,0,30,3
1681928261422,MATH 18,B02,182764,Anzaldo; Leesa B,26,0,30,4
1681928261422,MATH 18,B03,182765,Anzaldo; Leesa B,29,0,30,1
1681928261422,MATH 18,B04,182766,Anzaldo; Leesa B,30,0,30,0
1681928262445,MATH 20A,A01,182771,Suk; Andrew Hoon,28,0,30,2
1681928263477,MATH 20B,A01,182775,Bach; Quang Tran,30,0,30,0
1681928263477,MATH 20B,A02,182777,Bach; Quang Tran,29,0,30,1
1681928263477,MATH 20B,B01,182780,Bach; Quang Tran,26,0,30,4
1681928263477,MATH 20B,B02,182782,Bach; Quang Tran,30,0,30,0
1681928264508,MATH 20C,A01,182787,Staff,24,0,30,6
1681928264508,MATH 20C,A02,182790,Staff,29,0,30,1
1681928264508,MATH 20C,B01,182792,Staff,23,0,30,7
1681928264508,MATH 20C,B02,182796,Staff,26,0,30,4
1681928265530,MATH 20D,A01,182799,Staff,27,0,30,3
1681928265530,MATH 20D,A02,182802,Staff,29,0,30,1
1681928265530,MATH 20D,A03,182803,Staff,30,0,30,0
1681928266569,MATH 20E,A01,182809,Verstraete; Jacques Allan,21,0,30,9
1681928266569,MATH 20E,A02,182811,Verstraete; Jacques Allan,28,0,30,2
1681928266569,MATH 20E,B01,182814,Verstraete; Jacques Allan,22,0,30,8
1681928266569,MATH 20E,B02,182815,Verstraete; Jacques Allan,29,0,30,1
1681928267593,MATH 103A,A01,182820,Staff,3,0,30,27
1681928267593,MATH 103A,A02,182821,Staff,27,0,30,3
1681928267593,MATH 103A,A03,182822,Staff,22,0,30,8
1681928267593,MATH 103A,B01,182825,Staff,22,0,30,8
1681928267593,MATH 103A,B02,182826,Staff,30,0,30,0
1681928267593,MATH 103A,B03,182830,Staff,30,0,30,0
1681928268621,MATH 109,A01,182836,Chow; Bennett,23,0,30,7
1681928268621,MATH 109,A02,182838,Chow; Bennett,29,0,30,1
1681928268621,MATH 109,A03,182894,Chow; Bennett,29,0,30,1
1681928268621,MATH 109,B01,182908,Chow; Bennett,27,0,30,3
1681928268621,MATH 109,B02,182909,Chow; Bennett,30,0,30,0
1681928268621,MATH 109,B03,182910,Chow; Bennett,26,0,30,4
1681928269648,MATH 142A,A01,182925,Staff,5,0,30,25
1681928269648,MATH 142A,A02,182935,Staff,23,0,30,7
1681928269648,MATH 142A,A03,182967,Staff,26,0,30,4
1681928269648,MATH 142A,B01,183125,Staff,23,0,30,7
1681928269648,MATH 142A,B02,183157,Staff,27,0,30,3
1681928269648,MATH 142A,B03,183158,Staff,29,0,30,1
1681928270672,MATH 183,A01,183160,Arias-Castro; Ery,23,0,30,7
1681928270672,MATH 183,A02,183161,Arias-Castro; Ery,29,0,30,1
1681928270672,MATH 183,B01,183163,Arias-Castro; Ery,28,0,30,2
1681928270672,MATH 183,B02,183164,Arias-Castro; Ery,28,0,30,2
1681928271697,MATH 193A,A01,183167,Staff,0,0,35,35
1681928271697,MATH 193A,A02,183168,Staff,27,0,35,8
1681928271697,MATH 193A,A03,183169,Staff,34,0,35,1
1681928271697,MATH 193A,A04,183170,Staff,27,0,35,8
1681928272720,MGT 4,A01,202395,Anderson; John Charles,76,0,80,4
1681928273745,MGT 5,A00,202396,Houskeeper; Robert,79,0,90,11
1681928274774,MGT 103,A00,202397,Eberhard; Craig A,49,0,90,41
1681928275800,MGT 131A,A00,202398,Houskeeper; Robert,82,0,90,8
1681928276826,MGT 135,A00,202399,Anderson; John Charles,81,0,90,9
1681928277851,MGT 162R,A00,202403,Gneezy; Uri,126,0,200,74
1681928278877,MGT 172,A00,202404,Hedges; Kathleen,31,0,90,59
1681928279903,MGT 181,A00,202405,Dunn; Louis Jean,79,0,90,11
1681928280937,MMW 14,A01,183200,Staff,5,0,28,23
1681928280937,MMW 14,A02,183201,Staff,25,0,28,3
1681928280937,MMW 14,A03,183202,Staff,24,0,28,4
1681928280937,MMW 14,A04,183203,Staff,25,0,28,3
1681928280937,MMW 14,A05,183204,Staff,26,0,28,2
1681928280937,MMW 14,A06,183205,Staff,27,0,28,1
1681928280937,MMW 14,B01,183207,Staff,26,0,28,2
1681928280937,MMW 14,B02,183208,Staff,28,0,28,0
1681928280937,MMW 14,B03,183209,Staff,28,0,28,0
1681928280937,MMW 14,B04,183210,Staff,28,0,28,0
1681928280937,MMW 14,B05,183211,Staff,28,0,28,0
1681928280937,MMW 14,B06,183212,Staff,27,0,28,1
1681928281958,MMW 14GS,A00,183213,Zhiri; Oumelbanine,28,0,28,0
1681928282984,MMW 15GS,B00,183215,Rahimi; Babak,28,0,28,0
1681928284007,MMW 121,A01,183217,Patterson; Patrick H.,9,0,28,19
1681928284007,MMW 121,A02,183218,Patterson; Patrick H.,24,0,28,4
1681928285030,MUS 1A,A01,182554,Staff,3,0,35,32
1681928286062,MUS 5,A01,182558,Staff,17,0,35,18
1681928287087,MUS 6,A01,182562,Staff,22,0,35,13
1681928288110,MUS 8GS,A00,182563,Borgo; David Garcia,25,0,25,0
1681928289136,MUS 13,A01,182567,Staff,23,0,25,2
1681928290165,MUS 15,A01,182570,Staff,31,0,35,4
1681928290165,MUS 15,B01,182575,Staff,7,0,35,28
1681928291188,MUS 80,A00,182578,Staff,22,0,25,3
1681928291188,MUS 80,B00,182581,Staff,20,0,25,5
1681928292231,MUS 113,A00,182582,Staff,25,0,25,0
1681928293253,MUS 114,A00,182583,Staff,1,0,25,24
1681928294276,MUS 150GS,A01,182588,Borgo; David Garcia,24,0,25,1
1681928295307,PHIL 1,A00,182590,Staff,34,0,40,6
1681928296333,PHIL 10,A01,182596,Grush; Rick Scott,30,0,35,5
1681928296333,PHIL 10,A02,182597,Grush; Rick Scott,33,0,35,2
1681928297363,PHIL 15,A01,182601,Staff,31,0,35,4
1681928297363,PHIL 15,A02,182602,Staff,33,0,35,2
1681928298391,PHIL 27,A01,182604,Staff,28,0,35,7
1681928298391,PHIL 27,A02,182607,Staff,35,0,35,0
1681928299418,PHIL 32,A01,182609,Staff,35,0,35,0
1681928299418,PHIL 32,A02,182612,Staff,35,0,35,0
1681928300442,PHIL 130,A00,182614,Staff,58,0,70,12
1681928301468,PHIL 136,A00,182616,Cohen; Jonathan David,66,0,70,4
1681928302491,PHIL 155,A00,182617,Vargas; Manuel Rogelio,58,0,70,12
1681928303518,PHIL 163,A01,182620,Staff,15,0,20,5
1681928303518,PHIL 163,A02,182624,Staff,10,0,20,10
1681928304542,PHIL 164,A00,182627,Staff,29,0,40,11
1681928305571,PHIL 173,A00,182628,Staff,35,0,40,5
1681928306594,PHYS 1A,A00,183221,Staff,53,0,60,7
1681928307625,PHYS 1AL,001,183222,Staff,24,0,30,6
1681928307625,PHYS 1AL,002,183223,Staff,25,0,30,5
1681928308658,PHYS 1B,A00,183231,Staff,41,0,60,19
1681928309685,PHYS 1BL,001,183232,Staff,17,0,30,13
1681928309685,PHYS 1BL,002,183233,Staff,27,0,30,3
1681928310712,PHYS 1C,A00,183240,Staff,21,0,60,39
1681928311737,PHYS 1CL,001,183241,Staff,9,0,30,21
1681928311737,PHYS 1CL,002,183242,Staff,22,0,30,8
1681928312760,PHYS 2AR,A01,183250,Staff,40,0,50,10
1681928313792,PHYS 2B,A01,183252,Staff,103,0,115,12
1681928314816,PHYS 2BL,A01,183254,Staff,21,0,24,3
1681928314816,PHYS 2BL,A02,183255,Staff,21,0,24,3
1681928315843,PHYS 2C,A01,183522,Staff,101,0,115,14
1681928316872,PHYS 4A,A01,183524,Staff,49,0,50,1
1681928317898,POLI 5,A00,183525,Staff,44,0,50,6
1681928318921,POLI 12,A00,183540,Staff,45,0,50,5
1681928319949,POLI 13R,A00,183541,Forman; Fonna,40,0,50,10
1681928321050,POLI 30,A00,183542,Mignozzetti; Umberto,48,0,50,2
1681928322073,POLI 100A,A00,183543,Staff,44,0,50,6
1681928323098,POLI 100E,A00,223598,Staff,32,0,35,3
1681928324122,POLI 103A,A00,183564,Kousser; Thad,35,0,50,15
1681928325146,POLI 104B,A00,201329,Staff,28,0,35,7
1681928326171,POLI 113BR,A00,183576,Hoston; Germaine,22,0,50,28
1681928327207,POLI 114BR,A00,183588,Staff,27,0,30,3
1681928328233,POLI 117R,A00,183595,Forman; Fonna,4,0,20,16
1681928329262,POLI 120H,A00,183596,Fisk; David Lee,14,0,20,6
1681928330289,POLI 130AA,A00,183597,Staff,13,0,20,7
1681928331314,POLI 134AA,A00,183598,Staff,19,0,20,1
1681928332345,POLI 135,A00,183599,Fisk; David Lee,19,0,25,6
1681928333367,POLI 142P,A00,183623,Staff,37,0,40,3
1681928334393,POLI 144D,A00,183624,Staff,22,0,25,3
1681928335426,POLI 151,A00,183625,Staff,15,0,20,5
1681928336452,POLI 162,A00,183626,Mignozzetti; Umberto,17,0,20,3
1681928337474,PSYC 1,A00,253748,Staff,86,0,90,4
1681928338499,PSYC 2,A00,183627,Moranton; Nirelia Melbina-,24,0,35,11
1681928339530,PSYC 3,A00,183628,Staff,43,0,45,2
1681928341580,PSYC 60,A01,183631,Lowe; Angela Beth,35,0,40,5
1681928342616,PSYC 70,A01,253757,Staff,36,0,45,9
1681928343647,PSYC 101,A00,183632,Heyman; Gail D.,43,0,60,17
1681928344683,PSYC 105,A00,183848,Lowe; Angela Beth,46,0,60,14
1681928345715,PSYC 106,A00,183849,Dobkins; Karen R.,39,0,60,21
1681928346749,PSYC 108,A00,253750,Staff,14,0,60,46
1681928347780,PSYC 114,A01,184275,Winkielman; Piotr,0,8,30,30
1681928348820,PSYC 122,A00,183856,Moranton; Nirelia Melbina-,0,16,30,30
1681928349849,PSYC 124,A00,183865,Chapman; Eddie Nathaniel,43,0,80,37
1681928350877,PSYC 137,A00,183880,Staff,17,0,25,8
1681928352931,PSYC 154,A00,183910,Lacefield; Katharine I,0,25,90,90
1681928354979,PSYC 162,A00,183946,Wixted; John T,42,0,90,48
1681928356011,PSYC 172,A00,183947,Gorman; Michael R.,6,0,30,24
1681928357034,PSYC 178,A00,183963,Glaser; Dale,15,0,40,25
1681928358056,PSYC 181GS,A00,183964,Anagnostaras; Stephan,10,0,10,0
1681928359095,PSYC 186GS,A01,257660,Staff,10,0,10,0
1681928360119,PSYC 193,B00,253749,Staff,22,0,25,3
1681928362173,PSYC 193L,A01,184122,Staff,33,0,35,2
1681928362173,PSYC 193L,C01,184167,Winkielman; Piotr,14,0,30,16
1681928363204,RELI 188GS,A00,182629,Rahimi; Babak,20,0,20,0
1681928364248,SE 101A,A00,182646,Staff,26,0,30,4
1681928365271,SE 101C,A00,182650,Staff,12,0,20,8
1681928366309,SE 110A,A00,182651,Staff,28,0,28,0
1681928367333,SE 130A,A00,182652,Staff,38,0,40,2
1681928368366,SIO 46GS,A00,182636,Cook; Geoffrey W,25,0,28,3
1681928369391,SIO 109R,A00,194459,Staff,1,0,20,19
1681928370415,SIO 121GS,A00,182639,Cook; Geoffrey W,25,0,28,3
1681928371438,SIO 132,A01,182642,Staff,30,0,40,10
1681928372462,SIO 139,A00,182644,Kacev; David,36,0,40,4
1681928373489,SOCI 2,A01,258404,Staff,33,0,36,3
1681928373489,SOCI 2,A02,258405,Staff,35,0,36,1
1681928374521,SOCI 60,A01,258408,Staff,29,0,30,1
1681928374521,SOCI 60,A02,258413,Staff,30,0,30,0
1681928375550,SOCI 100,A01,258415,Staff,29,0,30,1
1681928375550,SOCI 100,A02,258416,Staff,28,0,30,2
1681928381713,SOCI 127,A00,258421,Staff,19,0,30,11
1681928382738,SOCI 132,A00,258422,Staff,44,0,50,6
1681928383764,SOCI 133,A00,258423,Staff,26,0,30,4
1681928384789,SOCI 138GS,A00,258424,Staff,15,0,15,0
1681928385812,SOCI 145,A00,258425,Staff,24,0,30,6
1681928386835,SOCI 148,A00,258426,Staff,24,0,30,6
1681928387865,SOCI 153,A00,199217,Staff,29,0,30,1
1681928388901,SOCI 160,A00,258427,Staff,27,0,30,3
1681928389925,SOCI 160E,A00,258435,Staff,56,0,60,4
1681928390956,SOCI 189GS,A00,258436,Staff,15,0,15,0
1681928391978,SOCI 190GS,A00,258437,Staff,15,0,15,0
1681928393001,SYN 2,001,182658,Staff,8,0,16,8
1681928393001,SYN 2,002,201439,Staff,14,0,16,2
1681928393001,SYN 2,003,201443,Staff,16,0,16,0
1681928394026,SYN 100,A01,182657,Staff,13,0,20,7
1681928395050,TDAC 1,A00,184381,Salovey; Todd,16,0,20,4
1681928395050,TDAC 1,B00,184385,Harting; Carla Kelso,19,0,20,1
1681928395050,TDAC 1,C00,184394,Staff,18,0,20,2
1681928396089,TDAC 101,A00,184483,Harting; Carla Kelso,19,0,20,1
1681928397111,TDDE 111,A00,184496,Staff,14,0,15,1
1681928398134,TDDE 131,A00,184504,Staff,20,0,20,0
1681928398134,TDDE 131,B00,184505,Staff,17,0,18,1
1681928398134,TDDE 131,C00,184534,Staff,49,0,50,1
1681928398134,TDDE 131,D00,184564,Staff,15,0,15,0
1681928398134,TDDE 131,E00,204725,Staff,18,0,20,2
1681928399165,TDGE 1,A01,184414,Salovey; Todd,35,0,50,15
1681928400190,TDGE 5,A01,184419,Staff,23,0,24,1
1681928401217,TDGE 10,A00,184428,Fulton; Julia,27,0,50,23
1681928402240,TDGE 124,A00,184565,Fulton; Julia,0,0,50,50
1681928403274,TDGE 125,B00,184567,Meyer; Ursula,9,0,25,16
1681928404297,TDHT 101,A00,184568,Staff,21,0,25,4
1681928404297,TDHT 101,B00,184569,Staff,20,0,20,0
1681928405321,TDHT 114,A00,184570,Staff,49,0,50,1
1681928406344,TDMV 1,A00,184437,Arcidiacono; Kristin,21,0,30,9
1681928406344,TDMV 1,B00,184448,Caligagan; Maria T.,23,0,30,7
1681928407373,TDMV 2,A00,184449,Weinberg; Sadie,27,0,30,3
1681928407373,TDMV 2,B00,184453,Arcidiacono; Kristin,29,0,30,1
1681928408395,TDMV 110,A00,184571,Weinberg; Sadie,30,0,30,0
1681928409418,TDMV 142,A00,184572,Caligagan; Tony,26,0,30,4
1681928409418,TDMV 142,B00,184573,Caligagan; Maria T.,26,0,30,4
1681928410447,TDTR 20,A00,184482,Jun; Grace Shin Hae,25,0,25,0
1681928411470,USP 2,A01,184290,Hinds; Juli Beth,24,0,25,1
1681928412496,USP 3,A01,184295,Staff,21,0,25,4
1681928413520,USP 4,A00,184304,McTague; Sarah,13,0,25,12
1681928414543,USP 100,A00,184315,Staff,16,0,25,9
1681928415582,USP 105,A00,184326,Staff,21,0,25,4
1681928416625,USP 151,A00,184327,Staff,18,0,25,7
1681928417646,USP 170,A00,184380,Hinds; Juli Beth,13,0,25,12
1681928418681,VIS 21B,A01,182660,Staff,28,0,31,3
1681928418681,VIS 21B,A02,182662,Staff,30,0,31,1
1681928419707,VIS 103D,A00,182663,Staff,74,0,75,1
1681928420731,VIS 105D,A00,182667,Li; Huai,14,0,22,8
1681928421753,VIS 122GS,A00,182668,Herbst; Matthew,20,0,20,0
1681928422779,VIS 128C,A00,182673,Staff,69,0,75,6
1681928423802,VIS 130,A00,182675,Staff,19,0,22,3
1681928424908,VIS 160A,A00,182678,Stalbaum; Brett,4,0,10,6
1681928426973,WCWP 10B,A00,201679,Staff,15,0,15,0
1681928426973,WCWP 10B,B00,201695,Staff,15,0,15,0
1681928427994,WCWP 100,A00,201716,Staff,12,0,15,3
1681928427994,WCWP 100,B00,201717,Staff,0,0,15,15
1681928430078,ANSC 105GS,A00,258289,Staff,0,0,0,0
1681928431103,ANSC 125GS,A00,258295,Staff,0,0,0,0
1681928432125,ANSC 150,A00,258267,Staff,28,0,40,12
1681928433147,ANSC 190GS,A00,258280,Staff,0,0,0,0
1681928434178,ANTH 1,A00,258264,Staff,38,0,40,2
1681928435203,ANTH 2,A01,258259,Staff,72,0,76,4
1681928436235,ANTH 23,A01,258228,Staff,36,0,40,4
1681928437268,ANTH 101,A01,258236,Staff,38,0,40,2
1681928438303,ANTH 102,A00,258272,Staff,59,0,60,1
1681928439333,ANTH 105,A00,258244,Staff,29,0,35,6
1681928440365,BENG 130,A00,253975,Staff,37,0,40,3
1681928441391,BIBC 102,A01,191866,Flagg; Matthew Paul,16,0,32,16
1681928441391,BIBC 102,A02,191867,Flagg; Matthew Paul,21,0,32,11
1681928441391,BIBC 102,A03,191868,Flagg; Matthew Paul,29,0,32,3
1681928441391,BIBC 102,A04,191936,Flagg; Matthew Paul,22,0,32,10
1681928441391,BIBC 102,A05,191937,Flagg; Matthew Paul,0,0,32,32
1681928442413,BICD 100,A01,191939,Cooper; Andrew Michael,27,0,32,5
1681928442413,BICD 100,A02,191940,Cooper; Andrew Michael,32,0,32,0
1681928442413,BICD 100,A03,191941,Cooper; Andrew Michael,32,0,32,0
1681928442413,BICD 100,A04,191942,Cooper; Andrew Michael,32,0,32,0
1681928442413,BICD 100,A05,191943,Cooper; Andrew Michael,32,0,32,0
1681928443459,BIEB 126,A01,191945,Cleland; Elsa Eleanor,0,2,32,32
1681928443459,BIEB 126,A02,191946,Cleland; Elsa Eleanor,26,0,32,6
1681928443459,BIEB 126,A03,191947,Cleland; Elsa Eleanor,29,0,32,3
1681928443459,BIEB 126,A04,191948,Cleland; Elsa Eleanor,17,0,32,15
1681928443459,BIEB 126,A05,191996,Cleland; Elsa Eleanor,28,0,32,4
1681928444497,BIEB 136GS,A00,191997,Shurin; Jonathan & Holway; David A.,0,0,0,8
1681928445522,BIEB 137GS,A01,191999,Shurin; Jonathan & Holway; David A.,0,0,0,7
1681928446558,BILD 1,A01,205385,Staff,30,0,32,2
1681928446558,BILD 1,A02,205386,Staff,30,0,32,2
1681928446558,BILD 1,A03,205387,Staff,31,0,32,1
1681928446558,BILD 1,A04,205388,Staff,26,0,32,6
1681928447580,BILD 2,A01,191774,Staff,27,0,32,5
1681928447580,BILD 2,A02,191775,Staff,30,0,32,2
1681928447580,BILD 2,A03,191777,Staff,30,0,32,2
1681928447580,BILD 2,A04,191856,Staff,30,0,32,2
1681928447580,BILD 2,A05,191857,Staff,31,0,32,1
1681928447580,BILD 2,A06,191858,Staff,32,0,32,0
1681928447580,BILD 2,A07,191859,Staff,31,0,32,1
1681928448611,BILD 3,A01,205391,Staff,28,0,32,4
1681928448611,BILD 3,A02,205393,Staff,32,0,32,0
1681928448611,BILD 3,A03,205394,Staff,27,0,32,5
1681928448611,BILD 3,A04,205395,Staff,32,0,32,0
1681928449647,BILD 20,A01,191861,Staff,32,0,32,0
1681928449647,BILD 20,A02,191862,Staff,32,0,32,0
1681928450670,BILD 30,A01,191864,Staff,31,0,32,1
1681928451692,BIMM 100,A01,192019,Staff,0,0,32,32
1681928451692,BIMM 100,A02,192020,Staff,18,0,32,14
1681928451692,BIMM 100,A03,192035,Staff,18,0,32,14
1681928452716,BIMM 110,A01,192037,Tat; John,0,0,32,32
1681928452716,BIMM 110,A02,192038,Tat; John,5,0,32,27
1681928453742,BIMM 120,A01,192040,Pickett; Brooke Elizabeth,0,0,32,32
1681928453742,BIMM 120,A02,192041,Pickett; Brooke Elizabeth,9,0,32,23
1681928453742,BIMM 120,A03,192042,Pickett; Brooke Elizabeth,14,0,32,18
1681928454769,BIPN 100,A01,192044,Armour; Jon Christopher,23,0,32,9
1681928454769,BIPN 100,A02,192059,Armour; Jon Christopher,30,0,32,2
1681928454769,BIPN 100,A03,192064,Armour; Jon Christopher,30,0,32,2
1681928454769,BIPN 100,A04,192073,Armour; Jon Christopher,26,0,32,6
1681928455806,BIPN 148,A01,205411,Leutgeb; Jill K.,15,0,32,17
1681928455806,BIPN 148,A02,205412,Leutgeb; Jill K.,31,0,32,1
1681928455806,BIPN 148,A03,205413,Leutgeb; Jill K.,30,0,32,2
1681928455806,BIPN 148,A04,205414,Leutgeb; Jill K.,30,0,32,2
1681928456832,BIPN 160,A01,192115,Marino; Marc J,15,0,32,17
1681928456832,BIPN 160,A02,192148,Marino; Marc J,27,0,32,5
1681928456832,BIPN 160,A03,192158,Marino; Marc J,31,0,32,1
1681928456832,BIPN 160,A04,192190,Marino; Marc J,32,0,32,0
1681928456832,BIPN 160,A05,192287,Marino; Marc J,32,0,32,0
1681928456832,BIPN 160,A06,192288,Marino; Marc J,32,0,32,0
1681928457858,BIPN 194,A00,206038,Staff,28,0,32,4
1681928458886,BISP 194,A00,192289,Leutgeb; Stefan,11,0,32,21
1681928458886,BISP 194,B00,245332,Nieh; James Charles,26,0,32,6
1681928459910,CAT 124,A01,202247,Staff,15,0,15,0
1681928460940,CAT 125,A00,202248,Staff,18,0,20,2
1681928460940,CAT 125,B00,202253,Staff,20,0,20,0
1681928460940,CAT 125,C00,202257,Staff,18,0,20,2
1681928461982,CAT 125GS,A01,202273,Bronstein; Phoebe Malan,20,0,20,0
1681928463009,CAT 125R,A00,202284,Staff,17,0,20,3
1681928463009,CAT 125R,C00,202286,Staff,5,0,20,15
1681928463009,CAT 125R,D00,202291,Staff,17,0,20,3
1681928463009,CAT 125R,E00,202295,Staff,13,0,20,7
1681928463009,CAT 125R,F00,202302,Staff,7,0,20,13
1681928464050,CENG 100,A00,204724,Opatkiewicz; Justin Paul,25,0,25,0
1681928465075,CGS 2A,A01,180420,Staff,30,0,36,6
1681928466103,CGS 101,A00,180421,Staff,16,0,20,4
1681928467126,CGS 112,A00,180422,Staff,9,0,16,7
1681928468148,CGS 113,A00,180423,Staff,18,0,20,2
1681928469173,CGS 137,A00,180424,Staff,12,0,12,0
1681928470202,CGS 147,A00,180425,Staff,10,0,10,0
1681928471226,CHEM 6A,A01,179556,Staff,93,0,100,7
1681928471226,CHEM 6A,A02,179558,Staff,0,0,0,0
1681928472249,CHEM 6B,A01,179560,Staff,100,0,100,0
1681928473272,CHEM 6C,A01,179565,Jazzar; Rodolphe,93,0,100,7
1681928474304,CHEM 7L,A01,179586,Schurmeier; Kimberly,10,0,24,14
1681928474304,CHEM 7L,A02,179587,Schurmeier; Kimberly,23,0,24,1
1681928474304,CHEM 7L,A03,179590,Schurmeier; Kimberly,22,0,24,2
1681928474304,CHEM 7L,A04,179591,Schurmeier; Kimberly,22,0,24,2
1681928474304,CHEM 7L,B01,179598,Schurmeier; Kimberly,16,0,24,8
1681928474304,CHEM 7L,B02,179599,Schurmeier; Kimberly,24,0,24,0
1681928474304,CHEM 7L,B03,179606,Schurmeier; Kimberly,22,0,24,2
1681928474304,CHEM 7L,B04,179607,Schurmeier; Kimberly,22,0,24,2
1681928475329,CHEM 11,A01,179609,Stallings; Dontarie M,87,0,100,13
1681928476355,CHEM 40A,A01,179621,Staff,40,0,50,10
1681928476355,CHEM 40A,A02,179622,Staff,46,0,50,4
1681928477379,CHEM 40B,A01,179630,Weizman; Haim,47,0,50,3
1681928477379,CHEM 40B,A02,179631,Weizman; Haim,44,0,50,6
1681928478409,CHEM 41A,A01,179660,Klosterman; Jeremy K,93,0,100,7
1681928479432,CHEM 43A,A01,179683,Klosterman; Jeremy K,0,0,24,24
1681928479432,CHEM 43A,A02,179688,Klosterman; Jeremy K,8,0,24,16
1681928479432,CHEM 43A,A03,179689,Klosterman; Jeremy K,18,0,24,6
1681928479432,CHEM 43A,A04,179691,Klosterman; Jeremy K,18,0,24,6
1681928480460,CHEM 114A,A01,179693,Stallings; Dontarie M,68,0,100,32
1681928481489,CHEM 143B,A01,179698,Weizman; Haim,16,0,24,8
1681928481489,CHEM 143B,A02,179700,Weizman; Haim,24,0,24,0
1681928482514,CHIN 169A,A00,179701,Wang; Xiao,20,0,20,0
1681928483537,COGS 2,A01,179750,Boyle; Mary E. T.,17,0,30,13
1681928484560,COGS 9,A01,179759,Jones; Cameron Robert,40,0,50,10
1681928485582,COGS 14A,A01,179854,Staff,14,0,50,36
1681928486623,COGS 14B,A01,179856,Staff,52,0,60,8
1681928487648,COGS 17,A01,179874,Staff,71,0,75,4
1681928488670,COGS 18,A01,179884,Staff,59,0,80,21
1681928489699,COGS 100,A01,179886,Staff,33,0,60,27
1681928490724,COGS 101B,A01,179892,Staff,0,2,30,30
1681928491751,COGS 101C,A01,179894,Staff,27,0,30,3
1681928492776,COGS 107A,A01,179896,Boyle; Mary E. T.,29,0,40,11
1681928493803,COGS 108,A01,179898,Simpkins; Charles Alexander,0,30,60,60
1681928494830,COGS 109,A01,179900,Staff,32,0,40,8
1681928495853,COGS 118A,A01,179946,Staff,5,0,40,35
1681928496876,COGS 153,A00,179978,Staff,0,6,30,30
1681928497902,COGS 156,A01,179981,Staff,21,0,30,9
1681928499953,COGS 172,A01,179987,Staff,10,0,30,20
1681928502001,COGS 186,A01,179991,Staff,11,0,30,19
1681928503027,COMM 10,A01,180001,Staff,12,0,25,13
1681928503027,COMM 10,A02,180004,Staff,20,0,25,5
1681928504049,COMM 100A,A01,180016,Staff,13,0,25,12
1681928504049,COMM 100A,A02,180020,Staff,24,0,25,1
1681928505080,COMM 101T,A00,180029,Halm; Gavin Patrick,21,0,35,14
1681928506108,COMM 106V,A00,180043,Staff,34,0,35,1
1681928507138,COMM 109P,A00,180044,Staff,30,0,35,5
1681928508163,COMM 113T,A00,180045,Havis; Allan,37,0,45,8
1681928509190,COMM 132,A00,180046,McKenna; Denise,22,0,30,8
1681928510211,COMM 143,A00,180047,Staff,16,0,30,14
1681928511239,COMM 190,A00,180048,Conner; Thomas Hartnell,18,0,23,5
1681928512265,CSE 8A,A50,180053,Cao; Yingjun,21,0,50,29
1681928512265,CSE 8A,B50,180180,Staff,50,0,50,0
1681928513291,CSE 11,A01,180190,Cao; Yingjun,21,0,50,29
1681928514317,CSE 20,A01,180192,Briones; Jor-el Thomas Caparas,21,0,30,9
1681928515353,CSE 21,A01,194538,Briones; Jor-el Thomas Caparas,50,0,60,10
1681928516376,CSE 30,A01,180324,Eldon; John,74,0,100,26
1681928517400,CSE 101,A01,201353,Staff,0,27,40,40
1681928518422,CSE 134B,A01,180326,Powell; Thomas Allan,73,0,100,27
1681928519457,CSE 140,A01,180328,Staff,26,0,75,49
1681928520482,CSE 140L,A01,180344,Eldon; John,50,0,100,50
1681928521505,CSE 150A,A01,180411,Staff,0,18,50,50
1681928522536,CSE 151A,A01,180414,Staff,0,13,50,50
1681928523584,CSE 175,A01,222521,Kumar; Rakesh,50,0,50,0
1681928524617,CSE 190,A00,201419,Staff,42,0,49,7
1681928525641,CSS 1,A01,194536,Staff,34,0,50,16
1681928526668,DSC 30,A01,202385,Staff,48,0,50,2
1681928527698,DSC 40A,A01,202387,Albuyeh; Rod,50,0,50,0
1681928528795,DSC 190,A01,202389,Silberman; Jack,21,0,21,0
1681928529821,DSGN 100,A01,179993,Staff,13,0,30,17
1681928530848,ECE 65,A50,180708,Staff,10,0,20,10
1681928530848,ECE 65,A51,180739,Staff,19,0,20,1
1681928531872,ECON 1,A01,180427,Famulari; Melissa,66,0,70,4
1681928532894,ECON 2,A01,180450,Levkoff; Steven B.,64,0,70,6
1681928533918,ECON 4,A01,203351,Anderson; John Charles,6,0,10,4
1681928534945,ECON 100A,A01,180472,Famulari; Melissa,59,0,70,11
1681928535971,ECON 120A,A01,180549,Staff,62,0,70,8
1681928537001,ECON 120B,A01,180655,Ma; Xinwei,41,0,70,29
1681928538025,ECON 129,A00,203333,Eckert; Fabian Paul,11,0,35,24
1681928539056,ECON 131,A00,180656,Staff,2,0,35,33
1681928540079,ECON 172B,A01,180672,Levkoff; Steven B.,31,0,35,4
1681928541103,ECON 178,A01,203342,Zhu; Ying,5,0,35,30
1681928542125,EDS 108GS,A00,202383,Wishard Guerra; Alison G.,20,0,20,0
1681928543150,EDS 111GS,A00,202347,Wishard Guerra; Alison G.,20,0,20,0
1681928544178,EDS 112,A01,202323,Staff,53,0,60,7
1681928545219,EDS 113,A00,202340,Staff,32,0,35,3
1681928546255,EDS 118,A00,201231,Staff,19,0,30,11
1681928547302,EDS 119,A00,204994,Staff,8,0,10,2
1681928548332,EDS 124BR,A00,202324,Eguchi; Emi,0,0,25,25
1681928549355,EDS 126,A01,203208,Jones; Makeba,26,0,30,4
1681928550378,EDS 135,A01,202333,Staff,17,0,20,3
1681928551403,EDS 180,A00,202311,Staff,47,0,50,3
1681928552430,ERC 190GS,A01,253747,Staff,28,0,28,0
1681928553453,ETHN 104,A00,180742,Staff,22,0,35,13
1681928554476,ETHN 118,A00,180745,Staff,27,0,35,8
1681928555499,ETHN 127,A00,180747,Staff,8,0,16,8
1681928556523,ETHN 137,A00,180880,Staff,11,0,12,1
1681928557570,ETHN 147,A00,180890,Staff,8,0,10,2
1681928558598,ETHN 154,A00,180891,Staff,6,0,8,2
1681928559620,ETHN 168,A00,180892,Staff,9,0,10,1
1681928560642,GLBH 20,A00,201051,Hannah; Seth Donal,0,5,0,1
1681928561674,GLBH 111,A01,209338,Burgos; Jose L.,0,0,0,0
1681928562704,GLBH 150,A00,258300,Staff,0,4,0,0
1681928563727,GLBH 181,A00,201207,Staff,9,0,40,31
1681928564757,HIEU 109,A00,180898,Staff,19,0,20,1
1681928565779,HIEU 111,A00,180899,Staff,0,2,20,20
1681928566806,HIEU 124,A00,180900,Staff,17,0,20,3
1681928567869,HILA 122,A00,180901,Staff,17,0,20,3
1681928568898,HILA 132,A00,180902,Vitz; Matthew,0,1,20,20
1681928569920,HILD 10,A01,180896,Staff,14,0,20,6
1681928570945,HILD 30GS,A00,180897,Edington; Claire Ellen,0,0,0,0
1681928571968,HISC 105,A00,180903,Staff,20,0,20,0
1681928572994,HISC 117,A00,180904,Staff,10,0,20,10
1681928574029,HIUS 108B,A00,181005,Staff,18,0,20,2
1681928575056,HIUS 113,A00,181093,Staff,0,0,20,20
1681928576086,HUM 3,A01,181190,Patterson; Patrick H.,35,0,50,15
1681928576086,HUM 3,B01,181195,Staff,46,0,50,4
1681928577120,HUM 3GS,A00,181196,Herbst; Matthew,0,0,0,0
1681928578146,HUM 4,A01,181227,West; Geoffrey Scott,33,0,50,17
1681928578146,HUM 4,B01,181282,Staff,41,0,50,9
1681928579168,HUM 4GS,A00,181377,Lyon; Antony J.,0,0,0,0
1681928580209,HUM 5,A01,181536,Zavodny; Tatiana Sophia,25,0,50,25
1681928580209,HUM 5,B01,181908,Staff,34,0,50,16
1681928581240,INTL 190,A00,181909,Segui; Alan S,0,0,0,8
1681928581240,INTL 190,B00,181961,Segui; Alan S,0,0,0,7
1681928582268,JAPN 20AR,A01,182113,Ross; Kayoko F,15,0,20,5
1681928583295,LATI 50,A01,202391,Martin-Cabrera; Luis,18,0,30,12
1681928583295,LATI 50,A02,202392,Martin-Cabrera; Luis,26,0,30,4
1681928584322,LATI 180,A00,202393,Kokinis; Troy Andreas,24,0,25,1
1681928585350,LIFR 1A,A00,182119,Staff,13,0,14,1
1681928586376,LIFR 1AX,A00,182324,Staff,13,0,14,1
1681928587404,LIFR 1B,A00,182259,Staff,12,0,14,2
1681928588429,LIFR 1BX,A00,182273,Staff,12,0,14,2
1681928589456,LIGN 8,A00,182330,Staff,129,0,150,21
1681928590482,LIGN 9GS,A00,182362,Staff,15,0,20,5
1681928591505,LIGN 119,A00,204992,Takahashi; Maho,11,0,15,4
1681928592530,LIGN 130,A01,182384,Staff,47,0,50,3
1681928593555,LIGN 149GS,A00,182390,Staff,15,0,20,5
1681928594581,LIGN 170,A00,182404,Staff,23,0,30,7
1681928595607,LISP 1D,A00,182281,Staff,7,0,14,7
1681928595607,LISP 1D,B00,182287,Staff,13,0,14,1
1681928595607,LISP 1D,C00,182295,Staff,10,0,14,4
1681928595607,LISP 1D,D00,182301,Staff,14,0,14,0
1681928596633,LISP 1DX,A00,182309,Staff,19,0,28,9
1681928596633,LISP 1DX,B00,182316,Staff,25,0,28,3
1681928597655,LTAF 120GS,A00,182412,Zhiri; Oumelbanine,20,0,20,0
1681928598677,LTCS 172GS,A00,182437,Bronstein; Phoebe Malan,20,0,20,0
1681928599701,LTEA 138,A00,182457,Staff,18,0,40,22
1681928600726,LTEN 114,A01,182490,Staff,23,0,25,2
1681928601750,LTEN 130GS,A00,182491,Lyon; Antony J.,20,0,20,0
1681928602773,LTEN 169,A00,182493,Cuong; Marisol,18,0,25,7
1681928603801,LTEN 178,A00,182501,Staff,14,0,15,1
1681928604842,LTEN 181,A00,182515,Staff,19,0,25,6
1681928605864,LTEN 185GS,A00,197655,Forbes; Camille,20,0,20,0
1681928606888,LTSP 100B,A00,202208,Bessett; Ryan Matthew,24,0,25,1
1681928607913,LTWL 100,A00,182516,Myerston Santana; Jacobo,20,0,30,10
1681928608940,LTWR 100GS,A00,182518,Forbes; Camille,20,0,20,0
1681928609972,LTWR 102,A00,182522,Staff,15,0,15,0
1681928609972,LTWR 102,B00,182525,Staff,14,0,15,1
1681928610996,LTWR 115,A00,182526,Staff,10,0,15,5
1681928612024,MAE 8,A01,182528,Pham; Hieu Tan,67,0,70,3
1681928613047,MAE 11,A00,182529,Bahadori; Mohammad Yousef,91,0,100,9
1681928614074,MAE 20,A00,182530,Evdokimenko; Ekaterina,68,0,70,2
1681928615098,MAE 30A,A00,182532,Staff,44,0,45,1
1681928616123,MAE 101A,A00,182533,Bahadori; Mohammad Yousef,94,0,100,6
1681928617158,MAE 101C,A00,182538,Staff,62,0,70,8
1681928618185,MAE 104,A00,182539,Staff,44,0,50,6
1681928619223,MAE 131A,A00,182540,Ghazinejad; Maziar,40,0,45,5
1681928620246,MAE 143A,A00,182548,Bewley; Thomas R,43,0,50,7
1681928621277,MAE 150,A00,182549,Staff,28,0,40,12
1681928622301,MAE 160,A00,182550,Evdokimenko; Ekaterina,41,0,60,19
1681928623328,MATH 3C,A01,182725,Staff,24,0,30,6
1681928624355,MATH 10A,A01,182729,Staff,24,0,30,6
1681928624355,MATH 10A,B01,182732,Staff,25,0,30,5
1681928625388,MATH 10B,A01,182737,Staff,17,0,30,13
1681928625388,MATH 10B,A02,182738,Staff,26,0,30,4
1681928625388,MATH 10B,B01,182744,Staff,25,0,30,5
1681928625388,MATH 10B,B02,182745,Staff,27,0,30,3
1681928626413,MATH 18,A01,182750,Anzaldo; Leesa B,28,0,30,2
1681928626413,MATH 18,A02,182751,Anzaldo; Leesa B,28,0,30,2
1681928626413,MATH 18,A03,182753,Anzaldo; Leesa B,27,0,30,3
1681928626413,MATH 18,A04,182757,Anzaldo; Leesa B,29,0,30,1
1681928626413,MATH 18,B01,182761,Anzaldo; Leesa B,27,0,30,3
1681928626413,MATH 18,B02,182764,Anzaldo; Leesa B,26,0,30,4
1681928626413,MATH 18,B03,182765,Anzaldo; Leesa B,29,0,30,1
1681928626413,MATH 18,B04,182766,Anzaldo; Leesa B,30,0,30,0
1681928627436,MATH 20A,A01,182771,Suk; Andrew Hoon,28,0,30,2
1681928628461,MATH 20B,A01,182775,Bach; Quang Tran,30,0,30,0
1681928628461,MATH 20B,A02,182777,Bach; Quang Tran,29,0,30,1
1681928628461,MATH 20B,B01,182780,Bach; Quang Tran,26,0,30,4
1681928628461,MATH 20B,B02,182782,Bach; Quang Tran,30,0,30,0
1681928629489,MATH 20C,A01,182787,Staff,24,0,30,6
1681928629489,MATH 20C,A02,182790,Staff,29,0,30,1
1681928629489,MATH 20C,B01,182792,Staff,23,0,30,7
1681928629489,MATH 20C,B02,182796,Staff,26,0,30,4
1681928630517,MATH 20D,A01,182799,Staff,27,0,30,3
1681928630517,MATH 20D,A02,182802,Staff,29,0,30,1
1681928630517,MATH 20D,A03,182803,Staff,30,0,30,0
1681928631554,MATH 20E,A01,182809,Verstraete; Jacques Allan,20,0,30,10
1681928631554,MATH 20E,A02,182811,Verstraete; Jacques Allan,28,0,30,2
1681928631554,MATH 20E,B01,182814,Verstraete; Jacques Allan,21,0,30,9
1681928631554,MATH 20E,B02,182815,Verstraete; Jacques Allan,29,0,30,1
1681928632676,MATH 103A,A01,182820,Staff,3,0,30,27
1681928632676,MATH 103A,A02,182821,Staff,27,0,30,3
1681928632676,MATH 103A,A03,182822,Staff,22,0,30,8
1681928632676,MATH 103A,B01,182825,Staff,22,0,30,8
1681928632676,MATH 103A,B02,182826,Staff,30,0,30,0
1681928632676,MATH 103A,B03,182830,Staff,30,0,30,0
1681928633701,MATH 109,A01,182836,Chow; Bennett,23,0,30,7
1681928633701,MATH 109,A02,182838,Chow; Bennett,29,0,30,1
1681928633701,MATH 109,A03,182894,Chow; Bennett,29,0,30,1
1681928633701,MATH 109,B01,182908,Chow; Bennett,27,0,30,3
1681928633701,MATH 109,B02,182909,Chow; Bennett,30,0,30,0
1681928633701,MATH 109,B03,182910,Chow; Bennett,26,0,30,4
1681928634729,MATH 142A,A01,182925,Staff,5,0,30,25
1681928634729,MATH 142A,A02,182935,Staff,23,0,30,7
1681928634729,MATH 142A,A03,182967,Staff,26,0,30,4
1681928634729,MATH 142A,B01,183125,Staff,23,0,30,7
1681928634729,MATH 142A,B02,183157,Staff,27,0,30,3
1681928634729,MATH 142A,B03,183158,Staff,29,0,30,1
1681928635757,MATH 183,A01,183160,Arias-Castro; Ery,23,0,30,7
1681928635757,MATH 183,A02,183161,Arias-Castro; Ery,29,0,30,1
1681928635757,MATH 183,B01,183163,Arias-Castro; Ery,28,0,30,2
1681928635757,MATH 183,B02,183164,Arias-Castro; Ery,28,0,30,2
1681928636789,MATH 193A,A01,183167,Staff,0,0,35,35
1681928636789,MATH 193A,A02,183168,Staff,26,0,35,9
1681928636789,MATH 193A,A03,183169,Staff,34,0,35,1
1681928636789,MATH 193A,A04,183170,Staff,27,0,35,8
1681928637813,MGT 4,A01,202395,Anderson; John Charles,76,0,80,4
1681928638843,MGT 5,A00,202396,Houskeeper; Robert,79,0,90,11
1681928639865,MGT 103,A00,202397,Eberhard; Craig A,49,0,90,41
1681928640893,MGT 131A,A00,202398,Houskeeper; Robert,82,0,90,8
1681928641928,MGT 135,A00,202399,Anderson; John Charles,81,0,90,9
1681928642955,MGT 162R,A00,202403,Gneezy; Uri,124,0,200,76
1681928643981,MGT 172,A00,202404,Hedges; Kathleen,31,0,90,59
1681928645008,MGT 181,A00,202405,Dunn; Louis Jean,79,0,90,11
1681928646032,MMW 14,A01,183200,Staff,5,0,28,23
1681928646032,MMW 14,A02,183201,Staff,25,0,28,3
1681928646032,MMW 14,A03,183202,Staff,24,0,28,4
1681928646032,MMW 14,A04,183203,Staff,25,0,28,3
1681928646032,MMW 14,A05,183204,Staff,26,0,28,2
1681928646032,MMW 14,A06,183205,Staff,27,0,28,1
1681928646032,MMW 14,B01,183207,Staff,26,0,28,2
1681928646032,MMW 14,B02,183208,Staff,28,0,28,0
1681928646032,MMW 14,B03,183209,Staff,28,0,28,0
1681928646032,MMW 14,B04,183210,Staff,28,0,28,0
1681928646032,MMW 14,B05,183211,Staff,28,0,28,0
1681928646032,MMW 14,B06,183212,Staff,27,0,28,1
1681928647057,MMW 14GS,A00,183213,Zhiri; Oumelbanine,28,0,28,0
1681928648092,MMW 15GS,B00,183215,Rahimi; Babak,28,0,28,0
1681928649122,MMW 121,A01,183217,Patterson; Patrick H.,9,0,28,19
1681928649122,MMW 121,A02,183218,Patterson; Patrick H.,24,0,28,4
1681928650149,MUS 1A,A01,182554,Staff,3,0,35,32
1681928651177,MUS 5,A01,182558,Staff,17,0,35,18
1681928652209,MUS 6,A01,182562,Staff,22,0,35,13
1681928653233,MUS 8GS,A00,182563,Borgo; David Garcia,25,0,25,0
1681928654258,MUS 13,A01,182567,Staff,23,0,25,2
1681928655291,MUS 15,A01,182570,Staff,31,0,35,4
1681928655291,MUS 15,B01,182575,Staff,7,0,35,28
1681928656319,MUS 80,A00,182578,Staff,22,0,25,3
1681928656319,MUS 80,B00,182581,Staff,20,0,25,5
1681928657342,MUS 113,A00,182582,Staff,25,0,25,0
1681928658373,MUS 114,A00,182583,Staff,1,0,25,24
1681928659405,MUS 150GS,A01,182588,Borgo; David Garcia,24,0,25,1
1681928660436,PHIL 1,A00,182590,Staff,34,0,40,6
1681928661461,PHIL 10,A01,182596,Grush; Rick Scott,30,0,35,5
1681928661461,PHIL 10,A02,182597,Grush; Rick Scott,33,0,35,2
1681928662496,PHIL 15,A01,182601,Staff,31,0,35,4
1681928662496,PHIL 15,A02,182602,Staff,33,0,35,2
1681928663526,PHIL 27,A01,182604,Staff,28,0,35,7
1681928663526,PHIL 27,A02,182607,Staff,35,0,35,0
1681928664548,PHIL 32,A01,182609,Staff,35,0,35,0
1681928664548,PHIL 32,A02,182612,Staff,35,0,35,0
1681928665571,PHIL 130,A00,182614,Staff,58,0,70,12
1681928666599,PHIL 136,A00,182616,Cohen; Jonathan David,66,0,70,4
1681928667623,PHIL 155,A00,182617,Vargas; Manuel Rogelio,58,0,70,12
1681928668648,PHIL 163,A01,182620,Staff,15,0,20,5
1681928668648,PHIL 163,A02,182624,Staff,10,0,20,10
1681928669678,PHIL 164,A00,182627,Staff,29,0,40,11
1681928670707,PHIL 173,A00,182628,Staff,35,0,40,5
1681928671730,PHYS 1A,A00,183221,Staff,53,0,60,7
1681928672753,PHYS 1AL,001,183222,Staff,24,0,30,6
1681928672753,PHYS 1AL,002,183223,Staff,25,0,30,5
1681928673781,PHYS 1B,A00,183231,Staff,41,0,60,19
1681928674821,PHYS 1BL,001,183232,Staff,16,0,30,14
1681928674821,PHYS 1BL,002,183233,Staff,27,0,30,3
1681928675845,PHYS 1C,A00,183240,Staff,21,0,60,39
1681928676871,PHYS 1CL,001,183241,Staff,9,0,30,21
1681928676871,PHYS 1CL,002,183242,Staff,22,0,30,8
1681928677907,PHYS 2AR,A01,183250,Staff,40,0,50,10
1681928678931,PHYS 2B,A01,183252,Staff,103,0,115,12
1681928679957,PHYS 2BL,A01,183254,Staff,21,0,24,3
1681928679957,PHYS 2BL,A02,183255,Staff,21,0,24,3
1681928680982,PHYS 2C,A01,183522,Staff,101,0,115,14
1681928682018,PHYS 4A,A01,183524,Staff,49,0,50,1
1681928683049,POLI 5,A00,183525,Staff,44,0,50,6
1681928684075,POLI 12,A00,183540,Staff,45,0,50,5
1681928685105,POLI 13R,A00,183541,Forman; Fonna,40,0,50,10
1681928686128,POLI 30,A00,183542,Mignozzetti; Umberto,48,0,50,2
1681928687155,POLI 100A,A00,183543,Staff,44,0,50,6
1681928688188,POLI 100E,A00,223598,Staff,32,0,35,3
1681928689211,POLI 103A,A00,183564,Kousser; Thad,35,0,50,15
1681928690248,POLI 104B,A00,201329,Staff,28,0,35,7
1681928691275,POLI 113BR,A00,183576,Hoston; Germaine,23,0,50,27
1681928692298,POLI 114BR,A00,183588,Staff,27,0,30,3
1681928693331,POLI 117R,A00,183595,Forman; Fonna,4,0,20,16
1681928694354,POLI 120H,A00,183596,Fisk; David Lee,14,0,20,6
1681928695379,POLI 130AA,A00,183597,Staff,13,0,20,7
1681928696410,POLI 134AA,A00,183598,Staff,19,0,20,1
1681928697436,POLI 135,A00,183599,Fisk; David Lee,19,0,25,6
1681928698462,POLI 142P,A00,183623,Staff,37,0,40,3
1681928699483,POLI 144D,A00,183624,Staff,22,0,25,3
1681928700508,POLI 151,A00,183625,Staff,15,0,20,5
1681928701537,POLI 162,A00,183626,Mignozzetti; Umberto,17,0,20,3
1681928702569,PSYC 1,A00,253748,Staff,86,0,90,4
1681928703595,PSYC 2,A00,183627,Moranton; Nirelia Melbina-,24,0,35,11
1681928704623,PSYC 3,A00,183628,Staff,43,0,45,2
1681928706675,PSYC 60,A01,183631,Lowe; Angela Beth,35,0,40,5
1681928707709,PSYC 70,A01,253757,Staff,36,0,45,9
1681928708734,PSYC 101,A00,183632,Heyman; Gail D.,43,0,60,17
1681928709765,PSYC 105,A00,183848,Lowe; Angela Beth,46,0,60,14
1681928710788,PSYC 106,A00,183849,Dobkins; Karen R.,39,0,60,21
1681928711812,PSYC 108,A00,253750,Staff,14,0,60,46
1681928712834,PSYC 114,A01,184275,Winkielman; Piotr,0,8,30,30
1681928713860,PSYC 122,A00,183856,Moranton; Nirelia Melbina-,0,16,30,30
1681928714883,PSYC 124,A00,183865,Chapman; Eddie Nathaniel,43,0,80,37
1681928715914,PSYC 137,A00,183880,Staff,17,0,25,8
1681928717963,PSYC 154,A00,183910,Lacefield; Katharine I,0,26,90,90
1681928720011,PSYC 162,A00,183946,Wixted; John T,42,0,90,48
1681928721037,PSYC 172,A00,183947,Gorman; Michael R.,5,0,30,25
1681928722060,PSYC 178,A00,183963,Glaser; Dale,15,0,40,25
1681928723095,PSYC 181GS,A00,183964,Anagnostaras; Stephan,10,0,10,0
1681928724137,PSYC 186GS,A01,257660,Staff,10,0,10,0
1681928725162,PSYC 193,B00,253749,Staff,22,0,25,3
1681928727221,PSYC 193L,A01,184122,Staff,33,0,35,2
1681928727221,PSYC 193L,C01,184167,Winkielman; Piotr,14,0,30,16
1681928728244,RELI 188GS,A00,182629,Rahimi; Babak,20,0,20,0
1681928729271,SE 101A,A00,182646,Staff,26,0,30,4
1681928730294,SE 101C,A00,182650,Staff,12,0,20,8
1681928731317,SE 110A,A00,182651,Staff,28,0,28,0
1681928732339,SE 130A,A00,182652,Staff,38,0,40,2
1681928733363,SIO 46GS,A00,182636,Cook; Geoffrey W,25,0,28,3
1681928734385,SIO 109R,A00,194459,Staff,0,0,20,20
1681928735419,SIO 121GS,A00,182639,Cook; Geoffrey W,25,0,28,3
1681928736517,SIO 132,A01,182642,Staff,30,0,40,10
1681928737540,SIO 139,A00,182644,Kacev; David,36,0,40,4
1681928738564,SOCI 2,A01,258404,Staff,33,0,36,3
1681928738564,SOCI 2,A02,258405,Staff,35,0,36,1
1681928739596,SOCI 60,A01,258408,Staff,29,0,30,1
1681928739596,SOCI 60,A02,258413,Staff,30,0,30,0
1681928740622,SOCI 100,A01,258415,Staff,29,0,30,1
1681928740622,SOCI 100,A02,258416,Staff,28,0,30,2
1681928746783,SOCI 127,A00,258421,Staff,19,0,30,11
1681928747809,SOCI 132,A00,258422,Staff,44,0,50,6
1681928748837,SOCI 133,A00,258423,Staff,26,0,30,4
1681928749865,SOCI 138GS,A00,258424,Staff,15,0,15,0
1681928750892,SOCI 145,A00,258425,Staff,24,0,30,6
1681928751915,SOCI 148,A00,258426,Staff,24,0,30,6
1681928752936,SOCI 153,A00,199217,Staff,29,0,30,1
1681928753962,SOCI 160,A00,258427,Staff,27,0,30,3
1681928754987,SOCI 160E,A00,258435,Staff,56,0,60,4
1681928756009,SOCI 189GS,A00,258436,Staff,15,0,15,0
1681928757040,SOCI 190GS,A00,258437,Staff,15,0,15,0
1681928758063,SYN 2,001,182658,Staff,8,0,16,8
1681928758063,SYN 2,002,201439,Staff,14,0,16,2
1681928758063,SYN 2,003,201443,Staff,16,0,16,0
1681928759088,SYN 100,A01,182657,Staff,13,0,20,7
1681928760129,TDAC 1,A00,184381,Salovey; Todd,16,0,20,4
1681928760129,TDAC 1,B00,184385,Harting; Carla Kelso,19,0,20,1
1681928760129,TDAC 1,C00,184394,Staff,18,0,20,2
1681928761164,TDAC 101,A00,184483,Harting; Carla Kelso,19,0,20,1
1681928762186,TDDE 111,A00,184496,Staff,14,0,15,1
1681928763215,TDDE 131,A00,184504,Staff,20,0,20,0
1681928763215,TDDE 131,B00,184505,Staff,17,0,18,1
1681928763215,TDDE 131,C00,184534,Staff,49,0,50,1
1681928763215,TDDE 131,D00,184564,Staff,15,0,15,0
1681928763215,TDDE 131,E00,204725,Staff,18,0,20,2
1681928764245,TDGE 1,A01,184414,Salovey; Todd,35,0,50,15
1681928765271,TDGE 5,A01,184419,Staff,23,0,24,1
1681928766298,TDGE 10,A00,184428,Fulton; Julia,27,0,50,23
1681928767323,TDGE 124,A00,184565,Fulton; Julia,0,1,50,50
1681928768361,TDGE 125,B00,184567,Meyer; Ursula,8,0,25,17
1681928769383,TDHT 101,A00,184568,Staff,21,0,25,4
1681928769383,TDHT 101,B00,184569,Staff,20,0,20,0
1681928770409,TDHT 114,A00,184570,Staff,49,0,50,1
1681928771435,TDMV 1,A00,184437,Arcidiacono; Kristin,21,0,30,9
1681928771435,TDMV 1,B00,184448,Caligagan; Maria T.,23,0,30,7
1681928772461,TDMV 2,A00,184449,Weinberg; Sadie,27,0,30,3
1681928772461,TDMV 2,B00,184453,Arcidiacono; Kristin,29,0,30,1
1681928773512,TDMV 110,A00,184571,Weinberg; Sadie,30,0,30,0
1681928774540,TDMV 142,A00,184572,Caligagan; Tony,26,0,30,4
1681928774540,TDMV 142,B00,184573,Caligagan; Maria T.,26,0,30,4
1681928775565,TDTR 20,A00,184482,Jun; Grace Shin Hae,25,0,25,0
1681928776591,USP 2,A01,184290,Hinds; Juli Beth,24,0,25,1
1681928777614,USP 3,A01,184295,Staff,21,0,25,4
1681928778638,USP 4,A00,184304,McTague; Sarah,13,0,25,12
1681928779666,USP 100,A00,184315,Staff,16,0,25,9
1681928780694,USP 105,A00,184326,Staff,21,0,25,4
1681928781729,USP 151,A00,184327,Staff,18,0,25,7
1681928782753,USP 170,A00,184380,Hinds; Juli Beth,13,0,25,12
1681928783780,VIS 21B,A01,182660,Staff,28,0,31,3
1681928783780,VIS 21B,A02,182662,Staff,30,0,31,1
1681928784813,VIS 103D,A00,182663,Staff,74,0,75,1
1681928785838,VIS 105D,A00,182667,Li; Huai,14,0,22,8
1681928786861,VIS 122GS,A00,182668,Herbst; Matthew,20,0,20,0
1681928787884,VIS 128C,A00,182673,Staff,69,0,75,6
1681928788907,VIS 130,A00,182675,Staff,19,0,22,3
1681928789930,VIS 160A,A00,182678,Stalbaum; Brett,4,0,10,6
1681928792000,WCWP 10B,A00,201679,Staff,15,0,15,0
1681928792000,WCWP 10B,B00,201695,Staff,15,0,15,0
1681928793029,WCWP 100,A00,201716,Staff,12,0,15,3
1681928793029,WCWP 100,B00,201717,Staff,0,0,15,15
1681928795129,ANSC 105GS,A00,258289,Staff,0,0,0,0
1681928796151,ANSC 125GS,A00,258295,Staff,0,0,0,0
1681928797175,ANSC 150,A00,258267,Staff,28,0,40,12
1681928798200,ANSC 190GS,A00,258280,Staff,0,0,0,0
1681928799222,ANTH 1,A00,258264,Staff,38,0,40,2
1681928800260,ANTH 2,A01,258259,Staff,72,0,76,4
1681928801283,ANTH 23,A01,258228,Staff,36,0,40,4
1681928802309,ANTH 101,A01,258236,Staff,38,0,40,2
1681928803346,ANTH 102,A00,258272,Staff,59,0,60,1
1681928804381,ANTH 105,A00,258244,Staff,29,0,35,6
1681928805417,BENG 130,A00,253975,Staff,37,0,40,3
1681928806444,BIBC 102,A01,191866,Flagg; Matthew Paul,17,0,32,15
1681928806444,BIBC 102,A02,191867,Flagg; Matthew Paul,21,0,32,11
1681928806444,BIBC 102,A03,191868,Flagg; Matthew Paul,28,0,32,4
1681928806444,BIBC 102,A04,191936,Flagg; Matthew Paul,22,0,32,10
1681928806444,BIBC 102,A05,191937,Flagg; Matthew Paul,0,0,32,32
1681928807473,BICD 100,A01,191939,Cooper; Andrew Michael,27,0,32,5
1681928807473,BICD 100,A02,191940,Cooper; Andrew Michael,32,0,32,0
1681928807473,BICD 100,A03,191941,Cooper; Andrew Michael,32,0,32,0
1681928807473,BICD 100,A04,191942,Cooper; Andrew Michael,32,0,32,0
1681928807473,BICD 100,A05,191943,Cooper; Andrew Michael,32,0,32,0
1681928808498,BIEB 126,A01,191945,Cleland; Elsa Eleanor,0,2,32,32
1681928808498,BIEB 126,A02,191946,Cleland; Elsa Eleanor,26,0,32,6
1681928808498,BIEB 126,A03,191947,Cleland; Elsa Eleanor,29,0,32,3
1681928808498,BIEB 126,A04,191948,Cleland; Elsa Eleanor,17,0,32,15
1681928808498,BIEB 126,A05,191996,Cleland; Elsa Eleanor,28,0,32,4
1681928809527,BIEB 136GS,A00,191997,Shurin; Jonathan & Holway; David A.,0,0,0,8
1681928810550,BIEB 137GS,A01,191999,Shurin; Jonathan & Holway; David A.,0,0,0,7
1681928811573,BILD 1,A01,205385,Staff,30,0,32,2
1681928811573,BILD 1,A02,205386,Staff,30,0,32,2
1681928811573,BILD 1,A03,205387,Staff,31,0,32,1
1681928811573,BILD 1,A04,205388,Staff,26,0,32,6
1681928812600,BILD 2,A01,191774,Staff,27,0,32,5
1681928812600,BILD 2,A02,191775,Staff,30,0,32,2
1681928812600,BILD 2,A03,191777,Staff,30,0,32,2
1681928812600,BILD 2,A04,191856,Staff,30,0,32,2
1681928812600,BILD 2,A05,191857,Staff,31,0,32,1
1681928812600,BILD 2,A06,191858,Staff,32,0,32,0
1681928812600,BILD 2,A07,191859,Staff,31,0,32,1
1681928813623,BILD 3,A01,205391,Staff,27,0,32,5
1681928813623,BILD 3,A02,205393,Staff,32,0,32,0
1681928813623,BILD 3,A03,205394,Staff,27,0,32,5
1681928813623,BILD 3,A04,205395,Staff,32,0,32,0
1681928814647,BILD 20,A01,191861,Staff,32,0,32,0
1681928814647,BILD 20,A02,191862,Staff,32,0,32,0
1681928815669,BILD 30,A01,191864,Staff,31,0,32,1
1681928816693,BIMM 100,A01,192019,Staff,0,0,32,32
1681928816693,BIMM 100,A02,192020,Staff,18,0,32,14
1681928816693,BIMM 100,A03,192035,Staff,18,0,32,14
1681928817717,BIMM 110,A01,192037,Tat; John,0,0,32,32
1681928817717,BIMM 110,A02,192038,Tat; John,5,0,32,27
1681928818743,BIMM 120,A01,192040,Pickett; Brooke Elizabeth,0,0,32,32
1681928818743,BIMM 120,A02,192041,Pickett; Brooke Elizabeth,9,0,32,23
1681928818743,BIMM 120,A03,192042,Pickett; Brooke Elizabeth,14,0,32,18
1681928819766,BIPN 100,A01,192044,Armour; Jon Christopher,23,0,32,9
1681928819766,BIPN 100,A02,192059,Armour; Jon Christopher,30,0,32,2
1681928819766,BIPN 100,A03,192064,Armour; Jon Christopher,30,0,32,2
1681928819766,BIPN 100,A04,192073,Armour; Jon Christopher,26,0,32,6
1681928820803,BIPN 148,A01,205411,Leutgeb; Jill K.,15,0,32,17
1681928820803,BIPN 148,A02,205412,Leutgeb; Jill K.,31,0,32,1
1681928820803,BIPN 148,A03,205413,Leutgeb; Jill K.,30,0,32,2
1681928820803,BIPN 148,A04,205414,Leutgeb; Jill K.,30,0,32,2
1681928821827,BIPN 160,A01,192115,Marino; Marc J,15,0,32,17
1681928821827,BIPN 160,A02,192148,Marino; Marc J,27,0,32,5
1681928821827,BIPN 160,A03,192158,Marino; Marc J,31,0,32,1
1681928821827,BIPN 160,A04,192190,Marino; Marc J,32,0,32,0
1681928821827,BIPN 160,A05,192287,Marino; Marc J,32,0,32,0
1681928821827,BIPN 160,A06,192288,Marino; Marc J,32,0,32,0
1681928822851,BIPN 194,A00,206038,Staff,28,0,32,4
1681928823874,BISP 194,A00,192289,Leutgeb; Stefan,11,0,32,21
1681928823874,BISP 194,B00,245332,Nieh; James Charles,26,0,32,6
1681928824904,CAT 124,A01,202247,Staff,15,0,15,0
1681928825932,CAT 125,A00,202248,Staff,18,0,20,2
1681928825932,CAT 125,B00,202253,Staff,20,0,20,0
1681928825932,CAT 125,C00,202257,Staff,18,0,20,2
1681928826958,CAT 125GS,A01,202273,Bronstein; Phoebe Malan,20,0,20,0
1681928827983,CAT 125R,A00,202284,Staff,17,0,20,3
1681928827983,CAT 125R,C00,202286,Staff,5,0,20,15
1681928827983,CAT 125R,D00,202291,Staff,17,0,20,3
1681928827983,CAT 125R,E00,202295,Staff,13,0,20,7
1681928827983,CAT 125R,F00,202302,Staff,7,0,20,13
1681928829011,CENG 100,A00,204724,Opatkiewicz; Justin Paul,25,0,25,0
1681928830035,CGS 2A,A01,180420,Staff,30,0,36,6
1681928831057,CGS 101,A00,180421,Staff,16,0,20,4
1681928832095,CGS 112,A00,180422,Staff,9,0,16,7
1681928833124,CGS 113,A00,180423,Staff,18,0,20,2
1681928834159,CGS 137,A00,180424,Staff,12,0,12,0
1681928835189,CGS 147,A00,180425,Staff,10,0,10,0
1681928836220,CHEM 6A,A01,179556,Staff,93,0,100,7
1681928836220,CHEM 6A,A02,179558,Staff,0,0,0,0
1681928837261,CHEM 6B,A01,179560,Staff,100,0,100,0
1681928838289,CHEM 6C,A01,179565,Jazzar; Rodolphe,93,0,100,7
1681928839315,CHEM 7L,A01,179586,Schurmeier; Kimberly,10,0,24,14
1681928839315,CHEM 7L,A02,179587,Schurmeier; Kimberly,23,0,24,1
1681928839315,CHEM 7L,A03,179590,Schurmeier; Kimberly,22,0,24,2
1681928839315,CHEM 7L,A04,179591,Schurmeier; Kimberly,22,0,24,2
1681928839315,CHEM 7L,B01,179598,Schurmeier; Kimberly,16,0,24,8
1681928839315,CHEM 7L,B02,179599,Schurmeier; Kimberly,24,0,24,0
1681928839315,CHEM 7L,B03,179606,Schurmeier; Kimberly,22,0,24,2
1681928839315,CHEM 7L,B04,179607,Schurmeier; Kimberly,22,0,24,2
1681928840422,CHEM 11,A01,179609,Stallings; Dontarie M,87,0,100,13
1681928841449,CHEM 40A,A01,179621,Staff,39,0,50,11
1681928841449,CHEM 40A,A02,179622,Staff,46,0,50,4
1681928842478,CHEM 40B,A01,179630,Weizman; Haim,47,0,50,3
1681928842478,CHEM 40B,A02,179631,Weizman; Haim,44,0,50,6
1681928843503,CHEM 41A,A01,179660,Klosterman; Jeremy K,93,0,100,7
1681928844526,CHEM 43A,A01,179683,Klosterman; Jeremy K,0,0,24,24
1681928844526,CHEM 43A,A02,179688,Klosterman; Jeremy K,7,0,24,17
1681928844526,CHEM 43A,A03,179689,Klosterman; Jeremy K,18,0,24,6
1681928844526,CHEM 43A,A04,179691,Klosterman; Jeremy K,18,0,24,6
1681928845559,CHEM 114A,A01,179693,Stallings; Dontarie M,68,0,100,32
1681928846591,CHEM 143B,A01,179698,Weizman; Haim,16,0,24,8
1681928846591,CHEM 143B,A02,179700,Weizman; Haim,24,0,24,0
1681928847621,CHIN 169A,A00,179701,Wang; Xiao,20,0,20,0
1681928848657,COGS 2,A01,179750,Boyle; Mary E. T.,17,0,30,13
1681928849689,COGS 9,A01,179759,Jones; Cameron Robert,40,0,50,10
1681928850711,COGS 14A,A01,179854,Staff,13,0,50,37
1681928851735,COGS 14B,A01,179856,Staff,52,0,60,8
1681928852760,COGS 17,A01,179874,Staff,71,0,75,4
1681928853783,COGS 18,A01,179884,Staff,59,0,80,21
1681928854821,COGS 100,A01,179886,Staff,33,0,60,27
1681928855846,COGS 101B,A01,179892,Staff,0,2,30,30
1681928856871,COGS 101C,A01,179894,Staff,26,0,30,4
1681928857918,COGS 107A,A01,179896,Boyle; Mary E. T.,29,0,40,11
1681928858948,COGS 108,A01,179898,Simpkins; Charles Alexander,0,32,60,60
1681928859974,COGS 109,A01,179900,Staff,32,0,40,8
1681928860996,COGS 118A,A01,179946,Staff,5,0,40,35
1681928862030,COGS 153,A00,179978,Staff,0,6,30,30
1681928863056,COGS 156,A01,179981,Staff,21,0,30,9
1681928865124,COGS 172,A01,179987,Staff,10,0,30,20
1681928867172,COGS 186,A01,179991,Staff,11,0,30,19
1681928868205,COMM 10,A01,180001,Staff,12,0,25,13
1681928868205,COMM 10,A02,180004,Staff,20,0,25,5
1681928869231,COMM 100A,A01,180016,Staff,13,0,25,12
1681928869231,COMM 100A,A02,180020,Staff,24,0,25,1
1681928870265,COMM 101T,A00,180029,Halm; Gavin Patrick,21,0,35,14
1681928871295,COMM 106V,A00,180043,Staff,34,0,35,1
1681928872318,COMM 109P,A00,180044,Staff,30,0,35,5
1681928873343,COMM 113T,A00,180045,Havis; Allan,37,0,45,8
1681928874377,COMM 132,A00,180046,McKenna; Denise,22,0,30,8
1681928875401,COMM 143,A00,180047,Staff,16,0,30,14
1681928876428,COMM 190,A00,180048,Conner; Thomas Hartnell,18,0,23,5
1681928877465,CSE 8A,A50,180053,Cao; Yingjun,21,0,50,29
1681928877465,CSE 8A,B50,180180,Staff,50,0,50,0
1681928878498,CSE 11,A01,180190,Cao; Yingjun,21,0,50,29
1681928879524,CSE 20,A01,180192,Briones; Jor-el Thomas Caparas,21,0,30,9
1681928880549,CSE 21,A01,194538,Briones; Jor-el Thomas Caparas,50,0,60,10
1681928881581,CSE 30,A01,180324,Eldon; John,73,0,100,27
1681928882606,CSE 101,A01,201353,Staff,0,27,40,40
1681928883635,CSE 134B,A01,180326,Powell; Thomas Allan,73,0,100,27
1681928884662,CSE 140,A01,180328,Staff,26,0,75,49
1681928885694,CSE 140L,A01,180344,Eldon; John,50,0,100,50
1681928886724,CSE 150A,A01,180411,Staff,0,18,50,50
1681928887752,CSE 151A,A01,180414,Staff,0,13,50,50
1681928888792,CSE 175,A01,222521,Kumar; Rakesh,50,0,50,0
1681928889830,CSE 190,A00,201419,Staff,42,0,49,7
1681928890854,CSS 1,A01,194536,Staff,34,0,50,16
1681928891876,DSC 30,A01,202385,Staff,48,0,50,2
1681928892916,DSC 40A,A01,202387,Albuyeh; Rod,50,0,50,0
1681928893943,DSC 190,A01,202389,Silberman; Jack,21,0,21,0
1681928894972,DSGN 100,A01,179993,Staff,13,0,30,17
1681928895997,ECE 65,A50,180708,Staff,10,0,20,10
1681928895997,ECE 65,A51,180739,Staff,19,0,20,1
1681928897022,ECON 1,A01,180427,Famulari; Melissa,66,0,70,4
1681928898052,ECON 2,A01,180450,Levkoff; Steven B.,64,0,70,6
1681928899080,ECON 4,A01,203351,Anderson; John Charles,6,0,10,4
1681928900104,ECON 100A,A01,180472,Famulari; Melissa,59,0,70,11
1681928901126,ECON 120A,A01,180549,Staff,62,0,70,8
1681928902151,ECON 120B,A01,180655,Ma; Xinwei,41,0,70,29
1681928903176,ECON 129,A00,203333,Eckert; Fabian Paul,11,0,35,24
1681928904198,ECON 131,A00,180656,Staff,2,0,35,33
1681928905220,ECON 172B,A01,180672,Levkoff; Steven B.,31,0,35,4
1681928906242,ECON 178,A01,203342,Zhu; Ying,5,0,35,30
1681928907270,EDS 108GS,A00,202383,Wishard Guerra; Alison G.,20,0,20,0
1681928908304,EDS 111GS,A00,202347,Wishard Guerra; Alison G.,20,0,20,0
1681928909329,EDS 112,A01,202323,Staff,53,0,60,7
1681928910359,EDS 113,A00,202340,Staff,32,0,35,3
1681928911397,EDS 118,A00,201231,Staff,19,0,30,11
1681928912428,EDS 119,A00,204994,Staff,8,0,10,2
1681928913457,EDS 124BR,A00,202324,Eguchi; Emi,0,0,25,25
1681928914479,EDS 126,A01,203208,Jones; Makeba,26,0,30,4
1681928915511,EDS 135,A01,202333,Staff,17,0,20,3
1681928916534,EDS 180,A00,202311,Staff,47,0,50,3
1681928917560,ERC 190GS,A01,253747,Staff,28,0,28,0
1681928918585,ETHN 104,A00,180742,Staff,22,0,35,13
1681928919611,ETHN 118,A00,180745,Staff,27,0,35,8
1681928920646,ETHN 127,A00,180747,Staff,8,0,16,8
1681928921685,ETHN 137,A00,180880,Staff,11,0,12,1
1681928922727,ETHN 147,A00,180890,Staff,8,0,10,2
1681928923759,ETHN 154,A00,180891,Staff,6,0,8,2
1681928924783,ETHN 168,A00,180892,Staff,9,0,10,1
1681928925805,GLBH 20,A00,201051,Hannah; Seth Donal,0,5,0,1
1681928926834,GLBH 111,A01,209338,Burgos; Jose L.,0,0,0,0
1681928927863,GLBH 150,A00,258300,Staff,0,4,0,0
1681928928897,GLBH 181,A00,201207,Staff,9,0,40,31
1681928929930,HIEU 109,A00,180898,Staff,19,0,20,1
1681928930956,HIEU 111,A00,180899,Staff,0,2,20,20
1681928931984,HIEU 124,A00,180900,Staff,17,0,20,3
1681928933011,HILA 122,A00,180901,Staff,17,0,20,3
1681928934035,HILA 132,A00,180902,Vitz; Matthew,0,1,20,20
1681928935060,HILD 10,A01,180896,Staff,14,0,20,6
1681928936083,HILD 30GS,A00,180897,Edington; Claire Ellen,0,0,0,0
1681928937109,HISC 105,A00,180903,Staff,20,0,20,0
1681928938141,HISC 117,A00,180904,Staff,10,0,20,10
1681928939165,HIUS 108B,A00,181005,Staff,18,0,20,2
1681928940188,HIUS 113,A00,181093,Staff,1,0,20,19
1681928941211,HUM 3,A01,181190,Patterson; Patrick H.,35,0,50,15
1681928941211,HUM 3,B01,181195,Staff,46,0,50,4
1681928942233,HUM 3GS,A00,181196,Herbst; Matthew,0,0,0,0
1681928943259,HUM 4,A01,181227,West; Geoffrey Scott,33,0,50,17
1681928943259,HUM 4,B01,181282,Staff,41,0,50,9
1681928944364,HUM 4GS,A00,181377,Lyon; Antony J.,0,0,0,0
1681928945387,HUM 5,A01,181536,Zavodny; Tatiana Sophia,25,0,50,25
1681928945387,HUM 5,B01,181908,Staff,33,0,50,17
1681928946410,INTL 190,A00,181909,Segui; Alan S,0,0,0,8
1681928946410,INTL 190,B00,181961,Segui; Alan S,0,0,0,7
1681928947441,JAPN 20AR,A01,182113,Ross; Kayoko F,15,0,20,5
1681928948468,LATI 50,A01,202391,Martin-Cabrera; Luis,18,0,30,12
1681928948468,LATI 50,A02,202392,Martin-Cabrera; Luis,26,0,30,4
1681928949494,LATI 180,A00,202393,Kokinis; Troy Andreas,24,0,25,1
1681928950529,LIFR 1A,A00,182119,Staff,13,0,14,1
1681928951571,LIFR 1AX,A00,182324,Staff,13,0,14,1
1681928952593,LIFR 1B,A00,182259,Staff,12,0,14,2
1681928953617,LIFR 1BX,A00,182273,Staff,12,0,14,2
1681928954642,LIGN 8,A00,182330,Staff,129,0,150,21
1681928955666,LIGN 9GS,A00,182362,Staff,15,0,20,5
1681928956693,LIGN 119,A00,204992,Takahashi; Maho,11,0,15,4
1681928957718,LIGN 130,A01,182384,Staff,47,0,50,3
1681928958749,LIGN 149GS,A00,182390,Staff,15,0,20,5
1681928959777,LIGN 170,A00,182404,Staff,23,0,30,7
1681928960813,LISP 1D,A00,182281,Staff,7,0,14,7
1681928960813,LISP 1D,B00,182287,Staff,13,0,14,1
1681928960813,LISP 1D,C00,182295,Staff,10,0,14,4
1681928960813,LISP 1D,D00,182301,Staff,14,0,14,0
1681928961842,LISP 1DX,A00,182309,Staff,19,0,28,9
1681928961842,LISP 1DX,B00,182316,Staff,25,0,28,3
1681928962872,LTAF 120GS,A00,182412,Zhiri; Oumelbanine,20,0,20,0
1681928963907,LTCS 172GS,A00,182437,Bronstein; Phoebe Malan,20,0,20,0
1681928964936,LTEA 138,A00,182457,Staff,18,0,40,22
1681928965961,LTEN 114,A01,182490,Staff,23,0,25,2
1681928966987,LTEN 130GS,A00,182491,Lyon; Antony J.,20,0,20,0
1681928968010,LTEN 169,A00,182493,Cuong; Marisol,18,0,25,7
1681928969037,LTEN 178,A00,182501,Staff,14,0,15,1
1681928970063,LTEN 181,A00,182515,Staff,19,0,25,6
1681928971092,LTEN 185GS,A00,197655,Forbes; Camille,20,0,20,0
1681928972125,LTSP 100B,A00,202208,Bessett; Ryan Matthew,24,0,25,1
1681928973151,LTWL 100,A00,182516,Myerston Santana; Jacobo,20,0,30,10
1681928974175,LTWR 100GS,A00,182518,Forbes; Camille,20,0,20,0
1681928975201,LTWR 102,A00,182522,Staff,15,0,15,0
1681928975201,LTWR 102,B00,182525,Staff,14,0,15,1
1681928976234,LTWR 115,A00,182526,Staff,10,0,15,5
1681928977260,MAE 8,A01,182528,Pham; Hieu Tan,67,0,70,3
1681928978292,MAE 11,A00,182529,Bahadori; Mohammad Yousef,91,0,100,9
1681928979317,MAE 20,A00,182530,Evdokimenko; Ekaterina,68,0,70,2
1681928980345,MAE 30A,A00,182532,Staff,44,0,45,1
1681928981380,MAE 101A,A00,182533,Bahadori; Mohammad Yousef,94,0,100,6
1681928982402,MAE 101C,A00,182538,Staff,62,0,70,8
1681928983430,MAE 104,A00,182539,Staff,44,0,50,6
1681928984469,MAE 131A,A00,182540,Ghazinejad; Maziar,40,0,45,5
1681928985503,MAE 143A,A00,182548,Bewley; Thomas R,43,0,50,7
1681928986529,MAE 150,A00,182549,Staff,28,0,40,12
1681928987554,MAE 160,A00,182550,Evdokimenko; Ekaterina,41,0,60,19
1681928988580,MATH 3C,A01,182725,Staff,24,0,30,6
1681928989603,MATH 10A,A01,182729,Staff,24,0,30,6
1681928989603,MATH 10A,B01,182732,Staff,25,0,30,5
1681928990632,MATH 10B,A01,182737,Staff,17,0,30,13
1681928990632,MATH 10B,A02,182738,Staff,26,0,30,4
1681928990632,MATH 10B,B01,182744,Staff,25,0,30,5
1681928990632,MATH 10B,B02,182745,Staff,27,0,30,3
1681928991660,MATH 18,A01,182750,Anzaldo; Leesa B,28,0,30,2
1681928991660,MATH 18,A02,182751,Anzaldo; Leesa B,28,0,30,2
1681928991660,MATH 18,A03,182753,Anzaldo; Leesa B,27,0,30,3
1681928991660,MATH 18,A04,182757,Anzaldo; Leesa B,29,0,30,1
1681928991660,MATH 18,B01,182761,Anzaldo; Leesa B,27,0,30,3
1681928991660,MATH 18,B02,182764,Anzaldo; Leesa B,26,0,30,4
1681928991660,MATH 18,B03,182765,Anzaldo; Leesa B,29,0,30,1
1681928991660,MATH 18,B04,182766,Anzaldo; Leesa B,30,0,30,0
1681928992685,MATH 20A,A01,182771,Suk; Andrew Hoon,28,0,30,2
1681928993717,MATH 20B,A01,182775,Bach; Quang Tran,30,0,30,0
1681928993717,MATH 20B,A02,182777,Bach; Quang Tran,29,0,30,1
1681928993717,MATH 20B,B01,182780,Bach; Quang Tran,26,0,30,4
1681928993717,MATH 20B,B02,182782,Bach; Quang Tran,30,0,30,0
1681928994740,MATH 20C,A01,182787,Staff,24,0,30,6
1681928994740,MATH 20C,A02,182790,Staff,29,0,30,1
1681928994740,MATH 20C,B01,182792,Staff,23,0,30,7
1681928994740,MATH 20C,B02,182796,Staff,26,0,30,4
1681928995769,MATH 20D,A01,182799,Staff,27,0,30,3
1681928995769,MATH 20D,A02,182802,Staff,29,0,30,1
1681928995769,MATH 20D,A03,182803,Staff,30,0,30,0
1681928996796,MATH 20E,A01,182809,Verstraete; Jacques Allan,20,0,30,10
1681928996796,MATH 20E,A02,182811,Verstraete; Jacques Allan,28,0,30,2
1681928996796,MATH 20E,B01,182814,Verstraete; Jacques Allan,21,0,30,9
1681928996796,MATH 20E,B02,182815,Verstraete; Jacques Allan,29,0,30,1
1681928997820,MATH 103A,A01,182820,Staff,3,0,30,27
1681928997820,MATH 103A,A02,182821,Staff,27,0,30,3
1681928997820,MATH 103A,A03,182822,Staff,22,0,30,8
1681928997820,MATH 103A,B01,182825,Staff,21,0,30,9
1681928997820,MATH 103A,B02,182826,Staff,30,0,30,0
1681928997820,MATH 103A,B03,182830,Staff,30,0,30,0
1681928998850,MATH 109,A01,182836,Chow; Bennett,23,0,30,7
1681928998850,MATH 109,A02,182838,Chow; Bennett,29,0,30,1
1681928998850,MATH 109,A03,182894,Chow; Bennett,29,0,30,1
1681928998850,MATH 109,B01,182908,Chow; Bennett,27,0,30,3
1681928998850,MATH 109,B02,182909,Chow; Bennett,30,0,30,0
1681928998850,MATH 109,B03,182910,Chow; Bennett,26,0,30,4
1681928999880,MATH 142A,A01,182925,Staff,5,0,30,25
1681928999880,MATH 142A,A02,182935,Staff,23,0,30,7
1681928999880,MATH 142A,A03,182967,Staff,26,0,30,4
1681928999880,MATH 142A,B01,183125,Staff,23,0,30,7
1681928999880,MATH 142A,B02,183157,Staff,26,0,30,4
1681928999880,MATH 142A,B03,183158,Staff,29,0,30,1
1681929000912,MATH 183,A01,183160,Arias-Castro; Ery,23,0,30,7
1681929000912,MATH 183,A02,183161,Arias-Castro; Ery,29,0,30,1
1681929000912,MATH 183,B01,183163,Arias-Castro; Ery,28,0,30,2
1681929000912,MATH 183,B02,183164,Arias-Castro; Ery,28,0,30,2
1681929001947,MATH 193A,A01,183167,Staff,0,0,35,35
1681929001947,MATH 193A,A02,183168,Staff,23,0,35,12
1681929001947,MATH 193A,A03,183169,Staff,34,0,35,1
1681929001947,MATH 193A,A04,183170,Staff,27,0,35,8
1681929002974,MGT 4,A01,202395,Anderson; John Charles,76,0,80,4
1681929003996,MGT 5,A00,202396,Houskeeper; Robert,79,0,90,11
1681929005018,MGT 103,A00,202397,Eberhard; Craig A,49,0,90,41
1681929006050,MGT 131A,A00,202398,Houskeeper; Robert,82,0,90,8
1681929007079,MGT 135,A00,202399,Anderson; John Charles,81,0,90,9
1681929008103,MGT 162R,A00,202403,Gneezy; Uri,124,0,200,76
1681929009128,MGT 172,A00,202404,Hedges; Kathleen,31,0,90,59
1681929010152,MGT 181,A00,202405,Dunn; Louis Jean,79,0,90,11
1681929011179,MMW 14,A01,183200,Staff,5,0,28,23
1681929011179,MMW 14,A02,183201,Staff,25,0,28,3
1681929011179,MMW 14,A03,183202,Staff,24,0,28,4
1681929011179,MMW 14,A04,183203,Staff,25,0,28,3
1681929011179,MMW 14,A05,183204,Staff,26,0,28,2
1681929011179,MMW 14,A06,183205,Staff,27,0,28,1
1681929011179,MMW 14,B01,183207,Staff,26,0,28,2
1681929011179,MMW 14,B02,183208,Staff,28,0,28,0
1681929011179,MMW 14,B03,183209,Staff,28,0,28,0
1681929011179,MMW 14,B04,183210,Staff,28,0,28,0
1681929011179,MMW 14,B05,183211,Staff,28,0,28,0
1681929011179,MMW 14,B06,183212,Staff,27,0,28,1
1681929012221,MMW 14GS,A00,183213,Zhiri; Oumelbanine,28,0,28,0
1681929013244,MMW 15GS,B00,183215,Rahimi; Babak,28,0,28,0
1681929014272,MMW 121,A01,183217,Patterson; Patrick H.,9,0,28,19
1681929014272,MMW 121,A02,183218,Patterson; Patrick H.,24,0,28,4
1681929015295,MUS 1A,A01,182554,Staff,3,0,35,32
1681929016327,MUS 5,A01,182558,Staff,17,0,35,18
1681929017358,MUS 6,A01,182562,Staff,22,0,35,13
1681929018389,MUS 8GS,A00,182563,Borgo; David Garcia,25,0,25,0
1681929019425,MUS 13,A01,182567,Staff,23,0,25,2
1681929020450,MUS 15,A01,182570,Staff,31,0,35,4
1681929020450,MUS 15,B01,182575,Staff,7,0,35,28
1681929021479,MUS 80,A00,182578,Staff,22,0,25,3
1681929021479,MUS 80,B00,182581,Staff,20,0,25,5
1681929022513,MUS 113,A00,182582,Staff,25,0,25,0
1681929023539,MUS 114,A00,182583,Staff,1,0,25,24
1681929024562,MUS 150GS,A01,182588,Borgo; David Garcia,24,0,25,1
1681929025588,PHIL 1,A00,182590,Staff,34,0,40,6
1681929026619,PHIL 10,A01,182596,Grush; Rick Scott,30,0,35,5
1681929026619,PHIL 10,A02,182597,Grush; Rick Scott,33,0,35,2
1681929027647,PHIL 15,A01,182601,Staff,31,0,35,4
1681929027647,PHIL 15,A02,182602,Staff,33,0,35,2
1681929028676,PHIL 27,A01,182604,Staff,27,0,35,8
1681929028676,PHIL 27,A02,182607,Staff,35,0,35,0
1681929029699,PHIL 32,A01,182609,Staff,35,0,35,0
1681929029699,PHIL 32,A02,182612,Staff,35,0,35,0
1681929030730,PHIL 130,A00,182614,Staff,58,0,70,12
1681929031754,PHIL 136,A00,182616,Cohen; Jonathan David,66,0,70,4
1681929032781,PHIL 155,A00,182617,Vargas; Manuel Rogelio,58,0,70,12
1681929033808,PHIL 163,A01,182620,Staff,15,0,20,5
1681929033808,PHIL 163,A02,182624,Staff,10,0,20,10
1681929034840,PHIL 164,A00,182627,Staff,29,0,40,11
1681929035863,PHIL 173,A00,182628,Staff,35,0,40,5
1681929036885,PHYS 1A,A00,183221,Staff,53,0,60,7
1681929037909,PHYS 1AL,001,183222,Staff,25,0,30,5
1681929037909,PHYS 1AL,002,183223,Staff,24,0,30,6
1681929038940,PHYS 1B,A00,183231,Staff,41,0,60,19
1681929039963,PHYS 1BL,001,183232,Staff,16,0,30,14
1681929039963,PHYS 1BL,002,183233,Staff,27,0,30,3
1681929040996,PHYS 1C,A00,183240,Staff,21,0,60,39
1681929042024,PHYS 1CL,001,183241,Staff,9,0,30,21
1681929042024,PHYS 1CL,002,183242,Staff,22,0,30,8
1681929043065,PHYS 2AR,A01,183250,Staff,40,0,50,10
1681929044087,PHYS 2B,A01,183252,Staff,103,0,115,12
1681929045110,PHYS 2BL,A01,183254,Staff,21,0,24,3
1681929045110,PHYS 2BL,A02,183255,Staff,21,0,24,3
1681929046144,PHYS 2C,A01,183522,Staff,101,0,115,14
1681929047178,PHYS 4A,A01,183524,Staff,49,0,50,1
1681929048275,POLI 5,A00,183525,Staff,44,0,50,6
1681929049300,POLI 12,A00,183540,Staff,45,0,50,5
1681929050322,POLI 13R,A00,183541,Forman; Fonna,40,0,50,10
1681929051347,POLI 30,A00,183542,Mignozzetti; Umberto,48,0,50,2
1681929052377,POLI 100A,A00,183543,Staff,44,0,50,6
1681929053414,POLI 100E,A00,223598,Staff,32,0,35,3
1681929054445,POLI 103A,A00,183564,Kousser; Thad,35,0,50,15
1681929055473,POLI 104B,A00,201329,Staff,28,0,35,7
1681929056497,POLI 113BR,A00,183576,Hoston; Germaine,23,0,50,27
1681929057525,POLI 114BR,A00,183588,Staff,27,0,30,3
1681929058551,POLI 117R,A00,183595,Forman; Fonna,4,0,20,16
1681929059578,POLI 120H,A00,183596,Fisk; David Lee,14,0,20,6
1681929060602,POLI 130AA,A00,183597,Staff,13,0,20,7
1681929061703,POLI 134AA,A00,183598,Staff,19,0,20,1
1681929062737,POLI 135,A00,183599,Fisk; David Lee,19,0,25,6
1681929063769,POLI 142P,A00,183623,Staff,37,0,40,3
1681929064799,POLI 144D,A00,183624,Staff,22,0,25,3
1681929065825,POLI 151,A00,183625,Staff,15,0,20,5
1681929066848,POLI 162,A00,183626,Mignozzetti; Umberto,17,0,20,3
1681929067884,PSYC 1,A00,253748,Staff,86,0,90,4
1681929068912,PSYC 2,A00,183627,Moranton; Nirelia Melbina-,23,0,35,12
1681929069943,PSYC 3,A00,183628,Staff,43,0,45,2
1681929072019,PSYC 60,A01,183631,Lowe; Angela Beth,35,0,40,5
1681929073049,PSYC 70,A01,253757,Staff,36,0,45,9
1681929074072,PSYC 101,A00,183632,Heyman; Gail D.,43,0,60,17
1681929075116,PSYC 105,A00,183848,Lowe; Angela Beth,46,0,60,14
1681929076141,PSYC 106,A00,183849,Dobkins; Karen R.,39,0,60,21
1681929077165,PSYC 108,A00,253750,Staff,13,0,60,47
1681929078190,PSYC 114,A01,184275,Winkielman; Piotr,0,8,30,30
1681929079218,PSYC 122,A00,183856,Moranton; Nirelia Melbina-,0,16,30,30
1681929080241,PSYC 124,A00,183865,Chapman; Eddie Nathaniel,43,0,80,37
1681929081273,PSYC 137,A00,183880,Staff,17,0,25,8
1681929083319,PSYC 154,A00,183910,Lacefield; Katharine I,0,27,90,90
1681929085373,PSYC 162,A00,183946,Wixted; John T,41,0,90,49
1681929086400,PSYC 172,A00,183947,Gorman; Michael R.,5,0,30,25
1681929087423,PSYC 178,A00,183963,Glaser; Dale,15,0,40,25
1681929088451,PSYC 181GS,A00,183964,Anagnostaras; Stephan,10,0,10,0
1681929089477,PSYC 186GS,A01,257660,Staff,10,0,10,0
1681929090502,PSYC 193,B00,253749,Staff,22,0,25,3
1681929092559,PSYC 193L,A01,184122,Staff,33,0,35,2
1681929092559,PSYC 193L,C01,184167,Winkielman; Piotr,14,0,30,16
1681929093590,RELI 188GS,A00,182629,Rahimi; Babak,20,0,20,0
1681929094613,SE 101A,A00,182646,Staff,26,0,30,4
1681929095643,SE 101C,A00,182650,Staff,12,0,20,8
1681929096671,SE 110A,A00,182651,Staff,28,0,28,0
1681929097701,SE 130A,A00,182652,Staff,38,0,40,2
1681929098738,SIO 46GS,A00,182636,Cook; Geoffrey W,25,0,28,3
1681929099760,SIO 109R,A00,194459,Staff,0,0,20,20
1681929100785,SIO 121GS,A00,182639,Cook; Geoffrey W,25,0,28,3
1681929101807,SIO 132,A01,182642,Staff,30,0,40,10
1681929102834,SIO 139,A00,182644,Kacev; David,36,0,40,4
1681929103857,SOCI 2,A01,258404,Staff,33,0,36,3
1681929103857,SOCI 2,A02,258405,Staff,35,0,36,1
1681929104883,SOCI 60,A01,258408,Staff,29,0,30,1
1681929104883,SOCI 60,A02,258413,Staff,30,0,30,0
1681929105910,SOCI 100,A01,258415,Staff,29,0,30,1
1681929105910,SOCI 100,A02,258416,Staff,28,0,30,2
1681929112059,SOCI 127,A00,258421,Staff,19,0,30,11
1681929113084,SOCI 132,A00,258422,Staff,43,0,50,7
1681929114112,SOCI 133,A00,258423,Staff,26,0,30,4
1681929115135,SOCI 138GS,A00,258424,Staff,15,0,15,0
1681929116161,SOCI 145,A00,258425,Staff,24,0,30,6
1681929117184,SOCI 148,A00,258426,Staff,24,0,30,6
1681929118213,SOCI 153,A00,199217,Staff,29,0,30,1
1681929119243,SOCI 160,A00,258427,Staff,27,0,30,3
1681929120267,SOCI 160E,A00,258435,Staff,55,0,60,5
1681929121317,SOCI 189GS,A00,258436,Staff,15,0,15,0
1681929122339,SOCI 190GS,A00,258437,Staff,15,0,15,0
1681929123362,SYN 2,001,182658,Staff,8,0,16,8
1681929123362,SYN 2,002,201439,Staff,14,0,16,2
1681929123362,SYN 2,003,201443,Staff,16,0,16,0
1681929124393,SYN 100,A01,182657,Staff,13,0,20,7
1681929125429,TDAC 1,A00,184381,Salovey; Todd,16,0,20,4
1681929125429,TDAC 1,B00,184385,Harting; Carla Kelso,19,0,20,1
1681929125429,TDAC 1,C00,184394,Staff,18,0,20,2
1681929126452,TDAC 101,A00,184483,Harting; Carla Kelso,19,0,20,1
1681929127479,TDDE 111,A00,184496,Staff,14,0,15,1
1681929128502,TDDE 131,A00,184504,Staff,20,0,20,0
1681929128502,TDDE 131,B00,184505,Staff,17,0,18,1
1681929128502,TDDE 131,C00,184534,Staff,49,0,50,1
1681929128502,TDDE 131,D00,184564,Staff,15,0,15,0
1681929128502,TDDE 131,E00,204725,Staff,18,0,20,2
1681929129533,TDGE 1,A01,184414,Salovey; Todd,35,0,50,15
1681929130555,TDGE 5,A01,184419,Staff,23,0,24,1
1681929131586,TDGE 10,A00,184428,Fulton; Julia,27,0,50,23
1681929132613,TDGE 124,A00,184565,Fulton; Julia,0,1,50,50
1681929133641,TDGE 125,B00,184567,Meyer; Ursula,8,0,25,17
1681929134666,TDHT 101,A00,184568,Staff,21,0,25,4
1681929134666,TDHT 101,B00,184569,Staff,20,0,20,0
1681929135692,TDHT 114,A00,184570,Staff,49,0,50,1
1681929136720,TDMV 1,A00,184437,Arcidiacono; Kristin,21,0,30,9
1681929136720,TDMV 1,B00,184448,Caligagan; Maria T.,23,0,30,7
1681929137753,TDMV 2,A00,184449,Weinberg; Sadie,27,0,30,3
1681929137753,TDMV 2,B00,184453,Arcidiacono; Kristin,29,0,30,1
1681929138798,TDMV 110,A00,184571,Weinberg; Sadie,30,0,30,0
1681929139822,TDMV 142,A00,184572,Caligagan; Tony,26,0,30,4
1681929139822,TDMV 142,B00,184573,Caligagan; Maria T.,26,0,30,4
1681929140845,TDTR 20,A00,184482,Jun; Grace Shin Hae,25,0,25,0
1681929141873,USP 2,A01,184290,Hinds; Juli Beth,24,0,25,1
1681929142896,USP 3,A01,184295,Staff,21,0,25,4
1681929143926,USP 4,A00,184304,McTague; Sarah,13,0,25,12
1681929144953,USP 100,A00,184315,Staff,16,0,25,9
1681929145992,USP 105,A00,184326,Staff,21,0,25,4
1681929147015,USP 151,A00,184327,Staff,18,0,25,7
1681929148037,USP 170,A00,184380,Hinds; Juli Beth,13,0,25,12
1681929149064,VIS 21B,A01,182660,Staff,28,0,31,3
1681929149064,VIS 21B,A02,182662,Staff,30,0,31,1
1681929150090,VIS 103D,A00,182663,Staff,74,0,75,1
1681929151113,VIS 105D,A00,182667,Li; Huai,14,0,22,8
1681929152210,VIS 122GS,A00,182668,Herbst; Matthew,20,0,20,0
1681929153235,VIS 128C,A00,182673,Staff,69,0,75,6
1681929154267,VIS 130,A00,182675,Staff,19,0,22,3
1681929155296,VIS 160A,A00,182678,Stalbaum; Brett,4,0,10,6
1681929157347,WCWP 10B,A00,201679,Staff,15,0,15,0
1681929157347,WCWP 10B,B00,201695,Staff,15,0,15,0
1681929158381,WCWP 100,A00,201716,Staff,12,0,15,3
1681929158381,WCWP 100,B00,201717,Staff,1,0,15,14
1681929160463,ANSC 105GS,A00,258289,Staff,0,0,0,0
1681929161485,ANSC 125GS,A00,258295,Staff,0,0,0,0
1681929162510,ANSC 150,A00,258267,Staff,28,0,40,12
1681929163532,ANSC 190GS,A00,258280,Staff,0,0,0,0
1681929164559,ANTH 1,A00,258264,Staff,38,0,40,2
1681929165584,ANTH 2,A01,258259,Staff,72,0,76,4
1681929166608,ANTH 23,A01,258228,Staff,36,0,40,4
1681929167629,ANTH 101,A01,258236,Staff,38,0,40,2
1681929168654,ANTH 102,A00,258272,Staff,59,0,60,1
1681929169693,ANTH 105,A00,258244,Staff,29,0,35,6
1681929170719,BENG 130,A00,253975,Staff,37,0,40,3
1681929171749,BIBC 102,A01,191866,Flagg; Matthew Paul,17,0,32,15
1681929171749,BIBC 102,A02,191867,Flagg; Matthew Paul,21,0,32,11
1681929171749,BIBC 102,A03,191868,Flagg; Matthew Paul,28,0,32,4
1681929171749,BIBC 102,A04,191936,Flagg; Matthew Paul,22,0,32,10
1681929171749,BIBC 102,A05,191937,Flagg; Matthew Paul,0,0,32,32
1681929172779,BICD 100,A01,191939,Cooper; Andrew Michael,27,0,32,5
1681929172779,BICD 100,A02,191940,Cooper; Andrew Michael,32,0,32,0
1681929172779,BICD 100,A03,191941,Cooper; Andrew Michael,32,0,32,0
1681929172779,BICD 100,A04,191942,Cooper; Andrew Michael,32,0,32,0
1681929172779,BICD 100,A05,191943,Cooper; Andrew Michael,32,0,32,0
1681929173817,BIEB 126,A01,191945,Cleland; Elsa Eleanor,0,2,32,32
1681929173817,BIEB 126,A02,191946,Cleland; Elsa Eleanor,26,0,32,6
1681929173817,BIEB 126,A03,191947,Cleland; Elsa Eleanor,29,0,32,3
1681929173817,BIEB 126,A04,191948,Cleland; Elsa Eleanor,17,0,32,15
1681929173817,BIEB 126,A05,191996,Cleland; Elsa Eleanor,28,0,32,4
1681929174842,BIEB 136GS,A00,191997,Shurin; Jonathan & Holway; David A.,0,0,0,8
1681929175869,BIEB 137GS,A01,191999,Shurin; Jonathan & Holway; David A.,0,0,0,7
1681929176893,BILD 1,A01,205385,Staff,30,0,32,2
1681929176893,BILD 1,A02,205386,Staff,30,0,32,2
1681929176893,BILD 1,A03,205387,Staff,31,0,32,1
1681929176893,BILD 1,A04,205388,Staff,26,0,32,6
1681929177924,BILD 2,A01,191774,Staff,27,0,32,5
1681929177924,BILD 2,A02,191775,Staff,30,0,32,2
1681929177924,BILD 2,A03,191777,Staff,30,0,32,2
1681929177924,BILD 2,A04,191856,Staff,30,0,32,2
1681929177924,BILD 2,A05,191857,Staff,31,0,32,1
1681929177924,BILD 2,A06,191858,Staff,32,0,32,0
1681929177924,BILD 2,A07,191859,Staff,31,0,32,1
1681929178965,BILD 3,A01,205391,Staff,27,0,32,5
1681929178965,BILD 3,A02,205393,Staff,32,0,32,0
1681929178965,BILD 3,A03,205394,Staff,27,0,32,5
1681929178965,BILD 3,A04,205395,Staff,32,0,32,0
1681929179990,BILD 20,A01,191861,Staff,32,0,32,0
1681929179990,BILD 20,A02,191862,Staff,32,0,32,0
1681929181013,BILD 30,A01,191864,Staff,31,0,32,1
1681929182045,BIMM 100,A01,192019,Staff,0,0,32,32
1681929182045,BIMM 100,A02,192020,Staff,18,0,32,14
1681929182045,BIMM 100,A03,192035,Staff,18,0,32,14
1681929183076,BIMM 110,A01,192037,Tat; John,0,0,32,32
1681929183076,BIMM 110,A02,192038,Tat; John,5,0,32,27
1681929184107,BIMM 120,A01,192040,Pickett; Brooke Elizabeth,0,0,32,32
1681929184107,BIMM 120,A02,192041,Pickett; Brooke Elizabeth,9,0,32,23
1681929184107,BIMM 120,A03,192042,Pickett; Brooke Elizabeth,14,0,32,18
1681929185134,BIPN 100,A01,192044,Armour; Jon Christopher,23,0,32,9
1681929185134,BIPN 100,A02,192059,Armour; Jon Christopher,30,0,32,2
1681929185134,BIPN 100,A03,192064,Armour; Jon Christopher,30,0,32,2
1681929185134,BIPN 100,A04,192073,Armour; Jon Christopher,26,0,32,6
1681929186167,BIPN 148,A01,205411,Leutgeb; Jill K.,14,0,32,18
1681929186167,BIPN 148,A02,205412,Leutgeb; Jill K.,31,0,32,1
1681929186167,BIPN 148,A03,205413,Leutgeb; Jill K.,30,0,32,2
1681929186167,BIPN 148,A04,205414,Leutgeb; Jill K.,30,0,32,2
1681929187191,BIPN 160,A01,192115,Marino; Marc J,15,0,32,17
1681929187191,BIPN 160,A02,192148,Marino; Marc J,27,0,32,5
1681929187191,BIPN 160,A03,192158,Marino; Marc J,31,0,32,1
1681929187191,BIPN 160,A04,192190,Marino; Marc J,32,0,32,0
1681929187191,BIPN 160,A05,192287,Marino; Marc J,32,0,32,0
1681929187191,BIPN 160,A06,192288,Marino; Marc J,32,0,32,0
1681929188217,BIPN 194,A00,206038,Staff,28,0,32,4
1681929189245,BISP 194,A00,192289,Leutgeb; Stefan,11,0,32,21
1681929189245,BISP 194,B00,245332,Nieh; James Charles,26,0,32,6
1681929190267,CAT 124,A01,202247,Staff,15,0,15,0
1681929191310,CAT 125,A00,202248,Staff,18,0,20,2
1681929191310,CAT 125,B00,202253,Staff,20,0,20,0
1681929191310,CAT 125,C00,202257,Staff,18,0,20,2
1681929192337,CAT 125GS,A01,202273,Bronstein; Phoebe Malan,20,0,20,0
1681929193361,CAT 125R,A00,202284,Staff,17,0,20,3
1681929193361,CAT 125R,C00,202286,Staff,5,0,20,15
1681929193361,CAT 125R,D00,202291,Staff,17,0,20,3
1681929193361,CAT 125R,E00,202295,Staff,13,0,20,7
1681929193361,CAT 125R,F00,202302,Staff,7,0,20,13
1681929194394,CENG 100,A00,204724,Opatkiewicz; Justin Paul,25,0,25,0
1681929195434,CGS 2A,A01,180420,Staff,30,0,36,6
1681929196458,CGS 101,A00,180421,Staff,15,0,20,5
1681929197486,CGS 112,A00,180422,Staff,9,0,16,7
1681929198511,CGS 113,A00,180423,Staff,18,0,20,2
1681929199536,CGS 137,A00,180424,Staff,12,0,12,0
1681929200558,CGS 147,A00,180425,Staff,10,0,10,0
1681929201586,CHEM 6A,A01,179556,Staff,93,0,100,7
1681929201586,CHEM 6A,A02,179558,Staff,0,0,0,0
1681929202613,CHEM 6B,A01,179560,Staff,100,0,100,0
1681929203642,CHEM 6C,A01,179565,Jazzar; Rodolphe,93,0,100,7
1681929204670,CHEM 7L,A01,179586,Schurmeier; Kimberly,10,0,24,14
1681929204670,CHEM 7L,A02,179587,Schurmeier; Kimberly,23,0,24,1
1681929204670,CHEM 7L,A03,179590,Schurmeier; Kimberly,22,0,24,2
1681929204670,CHEM 7L,A04,179591,Schurmeier; Kimberly,22,0,24,2
1681929204670,CHEM 7L,B01,179598,Schurmeier; Kimberly,15,0,24,9
1681929204670,CHEM 7L,B02,179599,Schurmeier; Kimberly,24,0,24,0
1681929204670,CHEM 7L,B03,179606,Schurmeier; Kimberly,22,0,24,2
1681929204670,CHEM 7L,B04,179607,Schurmeier; Kimberly,22,0,24,2
1681929205704,CHEM 11,A01,179609,Stallings; Dontarie M,87,0,100,13
1681929206739,CHEM 40A,A01,179621,Staff,39,0,50,11
1681929206739,CHEM 40A,A02,179622,Staff,46,0,50,4
1681929207765,CHEM 40B,A01,179630,Weizman; Haim,46,0,50,4
1681929207765,CHEM 40B,A02,179631,Weizman; Haim,44,0,50,6
1681929208794,CHEM 41A,A01,179660,Klosterman; Jeremy K,92,0,100,8
1681929209818,CHEM 43A,A01,179683,Klosterman; Jeremy K,0,0,24,24
1681929209818,CHEM 43A,A02,179688,Klosterman; Jeremy K,7,0,24,17
1681929209818,CHEM 43A,A03,179689,Klosterman; Jeremy K,18,0,24,6
1681929209818,CHEM 43A,A04,179691,Klosterman; Jeremy K,18,0,24,6
1681929210841,CHEM 114A,A01,179693,Stallings; Dontarie M,68,0,100,32
1681929211865,CHEM 143B,A01,179698,Weizman; Haim,16,0,24,8
1681929211865,CHEM 143B,A02,179700,Weizman; Haim,24,0,24,0
1681929212890,CHIN 169A,A00,179701,Wang; Xiao,20,0,20,0
1681929213923,COGS 2,A01,179750,Boyle; Mary E. T.,17,0,30,13
1681929214956,COGS 9,A01,179759,Jones; Cameron Robert,40,0,50,10
1681929215982,COGS 14A,A01,179854,Staff,12,0,50,38
1681929217005,COGS 14B,A01,179856,Staff,52,0,60,8
1681929218046,COGS 17,A01,179874,Staff,71,0,75,4
1681929219070,COGS 18,A01,179884,Staff,59,0,80,21
1681929220101,COGS 100,A01,179886,Staff,33,0,60,27
1681929221124,COGS 101B,A01,179892,Staff,0,2,30,30
1681929222147,COGS 101C,A01,179894,Staff,26,0,30,4
1681929223170,COGS 107A,A01,179896,Boyle; Mary E. T.,29,0,40,11
1681929224194,COGS 108,A01,179898,Simpkins; Charles Alexander,0,32,60,60
1681929225221,COGS 109,A01,179900,Staff,32,0,40,8
1681929226242,COGS 118A,A01,179946,Staff,5,0,40,35
1681929227265,COGS 153,A00,179978,Staff,0,6,30,30
1681929228287,COGS 156,A01,179981,Staff,21,0,30,9
1681929230353,COGS 172,A01,179987,Staff,10,0,30,20
1681929232406,COGS 186,A01,179991,Staff,11,0,30,19
1681929233430,COMM 10,A01,180001,Staff,11,0,25,14
1681929233430,COMM 10,A02,180004,Staff,20,0,25,5
1681929234463,COMM 100A,A01,180016,Staff,13,0,25,12
1681929234463,COMM 100A,A02,180020,Staff,24,0,25,1
1681929235488,COMM 101T,A00,180029,Halm; Gavin Patrick,21,0,35,14
1681929236510,COMM 106V,A00,180043,Staff,34,0,35,1
1681929237533,COMM 109P,A00,180044,Staff,30,0,35,5
1681929238559,COMM 113T,A00,180045,Havis; Allan,37,0,45,8
1681929239584,COMM 132,A00,180046,McKenna; Denise,21,0,30,9
1681929240610,COMM 143,A00,180047,Staff,16,0,30,14
1681929241632,COMM 190,A00,180048,Conner; Thomas Hartnell,17,0,23,6
1681929242663,CSE 8A,A50,180053,Cao; Yingjun,21,0,50,29
1681929242663,CSE 8A,B50,180180,Staff,50,0,50,0
1681929243689,CSE 11,A01,180190,Cao; Yingjun,21,0,50,29
1681929244715,CSE 20,A01,180192,Briones; Jor-el Thomas Caparas,21,0,30,9
1681929245738,CSE 21,A01,194538,Briones; Jor-el Thomas Caparas,50,0,60,10
1681929246764,CSE 30,A01,180324,Eldon; John,73,0,100,27
1681929247790,CSE 101,A01,201353,Staff,0,29,40,40
1681929248815,CSE 134B,A01,180326,Powell; Thomas Allan,73,0,100,27
1681929249842,CSE 140,A01,180328,Staff,25,0,75,50
1681929250865,CSE 140L,A01,180344,Eldon; John,49,0,100,51
1681929251888,CSE 150A,A01,180411,Staff,0,18,50,50
1681929252920,CSE 151A,A01,180414,Staff,0,13,50,50
1681929253950,CSE 175,A01,222521,Kumar; Rakesh,50,0,50,0
1681929254976,CSE 190,A00,201419,Staff,42,0,49,7
1681929256086,CSS 1,A01,194536,Staff,33,0,50,17
1681929257118,DSC 30,A01,202385,Staff,48,0,50,2
1681929258152,DSC 40A,A01,202387,Albuyeh; Rod,50,0,50,0
1681929259178,DSC 190,A01,202389,Silberman; Jack,21,0,21,0
1681929260210,DSGN 100,A01,179993,Staff,13,0,30,17
1681929261235,ECE 65,A50,180708,Staff,10,0,20,10
1681929261235,ECE 65,A51,180739,Staff,19,0,20,1
1681929262283,ECON 1,A01,180427,Famulari; Melissa,66,0,70,4
1681929263345,ECON 2,A01,180450,Levkoff; Steven B.,64,0,70,6
1681929264377,ECON 4,A01,203351,Anderson; John Charles,6,0,10,4
1681929265412,ECON 100A,A01,180472,Famulari; Melissa,59,0,70,11
1681929266439,ECON 120A,A01,180549,Staff,62,0,70,8
1681929267466,ECON 120B,A01,180655,Ma; Xinwei,39,0,70,31
1681929268489,ECON 129,A00,203333,Eckert; Fabian Paul,11,0,35,24
1681929269512,ECON 131,A00,180656,Staff,2,0,35,33
1681929270540,ECON 172B,A01,180672,Levkoff; Steven B.,31,0,35,4
1681929271562,ECON 178,A01,203342,Zhu; Ying,5,0,35,30
1681929272587,EDS 108GS,A00,202383,Wishard Guerra; Alison G.,20,0,20,0
1681929273611,EDS 111GS,A00,202347,Wishard Guerra; Alison G.,20,0,20,0
1681929274637,EDS 112,A01,202323,Staff,53,0,60,7
1681929275665,EDS 113,A00,202340,Staff,32,0,35,3
1681929276694,EDS 118,A00,201231,Staff,19,0,30,11
1681929277719,EDS 119,A00,204994,Staff,8,0,10,2
1681929278743,EDS 124BR,A00,202324,Eguchi; Emi,0,0,25,25
1681929279773,EDS 126,A01,203208,Jones; Makeba,26,0,30,4
1681929280799,EDS 135,A01,202333,Staff,17,0,20,3
1681929281828,EDS 180,A00,202311,Staff,47,0,50,3
1681929282855,ERC 190GS,A01,253747,Staff,28,0,28,0
1681929283880,ETHN 104,A00,180742,Staff,21,0,35,14
1681929284903,ETHN 118,A00,180745,Staff,27,0,35,8
1681929285927,ETHN 127,A00,180747,Staff,8,0,16,8
1681929286957,ETHN 137,A00,180880,Staff,11,0,12,1
1681929287981,ETHN 147,A00,180890,Staff,8,0,10,2
1681929289012,ETHN 154,A00,180891,Staff,6,0,8,2
1681929290039,ETHN 168,A00,180892,Staff,9,0,10,1
1681929291061,GLBH 20,A00,201051,Hannah; Seth Donal,0,5,0,1
1681929292085,GLBH 111,A01,209338,Burgos; Jose L.,0,0,0,0
1681929293108,GLBH 150,A00,258300,Staff,0,4,0,0
1681929294132,GLBH 181,A00,201207,Staff,9,0,40,31
1681929295156,HIEU 109,A00,180898,Staff,19,0,20,1
1681929296179,HIEU 111,A00,180899,Staff,0,2,20,20
1681929297204,HIEU 124,A00,180900,Staff,17,0,20,3
1681929298230,HILA 122,A00,180901,Staff,17,0,20,3
1681929299255,HILA 132,A00,180902,Vitz; Matthew,0,1,20,20
1681929300277,HILD 10,A01,180896,Staff,13,0,20,7
1681929301301,HILD 30GS,A00,180897,Edington; Claire Ellen,0,0,0,0
1681929302330,HISC 105,A00,180903,Staff,20,0,20,0
1681929303366,HISC 117,A00,180904,Staff,10,0,20,10
1681929304388,HIUS 108B,A00,181005,Staff,18,0,20,2
1681929305414,HIUS 113,A00,181093,Staff,1,0,20,19
1681929306438,HUM 3,A01,181190,Patterson; Patrick H.,35,0,50,15
1681929306438,HUM 3,B01,181195,Staff,45,0,50,5
1681929307471,HUM 3GS,A00,181196,Herbst; Matthew,0,0,0,0
1681929308502,HUM 4,A01,181227,West; Geoffrey Scott,33,0,50,17
1681929308502,HUM 4,B01,181282,Staff,41,0,50,9
1681929309524,HUM 4GS,A00,181377,Lyon; Antony J.,0,0,0,0
1681929310553,HUM 5,A01,181536,Zavodny; Tatiana Sophia,25,0,50,25
1681929310553,HUM 5,B01,181908,Staff,33,0,50,17
1681929311576,INTL 190,A00,181909,Segui; Alan S,0,0,0,8
1681929311576,INTL 190,B00,181961,Segui; Alan S,0,0,0,7
1681929312600,JAPN 20AR,A01,182113,Ross; Kayoko F,15,0,20,5
1681929313622,LATI 50,A01,202391,Martin-Cabrera; Luis,17,0,30,13
1681929313622,LATI 50,A02,202392,Martin-Cabrera; Luis,26,0,30,4
1681929314647,LATI 180,A00,202393,Kokinis; Troy Andreas,24,0,25,1
1681929315670,LIFR 1A,A00,182119,Staff,13,0,14,1
1681929316710,LIFR 1AX,A00,182324,Staff,13,0,14,1
1681929317733,LIFR 1B,A00,182259,Staff,12,0,14,2
1681929318756,LIFR 1BX,A00,182273,Staff,12,0,14,2
1681929319786,LIGN 8,A00,182330,Staff,129,0,150,21
1681929320808,LIGN 9GS,A00,182362,Staff,15,0,20,5
1681929321838,LIGN 119,A00,204992,Takahashi; Maho,11,0,15,4
1681929322861,LIGN 130,A01,182384,Staff,47,0,50,3
1681929323893,LIGN 149GS,A00,182390,Staff,15,0,20,5
1681929324925,LIGN 170,A00,182404,Staff,23,0,30,7
1681929325967,LISP 1D,A00,182281,Staff,7,0,14,7
1681929325967,LISP 1D,B00,182287,Staff,13,0,14,1
1681929325967,LISP 1D,C00,182295,Staff,10,0,14,4
1681929325967,LISP 1D,D00,182301,Staff,14,0,14,0
1681929326991,LISP 1DX,A00,182309,Staff,19,0,28,9
1681929326991,LISP 1DX,B00,182316,Staff,25,0,28,3
1681929328017,LTAF 120GS,A00,182412,Zhiri; Oumelbanine,20,0,20,0
1681929329046,LTCS 172GS,A00,182437,Bronstein; Phoebe Malan,20,0,20,0
1681929330072,LTEA 138,A00,182457,Staff,18,0,40,22
1681929331105,LTEN 114,A01,182490,Staff,23,0,25,2
1681929332127,LTEN 130GS,A00,182491,Lyon; Antony J.,20,0,20,0
1681929333160,LTEN 169,A00,182493,Cuong; Marisol,18,0,25,7
1681929334185,LTEN 178,A00,182501,Staff,14,0,15,1
1681929335210,LTEN 181,A00,182515,Staff,19,0,25,6
1681929336233,LTEN 185GS,A00,197655,Forbes; Camille,20,0,20,0
1681929337258,LTSP 100B,A00,202208,Bessett; Ryan Matthew,24,0,25,1
1681929338281,LTWL 100,A00,182516,Myerston Santana; Jacobo,20,0,30,10
1681929339304,LTWR 100GS,A00,182518,Forbes; Camille,20,0,20,0
1681929340330,LTWR 102,A00,182522,Staff,15,0,15,0
1681929340330,LTWR 102,B00,182525,Staff,14,0,15,1
1681929341354,LTWR 115,A00,182526,Staff,10,0,15,5
1681929342377,MAE 8,A01,182528,Pham; Hieu Tan,67,0,70,3
1681929343401,MAE 11,A00,182529,Bahadori; Mohammad Yousef,91,0,100,9
1681929344429,MAE 20,A00,182530,Evdokimenko; Ekaterina,68,0,70,2
1681929345462,MAE 30A,A00,182532,Staff,44,0,45,1
1681929346486,MAE 101A,A00,182533,Bahadori; Mohammad Yousef,94,0,100,6
1681929347511,MAE 101C,A00,182538,Staff,62,0,70,8
1681929348534,MAE 104,A00,182539,Staff,44,0,50,6
1681929349558,MAE 131A,A00,182540,Ghazinejad; Maziar,40,0,45,5
1681929350585,MAE 143A,A00,182548,Bewley; Thomas R,43,0,50,7
1681929351614,MAE 150,A00,182549,Staff,28,0,40,12
1681929352641,MAE 160,A00,182550,Evdokimenko; Ekaterina,41,0,60,19
1681929353662,MATH 3C,A01,182725,Staff,24,0,30,6
1681929354693,MATH 10A,A01,182729,Staff,24,0,30,6
1681929354693,MATH 10A,B01,182732,Staff,25,0,30,5
1681929355716,MATH 10B,A01,182737,Staff,17,0,30,13
1681929355716,MATH 10B,A02,182738,Staff,25,0,30,5
1681929355716,MATH 10B,B01,182744,Staff,25,0,30,5
1681929355716,MATH 10B,B02,182745,Staff,27,0,30,3
1681929356739,MATH 18,A01,182750,Anzaldo; Leesa B,28,0,30,2
1681929356739,MATH 18,A02,182751,Anzaldo; Leesa B,28,0,30,2
1681929356739,MATH 18,A03,182753,Anzaldo; Leesa B,27,0,30,3
1681929356739,MATH 18,A04,182757,Anzaldo; Leesa B,29,0,30,1
1681929356739,MATH 18,B01,182761,Anzaldo; Leesa B,27,0,30,3
1681929356739,MATH 18,B02,182764,Anzaldo; Leesa B,26,0,30,4
1681929356739,MATH 18,B03,182765,Anzaldo; Leesa B,29,0,30,1
1681929356739,MATH 18,B04,182766,Anzaldo; Leesa B,30,0,30,0
1681929357763,MATH 20A,A01,182771,Suk; Andrew Hoon,28,0,30,2
1681929358792,MATH 20B,A01,182775,Bach; Quang Tran,30,0,30,0
1681929358792,MATH 20B,A02,182777,Bach; Quang Tran,29,0,30,1
1681929358792,MATH 20B,B01,182780,Bach; Quang Tran,26,0,30,4
1681929358792,MATH 20B,B02,182782,Bach; Quang Tran,30,0,30,0
1681929359898,MATH 20C,A01,182787,Staff,24,0,30,6
1681929359898,MATH 20C,A02,182790,Staff,29,0,30,1
1681929359898,MATH 20C,B01,182792,Staff,23,0,30,7
1681929359898,MATH 20C,B02,182796,Staff,26,0,30,4
1681929360921,MATH 20D,A01,182799,Staff,27,0,30,3
1681929360921,MATH 20D,A02,182802,Staff,29,0,30,1
1681929360921,MATH 20D,A03,182803,Staff,30,0,30,0
1681929361944,MATH 20E,A01,182809,Verstraete; Jacques Allan,20,0,30,10
1681929361944,MATH 20E,A02,182811,Verstraete; Jacques Allan,28,0,30,2
1681929361944,MATH 20E,B01,182814,Verstraete; Jacques Allan,21,0,30,9
1681929361944,MATH 20E,B02,182815,Verstraete; Jacques Allan,29,0,30,1
1681929362968,MATH 103A,A01,182820,Staff,3,0,30,27
1681929362968,MATH 103A,A02,182821,Staff,27,0,30,3
1681929362968,MATH 103A,A03,182822,Staff,22,0,30,8
1681929362968,MATH 103A,B01,182825,Staff,21,0,30,9
1681929362968,MATH 103A,B02,182826,Staff,30,0,30,0
1681929362968,MATH 103A,B03,182830,Staff,30,0,30,0
1681929363994,MATH 109,A01,182836,Chow; Bennett,23,0,30,7
1681929363994,MATH 109,A02,182838,Chow; Bennett,28,0,30,2
1681929363994,MATH 109,A03,182894,Chow; Bennett,29,0,30,1
1681929363994,MATH 109,B01,182908,Chow; Bennett,27,0,30,3
1681929363994,MATH 109,B02,182909,Chow; Bennett,30,0,30,0
1681929363994,MATH 109,B03,182910,Chow; Bennett,26,0,30,4
1681929365018,MATH 142A,A01,182925,Staff,4,0,30,26
1681929365018,MATH 142A,A02,182935,Staff,23,0,30,7
1681929365018,MATH 142A,A03,182967,Staff,25,0,30,5
1681929365018,MATH 142A,B01,183125,Staff,22,0,30,8
1681929365018,MATH 142A,B02,183157,Staff,26,0,30,4
1681929365018,MATH 142A,B03,183158,Staff,29,0,30,1
1681929366055,MATH 183,A01,183160,Arias-Castro; Ery,23,0,30,7
1681929366055,MATH 183,A02,183161,Arias-Castro; Ery,29,0,30,1
1681929366055,MATH 183,B01,183163,Arias-Castro; Ery,28,0,30,2
1681929366055,MATH 183,B02,183164,Arias-Castro; Ery,28,0,30,2
1681929367091,MATH 193A,A01,183167,Staff,0,0,35,35
1681929367091,MATH 193A,A02,183168,Staff,23,0,35,12
1681929367091,MATH 193A,A03,183169,Staff,34,0,35,1
1681929367091,MATH 193A,A04,183170,Staff,26,0,35,9
1681929368114,MGT 4,A01,202395,Anderson; John Charles,76,0,80,4
1681929369137,MGT 5,A00,202396,Houskeeper; Robert,79,0,90,11
1681929370161,MGT 103,A00,202397,Eberhard; Craig A,49,0,90,41
1681929371184,MGT 131A,A00,202398,Houskeeper; Robert,82,0,90,8
1681929372207,MGT 135,A00,202399,Anderson; John Charles,81,0,90,9
1681929373230,MGT 162R,A00,202403,Gneezy; Uri,124,0,200,76
1681929374252,MGT 172,A00,202404,Hedges; Kathleen,30,0,90,60
1681929375274,MGT 181,A00,202405,Dunn; Louis Jean,79,0,90,11
1681929376301,MMW 14,A01,183200,Staff,3,0,28,25
1681929376301,MMW 14,A02,183201,Staff,25,0,28,3
1681929376301,MMW 14,A03,183202,Staff,24,0,28,4
1681929376301,MMW 14,A04,183203,Staff,25,0,28,3
1681929376301,MMW 14,A05,183204,Staff,26,0,28,2
1681929376301,MMW 14,A06,183205,Staff,27,0,28,1
1681929376301,MMW 14,B01,183207,Staff,26,0,28,2
1681929376301,MMW 14,B02,183208,Staff,28,0,28,0
1681929376301,MMW 14,B03,183209,Staff,28,0,28,0
1681929376301,MMW 14,B04,183210,Staff,28,0,28,0
1681929376301,MMW 14,B05,183211,Staff,28,0,28,0
1681929376301,MMW 14,B06,183212,Staff,27,0,28,1
1681929377325,MMW 14GS,A00,183213,Zhiri; Oumelbanine,28,0,28,0
1681929378351,MMW 15GS,B00,183215,Rahimi; Babak,28,0,28,0
1681929379378,MMW 121,A01,183217,Patterson; Patrick H.,9,0,28,19
1681929379378,MMW 121,A02,183218,Patterson; Patrick H.,24,0,28,4
1681929380408,MUS 1A,A01,182554,Staff,2,0,35,33
1681929381430,MUS 5,A01,182558,Staff,17,0,35,18
1681929382466,MUS 6,A01,182562,Staff,22,0,35,13
1681929383492,MUS 8GS,A00,182563,Borgo; David Garcia,25,0,25,0
1681929384525,MUS 13,A01,182567,Staff,23,0,25,2
1681929385549,MUS 15,A01,182570,Staff,31,0,35,4
1681929385549,MUS 15,B01,182575,Staff,7,0,35,28
1681929386572,MUS 80,A00,182578,Staff,22,0,25,3
1681929386572,MUS 80,B00,182581,Staff,20,0,25,5
1681929387598,MUS 113,A00,182582,Staff,25,0,25,0
1681929388622,MUS 114,A00,182583,Staff,1,0,25,24
1681929389646,MUS 150GS,A01,182588,Borgo; David Garcia,24,0,25,1
1681929390667,PHIL 1,A00,182590,Staff,34,0,40,6
1681929391701,PHIL 10,A01,182596,Grush; Rick Scott,30,0,35,5
1681929391701,PHIL 10,A02,182597,Grush; Rick Scott,33,0,35,2
1681929392742,PHIL 15,A01,182601,Staff,31,0,35,4
1681929392742,PHIL 15,A02,182602,Staff,33,0,35,2
1681929393765,PHIL 27,A01,182604,Staff,26,0,35,9
1681929393765,PHIL 27,A02,182607,Staff,35,0,35,0
1681929394787,PHIL 32,A01,182609,Staff,35,0,35,0
1681929394787,PHIL 32,A02,182612,Staff,35,0,35,0
1681929395813,PHIL 130,A00,182614,Staff,58,0,70,12
1681929396843,PHIL 136,A00,182616,Cohen; Jonathan David,66,0,70,4
1681929397868,PHIL 155,A00,182617,Vargas; Manuel Rogelio,58,0,70,12
1681929398892,PHIL 163,A01,182620,Staff,15,0,20,5
1681929398892,PHIL 163,A02,182624,Staff,10,0,20,10
1681929399915,PHIL 164,A00,182627,Staff,29,0,40,11
1681929400957,PHIL 173,A00,182628,Staff,35,0,40,5
1681929401981,PHYS 1A,A00,183221,Staff,53,0,60,7
1681929403008,PHYS 1AL,001,183222,Staff,25,0,30,5
1681929403008,PHYS 1AL,002,183223,Staff,24,0,30,6
1681929404030,PHYS 1B,A00,183231,Staff,40,0,60,20
1681929405061,PHYS 1BL,001,183232,Staff,15,0,30,15
1681929405061,PHYS 1BL,002,183233,Staff,27,0,30,3
1681929406087,PHYS 1C,A00,183240,Staff,21,0,60,39
1681929407123,PHYS 1CL,001,183241,Staff,9,0,30,21
1681929407123,PHYS 1CL,002,183242,Staff,22,0,30,8
1681929408149,PHYS 2AR,A01,183250,Staff,40,0,50,10
1681929409183,PHYS 2B,A01,183252,Staff,102,0,115,13
1681929410212,PHYS 2BL,A01,183254,Staff,21,0,24,3
1681929410212,PHYS 2BL,A02,183255,Staff,21,0,24,3
1681929411238,PHYS 2C,A01,183522,Staff,101,0,115,14
1681929412266,PHYS 4A,A01,183524,Staff,49,0,50,1
1681929413290,POLI 5,A00,183525,Staff,44,0,50,6
1681929414315,POLI 12,A00,183540,Staff,45,0,50,5
1681929415339,POLI 13R,A00,183541,Forman; Fonna,40,0,50,10
1681929416362,POLI 30,A00,183542,Mignozzetti; Umberto,48,0,50,2
1681929417399,POLI 100A,A00,183543,Staff,44,0,50,6
1681929418438,POLI 100E,A00,223598,Staff,32,0,35,3
1681929419462,POLI 103A,A00,183564,Kousser; Thad,35,0,50,15
1681929420485,POLI 104B,A00,201329,Staff,28,0,35,7
1681929421515,POLI 113BR,A00,183576,Hoston; Germaine,23,0,50,27
1681929422548,POLI 114BR,A00,183588,Staff,27,0,30,3
1681929423573,POLI 117R,A00,183595,Forman; Fonna,4,0,20,16
1681929424599,POLI 120H,A00,183596,Fisk; David Lee,14,0,20,6
1681929425623,POLI 130AA,A00,183597,Staff,13,0,20,7
1681929426646,POLI 134AA,A00,183598,Staff,19,0,20,1
1681929427682,POLI 135,A00,183599,Fisk; David Lee,19,0,25,6
1681929428706,POLI 142P,A00,183623,Staff,37,0,40,3
1681929429729,POLI 144D,A00,183624,Staff,22,0,25,3
1681929430761,POLI 151,A00,183625,Staff,15,0,20,5
1681929431792,POLI 162,A00,183626,Mignozzetti; Umberto,17,0,20,3
1681929432814,PSYC 1,A00,253748,Staff,86,0,90,4
1681929433840,PSYC 2,A00,183627,Moranton; Nirelia Melbina-,23,0,35,12
1681929434877,PSYC 3,A00,183628,Staff,43,0,45,2
1681929436932,PSYC 60,A01,183631,Lowe; Angela Beth,35,0,40,5
1681929437965,PSYC 70,A01,253757,Staff,36,0,45,9
1681929439003,PSYC 101,A00,183632,Heyman; Gail D.,43,0,60,17
1681929440027,PSYC 105,A00,183848,Lowe; Angela Beth,46,0,60,14
1681929441051,PSYC 106,A00,183849,Dobkins; Karen R.,39,0,60,21
1681929442075,PSYC 108,A00,253750,Staff,13,0,60,47
1681929443101,PSYC 114,A01,184275,Winkielman; Piotr,0,8,30,30
1681929444127,PSYC 122,A00,183856,Moranton; Nirelia Melbina-,0,16,30,30
1681929445157,PSYC 124,A00,183865,Chapman; Eddie Nathaniel,43,0,80,37
1681929446183,PSYC 137,A00,183880,Staff,17,0,25,8
1681929448241,PSYC 154,A00,183910,Lacefield; Katharine I,0,27,90,90
1681929450288,PSYC 162,A00,183946,Wixted; John T,41,0,90,49
1681929451318,PSYC 172,A00,183947,Gorman; Michael R.,5,0,30,25
1681929452340,PSYC 178,A00,183963,Glaser; Dale,15,0,40,25
1681929453362,PSYC 181GS,A00,183964,Anagnostaras; Stephan,10,0,10,0
1681929454393,PSYC 186GS,A01,257660,Staff,10,0,10,0
1681929455420,PSYC 193,B00,253749,Staff,22,0,25,3
1681929457474,PSYC 193L,A01,184122,Staff,33,0,35,2
1681929457474,PSYC 193L,C01,184167,Winkielman; Piotr,14,0,30,16
1681929458507,RELI 188GS,A00,182629,Rahimi; Babak,20,0,20,0
1681929459537,SE 101A,A00,182646,Staff,26,0,30,4
1681929460565,SE 101C,A00,182650,Staff,12,0,20,8
1681929461602,SE 110A,A00,182651,Staff,28,0,28,0
1681929462628,SE 130A,A00,182652,Staff,38,0,40,2
1681929463732,SIO 46GS,A00,182636,Cook; Geoffrey W,25,0,28,3
1681929464757,SIO 109R,A00,194459,Staff,0,0,20,20
1681929465782,SIO 121GS,A00,182639,Cook; Geoffrey W,25,0,28,3
1681929466811,SIO 132,A01,182642,Staff,30,0,40,10
1681929467833,SIO 139,A00,182644,Kacev; David,36,0,40,4
1681929468855,SOCI 2,A01,258404,Staff,33,0,36,3
1681929468855,SOCI 2,A02,258405,Staff,35,0,36,1
1681929469884,SOCI 60,A01,258408,Staff,29,0,30,1
1681929469884,SOCI 60,A02,258413,Staff,30,0,30,0
1681929470909,SOCI 100,A01,258415,Staff,29,0,30,1
1681929470909,SOCI 100,A02,258416,Staff,28,0,30,2
1681929477077,SOCI 127,A00,258421,Staff,19,0,30,11
1681929478115,SOCI 132,A00,258422,Staff,43,0,50,7
1681929479139,SOCI 133,A00,258423,Staff,26,0,30,4
1681929480162,SOCI 138GS,A00,258424,Staff,15,0,15,0
1681929481185,SOCI 145,A00,258425,Staff,24,0,30,6
1681929482210,SOCI 148,A00,258426,Staff,24,0,30,6
1681929483236,SOCI 153,A00,199217,Staff,29,0,30,1
1681929484265,SOCI 160,A00,258427,Staff,27,0,30,3
1681929485290,SOCI 160E,A00,258435,Staff,55,0,60,5
1681929486317,SOCI 189GS,A00,258436,Staff,15,0,15,0
1681929487342,SOCI 190GS,A00,258437,Staff,15,0,15,0
1681929488371,SYN 2,001,182658,Staff,8,0,16,8
1681929488371,SYN 2,002,201439,Staff,14,0,16,2
1681929488371,SYN 2,003,201443,Staff,16,0,16,0
1681929489395,SYN 100,A01,182657,Staff,13,0,20,7
1681929490429,TDAC 1,A00,184381,Salovey; Todd,16,0,20,4
1681929490429,TDAC 1,B00,184385,Harting; Carla Kelso,19,0,20,1
1681929490429,TDAC 1,C00,184394,Staff,18,0,20,2
1681929491464,TDAC 101,A00,184483,Harting; Carla Kelso,19,0,20,1
1681929492489,TDDE 111,A00,184496,Staff,14,0,15,1
1681929493516,TDDE 131,A00,184504,Staff,20,0,20,0
1681929493516,TDDE 131,B00,184505,Staff,17,0,18,1
1681929493516,TDDE 131,C00,184534,Staff,49,0,50,1
1681929493516,TDDE 131,D00,184564,Staff,15,0,15,0
1681929493516,TDDE 131,E00,204725,Staff,18,0,20,2
1681929494539,TDGE 1,A01,184414,Salovey; Todd,35,0,50,15
1681929495561,TDGE 5,A01,184419,Staff,23,0,24,1
1681929496587,TDGE 10,A00,184428,Fulton; Julia,27,0,50,23
1681929497610,TDGE 124,A00,184565,Fulton; Julia,0,1,50,50
1681929498632,TDGE 125,B00,184567,Meyer; Ursula,8,0,25,17
1681929499653,TDHT 101,A00,184568,Staff,21,0,25,4
1681929499653,TDHT 101,B00,184569,Staff,20,0,20,0
1681929500680,TDHT 114,A00,184570,Staff,49,0,50,1
1681929501704,TDMV 1,A00,184437,Arcidiacono; Kristin,21,0,30,9
1681929501704,TDMV 1,B00,184448,Caligagan; Maria T.,23,0,30,7
1681929502730,TDMV 2,A00,184449,Weinberg; Sadie,27,0,30,3
1681929502730,TDMV 2,B00,184453,Arcidiacono; Kristin,29,0,30,1
1681929503757,TDMV 110,A00,184571,Weinberg; Sadie,30,0,30,0
1681929504781,TDMV 142,A00,184572,Caligagan; Tony,26,0,30,4
1681929504781,TDMV 142,B00,184573,Caligagan; Maria T.,26,0,30,4
1681929505809,TDTR 20,A00,184482,Jun; Grace Shin Hae,25,0,25,0
1681929506837,USP 2,A01,184290,Hinds; Juli Beth,24,0,25,1
1681929507865,USP 3,A01,184295,Staff,21,0,25,4
1681929508894,USP 4,A00,184304,McTague; Sarah,13,0,25,12
1681929509920,USP 100,A00,184315,Staff,16,0,25,9
1681929510945,USP 105,A00,184326,Staff,21,0,25,4
1681929511977,USP 151,A00,184327,Staff,18,0,25,7
1681929513004,USP 170,A00,184380,Hinds; Juli Beth,13,0,25,12
1681929514032,VIS 21B,A01,182660,Staff,28,0,31,3
1681929514032,VIS 21B,A02,182662,Staff,30,0,31,1
1681929515058,VIS 103D,A00,182663,Staff,74,0,75,1
1681929516083,VIS 105D,A00,182667,Li; Huai,14,0,22,8
1681929517111,VIS 122GS,A00,182668,Herbst; Matthew,20,0,20,0
1681929518137,VIS 128C,A00,182673,Staff,69,0,75,6
1681929519172,VIS 130,A00,182675,Staff,19,0,22,3
1681929520200,VIS 160A,A00,182678,Stalbaum; Brett,4,0,10,6
1681929522255,WCWP 10B,A00,201679,Staff,15,0,15,0
1681929522255,WCWP 10B,B00,201695,Staff,15,0,15,0
1681929523284,WCWP 100,A00,201716,Staff,12,0,15,3
1681929523284,WCWP 100,B00,201717,Staff,1,0,15,14
1681929525348,ANSC 105GS,A00,258289,Staff,0,0,0,0
1681929526371,ANSC 125GS,A00,258295,Staff,0,0,0,0
1681929527405,ANSC 150,A00,258267,Staff,28,0,40,12
1681929528430,ANSC 190GS,A00,258280,Staff,0,0,0,0
1681929529452,ANTH 1,A00,258264,Staff,38,0,40,2
1681929530483,ANTH 2,A01,258259,Staff,72,0,76,4
1681929531510,ANTH 23,A01,258228,Staff,35,0,40,5
1681929532533,ANTH 101,A01,258236,Staff,38,0,40,2
1681929533573,ANTH 102,A00,258272,Staff,59,0,60,1
1681929534599,ANTH 105,A00,258244,Staff,29,0,35,6
1681929535624,BENG 130,A00,253975,Staff,37,0,40,3
1681929536649,BIBC 102,A01,191866,Flagg; Matthew Paul,17,0,32,15
1681929536649,BIBC 102,A02,191867,Flagg; Matthew Paul,21,0,32,11
1681929536649,BIBC 102,A03,191868,Flagg; Matthew Paul,28,0,32,4
1681929536649,BIBC 102,A04,191936,Flagg; Matthew Paul,22,0,32,10
1681929536649,BIBC 102,A05,191937,Flagg; Matthew Paul,0,0,32,32
1681929537681,BICD 100,A01,191939,Cooper; Andrew Michael,27,0,32,5
1681929537681,BICD 100,A02,191940,Cooper; Andrew Michael,32,0,32,0
1681929537681,BICD 100,A03,191941,Cooper; Andrew Michael,32,0,32,0
1681929537681,BICD 100,A04,191942,Cooper; Andrew Michael,32,0,32,0
1681929537681,BICD 100,A05,191943,Cooper; Andrew Michael,32,0,32,0
1681929538707,BIEB 126,A01,191945,Cleland; Elsa Eleanor,0,2,32,32
1681929538707,BIEB 126,A02,191946,Cleland; Elsa Eleanor,26,0,32,6
1681929538707,BIEB 126,A03,191947,Cleland; Elsa Eleanor,29,0,32,3
1681929538707,BIEB 126,A04,191948,Cleland; Elsa Eleanor,17,0,32,15
1681929538707,BIEB 126,A05,191996,Cleland; Elsa Eleanor,28,0,32,4
1681929539744,BIEB 136GS,A00,191997,Shurin; Jonathan & Holway; David A.,0,0,0,8
1681929540771,BIEB 137GS,A01,191999,Shurin; Jonathan & Holway; David A.,0,0,0,7
1681929541798,BILD 1,A01,205385,Staff,30,0,32,2
1681929541798,BILD 1,A02,205386,Staff,30,0,32,2
1681929541798,BILD 1,A03,205387,Staff,31,0,32,1
1681929541798,BILD 1,A04,205388,Staff,26,0,32,6
1681929542829,BILD 2,A01,191774,Staff,27,0,32,5
1681929542829,BILD 2,A02,191775,Staff,30,0,32,2
1681929542829,BILD 2,A03,191777,Staff,30,0,32,2
1681929542829,BILD 2,A04,191856,Staff,30,0,32,2
1681929542829,BILD 2,A05,191857,Staff,31,0,32,1
1681929542829,BILD 2,A06,191858,Staff,32,0,32,0
1681929542829,BILD 2,A07,191859,Staff,31,0,32,1
1681929543863,BILD 3,A01,205391,Staff,27,0,32,5
1681929543863,BILD 3,A02,205393,Staff,32,0,32,0
1681929543863,BILD 3,A03,205394,Staff,27,0,32,5
1681929543863,BILD 3,A04,205395,Staff,32,0,32,0
1681929544886,BILD 20,A01,191861,Staff,32,0,32,0
1681929544886,BILD 20,A02,191862,Staff,32,0,32,0
1681929545913,BILD 30,A01,191864,Staff,31,0,32,1
1681929546937,BIMM 100,A01,192019,Staff,0,0,32,32
1681929546937,BIMM 100,A02,192020,Staff,18,0,32,14
1681929546937,BIMM 100,A03,192035,Staff,18,0,32,14
1681929547971,BIMM 110,A01,192037,Tat; John,0,0,32,32
1681929547971,BIMM 110,A02,192038,Tat; John,5,0,32,27
1681929548994,BIMM 120,A01,192040,Pickett; Brooke Elizabeth,0,0,32,32
1681929548994,BIMM 120,A02,192041,Pickett; Brooke Elizabeth,9,0,32,23
1681929548994,BIMM 120,A03,192042,Pickett; Brooke Elizabeth,14,0,32,18
1681929550017,BIPN 100,A01,192044,Armour; Jon Christopher,23,0,32,9
1681929550017,BIPN 100,A02,192059,Armour; Jon Christopher,30,0,32,2
1681929550017,BIPN 100,A03,192064,Armour; Jon Christopher,30,0,32,2
1681929550017,BIPN 100,A04,192073,Armour; Jon Christopher,26,0,32,6
1681929551057,BIPN 148,A01,205411,Leutgeb; Jill K.,14,0,32,18
1681929551057,BIPN 148,A02,205412,Leutgeb; Jill K.,31,0,32,1
1681929551057,BIPN 148,A03,205413,Leutgeb; Jill K.,30,0,32,2
1681929551057,BIPN 148,A04,205414,Leutgeb; Jill K.,30,0,32,2
1681929552080,BIPN 160,A01,192115,Marino; Marc J,15,0,32,17
1681929552080,BIPN 160,A02,192148,Marino; Marc J,27,0,32,5
1681929552080,BIPN 160,A03,192158,Marino; Marc J,31,0,32,1
1681929552080,BIPN 160,A04,192190,Marino; Marc J,32,0,32,0
1681929552080,BIPN 160,A05,192287,Marino; Marc J,32,0,32,0
1681929552080,BIPN 160,A06,192288,Marino; Marc J,32,0,32,0
1681929553104,BIPN 194,A00,206038,Leutgeb; Stefan,28,0,32,4
1681929554137,BISP 194,A00,192289,Nieh; James Charles,11,0,32,21
1681929554137,BISP 194,B00,245332,Staff,26,0,32,6
1681929555165,CAT 124,A01,202247,Staff,15,0,15,0
1681929556200,CAT 125,A00,202248,Staff,18,0,20,2
1681929556200,CAT 125,B00,202253,Staff,20,0,20,0
1681929556200,CAT 125,C00,202257,Staff,18,0,20,2
1681929557233,CAT 125GS,A01,202273,Bronstein; Phoebe Malan,20,0,20,0
1681929558259,CAT 125R,A00,202284,Staff,17,0,20,3
1681929558259,CAT 125R,C00,202286,Staff,5,0,20,15
1681929558259,CAT 125R,D00,202291,Staff,17,0,20,3
1681929558259,CAT 125R,E00,202295,Staff,13,0,20,7
1681929558259,CAT 125R,F00,202302,Staff,7,0,20,13
1681929559286,CENG 100,A00,204724,Opatkiewicz; Justin Paul,25,0,25,0
1681929560321,CGS 2A,A01,180420,Staff,30,0,36,6
1681929561347,CGS 101,A00,180421,Staff,15,0,20,5
1681929562381,CGS 112,A00,180422,Staff,9,0,16,7
1681929563405,CGS 113,A00,180423,Staff,18,0,20,2
1681929564427,CGS 137,A00,180424,Staff,12,0,12,0
1681929565450,CGS 147,A00,180425,Staff,10,0,10,0
1681929566475,CHEM 6A,A01,179556,Staff,93,0,100,7
1681929566475,CHEM 6A,A02,179558,Staff,0,0,0,0
1681929567579,CHEM 6B,A01,179560,Staff,100,0,100,0
1681929568605,CHEM 6C,A01,179565,Jazzar; Rodolphe,93,0,100,7
1681929569628,CHEM 7L,A01,179586,Schurmeier; Kimberly,10,0,24,14
1681929569628,CHEM 7L,A02,179587,Schurmeier; Kimberly,23,0,24,1
1681929569628,CHEM 7L,A03,179590,Schurmeier; Kimberly,22,0,24,2
1681929569628,CHEM 7L,A04,179591,Schurmeier; Kimberly,22,0,24,2
1681929569628,CHEM 7L,B01,179598,Schurmeier; Kimberly,15,0,24,9
1681929569628,CHEM 7L,B02,179599,Schurmeier; Kimberly,24,0,24,0
1681929569628,CHEM 7L,B03,179606,Schurmeier; Kimberly,22,0,24,2
1681929569628,CHEM 7L,B04,179607,Schurmeier; Kimberly,22,0,24,2
1681929570664,CHEM 11,A01,179609,Stallings; Dontarie M,87,0,100,13
1681929571690,CHEM 40A,A01,179621,Staff,38,0,50,12
1681929571690,CHEM 40A,A02,179622,Staff,46,0,50,4
1681929572714,CHEM 40B,A01,179630,Weizman; Haim,46,0,50,4
1681929572714,CHEM 40B,A02,179631,Weizman; Haim,44,0,50,6
1681929573748,CHEM 41A,A01,179660,Klosterman; Jeremy K,92,0,100,8
1681929574777,CHEM 43A,A01,179683,Klosterman; Jeremy K,0,0,24,24
1681929574777,CHEM 43A,A02,179688,Klosterman; Jeremy K,7,0,24,17
1681929574777,CHEM 43A,A03,179689,Klosterman; Jeremy K,18,0,24,6
1681929574777,CHEM 43A,A04,179691,Klosterman; Jeremy K,18,0,24,6
1681929575817,CHEM 114A,A01,179693,Stallings; Dontarie M,68,0,100,32
1681929576840,CHEM 143B,A01,179698,Weizman; Haim,16,0,24,8
1681929576840,CHEM 143B,A02,179700,Weizman; Haim,24,0,24,0
1681929577865,CHIN 169A,A00,179701,Wang; Xiao,20,0,20,0
1681929578889,COGS 2,A01,179750,Boyle; Mary E. T.,17,0,30,13
1681929579913,COGS 9,A01,179759,Jones; Cameron Robert,40,0,50,10
1681929580938,COGS 14A,A01,179854,Staff,11,0,50,39
1681929581964,COGS 14B,A01,179856,Staff,52,0,60,8
1681929582991,COGS 17,A01,179874,Staff,71,0,75,4
1681929584017,COGS 18,A01,179884,Staff,59,0,80,21
1681929585044,COGS 100,A01,179886,Staff,33,0,60,27
1681929586075,COGS 101B,A01,179892,Staff,0,3,30,30
1681929587102,COGS 101C,A01,179894,Staff,26,0,30,4
1681929588138,COGS 107A,A01,179896,Boyle; Mary E. T.,29,0,40,11
1681929589165,COGS 108,A01,179898,Simpkins; Charles Alexander,0,32,60,60
1681929590194,COGS 109,A01,179900,Staff,32,0,40,8
1681929591216,COGS 118A,A01,179946,Staff,5,0,40,35
1681929592241,COGS 153,A00,179978,Staff,0,6,30,30
1681929593264,COGS 156,A01,179981,Staff,21,0,30,9
1681929595313,COGS 172,A01,179987,Staff,10,0,30,20
1681929597369,COGS 186,A01,179991,Staff,11,0,30,19
1681929598398,COMM 10,A01,180001,Staff,10,0,25,15
1681929598398,COMM 10,A02,180004,Staff,20,0,25,5
1681929599426,COMM 100A,A01,180016,Staff,13,0,25,12
1681929599426,COMM 100A,A02,180020,Staff,24,0,25,1
1681929600458,COMM 101T,A00,180029,Halm; Gavin Patrick,21,0,35,14
1681929601481,COMM 106V,A00,180043,Staff,34,0,35,1
1681929602507,COMM 109P,A00,180044,Staff,30,0,35,5
1681929603542,COMM 113T,A00,180045,Havis; Allan,37,0,45,8
1681929604566,COMM 132,A00,180046,McKenna; Denise,21,0,30,9
1681929605590,COMM 143,A00,180047,Staff,16,0,30,14
1681929606612,COMM 190,A00,180048,Conner; Thomas Hartnell,17,0,23,6
1681929607634,CSE 8A,A50,180053,Cao; Yingjun,21,0,50,29
1681929607634,CSE 8A,B50,180180,Staff,50,0,50,0
1681929608657,CSE 11,A01,180190,Cao; Yingjun,21,0,50,29
1681929609683,CSE 20,A01,180192,Briones; Jor-el Thomas Caparas,21,0,30,9
1681929610723,CSE 21,A01,194538,Briones; Jor-el Thomas Caparas,50,0,60,10
1681929611749,CSE 30,A01,180324,Eldon; John,73,0,100,27
1681929612779,CSE 101,A01,201353,Staff,0,29,40,40
1681929613804,CSE 134B,A01,180326,Powell; Thomas Allan,73,0,100,27
1681929614827,CSE 140,A01,180328,Staff,24,0,75,51
1681929615851,CSE 140L,A01,180344,Eldon; John,48,0,100,52
1681929616883,CSE 150A,A01,180411,Staff,0,18,50,50
1681929617907,CSE 151A,A01,180414,Staff,0,13,50,50
1681929618929,CSE 175,A01,222521,Kumar; Rakesh,50,0,50,0
1681929619952,CSE 190,A00,201419,Staff,42,0,49,7
1681929620975,CSS 1,A01,194536,Staff,33,0,50,17
1681929622002,DSC 30,A01,202385,Staff,48,0,50,2
1681929623029,DSC 40A,A01,202387,Albuyeh; Rod,50,0,50,0
1681929624062,DSC 190,A01,202389,Silberman; Jack,21,0,21,0
1681929625086,DSGN 100,A01,179993,Staff,13,0,30,17
1681929626109,ECE 65,A50,180708,Staff,10,0,20,10
1681929626109,ECE 65,A51,180739,Staff,19,0,20,1
1681929627134,ECON 1,A01,180427,Famulari; Melissa,66,0,70,4
1681929628159,ECON 2,A01,180450,Levkoff; Steven B.,64,0,70,6
1681929629190,ECON 4,A01,203351,Anderson; John Charles,6,0,10,4
1681929630214,ECON 100A,A01,180472,Famulari; Melissa,59,0,70,11
1681929631251,ECON 120A,A01,180549,Staff,62,0,70,8
1681929632273,ECON 120B,A01,180655,Ma; Xinwei,39,0,70,31
1681929633295,ECON 129,A00,203333,Eckert; Fabian Paul,11,0,35,24
1681929634329,ECON 131,A00,180656,Staff,2,0,35,33
1681929635364,ECON 172B,A01,180672,Levkoff; Steven B.,31,0,35,4
1681929636393,ECON 178,A01,203342,Zhu; Ying,5,0,35,30
1681929637420,EDS 108GS,A00,202383,Wishard Guerra; Alison G.,20,0,20,0
1681929638458,EDS 111GS,A00,202347,Wishard Guerra; Alison G.,20,0,20,0
1681929639483,EDS 112,A01,202323,Staff,53,0,60,7
1681929640510,EDS 113,A00,202340,Staff,32,0,35,3
1681929641541,EDS 118,A00,201231,Staff,19,0,30,11
1681929642564,EDS 119,A00,204994,Staff,8,0,10,2
1681929643634,EDS 124BR,A00,202324,Eguchi; Emi,0,0,25,25
1681929644660,EDS 126,A01,203208,Jones; Makeba,26,0,30,4
1681929645689,EDS 135,A01,202333,Staff,17,0,20,3
1681929646712,EDS 180,A00,202311,Staff,47,0,50,3
1681929647735,ERC 190GS,A01,253747,Staff,28,0,28,0
1681929648771,ETHN 104,A00,180742,Staff,21,0,35,14
1681929649794,ETHN 118,A00,180745,Staff,26,0,35,9
1681929650818,ETHN 127,A00,180747,Staff,8,0,16,8
1681929651856,ETHN 137,A00,180880,Staff,11,0,12,1
1681929652889,ETHN 147,A00,180890,Staff,8,0,10,2
1681929653912,ETHN 154,A00,180891,Staff,6,0,8,2
1681929654937,ETHN 168,A00,180892,Staff,9,0,10,1
1681929655964,GLBH 20,A00,201051,Hannah; Seth Donal,0,5,0,1
1681929657003,GLBH 111,A01,209338,Burgos; Jose L.,0,0,0,0
1681929658025,GLBH 150,A00,258300,Staff,0,4,0,0
1681929659057,GLBH 181,A00,201207,Staff,8,0,40,32
1681929660082,HIEU 109,A00,180898,Staff,19,0,20,1
1681929661111,HIEU 111,A00,180899,Staff,0,2,20,20
1681929662141,HIEU 124,A00,180900,Staff,17,0,20,3
1681929663170,HILA 122,A00,180901,Staff,17,0,20,3
1681929664200,HILA 132,A00,180902,Vitz; Matthew,0,1,20,20
1681929665224,HILD 10,A01,180896,Staff,13,0,20,7
1681929666255,HILD 30GS,A00,180897,Edington; Claire Ellen,0,0,0,0
1681929667289,HISC 105,A00,180903,Staff,20,0,20,0
1681929668315,HISC 117,A00,180904,Staff,10,0,20,10
1681929669338,HIUS 108B,A00,181005,Staff,18,0,20,2
1681929670362,HIUS 113,A00,181093,Staff,1,0,20,19
1681929671465,HUM 3,A01,181190,Patterson; Patrick H.,35,0,50,15
1681929671465,HUM 3,B01,181195,Staff,45,0,50,5
1681929672496,HUM 3GS,A00,181196,Herbst; Matthew,0,0,0,0
1681929673534,HUM 4,A01,181227,West; Geoffrey Scott,33,0,50,17
1681929673534,HUM 4,B01,181282,Staff,41,0,50,9
1681929674562,HUM 4GS,A00,181377,Lyon; Antony J.,0,0,0,0
1681929675585,HUM 5,A01,181536,Zavodny; Tatiana Sophia,25,0,50,25
1681929675585,HUM 5,B01,181908,Staff,33,0,50,17
1681929676608,INTL 190,A00,181909,Segui; Alan S,0,0,0,8
1681929676608,INTL 190,B00,181961,Segui; Alan S,0,0,0,7
1681929677635,JAPN 20AR,A01,182113,Ross; Kayoko F,15,0,20,5
1681929678663,LATI 50,A01,202391,Martin-Cabrera; Luis,17,0,30,13
1681929678663,LATI 50,A02,202392,Martin-Cabrera; Luis,26,0,30,4
1681929679686,LATI 180,A00,202393,Kokinis; Troy Andreas,24,0,25,1
1681929680710,LIFR 1A,A00,182119,Staff,13,0,14,1
1681929681733,LIFR 1AX,A00,182324,Staff,13,0,14,1
1681929682760,LIFR 1B,A00,182259,Staff,12,0,14,2
1681929683788,LIFR 1BX,A00,182273,Staff,12,0,14,2
1681929684830,LIGN 8,A00,182330,Staff,129,0,150,21
1681929685853,LIGN 9GS,A00,182362,Staff,15,0,20,5
1681929686875,LIGN 119,A00,204992,Takahashi; Maho,11,0,15,4
1681929687909,LIGN 130,A01,182384,Staff,47,0,50,3
1681929688939,LIGN 149GS,A00,182390,Staff,15,0,20,5
1681929689961,LIGN 170,A00,182404,Staff,23,0,30,7
1681929690983,LISP 1D,A00,182281,Staff,7,0,14,7
1681929690983,LISP 1D,B00,182287,Staff,13,0,14,1
1681929690983,LISP 1D,C00,182295,Staff,10,0,14,4
1681929690983,LISP 1D,D00,182301,Staff,14,0,14,0
1681929692019,LISP 1DX,A00,182309,Staff,19,0,28,9
1681929692019,LISP 1DX,B00,182316,Staff,25,0,28,3
1681929693051,LTAF 120GS,A00,182412,Zhiri; Oumelbanine,20,0,20,0
1681929694075,LTCS 172GS,A00,182437,Bronstein; Phoebe Malan,20,0,20,0
1681929695098,LTEA 138,A00,182457,Staff,18,0,40,22
1681929696129,LTEN 114,A01,182490,Staff,23,0,25,2
1681929697170,LTEN 130GS,A00,182491,Lyon; Antony J.,20,0,20,0
1681929698300,LTEN 169,A00,182493,Cuong; Marisol,18,0,25,7
1681929699324,LTEN 178,A00,182501,Staff,14,0,15,1
1681929700348,LTEN 181,A00,182515,Staff,19,0,25,6
1681929701371,LTEN 185GS,A00,197655,Forbes; Camille,20,0,20,0
1681929702397,LTSP 100B,A00,202208,Bessett; Ryan Matthew,24,0,25,1
1681929703430,LTWL 100,A00,182516,Myerston Santana; Jacobo,20,0,30,10
1681929704459,LTWR 100GS,A00,182518,Forbes; Camille,20,0,20,0
1681929705500,LTWR 102,A00,182522,Staff,15,0,15,0
1681929705500,LTWR 102,B00,182525,Staff,14,0,15,1
1681929706522,LTWR 115,A00,182526,Staff,10,0,15,5
1681929707552,MAE 8,A01,182528,Pham; Hieu Tan,67,0,70,3
1681929708585,MAE 11,A00,182529,Bahadori; Mohammad Yousef,91,0,100,9
1681929709622,MAE 20,A00,182530,Evdokimenko; Ekaterina,68,0,70,2
1681929710645,MAE 30A,A00,182532,Staff,44,0,45,1
1681929711669,MAE 101A,A00,182533,Bahadori; Mohammad Yousef,94,0,100,6
1681929712693,MAE 101C,A00,182538,Staff,62,0,70,8
1681929713716,MAE 104,A00,182539,Staff,44,0,50,6
1681929714739,MAE 131A,A00,182540,Ghazinejad; Maziar,40,0,45,5
1681929715765,MAE 143A,A00,182548,Bewley; Thomas R,42,0,50,8
1681929716795,MAE 150,A00,182549,Staff,28,0,40,12
1681929717822,MAE 160,A00,182550,Evdokimenko; Ekaterina,41,0,60,19
1681929718846,MATH 3C,A01,182725,Staff,24,0,30,6
1681929719870,MATH 10A,A01,182729,Staff,24,0,30,6
1681929719870,MATH 10A,B01,182732,Staff,25,0,30,5
1681929720899,MATH 10B,A01,182737,Staff,17,0,30,13
1681929720899,MATH 10B,A02,182738,Staff,25,0,30,5
1681929720899,MATH 10B,B01,182744,Staff,25,0,30,5
1681929720899,MATH 10B,B02,182745,Staff,27,0,30,3
1681929721928,MATH 18,A01,182750,Anzaldo; Leesa B,28,0,30,2
1681929721928,MATH 18,A02,182751,Anzaldo; Leesa B,28,0,30,2
1681929721928,MATH 18,A03,182753,Anzaldo; Leesa B,27,0,30,3
1681929721928,MATH 18,A04,182757,Anzaldo; Leesa B,29,0,30,1
1681929721928,MATH 18,B01,182761,Anzaldo; Leesa B,27,0,30,3
1681929721928,MATH 18,B02,182764,Anzaldo; Leesa B,26,0,30,4
1681929721928,MATH 18,B03,182765,Anzaldo; Leesa B,29,0,30,1
1681929721928,MATH 18,B04,182766,Anzaldo; Leesa B,30,0,30,0
1681929722951,MATH 20A,A01,182771,Suk; Andrew Hoon,28,0,30,2
1681929723976,MATH 20B,A01,182775,Bach; Quang Tran,30,0,30,0
1681929723976,MATH 20B,A02,182777,Bach; Quang Tran,29,0,30,1
1681929723976,MATH 20B,B01,182780,Bach; Quang Tran,26,0,30,4
1681929723976,MATH 20B,B02,182782,Bach; Quang Tran,30,0,30,0
1681929725000,MATH 20C,A01,182787,Staff,24,0,30,6
1681929725000,MATH 20C,A02,182790,Staff,29,0,30,1
1681929725000,MATH 20C,B01,182792,Staff,23,0,30,7
1681929725000,MATH 20C,B02,182796,Staff,26,0,30,4
1681929726026,MATH 20D,A01,182799,Staff,27,0,30,3
1681929726026,MATH 20D,A02,182802,Staff,29,0,30,1
1681929726026,MATH 20D,A03,182803,Staff,30,0,30,0
1681929727048,MATH 20E,A01,182809,Verstraete; Jacques Allan,20,0,30,10
1681929727048,MATH 20E,A02,182811,Verstraete; Jacques Allan,28,0,30,2
1681929727048,MATH 20E,B01,182814,Verstraete; Jacques Allan,21,0,30,9
1681929727048,MATH 20E,B02,182815,Verstraete; Jacques Allan,29,0,30,1
1681929728072,MATH 103A,A01,182820,Staff,3,0,30,27
1681929728072,MATH 103A,A02,182821,Staff,27,0,30,3
1681929728072,MATH 103A,A03,182822,Staff,21,0,30,9
1681929728072,MATH 103A,B01,182825,Staff,21,0,30,9
1681929728072,MATH 103A,B02,182826,Staff,30,0,30,0
1681929728072,MATH 103A,B03,182830,Staff,30,0,30,0
1681929729097,MATH 109,A01,182836,Chow; Bennett,23,0,30,7
1681929729097,MATH 109,A02,182838,Chow; Bennett,28,0,30,2
1681929729097,MATH 109,A03,182894,Chow; Bennett,29,0,30,1
1681929729097,MATH 109,B01,182908,Chow; Bennett,27,0,30,3
1681929729097,MATH 109,B02,182909,Chow; Bennett,30,0,30,0
1681929729097,MATH 109,B03,182910,Chow; Bennett,26,0,30,4
1681929730120,MATH 142A,A01,182925,Staff,4,0,30,26
1681929730120,MATH 142A,A02,182935,Staff,23,0,30,7
1681929730120,MATH 142A,A03,182967,Staff,25,0,30,5
1681929730120,MATH 142A,B01,183125,Staff,22,0,30,8
1681929730120,MATH 142A,B02,183157,Staff,26,0,30,4
1681929730120,MATH 142A,B03,183158,Staff,29,0,30,1
1681929731151,MATH 183,A01,183160,Arias-Castro; Ery,23,0,30,7
1681929731151,MATH 183,A02,183161,Arias-Castro; Ery,29,0,30,1
1681929731151,MATH 183,B01,183163,Arias-Castro; Ery,27,0,30,3
1681929731151,MATH 183,B02,183164,Arias-Castro; Ery,28,0,30,2
1681929732184,MATH 193A,A01,183167,Staff,0,0,35,35
1681929732184,MATH 193A,A02,183168,Staff,23,0,35,12
1681929732184,MATH 193A,A03,183169,Staff,34,0,35,1
1681929732184,MATH 193A,A04,183170,Staff,26,0,35,9
1681929733213,MGT 4,A01,202395,Anderson; John Charles,76,0,80,4
1681929734246,MGT 5,A00,202396,Houskeeper; Robert,79,0,90,11
1681929735273,MGT 103,A00,202397,Eberhard; Craig A,49,0,90,41
1681929736296,MGT 131A,A00,202398,Houskeeper; Robert,81,0,90,9
1681929737320,MGT 135,A00,202399,Anderson; John Charles,81,0,90,9
1681929738357,MGT 162R,A00,202403,Gneezy; Uri,124,0,200,76
1681929739381,MGT 172,A00,202404,Hedges; Kathleen,30,0,90,60
1681929740408,MGT 181,A00,202405,Dunn; Louis Jean,79,0,90,11
1681929741436,MMW 14,A01,183200,Staff,3,0,28,25
1681929741436,MMW 14,A02,183201,Staff,25,0,28,3
1681929741436,MMW 14,A03,183202,Staff,24,0,28,4
1681929741436,MMW 14,A04,183203,Staff,25,0,28,3
1681929741436,MMW 14,A05,183204,Staff,26,0,28,2
1681929741436,MMW 14,A06,183205,Staff,27,0,28,1
1681929741436,MMW 14,B01,183207,Staff,26,0,28,2
1681929741436,MMW 14,B02,183208,Staff,28,0,28,0
1681929741436,MMW 14,B03,183209,Staff,28,0,28,0
1681929741436,MMW 14,B04,183210,Staff,28,0,28,0
1681929741436,MMW 14,B05,183211,Staff,28,0,28,0
1681929741436,MMW 14,B06,183212,Staff,27,0,28,1
1681929742459,MMW 14GS,A00,183213,Zhiri; Oumelbanine,28,0,28,0
1681929743490,MMW 15GS,B00,183215,Rahimi; Babak,28,0,28,0
1681929744525,MMW 121,A01,183217,Patterson; Patrick H.,9,0,28,19
1681929744525,MMW 121,A02,183218,Patterson; Patrick H.,24,0,28,4
1681929745552,MUS 1A,A01,182554,Staff,2,0,35,33
1681929746584,MUS 5,A01,182558,Staff,17,0,35,18
1681929747606,MUS 6,A01,182562,Staff,22,0,35,13
1681929748631,MUS 8GS,A00,182563,Borgo; David Garcia,25,0,25,0
1681929749653,MUS 13,A01,182567,Staff,23,0,25,2
1681929750683,MUS 15,A01,182570,Staff,31,0,35,4
1681929750683,MUS 15,B01,182575,Staff,7,0,35,28
1681929751713,MUS 80,A00,182578,Staff,22,0,25,3
1681929751713,MUS 80,B00,182581,Staff,20,0,25,5
1681929752744,MUS 113,A00,182582,Staff,25,0,25,0
1681929753770,MUS 114,A00,182583,Staff,1,0,25,24
1681929754793,MUS 150GS,A01,182588,Borgo; David Garcia,24,0,25,1
1681929755823,PHIL 1,A00,182590,Staff,34,0,40,6
1681929756850,PHIL 10,A01,182596,Grush; Rick Scott,30,0,35,5
1681929756850,PHIL 10,A02,182597,Grush; Rick Scott,33,0,35,2
1681929757874,PHIL 15,A01,182601,Staff,31,0,35,4
1681929757874,PHIL 15,A02,182602,Staff,33,0,35,2
1681929758913,PHIL 27,A01,182604,Staff,26,0,35,9
1681929758913,PHIL 27,A02,182607,Staff,35,0,35,0
1681929759937,PHIL 32,A01,182609,Staff,35,0,35,0
1681929759937,PHIL 32,A02,182612,Staff,35,0,35,0
1681929760959,PHIL 130,A00,182614,Staff,58,0,70,12
1681929761985,PHIL 136,A00,182616,Cohen; Jonathan David,66,0,70,4
1681929763016,PHIL 155,A00,182617,Vargas; Manuel Rogelio,57,0,70,13
1681929764039,PHIL 163,A01,182620,Staff,15,0,20,5
1681929764039,PHIL 163,A02,182624,Staff,10,0,20,10
1681929765063,PHIL 164,A00,182627,Staff,29,0,40,11
1681929766087,PHIL 173,A00,182628,Staff,35,0,40,5
1681929767111,PHYS 1A,A00,183221,Staff,53,0,60,7
1681929768140,PHYS 1AL,001,183222,Staff,25,0,30,5
1681929768140,PHYS 1AL,002,183223,Staff,24,0,30,6
1681929769163,PHYS 1B,A00,183231,Staff,40,0,60,20
1681929770189,PHYS 1BL,001,183232,Staff,15,0,30,15
1681929770189,PHYS 1BL,002,183233,Staff,27,0,30,3
1681929771217,PHYS 1C,A00,183240,Staff,21,0,60,39
1681929772257,PHYS 1CL,001,183241,Staff,9,0,30,21
1681929772257,PHYS 1CL,002,183242,Staff,22,0,30,8
1681929773287,PHYS 2AR,A01,183250,Staff,39,0,50,11
1681929774311,PHYS 2B,A01,183252,Staff,102,0,115,13
1681929775434,PHYS 2BL,A01,183254,Staff,21,0,24,3
1681929775434,PHYS 2BL,A02,183255,Staff,21,0,24,3
1681929776457,PHYS 2C,A01,183522,Staff,101,0,115,14
1681929777484,PHYS 4A,A01,183524,Staff,49,0,50,1
1681929778507,POLI 5,A00,183525,Staff,44,0,50,6
1681929779529,POLI 12,A00,183540,Staff,45,0,50,5
1681929780555,POLI 13R,A00,183541,Forman; Fonna,40,0,50,10
1681929781579,POLI 30,A00,183542,Mignozzetti; Umberto,48,0,50,2
1681929782610,POLI 100A,A00,183543,Staff,44,0,50,6
1681929783647,POLI 100E,A00,223598,Staff,32,0,35,3
1681929784684,POLI 103A,A00,183564,Kousser; Thad,35,0,50,15
1681929785708,POLI 104B,A00,201329,Staff,28,0,35,7
1681929786734,POLI 113BR,A00,183576,Hoston; Germaine,22,0,50,28
1681929787763,POLI 114BR,A00,183588,Staff,27,0,30,3
1681929788785,POLI 117R,A00,183595,Forman; Fonna,3,0,20,17
1681929789806,POLI 120H,A00,183596,Fisk; David Lee,14,0,20,6
1681929790834,POLI 130AA,A00,183597,Staff,13,0,20,7
1681929791859,POLI 134AA,A00,183598,Staff,19,0,20,1
1681929792882,POLI 135,A00,183599,Fisk; David Lee,19,0,25,6
1681929793905,POLI 142P,A00,183623,Staff,37,0,40,3
1681929794928,POLI 144D,A00,183624,Staff,22,0,25,3
1681929795957,POLI 151,A00,183625,Staff,15,0,20,5
1681929796981,POLI 162,A00,183626,Mignozzetti; Umberto,17,0,20,3
1681929798006,PSYC 1,A00,253748,Staff,85,0,90,5
1681929799029,PSYC 2,A00,183627,Moranton; Nirelia Melbina-,23,0,35,12
1681929800053,PSYC 3,A00,183628,Staff,43,0,45,2
1681929802106,PSYC 60,A01,183631,Lowe; Angela Beth,35,0,40,5
1681929803133,PSYC 70,A01,253757,Staff,36,0,45,9
1681929804160,PSYC 101,A00,183632,Heyman; Gail D.,42,0,60,18
1681929805185,PSYC 105,A00,183848,Lowe; Angela Beth,46,0,60,14
1681929806214,PSYC 106,A00,183849,Dobkins; Karen R.,39,0,60,21
1681929807239,PSYC 108,A00,253750,Staff,12,0,60,48
1681929808268,PSYC 114,A01,184275,Winkielman; Piotr,0,8,30,30
1681929809303,PSYC 122,A00,183856,Moranton; Nirelia Melbina-,0,16,30,30
1681929810325,PSYC 124,A00,183865,Chapman; Eddie Nathaniel,43,0,80,37
1681929811364,PSYC 137,A00,183880,Staff,17,0,25,8
1681929813411,PSYC 154,A00,183910,Lacefield; Katharine I,0,27,90,90
1681929815459,PSYC 162,A00,183946,Wixted; John T,40,0,90,50
1681929816485,PSYC 172,A00,183947,Gorman; Michael R.,5,0,30,25
1681929817507,PSYC 178,A00,183963,Glaser; Dale,15,0,40,25
1681929818533,PSYC 181GS,A00,183964,Anagnostaras; Stephan,10,0,10,0
1681929819563,PSYC 186GS,A01,257660,Staff,10,0,10,0
1681929820590,PSYC 193,B00,253749,Staff,22,0,25,3
1681929822636,PSYC 193L,A01,184122,Staff,33,0,35,2
1681929822636,PSYC 193L,C01,184167,Winkielman; Piotr,14,0,30,16
1681929823662,RELI 188GS,A00,182629,Rahimi; Babak,20,0,20,0
1681929824686,SE 101A,A00,182646,Staff,26,0,30,4
1681929825709,SE 101C,A00,182650,Staff,12,0,20,8
1681929826735,SE 110A,A00,182651,Staff,28,0,28,0
1681929827767,SE 130A,A00,182652,Staff,38,0,40,2
1681929828793,SIO 46GS,A00,182636,Cook; Geoffrey W,25,0,28,3
1681929829819,SIO 109R,A00,194459,Staff,0,0,20,20
1681929830843,SIO 121GS,A00,182639,Cook; Geoffrey W,25,0,28,3
1681929831875,SIO 132,A01,182642,Staff,30,0,40,10
1681929832904,SIO 139,A00,182644,Kacev; David,36,0,40,4
1681929833931,SOCI 2,A01,258404,Staff,33,0,36,3
1681929833931,SOCI 2,A02,258405,Staff,35,0,36,1
1681929834957,SOCI 60,A01,258408,Staff,29,0,30,1
1681929834957,SOCI 60,A02,258413,Staff,30,0,30,0
1681929835986,SOCI 100,A01,258415,Staff,29,0,30,1
1681929835986,SOCI 100,A02,258416,Staff,28,0,30,2
1681929842153,SOCI 127,A00,258421,Staff,19,0,30,11
1681929843186,SOCI 132,A00,258422,Staff,43,0,50,7
1681929844217,SOCI 133,A00,258423,Staff,26,0,30,4
1681929845238,SOCI 138GS,A00,258424,Staff,15,0,15,0
1681929846260,SOCI 145,A00,258425,Staff,24,0,30,6
1681929847286,SOCI 148,A00,258426,Staff,24,0,30,6
1681929848311,SOCI 153,A00,199217,Staff,29,0,30,1
1681929849342,SOCI 160,A00,258427,Staff,27,0,30,3
1681929850372,SOCI 160E,A00,258435,Staff,55,0,60,5
1681929851403,SOCI 189GS,A00,258436,Staff,15,0,15,0
1681929852427,SOCI 190GS,A00,258437,Staff,15,0,15,0
1681929853458,SYN 2,001,182658,Staff,8,0,16,8
1681929853458,SYN 2,002,201439,Staff,14,0,16,2
1681929853458,SYN 2,003,201443,Staff,16,0,16,0
1681929854482,SYN 100,A01,182657,Staff,13,0,20,7
1681929855506,TDAC 1,A00,184381,Salovey; Todd,16,0,20,4
1681929855506,TDAC 1,B00,184385,Harting; Carla Kelso,19,0,20,1
1681929855506,TDAC 1,C00,184394,Staff,18,0,20,2
1681929856532,TDAC 101,A00,184483,Harting; Carla Kelso,19,0,20,1
1681929857554,TDDE 111,A00,184496,Staff,14,0,15,1
1681929858581,TDDE 131,A00,184504,Staff,20,0,20,0
1681929858581,TDDE 131,B00,184505,Staff,17,0,18,1
1681929858581,TDDE 131,C00,184534,Staff,49,0,50,1
1681929858581,TDDE 131,D00,184564,Staff,15,0,15,0
1681929858581,TDDE 131,E00,204725,Staff,18,0,20,2
1681929859608,TDGE 1,A01,184414,Salovey; Todd,35,0,50,15
1681929860636,TDGE 5,A01,184419,Staff,23,0,24,1
1681929861658,TDGE 10,A00,184428,Fulton; Julia,27,0,50,23
1681929862683,TDGE 124,A00,184565,Fulton; Julia,0,2,50,50
1681929863710,TDGE 125,B00,184567,Meyer; Ursula,8,0,25,17
1681929864734,TDHT 101,A00,184568,Staff,21,0,25,4
1681929864734,TDHT 101,B00,184569,Staff,20,0,20,0
1681929865765,TDHT 114,A00,184570,Staff,49,0,50,1
1681929866790,TDMV 1,A00,184437,Arcidiacono; Kristin,21,0,30,9
1681929866790,TDMV 1,B00,184448,Caligagan; Maria T.,23,0,30,7
1681929867821,TDMV 2,A00,184449,Weinberg; Sadie,27,0,30,3
1681929867821,TDMV 2,B00,184453,Arcidiacono; Kristin,29,0,30,1
1681929868844,TDMV 110,A00,184571,Weinberg; Sadie,30,0,30,0
1681929869868,TDMV 142,A00,184572,Caligagan; Tony,26,0,30,4
1681929869868,TDMV 142,B00,184573,Caligagan; Maria T.,26,0,30,4
1681929870894,TDTR 20,A00,184482,Jun; Grace Shin Hae,25,0,25,0
1681929871924,USP 2,A01,184290,Hinds; Juli Beth,24,0,25,1
1681929872959,USP 3,A01,184295,Staff,20,0,25,5
1681929873994,USP 4,A00,184304,McTague; Sarah,13,0,25,12
1681929875019,USP 100,A00,184315,Staff,16,0,25,9
1681929876045,USP 105,A00,184326,Staff,21,0,25,4
1681929877071,USP 151,A00,184327,Staff,17,0,25,8
1681929878097,USP 170,A00,184380,Hinds; Juli Beth,13,0,25,12
1681929879198,VIS 21B,A01,182660,Staff,28,0,31,3
1681929879198,VIS 21B,A02,182662,Staff,30,0,31,1
1681929880220,VIS 103D,A00,182663,Staff,74,0,75,1
1681929881246,VIS 105D,A00,182667,Li; Huai,14,0,22,8
1681929882269,VIS 122GS,A00,182668,Herbst; Matthew,20,0,20,0
1681929883292,VIS 128C,A00,182673,Staff,69,0,75,6
1681929884320,VIS 130,A00,182675,Staff,19,0,22,3
1681929885343,VIS 160A,A00,182678,Stalbaum; Brett,4,0,10,6
1681929887462,WCWP 10B,A00,201679,Staff,15,0,15,0
1681929887462,WCWP 10B,B00,201695,Staff,15,0,15,0
1681929888484,WCWP 100,A00,201716,Staff,12,0,15,3
1681929888484,WCWP 100,B00,201717,Staff,1,0,15,14
1681929890561,ANSC 105GS,A00,258289,Staff,0,0,0,0
1681929891590,ANSC 125GS,A00,258295,Staff,0,0,0,0
1681929892616,ANSC 150,A00,258267,Staff,28,0,40,12
1681929893645,ANSC 190GS,A00,258280,Staff,0,0,0,0
1681929894673,ANTH 1,A00,258264,Staff,38,0,40,2
1681929895696,ANTH 2,A01,258259,Staff,72,0,76,4
1681929896718,ANTH 23,A01,258228,Staff,35,0,40,5
1681929897744,ANTH 101,A01,258236,Staff,38,0,40,2
1681929898769,ANTH 102,A00,258272,Staff,59,0,60,1
1681929899792,ANTH 105,A00,258244,Staff,29,0,35,6
1681929900818,BENG 130,A00,253975,Staff,37,0,40,3
1681929901848,BIBC 102,A01,191866,Flagg; Matthew Paul,17,0,32,15
1681929901848,BIBC 102,A02,191867,Flagg; Matthew Paul,21,0,32,11
1681929901848,BIBC 102,A03,191868,Flagg; Matthew Paul,28,0,32,4
1681929901848,BIBC 102,A04,191936,Flagg; Matthew Paul,22,0,32,10
1681929901848,BIBC 102,A05,191937,Flagg; Matthew Paul,0,0,32,32
1681929902883,BICD 100,A01,191939,Cooper; Andrew Michael,27,0,32,5
1681929902883,BICD 100,A02,191940,Cooper; Andrew Michael,32,0,32,0
1681929902883,BICD 100,A03,191941,Cooper; Andrew Michael,32,0,32,0
1681929902883,BICD 100,A04,191942,Cooper; Andrew Michael,32,0,32,0
1681929902883,BICD 100,A05,191943,Cooper; Andrew Michael,32,0,32,0
1681929903908,BIEB 126,A01,191945,Cleland; Elsa Eleanor,0,3,32,32
1681929903908,BIEB 126,A02,191946,Cleland; Elsa Eleanor,26,0,32,6
1681929903908,BIEB 126,A03,191947,Cleland; Elsa Eleanor,29,0,32,3
1681929903908,BIEB 126,A04,191948,Cleland; Elsa Eleanor,17,0,32,15
1681929903908,BIEB 126,A05,191996,Cleland; Elsa Eleanor,28,0,32,4
1681929904931,BIEB 136GS,A00,191997,Shurin; Jonathan & Holway; David A.,0,0,0,8
1681929905959,BIEB 137GS,A01,191999,Shurin; Jonathan & Holway; David A.,0,0,0,7
1681929906983,BILD 1,A01,205385,Staff,30,0,32,2
1681929906983,BILD 1,A02,205386,Staff,30,0,32,2
1681929906983,BILD 1,A03,205387,Staff,31,0,32,1
1681929906983,BILD 1,A04,205388,Staff,25,0,32,7
1681929908014,BILD 2,A01,191774,Staff,27,0,32,5
1681929908014,BILD 2,A02,191775,Staff,30,0,32,2
1681929908014,BILD 2,A03,191777,Staff,30,0,32,2
1681929908014,BILD 2,A04,191856,Staff,30,0,32,2
1681929908014,BILD 2,A05,191857,Staff,31,0,32,1
1681929908014,BILD 2,A06,191858,Staff,32,0,32,0
1681929908014,BILD 2,A07,191859,Staff,31,0,32,1
1681929909049,BILD 3,A01,205391,Staff,27,0,32,5
1681929909049,BILD 3,A02,205393,Staff,32,0,32,0
1681929909049,BILD 3,A03,205394,Staff,27,0,32,5
1681929909049,BILD 3,A04,205395,Staff,32,0,32,0
1681929910079,BILD 20,A01,191861,Staff,32,0,32,0
1681929910079,BILD 20,A02,191862,Staff,32,0,32,0
1681929911108,BILD 30,A01,191864,Staff,31,0,32,1
1681929912132,BIMM 100,A01,192019,Staff,0,0,32,32
1681929912132,BIMM 100,A02,192020,Staff,17,0,32,15
1681929912132,BIMM 100,A03,192035,Staff,18,0,32,14
1681929913160,BIMM 110,A01,192037,Tat; John,0,0,32,32
1681929913160,BIMM 110,A02,192038,Tat; John,5,0,32,27
1681929914194,BIMM 120,A01,192040,Pickett; Brooke Elizabeth,0,0,32,32
1681929914194,BIMM 120,A02,192041,Pickett; Brooke Elizabeth,9,0,32,23
1681929914194,BIMM 120,A03,192042,Pickett; Brooke Elizabeth,13,0,32,19
1681929915217,BIPN 100,A01,192044,Armour; Jon Christopher,23,0,32,9
1681929915217,BIPN 100,A02,192059,Armour; Jon Christopher,30,0,32,2
1681929915217,BIPN 100,A03,192064,Armour; Jon Christopher,30,0,32,2
1681929915217,BIPN 100,A04,192073,Armour; Jon Christopher,26,0,32,6
1681929916241,BIPN 148,A01,205411,Leutgeb; Jill K.,14,0,32,18
1681929916241,BIPN 148,A02,205412,Leutgeb; Jill K.,31,0,32,1
1681929916241,BIPN 148,A03,205413,Leutgeb; Jill K.,30,0,32,2
1681929916241,BIPN 148,A04,205414,Leutgeb; Jill K.,30,0,32,2
1681929917271,BIPN 160,A01,192115,Marino; Marc J,15,0,32,17
1681929917271,BIPN 160,A02,192148,Marino; Marc J,27,0,32,5
1681929917271,BIPN 160,A03,192158,Marino; Marc J,31,0,32,1
1681929917271,BIPN 160,A04,192190,Marino; Marc J,32,0,32,0
1681929917271,BIPN 160,A05,192287,Marino; Marc J,32,0,32,0
1681929917271,BIPN 160,A06,192288,Marino; Marc J,32,0,32,0
1681929918297,BIPN 194,A00,206038,Leutgeb; Stefan,28,0,32,4
1681929919322,BISP 194,A00,192289,Nieh; James Charles,11,0,32,21
1681929919322,BISP 194,B00,245332,Staff,26,0,32,6
1681929920353,CAT 124,A01,202247,Staff,15,0,15,0
1681929921378,CAT 125,A00,202248,Staff,18,0,20,2
1681929921378,CAT 125,B00,202253,Staff,20,0,20,0
1681929921378,CAT 125,C00,202257,Staff,18,0,20,2
1681929922402,CAT 125GS,A01,202273,Bronstein; Phoebe Malan,20,0,20,0
1681929923433,CAT 125R,A00,202284,Staff,17,0,20,3
1681929923433,CAT 125R,C00,202286,Staff,5,0,20,15
1681929923433,CAT 125R,D00,202291,Staff,17,0,20,3
1681929923433,CAT 125R,E00,202295,Staff,13,0,20,7
1681929923433,CAT 125R,F00,202302,Staff,7,0,20,13
1681929924460,CENG 100,A00,204724,Opatkiewicz; Justin Paul,25,0,25,0
1681929925488,CGS 2A,A01,180420,Staff,30,0,36,6
1681929926515,CGS 101,A00,180421,Staff,15,0,20,5
1681929927538,CGS 112,A00,180422,Staff,9,0,16,7
1681929928565,CGS 113,A00,180423,Staff,18,0,20,2
1681929929589,CGS 137,A00,180424,Staff,12,0,12,0
1681929930613,CGS 147,A00,180425,Staff,10,0,10,0
1681929931654,CHEM 6A,A01,179556,Staff,93,0,100,7
1681929931654,CHEM 6A,A02,179558,Staff,0,0,0,0
1681929932678,CHEM 6B,A01,179560,Staff,100,0,100,0
1681929933706,CHEM 6C,A01,179565,Jazzar; Rodolphe,92,0,100,8
1681929934730,CHEM 7L,A01,179586,Schurmeier; Kimberly,10,0,24,14
1681929934730,CHEM 7L,A02,179587,Schurmeier; Kimberly,23,0,24,1
1681929934730,CHEM 7L,A03,179590,Schurmeier; Kimberly,22,0,24,2
1681929934730,CHEM 7L,A04,179591,Schurmeier; Kimberly,22,0,24,2
1681929934730,CHEM 7L,B01,179598,Schurmeier; Kimberly,15,0,24,9
1681929934730,CHEM 7L,B02,179599,Schurmeier; Kimberly,24,0,24,0
1681929934730,CHEM 7L,B03,179606,Schurmeier; Kimberly,22,0,24,2
1681929934730,CHEM 7L,B04,179607,Schurmeier; Kimberly,22,0,24,2
1681929935757,CHEM 11,A01,179609,Stallings; Dontarie M,86,0,100,14
1681929936780,CHEM 40A,A01,179621,Staff,38,0,50,12
1681929936780,CHEM 40A,A02,179622,Staff,46,0,50,4
1681929937811,CHEM 40B,A01,179630,Weizman; Haim,46,0,50,4
1681929937811,CHEM 40B,A02,179631,Weizman; Haim,43,0,50,7
1681929938836,CHEM 41A,A01,179660,Klosterman; Jeremy K,92,0,100,8
1681929939861,CHEM 43A,A01,179683,Klosterman; Jeremy K,0,0,24,24
1681929939861,CHEM 43A,A02,179688,Klosterman; Jeremy K,6,0,24,18
1681929939861,CHEM 43A,A03,179689,Klosterman; Jeremy K,18,0,24,6
1681929939861,CHEM 43A,A04,179691,Klosterman; Jeremy K,18,0,24,6
1681929940885,CHEM 114A,A01,179693,Stallings; Dontarie M,68,0,100,32
1681929941916,CHEM 143B,A01,179698,Weizman; Haim,16,0,24,8
1681929941916,CHEM 143B,A02,179700,Weizman; Haim,24,0,24,0
1681929942945,CHIN 169A,A00,179701,Wang; Xiao,20,0,20,0
1681929943967,COGS 2,A01,179750,Boyle; Mary E. T.,17,0,30,13
1681929944990,COGS 9,A01,179759,Jones; Cameron Robert,40,0,50,10
1681929946017,COGS 14A,A01,179854,Staff,11,0,50,39
1681929947042,COGS 14B,A01,179856,Staff,52,0,60,8
1681929948068,COGS 17,A01,179874,Staff,71,0,75,4
1681929949094,COGS 18,A01,179884,Staff,59,0,80,21
1681929950118,COGS 100,A01,179886,Staff,33,0,60,27
1681929951153,COGS 101B,A01,179892,Staff,0,3,30,30
1681929952184,COGS 101C,A01,179894,Staff,26,0,30,4
1681929953209,COGS 107A,A01,179896,Boyle; Mary E. T.,29,0,40,11
1681929954239,COGS 108,A01,179898,Simpkins; Charles Alexander,0,32,60,60
1681929955279,COGS 109,A01,179900,Staff,32,0,40,8
1681929956302,COGS 118A,A01,179946,Staff,5,0,40,35
1681929957329,COGS 153,A00,179978,Staff,0,6,30,30
1681929958355,COGS 156,A01,179981,Staff,21,0,30,9
1681929960402,COGS 172,A01,179987,Staff,10,0,30,20
1681929962453,COGS 186,A01,179991,Staff,11,0,30,19
1681929963477,COMM 10,A01,180001,Staff,11,0,25,14
1681929963477,COMM 10,A02,180004,Staff,20,0,25,5
1681929964500,COMM 100A,A01,180016,Staff,13,0,25,12
1681929964500,COMM 100A,A02,180020,Staff,24,0,25,1
1681929965522,COMM 101T,A00,180029,Halm; Gavin Patrick,19,0,35,16
1681929966559,COMM 106V,A00,180043,Staff,34,0,35,1
1681929967585,COMM 109P,A00,180044,Staff,30,0,35,5
1681929968607,COMM 113T,A00,180045,Havis; Allan,37,0,45,8
1681929969633,COMM 132,A00,180046,McKenna; Denise,20,0,30,10
1681929970657,COMM 143,A00,180047,Staff,16,0,30,14
1681929971691,COMM 190,A00,180048,Conner; Thomas Hartnell,16,0,23,7
1681929972719,CSE 8A,A50,180053,Cao; Yingjun,21,0,50,29
1681929972719,CSE 8A,B50,180180,Staff,50,0,50,0
1681929973742,CSE 11,A01,180190,Cao; Yingjun,21,0,50,29
1681929974768,CSE 20,A01,180192,Briones; Jor-el Thomas Caparas,21,0,30,9
1681929975795,CSE 21,A01,194538,Briones; Jor-el Thomas Caparas,50,0,60,10
1681929976818,CSE 30,A01,180324,Eldon; John,73,0,100,27
1681929977848,CSE 101,A01,201353,Staff,0,30,40,40
1681929978874,CSE 134B,A01,180326,Powell; Thomas Allan,73,0,100,27
1681929979898,CSE 140,A01,180328,Staff,23,0,75,52
1681929980921,CSE 140L,A01,180344,Eldon; John,48,0,100,52
1681929981946,CSE 150A,A01,180411,Staff,0,18,50,50
1681929983045,CSE 151A,A01,180414,Staff,0,13,50,50
1681929984075,CSE 175,A01,222521,Kumar; Rakesh,50,0,50,0
1681929985101,CSE 190,A00,201419,Staff,42,0,49,7
1681929986126,CSS 1,A01,194536,Staff,32,0,50,18
1681929987151,DSC 30,A01,202385,Staff,48,0,50,2
1681929988183,DSC 40A,A01,202387,Albuyeh; Rod,50,0,50,0
1681929989212,DSC 190,A01,202389,Silberman; Jack,21,0,21,0
1681929990243,DSGN 100,A01,179993,Staff,13,0,30,17
1681929991283,ECE 65,A50,180708,Staff,10,0,20,10
1681929991283,ECE 65,A51,180739,Staff,19,0,20,1
1681929992317,ECON 1,A01,180427,Famulari; Melissa,66,0,70,4
1681929993342,ECON 2,A01,180450,Levkoff; Steven B.,64,0,70,6
1681929994367,ECON 4,A01,203351,Anderson; John Charles,6,0,10,4
1681929995396,ECON 100A,A01,180472,Famulari; Melissa,59,0,70,11
1681929996420,ECON 120A,A01,180549,Staff,62,0,70,8
1681929997454,ECON 120B,A01,180655,Ma; Xinwei,39,0,70,31
1681929998481,ECON 129,A00,203333,Eckert; Fabian Paul,11,0,35,24
1681929999525,ECON 131,A00,180656,Staff,1,0,35,34
1681930000549,ECON 172B,A01,180672,Levkoff; Steven B.,31,0,35,4
1681930001575,ECON 178,A01,203342,Zhu; Ying,5,0,35,30
1681930002597,EDS 108GS,A00,202383,Wishard Guerra; Alison G.,20,0,20,0
1681930003620,EDS 111GS,A00,202347,Wishard Guerra; Alison G.,20,0,20,0
1681930004642,EDS 112,A01,202323,Staff,53,0,60,7
1681930005665,EDS 113,A00,202340,Staff,32,0,35,3
1681930006688,EDS 118,A00,201231,Staff,19,0,30,11
1681930007712,EDS 119,A00,204994,Staff,8,0,10,2
1681930008735,EDS 124BR,A00,202324,Eguchi; Emi,0,0,25,25
1681930009761,EDS 126,A01,203208,Jones; Makeba,26,0,30,4
1681930010798,EDS 135,A01,202333,Staff,17,0,20,3
1681930011827,EDS 180,A00,202311,Staff,47,0,50,3
1681930012849,ERC 190GS,A01,253747,Staff,28,0,28,0
1681930013872,ETHN 104,A00,180742,Staff,21,0,35,14
1681930014899,ETHN 118,A00,180745,Staff,26,0,35,9
1681930015929,ETHN 127,A00,180747,Staff,8,0,16,8
1681930016958,ETHN 137,A00,180880,Staff,11,0,12,1
1681930017982,ETHN 147,A00,180890,Staff,8,0,10,2
1681930019005,ETHN 154,A00,180891,Staff,6,0,8,2
1681930020035,ETHN 168,A00,180892,Staff,9,0,10,1
1681930021059,GLBH 20,A00,201051,Hannah; Seth Donal,0,5,0,1
1681930022090,GLBH 111,A01,209338,Burgos; Jose L.,0,0,0,0
1681930023121,GLBH 150,A00,258300,Staff,0,4,0,0
1681930024147,GLBH 181,A00,201207,Staff,8,0,40,32
1681930025170,HIEU 109,A00,180898,Staff,19,0,20,1
1681930026196,HIEU 111,A00,180899,Staff,0,2,20,20
1681930027223,HIEU 124,A00,180900,Staff,17,0,20,3
1681930028247,HILA 122,A00,180901,Staff,17,0,20,3
1681930029272,HILA 132,A00,180902,Vitz; Matthew,0,1,20,20
1681930030295,HILD 10,A01,180896,Staff,13,0,20,7
1681930031321,HILD 30GS,A00,180897,Edington; Claire Ellen,0,0,0,0
1681930032349,HISC 105,A00,180903,Staff,20,0,20,0
1681930033386,HISC 117,A00,180904,Staff,10,0,20,10
1681930034412,HIUS 108B,A00,181005,Staff,18,0,20,2
1681930035437,HIUS 113,A00,181093,Staff,1,0,20,19
1681930036468,HUM 3,A01,181190,Patterson; Patrick H.,35,0,50,15
1681930036468,HUM 3,B01,181195,Staff,45,0,50,5
1681930037493,HUM 3GS,A00,181196,Herbst; Matthew,0,0,0,0
1681930038535,HUM 4,A01,181227,West; Geoffrey Scott,33,0,50,17
1681930038535,HUM 4,B01,181282,Staff,41,0,50,9
1681930039559,HUM 4GS,A00,181377,Lyon; Antony J.,0,0,0,0
1681930040586,HUM 5,A01,181536,Zavodny; Tatiana Sophia,25,0,50,25
1681930040586,HUM 5,B01,181908,Staff,33,0,50,17
1681930041609,INTL 190,A00,181909,Segui; Alan S,0,0,0,8
1681930041609,INTL 190,B00,181961,Segui; Alan S,0,0,0,7
1681930042634,JAPN 20AR,A01,182113,Ross; Kayoko F,15,0,20,5
1681930043663,LATI 50,A01,202391,Martin-Cabrera; Luis,17,0,30,13
1681930043663,LATI 50,A02,202392,Martin-Cabrera; Luis,26,0,30,4
1681930044697,LATI 180,A00,202393,Kokinis; Troy Andreas,24,0,25,1
1681930045718,LIFR 1A,A00,182119,Staff,13,0,14,1
1681930046744,LIFR 1AX,A00,182324,Staff,13,0,14,1
1681930047767,LIFR 1B,A00,182259,Staff,12,0,14,2
1681930048798,LIFR 1BX,A00,182273,Staff,12,0,14,2
1681930049826,LIGN 8,A00,182330,Staff,128,0,150,22
1681930050851,LIGN 9GS,A00,182362,Staff,15,0,20,5
1681930051873,LIGN 119,A00,204992,Takahashi; Maho,11,0,15,4
1681930052906,LIGN 130,A01,182384,Staff,47,0,50,3
1681930053931,LIGN 149GS,A00,182390,Staff,15,0,20,5
1681930054956,LIGN 170,A00,182404,Staff,23,0,30,7
1681930055991,LISP 1D,A00,182281,Staff,7,0,14,7
1681930055991,LISP 1D,B00,182287,Staff,13,0,14,1
1681930055991,LISP 1D,C00,182295,Staff,10,0,14,4
1681930055991,LISP 1D,D00,182301,Staff,14,0,14,0
1681930057014,LISP 1DX,A00,182309,Staff,19,0,28,9
1681930057014,LISP 1DX,B00,182316,Staff,25,0,28,3
1681930058037,LTAF 120GS,A00,182412,Zhiri; Oumelbanine,20,0,20,0
1681930059075,LTCS 172GS,A00,182437,Bronstein; Phoebe Malan,20,0,20,0
1681930060098,LTEA 138,A00,182457,Staff,18,0,40,22
1681930061130,LTEN 114,A01,182490,Staff,23,0,25,2
1681930062155,LTEN 130GS,A00,182491,Lyon; Antony J.,20,0,20,0
1681930063186,LTEN 169,A00,182493,Cuong; Marisol,18,0,25,7
1681930064210,LTEN 178,A00,182501,Staff,14,0,15,1
1681930065233,LTEN 181,A00,182515,Staff,19,0,25,6
1681930066257,LTEN 185GS,A00,197655,Forbes; Camille,20,0,20,0
1681930067280,LTSP 100B,A00,202208,Bessett; Ryan Matthew,24,0,25,1
1681930068308,LTWL 100,A00,182516,Myerston Santana; Jacobo,20,0,30,10
1681930069349,LTWR 100GS,A00,182518,Forbes; Camille,20,0,20,0
1681930070372,LTWR 102,A00,182522,Staff,15,0,15,0
1681930070372,LTWR 102,B00,182525,Staff,14,0,15,1
1681930071405,LTWR 115,A00,182526,Staff,10,0,15,5
1681930072434,MAE 8,A01,182528,Pham; Hieu Tan,67,0,70,3
1681930073459,MAE 11,A00,182529,Bahadori; Mohammad Yousef,91,0,100,9
1681930074485,MAE 20,A00,182530,Evdokimenko; Ekaterina,68,0,70,2
1681930075509,MAE 30A,A00,182532,Staff,44,0,45,1
1681930076540,MAE 101A,A00,182533,Bahadori; Mohammad Yousef,94,0,100,6
1681930077566,MAE 101C,A00,182538,Staff,62,0,70,8
1681930078591,MAE 104,A00,182539,Staff,44,0,50,6
1681930079613,MAE 131A,A00,182540,Ghazinejad; Maziar,40,0,45,5
1681930080636,MAE 143A,A00,182548,Bewley; Thomas R,42,0,50,8
1681930081659,MAE 150,A00,182549,Staff,28,0,40,12
1681930082692,MAE 160,A00,182550,Evdokimenko; Ekaterina,41,0,60,19
1681930083735,MATH 3C,A01,182725,Staff,24,0,30,6
1681930084773,MATH 10A,A01,182729,Staff,24,0,30,6
1681930084773,MATH 10A,B01,182732,Staff,25,0,30,5
1681930085800,MATH 10B,A01,182737,Staff,17,0,30,13
1681930085800,MATH 10B,A02,182738,Staff,25,0,30,5
1681930085800,MATH 10B,B01,182744,Staff,25,0,30,5
1681930085800,MATH 10B,B02,182745,Staff,27,0,30,3
1681930086905,MATH 18,A01,182750,Anzaldo; Leesa B,28,0,30,2
1681930086905,MATH 18,A02,182751,Anzaldo; Leesa B,28,0,30,2
1681930086905,MATH 18,A03,182753,Anzaldo; Leesa B,27,0,30,3
1681930086905,MATH 18,A04,182757,Anzaldo; Leesa B,29,0,30,1
1681930086905,MATH 18,B01,182761,Anzaldo; Leesa B,27,0,30,3
1681930086905,MATH 18,B02,182764,Anzaldo; Leesa B,26,0,30,4
1681930086905,MATH 18,B03,182765,Anzaldo; Leesa B,29,0,30,1
1681930086905,MATH 18,B04,182766,Anzaldo; Leesa B,30,0,30,0
1681930087935,MATH 20A,A01,182771,Suk; Andrew Hoon,28,0,30,2
1681930088958,MATH 20B,A01,182775,Bach; Quang Tran,30,0,30,0
1681930088958,MATH 20B,A02,182777,Bach; Quang Tran,29,0,30,1
1681930088958,MATH 20B,B01,182780,Bach; Quang Tran,26,0,30,4
1681930088958,MATH 20B,B02,182782,Bach; Quang Tran,30,0,30,0
1681930089982,MATH 20C,A01,182787,Staff,24,0,30,6
1681930089982,MATH 20C,A02,182790,Staff,29,0,30,1
1681930089982,MATH 20C,B01,182792,Staff,23,0,30,7
1681930089982,MATH 20C,B02,182796,Staff,26,0,30,4
1681930091015,MATH 20D,A01,182799,Staff,27,0,30,3
1681930091015,MATH 20D,A02,182802,Staff,29,0,30,1
1681930091015,MATH 20D,A03,182803,Staff,30,0,30,0
1681930092039,MATH 20E,A01,182809,Verstraete; Jacques Allan,20,0,30,10
1681930092039,MATH 20E,A02,182811,Verstraete; Jacques Allan,28,0,30,2
1681930092039,MATH 20E,B01,182814,Verstraete; Jacques Allan,21,0,30,9
1681930092039,MATH 20E,B02,182815,Verstraete; Jacques Allan,29,0,30,1
1681930093063,MATH 103A,A01,182820,Staff,3,0,30,27
1681930093063,MATH 103A,A02,182821,Staff,27,0,30,3
1681930093063,MATH 103A,A03,182822,Staff,21,0,30,9
1681930093063,MATH 103A,B01,182825,Staff,21,0,30,9
1681930093063,MATH 103A,B02,182826,Staff,30,0,30,0
1681930093063,MATH 103A,B03,182830,Staff,30,0,30,0
1681930094108,MATH 109,A01,182836,Chow; Bennett,23,0,30,7
1681930094108,MATH 109,A02,182838,Chow; Bennett,28,0,30,2
1681930094108,MATH 109,A03,182894,Chow; Bennett,29,0,30,1
1681930094108,MATH 109,B01,182908,Chow; Bennett,27,0,30,3
1681930094108,MATH 109,B02,182909,Chow; Bennett,30,0,30,0
1681930094108,MATH 109,B03,182910,Chow; Bennett,26,0,30,4
1681930095131,MATH 142A,A01,182925,Staff,4,0,30,26
1681930095131,MATH 142A,A02,182935,Staff,23,0,30,7
1681930095131,MATH 142A,A03,182967,Staff,25,0,30,5
1681930095131,MATH 142A,B01,183125,Staff,22,0,30,8
1681930095131,MATH 142A,B02,183157,Staff,26,0,30,4
1681930095131,MATH 142A,B03,183158,Staff,29,0,30,1
1681930096162,MATH 183,A01,183160,Arias-Castro; Ery,22,0,30,8
1681930096162,MATH 183,A02,183161,Arias-Castro; Ery,29,0,30,1
1681930096162,MATH 183,B01,183163,Arias-Castro; Ery,26,0,30,4
1681930096162,MATH 183,B02,183164,Arias-Castro; Ery,28,0,30,2
1681930097189,MATH 193A,A01,183167,Staff,0,0,35,35
1681930097189,MATH 193A,A02,183168,Staff,23,0,35,12
1681930097189,MATH 193A,A03,183169,Staff,34,0,35,1
1681930097189,MATH 193A,A04,183170,Staff,26,0,35,9
1681930098221,MGT 4,A01,202395,Anderson; John Charles,76,0,80,4
1681930099259,MGT 5,A00,202396,Houskeeper; Robert,79,0,90,11
1681930100284,MGT 103,A00,202397,Eberhard; Craig A,49,0,90,41
1681930101318,MGT 131A,A00,202398,Houskeeper; Robert,81,0,90,9
1681930102342,MGT 135,A00,202399,Anderson; John Charles,81,0,90,9
1681930103373,MGT 162R,A00,202403,Gneezy; Uri,124,0,200,76
1681930104407,MGT 172,A00,202404,Hedges; Kathleen,30,0,90,60
1681930105433,MGT 181,A00,202405,Dunn; Louis Jean,79,0,90,11
1681930106461,MMW 14,A01,183200,Staff,3,0,28,25
1681930106461,MMW 14,A02,183201,Staff,25,0,28,3
1681930106461,MMW 14,A03,183202,Staff,24,0,28,4
1681930106461,MMW 14,A04,183203,Staff,25,0,28,3
1681930106461,MMW 14,A05,183204,Staff,26,0,28,2
1681930106461,MMW 14,A06,183205,Staff,27,0,28,1
1681930106461,MMW 14,B01,183207,Staff,26,0,28,2
1681930106461,MMW 14,B02,183208,Staff,28,0,28,0
1681930106461,MMW 14,B03,183209,Staff,28,0,28,0
1681930106461,MMW 14,B04,183210,Staff,28,0,28,0
1681930106461,MMW 14,B05,183211,Staff,28,0,28,0
1681930106461,MMW 14,B06,183212,Staff,27,0,28,1
1681930107484,MMW 14GS,A00,183213,Zhiri; Oumelbanine,28,0,28,0
1681930108515,MMW 15GS,B00,183215,Rahimi; Babak,28,0,28,0
1681930109542,MMW 121,A01,183217,Patterson; Patrick H.,9,0,28,19
1681930109542,MMW 121,A02,183218,Patterson; Patrick H.,24,0,28,4
1681930110565,MUS 1A,A01,182554,Staff,2,0,35,33
1681930111589,MUS 5,A01,182558,Staff,17,0,35,18
1681930112617,MUS 6,A01,182562,Staff,22,0,35,13
1681930113641,MUS 8GS,A00,182563,Borgo; David Garcia,25,0,25,0
1681930114665,MUS 13,A01,182567,Staff,23,0,25,2
1681930115690,MUS 15,A01,182570,Staff,31,0,35,4
1681930115690,MUS 15,B01,182575,Staff,7,0,35,28
1681930116716,MUS 80,A00,182578,Staff,22,0,25,3
1681930116716,MUS 80,B00,182581,Staff,20,0,25,5
1681930117740,MUS 113,A00,182582,Staff,25,0,25,0
1681930118763,MUS 114,A00,182583,Staff,1,0,25,24
1681930119795,MUS 150GS,A01,182588,Borgo; David Garcia,24,0,25,1
1681930120817,PHIL 1,A00,182590,Staff,34,0,40,6
1681930121845,PHIL 10,A01,182596,Grush; Rick Scott,30,0,35,5
1681930121845,PHIL 10,A02,182597,Grush; Rick Scott,33,0,35,2
1681930122876,PHIL 15,A01,182601,Staff,31,0,35,4
1681930122876,PHIL 15,A02,182602,Staff,33,0,35,2
1681930123900,PHIL 27,A01,182604,Staff,26,0,35,9
1681930123900,PHIL 27,A02,182607,Staff,35,0,35,0
1681930124925,PHIL 32,A01,182609,Staff,35,0,35,0
1681930124925,PHIL 32,A02,182612,Staff,35,0,35,0
1681930125948,PHIL 130,A00,182614,Staff,58,0,70,12
1681930126971,PHIL 136,A00,182616,Cohen; Jonathan David,65,0,70,5
1681930127997,PHIL 155,A00,182617,Vargas; Manuel Rogelio,57,0,70,13
1681930129025,PHIL 163,A01,182620,Staff,15,0,20,5
1681930129025,PHIL 163,A02,182624,Staff,10,0,20,10
1681930130047,PHIL 164,A00,182627,Staff,29,0,40,11
1681930131073,PHIL 173,A00,182628,Staff,35,0,40,5
1681930132098,PHYS 1A,A00,183221,Staff,53,0,60,7
1681930133133,PHYS 1AL,001,183222,Staff,25,0,30,5
1681930133133,PHYS 1AL,002,183223,Staff,24,0,30,6
1681930134155,PHYS 1B,A00,183231,Staff,40,0,60,20
1681930135180,PHYS 1BL,001,183232,Staff,15,0,30,15
1681930135180,PHYS 1BL,002,183233,Staff,27,0,30,3
1681930136210,PHYS 1C,A00,183240,Staff,21,0,60,39
1681930137247,PHYS 1CL,001,183241,Staff,9,0,30,21
1681930137247,PHYS 1CL,002,183242,Staff,22,0,30,8
1681930138270,PHYS 2AR,A01,183250,Staff,39,0,50,11
1681930139309,PHYS 2B,A01,183252,Staff,102,0,115,13
1681930140346,PHYS 2BL,A01,183254,Staff,21,0,24,3
1681930140346,PHYS 2BL,A02,183255,Staff,21,0,24,3
1681930141386,PHYS 2C,A01,183522,Staff,101,0,115,14
1681930142412,PHYS 4A,A01,183524,Staff,49,0,50,1
1681930143434,POLI 5,A00,183525,Staff,44,0,50,6
1681930144457,POLI 12,A00,183540,Staff,45,0,50,5
1681930145483,POLI 13R,A00,183541,Forman; Fonna,40,0,50,10
1681930146522,POLI 30,A00,183542,Mignozzetti; Umberto,48,0,50,2
1681930147545,POLI 100A,A00,183543,Staff,44,0,50,6
1681930148574,POLI 100E,A00,223598,Staff,32,0,35,3
1681930149600,POLI 103A,A00,183564,Kousser; Thad,35,0,50,15
1681930150626,POLI 104B,A00,201329,Staff,28,0,35,7
1681930151662,POLI 113BR,A00,183576,Hoston; Germaine,22,0,50,28
1681930152687,POLI 114BR,A00,183588,Staff,27,0,30,3
1681930153712,POLI 117R,A00,183595,Forman; Fonna,3,0,20,17
1681930154744,POLI 120H,A00,183596,Fisk; David Lee,14,0,20,6
1681930155767,POLI 130AA,A00,183597,Staff,13,0,20,7
1681930156789,POLI 134AA,A00,183598,Staff,19,0,20,1
1681930157815,POLI 135,A00,183599,Fisk; David Lee,19,0,25,6
1681930158838,POLI 142P,A00,183623,Staff,37,0,40,3
1681930159869,POLI 144D,A00,183624,Staff,22,0,25,3
1681930160894,POLI 151,A00,183625,Staff,15,0,20,5
1681930161937,POLI 162,A00,183626,Mignozzetti; Umberto,17,0,20,3
1681930162960,PSYC 1,A00,253748,Staff,85,0,90,5
1681930163993,PSYC 2,A00,183627,Moranton; Nirelia Melbina-,23,0,35,12
1681930165025,PSYC 3,A00,183628,Staff,43,0,45,2
1681930167083,PSYC 60,A01,183631,Lowe; Angela Beth,35,0,40,5
1681930168112,PSYC 70,A01,253757,Staff,36,0,45,9
1681930169140,PSYC 101,A00,183632,Heyman; Gail D.,42,0,60,18
1681930170168,PSYC 105,A00,183848,Lowe; Angela Beth,46,0,60,14
1681930171197,PSYC 106,A00,183849,Dobkins; Karen R.,39,0,60,21
1681930172231,PSYC 108,A00,253750,Staff,12,0,60,48
1681930173259,PSYC 114,A01,184275,Winkielman; Piotr,0,8,30,30
1681930174285,PSYC 122,A00,183856,Moranton; Nirelia Melbina-,0,16,30,30
1681930175316,PSYC 124,A00,183865,Chapman; Eddie Nathaniel,43,0,80,37
1681930176338,PSYC 137,A00,183880,Staff,17,0,25,8
1681930178387,PSYC 154,A00,183910,Lacefield; Katharine I,0,27,90,90
1681930180434,PSYC 162,A00,183946,Wixted; John T,40,0,90,50
1681930181464,PSYC 172,A00,183947,Gorman; Michael R.,5,0,30,25
1681930182496,PSYC 178,A00,183963,Glaser; Dale,15,0,40,25
1681930183529,PSYC 181GS,A00,183964,Anagnostaras; Stephan,10,0,10,0
1681930184556,PSYC 186GS,A01,257660,Staff,10,0,10,0
1681930185587,PSYC 193,B00,253749,Staff,22,0,25,3
1681930187638,PSYC 193L,A01,184122,Staff,33,0,35,2
1681930187638,PSYC 193L,C01,184167,Winkielman; Piotr,14,0,30,16
1681930188662,RELI 188GS,A00,182629,Rahimi; Babak,20,0,20,0
1681930189693,SE 101A,A00,182646,Staff,26,0,30,4
1681930190790,SE 101C,A00,182650,Staff,12,0,20,8
1681930191815,SE 110A,A00,182651,Staff,28,0,28,0
1681930192839,SE 130A,A00,182652,Staff,38,0,40,2
1681930193861,SIO 46GS,A00,182636,Cook; Geoffrey W,25,0,28,3
1681930194889,SIO 109R,A00,194459,Staff,1,0,20,19
1681930195921,SIO 121GS,A00,182639,Cook; Geoffrey W,25,0,28,3
1681930196946,SIO 132,A01,182642,Staff,30,0,40,10
1681930197970,SIO 139,A00,182644,Kacev; David,36,0,40,4
1681930198992,SOCI 2,A01,258404,Staff,33,0,36,3
1681930198992,SOCI 2,A02,258405,Staff,35,0,36,1
1681930200021,SOCI 60,A01,258408,Staff,29,0,30,1
1681930200021,SOCI 60,A02,258413,Staff,30,0,30,0
1681930201047,SOCI 100,A01,258415,Staff,29,0,30,1
1681930201047,SOCI 100,A02,258416,Staff,28,0,30,2
1681930207240,SOCI 127,A00,258421,Staff,19,0,30,11
1681930208267,SOCI 132,A00,258422,Staff,43,0,50,7
1681930209299,SOCI 133,A00,258423,Staff,26,0,30,4
1681930210325,SOCI 138GS,A00,258424,Staff,15,0,15,0
1681930211362,SOCI 145,A00,258425,Staff,24,0,30,6
1681930212385,SOCI 148,A00,258426,Staff,24,0,30,6
1681930213408,SOCI 153,A00,199217,Staff,29,0,30,1
1681930214432,SOCI 160,A00,258427,Staff,27,0,30,3
1681930215463,SOCI 160E,A00,258435,Staff,55,0,60,5
1681930216486,SOCI 189GS,A00,258436,Staff,15,0,15,0
1681930217512,SOCI 190GS,A00,258437,Staff,15,0,15,0
1681930218540,SYN 2,001,182658,Staff,8,0,16,8
1681930218540,SYN 2,002,201439,Staff,14,0,16,2
1681930218540,SYN 2,003,201443,Staff,16,0,16,0
1681930219562,SYN 100,A01,182657,Staff,13,0,20,7
1681930220606,TDAC 1,A00,184381,Salovey; Todd,16,0,20,4
1681930220606,TDAC 1,B00,184385,Harting; Carla Kelso,19,0,20,1
1681930220606,TDAC 1,C00,184394,Staff,18,0,20,2
1681930221629,TDAC 101,A00,184483,Harting; Carla Kelso,19,0,20,1
1681930222662,TDDE 111,A00,184496,Staff,14,0,15,1
1681930223686,TDDE 131,A00,184504,Staff,20,0,20,0
1681930223686,TDDE 131,B00,184505,Staff,17,0,18,1
1681930223686,TDDE 131,C00,184534,Staff,49,0,50,1
1681930223686,TDDE 131,D00,184564,Staff,15,0,15,0
1681930223686,TDDE 131,E00,204725,Staff,18,0,20,2
1681930224714,TDGE 1,A01,184414,Salovey; Todd,35,0,50,15
1681930225739,TDGE 5,A01,184419,Staff,23,0,24,1
1681930226763,TDGE 10,A00,184428,Fulton; Julia,27,0,50,23
1681930227786,TDGE 124,A00,184565,Fulton; Julia,0,2,50,50
1681930228809,TDGE 125,B00,184567,Meyer; Ursula,8,0,25,17
1681930229848,TDHT 101,A00,184568,Staff,21,0,25,4
1681930229848,TDHT 101,B00,184569,Staff,20,0,20,0
1681930230871,TDHT 114,A00,184570,Staff,49,0,50,1
1681930231896,TDMV 1,A00,184437,Arcidiacono; Kristin,21,0,30,9
1681930231896,TDMV 1,B00,184448,Caligagan; Maria T.,23,0,30,7
1681930232923,TDMV 2,A00,184449,Weinberg; Sadie,27,0,30,3
1681930232923,TDMV 2,B00,184453,Arcidiacono; Kristin,29,0,30,1
1681930233948,TDMV 110,A00,184571,Weinberg; Sadie,30,0,30,0
1681930234971,TDMV 142,A00,184572,Caligagan; Tony,26,0,30,4
1681930234971,TDMV 142,B00,184573,Caligagan; Maria T.,26,0,30,4
1681930235998,TDTR 20,A00,184482,Jun; Grace Shin Hae,25,0,25,0
1681930237025,USP 2,A01,184290,Hinds; Juli Beth,23,0,25,2
1681930238049,USP 3,A01,184295,Staff,20,0,25,5
1681930239077,USP 4,A00,184304,McTague; Sarah,13,0,25,12
1681930240103,USP 100,A00,184315,Staff,16,0,25,9
1681930241128,USP 105,A00,184326,Staff,21,0,25,4
1681930242150,USP 151,A00,184327,Staff,17,0,25,8
1681930243173,USP 170,A00,184380,Hinds; Juli Beth,12,0,25,13
1681930244203,VIS 21B,A01,182660,Staff,28,0,31,3
1681930244203,VIS 21B,A02,182662,Staff,30,0,31,1
1681930245230,VIS 103D,A00,182663,Staff,74,0,75,1
1681930246252,VIS 105D,A00,182667,Li; Huai,14,0,22,8
1681930247284,VIS 122GS,A00,182668,Herbst; Matthew,20,0,20,0
1681930248310,VIS 128C,A00,182673,Staff,69,0,75,6
1681930249333,VIS 130,A00,182675,Staff,19,0,22,3
1681930250363,VIS 160A,A00,182678,Stalbaum; Brett,4,0,10,6
1681930252419,WCWP 10B,A00,201679,Staff,15,0,15,0
1681930252419,WCWP 10B,B00,201695,Staff,15,0,15,0
1681930253442,WCWP 100,A00,201716,Staff,12,0,15,3
1681930253442,WCWP 100,B00,201717,Staff,1,0,15,14
1681930255504,ANSC 105GS,A00,258289,Staff,0,0,0,0
1681930256529,ANSC 125GS,A00,258295,Staff,0,0,0,0
1681930257557,ANSC 150,A00,258267,Staff,28,0,40,12
1681930258584,ANSC 190GS,A00,258280,Staff,0,0,0,1
1681930259606,ANTH 1,A00,258264,Staff,38,0,40,2
1681930260639,ANTH 2,A01,258259,Staff,72,0,76,4
1681930261664,ANTH 23,A01,258228,Staff,35,0,40,5
1681930262689,ANTH 101,A01,258236,Staff,38,0,40,2
1681930263713,ANTH 102,A00,258272,Staff,59,0,60,1
1681930264746,ANTH 105,A00,258244,Staff,29,0,35,6
1681930265770,BENG 130,A00,253975,Staff,37,0,40,3
1681930266805,BIBC 102,A01,191866,Flagg; Matthew Paul,16,0,32,16
1681930266805,BIBC 102,A02,191867,Flagg; Matthew Paul,21,0,32,11
1681930266805,BIBC 102,A03,191868,Flagg; Matthew Paul,28,0,32,4
1681930266805,BIBC 102,A04,191936,Flagg; Matthew Paul,22,0,32,10
1681930266805,BIBC 102,A05,191937,Flagg; Matthew Paul,0,0,32,32
1681930267833,BICD 100,A01,191939,Cooper; Andrew Michael,27,0,32,5
1681930267833,BICD 100,A02,191940,Cooper; Andrew Michael,32,0,32,0
1681930267833,BICD 100,A03,191941,Cooper; Andrew Michael,32,0,32,0
1681930267833,BICD 100,A04,191942,Cooper; Andrew Michael,32,0,32,0
1681930267833,BICD 100,A05,191943,Cooper; Andrew Michael,32,0,32,0
1681930268862,BIEB 126,A01,191945,Cleland; Elsa Eleanor,0,3,32,32
1681930268862,BIEB 126,A02,191946,Cleland; Elsa Eleanor,26,0,32,6
1681930268862,BIEB 126,A03,191947,Cleland; Elsa Eleanor,29,0,32,3
1681930268862,BIEB 126,A04,191948,Cleland; Elsa Eleanor,17,0,32,15
1681930268862,BIEB 126,A05,191996,Cleland; Elsa Eleanor,28,0,32,4
1681930269890,BIEB 136GS,A00,191997,Shurin; Jonathan & Holway; David A.,0,0,0,8
1681930270917,BIEB 137GS,A01,191999,Shurin; Jonathan & Holway; David A.,0,0,0,7
1681930271943,BILD 1,A01,205385,Staff,30,0,32,2
1681930271943,BILD 1,A02,205386,Staff,30,0,32,2
1681930271943,BILD 1,A03,205387,Staff,31,0,32,1
1681930271943,BILD 1,A04,205388,Staff,25,0,32,7
1681930272973,BILD 2,A01,191774,Staff,27,0,32,5
1681930272973,BILD 2,A02,191775,Staff,30,0,32,2
1681930272973,BILD 2,A03,191777,Staff,30,0,32,2
1681930272973,BILD 2,A04,191856,Staff,30,0,32,2
1681930272973,BILD 2,A05,191857,Staff,31,0,32,1
1681930272973,BILD 2,A06,191858,Staff,32,0,32,0
1681930272973,BILD 2,A07,191859,Staff,31,0,32,1
1681930273996,BILD 3,A01,205391,Staff,27,0,32,5
1681930273996,BILD 3,A02,205393,Staff,32,0,32,0
1681930273996,BILD 3,A03,205394,Staff,27,0,32,5
1681930273996,BILD 3,A04,205395,Staff,32,0,32,0
1681930275020,BILD 20,A01,191861,Staff,32,0,32,0
1681930275020,BILD 20,A02,191862,Staff,32,0,32,0
1681930276059,BILD 30,A01,191864,Staff,31,0,32,1
1681930277088,BIMM 100,A01,192019,Staff,0,0,32,32
1681930277088,BIMM 100,A02,192020,Staff,17,0,32,15
1681930277088,BIMM 100,A03,192035,Staff,18,0,32,14
1681930278117,BIMM 110,A01,192037,Tat; John,0,0,32,32
1681930278117,BIMM 110,A02,192038,Tat; John,5,0,32,27
1681930279141,BIMM 120,A01,192040,Pickett; Brooke Elizabeth,0,0,32,32
1681930279141,BIMM 120,A02,192041,Pickett; Brooke Elizabeth,9,0,32,23
1681930279141,BIMM 120,A03,192042,Pickett; Brooke Elizabeth,13,0,32,19
1681930280169,BIPN 100,A01,192044,Armour; Jon Christopher,23,0,32,9
1681930280169,BIPN 100,A02,192059,Armour; Jon Christopher,30,0,32,2
1681930280169,BIPN 100,A03,192064,Armour; Jon Christopher,30,0,32,2
1681930280169,BIPN 100,A04,192073,Armour; Jon Christopher,26,0,32,6
1681930281193,BIPN 148,A01,205411,Leutgeb; Jill K.,14,0,32,18
1681930281193,BIPN 148,A02,205412,Leutgeb; Jill K.,31,0,32,1
1681930281193,BIPN 148,A03,205413,Leutgeb; Jill K.,30,0,32,2
1681930281193,BIPN 148,A04,205414,Leutgeb; Jill K.,30,0,32,2
1681930282220,BIPN 160,A01,192115,Marino; Marc J,15,0,32,17
1681930282220,BIPN 160,A02,192148,Marino; Marc J,27,0,32,5
1681930282220,BIPN 160,A03,192158,Marino; Marc J,31,0,32,1
1681930282220,BIPN 160,A04,192190,Marino; Marc J,32,0,32,0
1681930282220,BIPN 160,A05,192287,Marino; Marc J,32,0,32,0
1681930282220,BIPN 160,A06,192288,Marino; Marc J,32,0,32,0
1681930283247,BIPN 194,A00,206038,Leutgeb; Stefan,28,0,32,4
1681930284272,BISP 194,A00,192289,Nieh; James Charles,10,0,32,22
1681930284272,BISP 194,B00,245332,Staff,26,0,32,6
1681930285294,CAT 124,A01,202247,Staff,15,0,15,0
1681930286327,CAT 125,A00,202248,Staff,18,0,20,2
1681930286327,CAT 125,B00,202253,Staff,20,0,20,0
1681930286327,CAT 125,C00,202257,Staff,18,0,20,2
1681930287352,CAT 125GS,A01,202273,Bronstein; Phoebe Malan,20,0,20,0
1681930288381,CAT 125R,A00,202284,Staff,17,0,20,3
1681930288381,CAT 125R,C00,202286,Staff,5,0,20,15
1681930288381,CAT 125R,D00,202291,Staff,17,0,20,3
1681930288381,CAT 125R,E00,202295,Staff,13,0,20,7
1681930288381,CAT 125R,F00,202302,Staff,6,0,20,14
1681930289418,CENG 100,A00,204724,Opatkiewicz; Justin Paul,25,0,25,0
1681930290448,CGS 2A,A01,180420,Staff,30,0,36,6
1681930291475,CGS 101,A00,180421,Staff,15,0,20,5
1681930292502,CGS 112,A00,180422,Staff,9,0,16,7
1681930293536,CGS 113,A00,180423,Staff,18,0,20,2
1681930294631,CGS 137,A00,180424,Staff,12,0,12,0
1681930295657,CGS 147,A00,180425,Staff,10,0,10,0
1681930296680,CHEM 6A,A01,179556,Staff,92,0,100,8
1681930296680,CHEM 6A,A02,179558,Staff,0,0,0,0
1681930297703,CHEM 6B,A01,179560,Staff,100,0,100,0
1681930298733,CHEM 6C,A01,179565,Jazzar; Rodolphe,92,0,100,8
1681930299758,CHEM 7L,A01,179586,Schurmeier; Kimberly,10,0,24,14
1681930299758,CHEM 7L,A02,179587,Schurmeier; Kimberly,23,0,24,1
1681930299758,CHEM 7L,A03,179590,Schurmeier; Kimberly,22,0,24,2
1681930299758,CHEM 7L,A04,179591,Schurmeier; Kimberly,22,0,24,2
1681930299758,CHEM 7L,B01,179598,Schurmeier; Kimberly,15,0,24,9
1681930299758,CHEM 7L,B02,179599,Schurmeier; Kimberly,24,0,24,0
1681930299758,CHEM 7L,B03,179606,Schurmeier; Kimberly,22,0,24,2
1681930299758,CHEM 7L,B04,179607,Schurmeier; Kimberly,22,0,24,2
1681930300781,CHEM 11,A01,179609,Stallings; Dontarie M,87,0,100,13
1681930301808,CHEM 40A,A01,179621,Staff,38,0,50,12
1681930301808,CHEM 40A,A02,179622,Staff,46,0,50,4
1681930302831,CHEM 40B,A01,179630,Weizman; Haim,46,0,50,4
1681930302831,CHEM 40B,A02,179631,Weizman; Haim,43,0,50,7
1681930303856,CHEM 41A,A01,179660,Klosterman; Jeremy K,91,0,100,9
1681930304879,CHEM 43A,A01,179683,Klosterman; Jeremy K,0,0,24,24
1681930304879,CHEM 43A,A02,179688,Klosterman; Jeremy K,7,0,24,17
1681930304879,CHEM 43A,A03,179689,Klosterman; Jeremy K,17,0,24,7
1681930304879,CHEM 43A,A04,179691,Klosterman; Jeremy K,18,0,24,6
1681930305906,CHEM 114A,A01,179693,Stallings; Dontarie M,67,0,100,33
1681930306933,CHEM 143B,A01,179698,Weizman; Haim,16,0,24,8
1681930306933,CHEM 143B,A02,179700,Weizman; Haim,24,0,24,0
1681930307956,CHIN 169A,A00,179701,Wang; Xiao,20,0,20,0
1681930308982,COGS 2,A01,179750,Boyle; Mary E. T.,17,0,30,13
1681930310015,COGS 9,A01,179759,Jones; Cameron Robert,39,0,50,11
1681930311040,COGS 14A,A01,179854,Staff,11,0,50,39
1681930312069,COGS 14B,A01,179856,Staff,52,0,60,8
1681930313098,COGS 17,A01,179874,Staff,71,0,75,4
1681930314125,COGS 18,A01,179884,Staff,59,0,80,21
1681930315151,COGS 100,A01,179886,Staff,33,0,60,27
1681930316176,COGS 101B,A01,179892,Staff,0,3,30,30
1681930317205,COGS 101C,A01,179894,Staff,26,0,30,4
1681930318229,COGS 107A,A01,179896,Boyle; Mary E. T.,28,0,40,12
1681930319253,COGS 108,A01,179898,Simpkins; Charles Alexander,0,32,60,60
1681930320283,COGS 109,A01,179900,Staff,32,0,40,8
1681930321312,COGS 118A,A01,179946,Staff,5,0,40,35
1681930322345,COGS 153,A00,179978,Staff,0,6,30,30
1681930323371,COGS 156,A01,179981,Staff,21,0,30,9
1681930325426,COGS 172,A01,179987,Staff,10,0,30,20
1681930327471,COGS 186,A01,179991,Staff,11,0,30,19
1681930328494,COMM 10,A01,180001,Staff,11,0,25,14
1681930328494,COMM 10,A02,180004,Staff,20,0,25,5
1681930329526,COMM 100A,A01,180016,Staff,13,0,25,12
1681930329526,COMM 100A,A02,180020,Staff,24,0,25,1
1681930330568,COMM 101T,A00,180029,Halm; Gavin Patrick,19,0,35,16
1681930331598,COMM 106V,A00,180043,Staff,34,0,35,1
1681930332624,COMM 109P,A00,180044,Staff,30,0,35,5
1681930333647,COMM 113T,A00,180045,Havis; Allan,37,0,45,8
1681930334671,COMM 132,A00,180046,McKenna; Denise,20,0,30,10
1681930335698,COMM 143,A00,180047,Staff,16,0,30,14
1681930336730,COMM 190,A00,180048,Conner; Thomas Hartnell,16,0,23,7
1681930337755,CSE 8A,A50,180053,Cao; Yingjun,20,0,50,30
1681930337755,CSE 8A,B50,180180,Staff,50,0,50,0
1681930338786,CSE 11,A01,180190,Cao; Yingjun,21,0,50,29
1681930339811,CSE 20,A01,180192,Briones; Jor-el Thomas Caparas,21,0,30,9
1681930340841,CSE 21,A01,194538,Briones; Jor-el Thomas Caparas,49,0,60,11
1681930341863,CSE 30,A01,180324,Eldon; John,73,0,100,27
1681930342892,CSE 101,A01,201353,Staff,0,30,40,40
1681930343926,CSE 134B,A01,180326,Powell; Thomas Allan,73,0,100,27
1681930344952,CSE 140,A01,180328,Staff,23,0,75,52
1681930345979,CSE 140L,A01,180344,Eldon; John,48,0,100,52
1681930347002,CSE 150A,A01,180411,Staff,0,18,50,50
1681930348032,CSE 151A,A01,180414,Staff,0,14,50,50
1681930349055,CSE 175,A01,222521,Kumar; Rakesh,50,0,50,0
1681930350081,CSE 190,A00,201419,Staff,42,0,49,7
1681930351107,CSS 1,A01,194536,Staff,32,0,50,18
1681930352140,DSC 30,A01,202385,Staff,48,0,50,2
1681930353161,DSC 40A,A01,202387,Albuyeh; Rod,50,0,50,0
1681930354187,DSC 190,A01,202389,Silberman; Jack,21,0,21,0
1681930355210,DSGN 100,A01,179993,Staff,13,0,30,17
1681930356237,ECE 65,A50,180708,Staff,10,0,20,10
1681930356237,ECE 65,A51,180739,Staff,19,0,20,1
1681930357259,ECON 1,A01,180427,Famulari; Melissa,66,0,70,4
1681930358282,ECON 2,A01,180450,Levkoff; Steven B.,64,0,70,6
1681930359308,ECON 4,A01,203351,Anderson; John Charles,6,0,10,4
1681930360338,ECON 100A,A01,180472,Famulari; Melissa,59,0,70,11
1681930361361,ECON 120A,A01,180549,Staff,62,0,70,8
1681930362393,ECON 120B,A01,180655,Ma; Xinwei,38,0,70,32
1681930363434,ECON 129,A00,203333,Eckert; Fabian Paul,10,0,35,25
1681930364460,ECON 131,A00,180656,Staff,1,0,35,34
1681930365500,ECON 172B,A01,180672,Levkoff; Steven B.,31,0,35,4
1681930366526,ECON 178,A01,203342,Zhu; Ying,4,0,35,31
1681930367547,EDS 108GS,A00,202383,Wishard Guerra; Alison G.,20,0,20,0
1681930368577,EDS 111GS,A00,202347,Wishard Guerra; Alison G.,20,0,20,0
1681930369607,EDS 112,A01,202323,Staff,53,0,60,7
1681930370629,EDS 113,A00,202340,Staff,32,0,35,3
1681930371652,EDS 118,A00,201231,Staff,19,0,30,11
1681930372675,EDS 119,A00,204994,Staff,8,0,10,2
1681930373697,EDS 124BR,A00,202324,Eguchi; Emi,0,1,25,25
1681930374724,EDS 126,A01,203208,Jones; Makeba,26,0,30,4
1681930375750,EDS 135,A01,202333,Staff,17,0,20,3
1681930376773,EDS 180,A00,202311,Staff,47,0,50,3
1681930377799,ERC 190GS,A01,253747,Staff,28,0,28,0
1681930378822,ETHN 104,A00,180742,Staff,21,0,35,14
1681930379844,ETHN 118,A00,180745,Staff,26,0,35,9
1681930380865,ETHN 127,A00,180747,Staff,8,0,16,8
1681930381893,ETHN 137,A00,180880,Staff,11,0,12,1
1681930382923,ETHN 147,A00,180890,Staff,8,0,10,2
1681930383945,ETHN 154,A00,180891,Staff,6,0,8,2
1681930384973,ETHN 168,A00,180892,Staff,9,0,10,1
1681930386013,GLBH 20,A00,201051,Hannah; Seth Donal,0,6,0,1
1681930387037,GLBH 111,A01,209338,Burgos; Jose L.,0,0,0,0
1681930388064,GLBH 150,A00,258300,Staff,0,4,0,0
1681930389086,GLBH 181,A00,201207,Staff,7,0,40,33
1681930390109,HIEU 109,A00,180898,Staff,19,0,20,1
1681930391136,HIEU 111,A00,180899,Staff,0,2,20,20
1681930392159,HIEU 124,A00,180900,Staff,17,0,20,3
1681930393185,HILA 122,A00,180901,Staff,17,0,20,3
1681930394207,HILA 132,A00,180902,Vitz; Matthew,0,2,20,20
1681930395241,HILD 10,A01,180896,Staff,12,0,20,8
1681930396272,HILD 30GS,A00,180897,Edington; Claire Ellen,0,0,0,0
1681930397295,HISC 105,A00,180903,Staff,20,0,20,0
1681930398392,HISC 117,A00,180904,Staff,10,0,20,10
1681930399414,HIUS 108B,A00,181005,Staff,18,0,20,2
1681930400439,HIUS 113,A00,181093,Staff,1,0,20,19
1681930401461,HUM 3,A01,181190,Patterson; Patrick H.,35,0,50,15
1681930401461,HUM 3,B01,181195,Staff,45,0,50,5
1681930402487,HUM 3GS,A00,181196,Herbst; Matthew,0,0,0,0
1681930403509,HUM 4,A01,181227,West; Geoffrey Scott,33,0,50,17
1681930403509,HUM 4,B01,181282,Staff,41,0,50,9
1681930404535,HUM 4GS,A00,181377,Lyon; Antony J.,0,0,0,0
1681930405563,HUM 5,A01,181536,Zavodny; Tatiana Sophia,25,0,50,25
1681930405563,HUM 5,B01,181908,Staff,33,0,50,17
1681930406589,INTL 190,A00,181909,Segui; Alan S,0,0,0,8
1681930406589,INTL 190,B00,181961,Segui; Alan S,0,0,0,7
1681930407622,JAPN 20AR,A01,182113,Ross; Kayoko F,15,0,20,5
1681930408661,LATI 50,A01,202391,Martin-Cabrera; Luis,17,0,30,13
1681930408661,LATI 50,A02,202392,Martin-Cabrera; Luis,26,0,30,4
1681930409687,LATI 180,A00,202393,Kokinis; Troy Andreas,24,0,25,1
1681930410720,LIFR 1A,A00,182119,Staff,13,0,14,1
1681930411755,LIFR 1AX,A00,182324,Staff,13,0,14,1
1681930412781,LIFR 1B,A00,182259,Staff,12,0,14,2
1681930413809,LIFR 1BX,A00,182273,Staff,12,0,14,2
1681930414833,LIGN 8,A00,182330,Staff,127,0,150,23
1681930415857,LIGN 9GS,A00,182362,Staff,15,0,20,5
1681930416884,LIGN 119,A00,204992,Takahashi; Maho,11,0,15,4
1681930417917,LIGN 130,A01,182384,Staff,47,0,50,3
1681930418947,LIGN 149GS,A00,182390,Staff,15,0,20,5
1681930419974,LIGN 170,A00,182404,Staff,23,0,30,7
1681930420996,LISP 1D,A00,182281,Staff,7,0,14,7
1681930420996,LISP 1D,B00,182287,Staff,13,0,14,1
1681930420996,LISP 1D,C00,182295,Staff,10,0,14,4
1681930420996,LISP 1D,D00,182301,Staff,14,0,14,0
1681930422028,LISP 1DX,A00,182309,Staff,19,0,28,9
1681930422028,LISP 1DX,B00,182316,Staff,25,0,28,3
1681930423052,LTAF 120GS,A00,182412,Zhiri; Oumelbanine,20,0,20,0
1681930424078,LTCS 172GS,A00,182437,Bronstein; Phoebe Malan,20,0,20,0
1681930425103,LTEA 138,A00,182457,Staff,18,0,40,22
1681930426135,LTEN 114,A01,182490,Staff,23,0,25,2
1681930427166,LTEN 130GS,A00,182491,Lyon; Antony J.,20,0,20,0
1681930428189,LTEN 169,A00,182493,Cuong; Marisol,17,0,25,8
1681930429215,LTEN 178,A00,182501,Staff,14,0,15,1
1681930430237,LTEN 181,A00,182515,Staff,19,0,25,6
1681930431261,LTEN 185GS,A00,197655,Forbes; Camille,20,0,20,0
1681930432285,LTSP 100B,A00,202208,Bessett; Ryan Matthew,24,0,25,1
1681930433309,LTWL 100,A00,182516,Myerston Santana; Jacobo,20,0,30,10
1681930434334,LTWR 100GS,A00,182518,Forbes; Camille,20,0,20,0
1681930435365,LTWR 102,A00,182522,Staff,15,0,15,0
1681930435365,LTWR 102,B00,182525,Staff,14,0,15,1
1681930436390,LTWR 115,A00,182526,Staff,10,0,15,5
1681930437416,MAE 8,A01,182528,Pham; Hieu Tan,67,0,70,3
1681930438449,MAE 11,A00,182529,Bahadori; Mohammad Yousef,91,0,100,9
1681930439480,MAE 20,A00,182530,Evdokimenko; Ekaterina,67,0,70,3
1681930440512,MAE 30A,A00,182532,Staff,44,0,45,1
1681930441537,MAE 101A,A00,182533,Bahadori; Mohammad Yousef,94,0,100,6
1681930442560,MAE 101C,A00,182538,Staff,62,0,70,8
1681930443583,MAE 104,A00,182539,Staff,44,0,50,6
1681930444606,MAE 131A,A00,182540,Ghazinejad; Maziar,40,0,45,5
1681930445635,MAE 143A,A00,182548,Bewley; Thomas R,42,0,50,8
1681930446661,MAE 150,A00,182549,Staff,28,0,40,12
1681930447685,MAE 160,A00,182550,Evdokimenko; Ekaterina,41,0,60,19
1681930448717,MATH 3C,A01,182725,Staff,24,0,30,6
1681930449744,MATH 10A,A01,182729,Staff,24,0,30,6
1681930449744,MATH 10A,B01,182732,Staff,25,0,30,5
1681930450768,MATH 10B,A01,182737,Staff,16,0,30,14
1681930450768,MATH 10B,A02,182738,Staff,24,0,30,6
1681930450768,MATH 10B,B01,182744,Staff,25,0,30,5
1681930450768,MATH 10B,B02,182745,Staff,27,0,30,3
1681930451799,MATH 18,A01,182750,Anzaldo; Leesa B,28,0,30,2
1681930451799,MATH 18,A02,182751,Anzaldo; Leesa B,28,0,30,2
1681930451799,MATH 18,A03,182753,Anzaldo; Leesa B,27,0,30,3
1681930451799,MATH 18,A04,182757,Anzaldo; Leesa B,29,0,30,1
1681930451799,MATH 18,B01,182761,Anzaldo; Leesa B,27,0,30,3
1681930451799,MATH 18,B02,182764,Anzaldo; Leesa B,26,0,30,4
1681930451799,MATH 18,B03,182765,Anzaldo; Leesa B,29,0,30,1
1681930451799,MATH 18,B04,182766,Anzaldo; Leesa B,30,0,30,0
1681930452835,MATH 20A,A01,182771,Suk; Andrew Hoon,28,0,30,2
1681930453863,MATH 20B,A01,182775,Bach; Quang Tran,30,0,30,0
1681930453863,MATH 20B,A02,182777,Bach; Quang Tran,29,0,30,1
1681930453863,MATH 20B,B01,182780,Bach; Quang Tran,26,0,30,4
1681930453863,MATH 20B,B02,182782,Bach; Quang Tran,30,0,30,0
1681930454888,MATH 20C,A01,182787,Staff,24,0,30,6
1681930454888,MATH 20C,A02,182790,Staff,29,0,30,1
1681930454888,MATH 20C,B01,182792,Staff,23,0,30,7
1681930454888,MATH 20C,B02,182796,Staff,26,0,30,4
1681930455914,MATH 20D,A01,182799,Staff,27,0,30,3
1681930455914,MATH 20D,A02,182802,Staff,29,0,30,1
1681930455914,MATH 20D,A03,182803,Staff,30,0,30,0
1681930456944,MATH 20E,A01,182809,Verstraete; Jacques Allan,20,0,30,10
1681930456944,MATH 20E,A02,182811,Verstraete; Jacques Allan,28,0,30,2
1681930456944,MATH 20E,B01,182814,Verstraete; Jacques Allan,21,0,30,9
1681930456944,MATH 20E,B02,182815,Verstraete; Jacques Allan,29,0,30,1
1681930457977,MATH 103A,A01,182820,Staff,3,0,30,27
1681930457977,MATH 103A,A02,182821,Staff,27,0,30,3
1681930457977,MATH 103A,A03,182822,Staff,21,0,30,9
1681930457977,MATH 103A,B01,182825,Staff,21,0,30,9
1681930457977,MATH 103A,B02,182826,Staff,30,0,30,0
1681930457977,MATH 103A,B03,182830,Staff,30,0,30,0
1681930459005,MATH 109,A01,182836,Chow; Bennett,23,0,30,7
1681930459005,MATH 109,A02,182838,Chow; Bennett,28,0,30,2
1681930459005,MATH 109,A03,182894,Chow; Bennett,29,0,30,1
1681930459005,MATH 109,B01,182908,Chow; Bennett,27,0,30,3
1681930459005,MATH 109,B02,182909,Chow; Bennett,30,0,30,0
1681930459005,MATH 109,B03,182910,Chow; Bennett,26,0,30,4
1681930460028,MATH 142A,A01,182925,Staff,3,0,30,27
1681930460028,MATH 142A,A02,182935,Staff,23,0,30,7
1681930460028,MATH 142A,A03,182967,Staff,25,0,30,5
1681930460028,MATH 142A,B01,183125,Staff,22,0,30,8
1681930460028,MATH 142A,B02,183157,Staff,26,0,30,4
1681930460028,MATH 142A,B03,183158,Staff,29,0,30,1
1681930461067,MATH 183,A01,183160,Arias-Castro; Ery,22,0,30,8
1681930461067,MATH 183,A02,183161,Arias-Castro; Ery,29,0,30,1
1681930461067,MATH 183,B01,183163,Arias-Castro; Ery,26,0,30,4
1681930461067,MATH 183,B02,183164,Arias-Castro; Ery,28,0,30,2
1681930462092,MATH 193A,A01,183167,Staff,0,0,35,35
1681930462092,MATH 193A,A02,183168,Staff,23,0,35,12
1681930462092,MATH 193A,A03,183169,Staff,34,0,35,1
1681930462092,MATH 193A,A04,183170,Staff,26,0,35,9
1681930463114,MGT 4,A01,202395,Anderson; John Charles,76,0,80,4
1681930464147,MGT 5,A00,202396,Houskeeper; Robert,79,0,90,11
1681930465177,MGT 103,A00,202397,Eberhard; Craig A,49,0,90,41
1681930466199,MGT 131A,A00,202398,Houskeeper; Robert,81,0,90,9
1681930467230,MGT 135,A00,202399,Anderson; John Charles,81,0,90,9
1681930468262,MGT 162R,A00,202403,Gneezy; Uri,122,0,200,78
1681930469284,MGT 172,A00,202404,Hedges; Kathleen,30,0,90,60
1681930470310,MGT 181,A00,202405,Dunn; Louis Jean,79,0,90,11
1681930471337,MMW 14,A01,183200,Staff,1,0,28,27
1681930471337,MMW 14,A02,183201,Staff,25,0,28,3
1681930471337,MMW 14,A03,183202,Staff,24,0,28,4
1681930471337,MMW 14,A04,183203,Staff,25,0,28,3
1681930471337,MMW 14,A05,183204,Staff,26,0,28,2
1681930471337,MMW 14,A06,183205,Staff,27,0,28,1
1681930471337,MMW 14,B01,183207,Staff,26,0,28,2
1681930471337,MMW 14,B02,183208,Staff,28,0,28,0
1681930471337,MMW 14,B03,183209,Staff,28,0,28,0
1681930471337,MMW 14,B04,183210,Staff,28,0,28,0
1681930471337,MMW 14,B05,183211,Staff,28,0,28,0
1681930471337,MMW 14,B06,183212,Staff,27,0,28,1
1681930472360,MMW 14GS,A00,183213,Zhiri; Oumelbanine,28,0,28,0
1681930473389,MMW 15GS,B00,183215,Rahimi; Babak,28,0,28,0
1681930474415,MMW 121,A01,183217,Patterson; Patrick H.,8,0,28,20
1681930474415,MMW 121,A02,183218,Patterson; Patrick H.,25,0,28,3
1681930475437,MUS 1A,A01,182554,Staff,0,0,35,35
1681930476461,MUS 5,A01,182558,Staff,17,0,35,18
1681930477492,MUS 6,A01,182562,Staff,22,0,35,13
1681930478536,MUS 8GS,A00,182563,Borgo; David Garcia,25,0,25,0
1681930479561,MUS 13,A01,182567,Staff,23,0,25,2
1681930480592,MUS 15,A01,182570,Staff,31,0,35,4
1681930480592,MUS 15,B01,182575,Staff,7,0,35,28
1681930481628,MUS 80,A00,182578,Staff,22,0,25,3
1681930481628,MUS 80,B00,182581,Staff,20,0,25,5
1681930482655,MUS 113,A00,182582,Staff,25,0,25,0
1681930483678,MUS 114,A00,182583,Staff,1,0,25,24
1681930484704,MUS 150GS,A01,182588,Borgo; David Garcia,24,0,25,1
1681930485729,PHIL 1,A00,182590,Staff,34,0,40,6
1681930486752,PHIL 10,A01,182596,Grush; Rick Scott,30,0,35,5
1681930486752,PHIL 10,A02,182597,Grush; Rick Scott,33,0,35,2
1681930487776,PHIL 15,A01,182601,Staff,31,0,35,4
1681930487776,PHIL 15,A02,182602,Staff,33,0,35,2
1681930489367,PHIL 27,A01,182604,Staff,25,0,35,10
1681930489367,PHIL 27,A02,182607,Staff,35,0,35,0
1681930490391,PHIL 32,A01,182609,Staff,35,0,35,0
1681930490391,PHIL 32,A02,182612,Staff,35,0,35,0
1681930491428,PHIL 130,A00,182614,Staff,57,0,70,13
1681930492455,PHIL 136,A00,182616,Cohen; Jonathan David,64,0,70,6
1681930493477,PHIL 155,A00,182617,Vargas; Manuel Rogelio,57,0,70,13
1681930494503,PHIL 163,A01,182620,Staff,15,0,20,5
1681930494503,PHIL 163,A02,182624,Staff,10,0,20,10
1681930495534,PHIL 164,A00,182627,Staff,29,0,40,11
1681930496566,PHIL 173,A00,182628,Staff,35,0,40,5
1681930497595,PHYS 1A,A00,183221,Staff,53,0,60,7
1681930498628,PHYS 1AL,001,183222,Staff,25,0,30,5
1681930498628,PHYS 1AL,002,183223,Staff,24,0,30,6
1681930499652,PHYS 1B,A00,183231,Staff,40,0,60,20
1681930500681,PHYS 1BL,001,183232,Staff,15,0,30,15
1681930500681,PHYS 1BL,002,183233,Staff,27,0,30,3
1681930501710,PHYS 1C,A00,183240,Staff,21,0,60,39
1681930502842,PHYS 1CL,001,183241,Staff,8,0,30,22
1681930502842,PHYS 1CL,002,183242,Staff,22,0,30,8
1681930503865,PHYS 2AR,A01,183250,Staff,39,0,50,11
1681930504889,PHYS 2B,A01,183252,Staff,102,0,115,13
1681930505916,PHYS 2BL,A01,183254,Staff,21,0,24,3
1681930505916,PHYS 2BL,A02,183255,Staff,21,0,24,3
1681930506938,PHYS 2C,A01,183522,Staff,100,0,115,15
1681930507971,PHYS 4A,A01,183524,Staff,49,0,50,1
1681930509008,POLI 5,A00,183525,Staff,44,0,50,6
1681930510039,POLI 12,A00,183540,Staff,45,0,50,5
1681930511063,POLI 13R,A00,183541,Forman; Fonna,40,0,50,10
1681930512085,POLI 30,A00,183542,Mignozzetti; Umberto,48,0,50,2
1681930513114,POLI 100A,A00,183543,Staff,44,0,50,6
1681930514141,POLI 100E,A00,223598,Staff,32,0,35,3
1681930515172,POLI 103A,A00,183564,Kousser; Thad,35,0,50,15
1681930516197,POLI 104B,A00,201329,Staff,28,0,35,7
1681930517231,POLI 113BR,A00,183576,Hoston; Germaine,22,0,50,28
1681930518256,POLI 114BR,A00,183588,Staff,27,0,30,3
1681930519279,POLI 117R,A00,183595,Forman; Fonna,3,0,20,17
1681930520305,POLI 120H,A00,183596,Fisk; David Lee,14,0,20,6
1681930521328,POLI 130AA,A00,183597,Staff,13,0,20,7
1681930522358,POLI 134AA,A00,183598,Staff,19,0,20,1
1681930523385,POLI 135,A00,183599,Fisk; David Lee,19,0,25,6
1681930524409,POLI 142P,A00,183623,Staff,37,0,40,3
1681930525431,POLI 144D,A00,183624,Staff,22,0,25,3
1681930526458,POLI 151,A00,183625,Staff,15,0,20,5
1681930527479,POLI 162,A00,183626,Mignozzetti; Umberto,17,0,20,3
1681930528503,PSYC 1,A00,253748,Staff,85,0,90,5
1681930529601,PSYC 2,A00,183627,Moranton; Nirelia Melbina-,23,0,35,12
1681930530627,PSYC 3,A00,183628,Staff,43,0,45,2
1681930532675,PSYC 60,A01,183631,Lowe; Angela Beth,35,0,40,5
1681930533711,PSYC 70,A01,253757,Staff,36,0,45,9
1681930534736,PSYC 101,A00,183632,Heyman; Gail D.,42,0,60,18
1681930535758,PSYC 105,A00,183848,Lowe; Angela Beth,46,0,60,14
1681930536784,PSYC 106,A00,183849,Dobkins; Karen R.,39,0,60,21
1681930537808,PSYC 108,A00,253750,Staff,12,0,60,48
1681930538834,PSYC 114,A01,184275,Winkielman; Piotr,0,8,30,30
1681930539878,PSYC 122,A00,183856,Moranton; Nirelia Melbina-,0,16,30,30
1681930540900,PSYC 124,A00,183865,Chapman; Eddie Nathaniel,43,0,80,37
1681930541930,PSYC 137,A00,183880,Staff,17,0,25,8
1681930544027,PSYC 154,A00,183910,Lacefield; Katharine I,0,29,90,90
1681930546074,PSYC 162,A00,183946,Wixted; John T,40,0,90,50
1681930547109,PSYC 172,A00,183947,Gorman; Michael R.,5,0,30,25
1681930548142,PSYC 178,A00,183963,Glaser; Dale,15,0,40,25
1681930549165,PSYC 181GS,A00,183964,Anagnostaras; Stephan,10,0,10,0
1681930550188,PSYC 186GS,A01,257660,Staff,10,0,10,0
1681930551211,PSYC 193,B00,253749,Staff,22,0,25,3
1681930553263,PSYC 193L,A01,184122,Staff,33,0,35,2
1681930553263,PSYC 193L,C01,184167,Winkielman; Piotr,14,0,30,16
1681930554286,RELI 188GS,A00,182629,Rahimi; Babak,20,0,20,0
1681930555318,SE 101A,A00,182646,Staff,26,0,30,4
1681930556341,SE 101C,A00,182650,Staff,12,0,20,8
1681930557373,SE 110A,A00,182651,Staff,28,0,28,0
1681930558398,SE 130A,A00,182652,Staff,38,0,40,2
1681930559427,SIO 46GS,A00,182636,Cook; Geoffrey W,25,0,28,3
1681930560458,SIO 109R,A00,194459,Staff,0,1,20,20
1681930561482,SIO 121GS,A00,182639,Cook; Geoffrey W,25,0,28,3
1681930562504,SIO 132,A01,182642,Staff,30,0,40,10
1681930563536,SIO 139,A00,182644,Kacev; David,36,0,40,4
1681930564562,SOCI 2,A01,258404,Staff,33,0,36,3
1681930564562,SOCI 2,A02,258405,Staff,35,0,36,1
1681930565595,SOCI 60,A01,258408,Staff,29,0,30,1
1681930565595,SOCI 60,A02,258413,Staff,30,0,30,0
1681930566623,SOCI 100,A01,258415,Staff,29,0,30,1
1681930566623,SOCI 100,A02,258416,Staff,28,0,30,2
1681930572772,SOCI 127,A00,258421,Staff,19,0,30,11
1681930573798,SOCI 132,A00,258422,Staff,43,0,50,7
1681930574825,SOCI 133,A00,258423,Staff,26,0,30,4
1681930575848,SOCI 138GS,A00,258424,Staff,15,0,15,0
1681930576874,SOCI 145,A00,258425,Staff,24,0,30,6
1681930577900,SOCI 148,A00,258426,Staff,23,0,30,7
1681930578931,SOCI 153,A00,199217,Staff,29,0,30,1
1681930579957,SOCI 160,A00,258427,Staff,27,0,30,3
1681930580989,SOCI 160E,A00,258435,Staff,55,0,60,5
1681930582017,SOCI 189GS,A00,258436,Staff,15,0,15,0
1681930583045,SOCI 190GS,A00,258437,Staff,15,0,15,0
1681930584069,SYN 2,001,182658,Staff,8,0,16,8
1681930584069,SYN 2,002,201439,Staff,14,0,16,2
1681930584069,SYN 2,003,201443,Staff,16,0,16,0
1681930585092,SYN 100,A01,182657,Staff,13,0,20,7
1681930586115,TDAC 1,A00,184381,Salovey; Todd,16,0,20,4
1681930586115,TDAC 1,B00,184385,Harting; Carla Kelso,19,0,20,1
1681930586115,TDAC 1,C00,184394,Staff,18,0,20,2
1681930587142,TDAC 101,A00,184483,Harting; Carla Kelso,19,0,20,1
1681930588169,TDDE 111,A00,184496,Staff,14,0,15,1
1681930589193,TDDE 131,A00,184504,Staff,20,0,20,0
1681930589193,TDDE 131,B00,184505,Staff,17,0,18,1
1681930589193,TDDE 131,C00,184534,Staff,49,0,50,1
1681930589193,TDDE 131,D00,184564,Staff,15,0,15,0
1681930589193,TDDE 131,E00,204725,Staff,18,0,20,2
1681930590216,TDGE 1,A01,184414,Salovey; Todd,35,0,50,15
1681930591238,TDGE 5,A01,184419,Staff,23,0,24,1
1681930592260,TDGE 10,A00,184428,Fulton; Julia,27,0,50,23
1681930593283,TDGE 124,A00,184565,Fulton; Julia,0,2,50,50
1681930594312,TDGE 125,B00,184567,Meyer; Ursula,8,0,25,17
1681930595334,TDHT 101,A00,184568,Staff,21,0,25,4
1681930595334,TDHT 101,B00,184569,Staff,20,0,20,0
1681930596365,TDHT 114,A00,184570,Staff,49,0,50,1
1681930597398,TDMV 1,A00,184437,Arcidiacono; Kristin,21,0,30,9
1681930597398,TDMV 1,B00,184448,Caligagan; Maria T.,23,0,30,7
1681930598422,TDMV 2,A00,184449,Weinberg; Sadie,27,0,30,3
1681930598422,TDMV 2,B00,184453,Arcidiacono; Kristin,29,0,30,1
1681930599448,TDMV 110,A00,184571,Weinberg; Sadie,30,0,30,0
1681930600478,TDMV 142,A00,184572,Caligagan; Tony,26,0,30,4
1681930600478,TDMV 142,B00,184573,Caligagan; Maria T.,26,0,30,4
1681930601501,TDTR 20,A00,184482,Jun; Grace Shin Hae,25,0,25,0
1681930602523,USP 2,A01,184290,Hinds; Juli Beth,23,0,25,2
1681930603548,USP 3,A01,184295,Staff,20,0,25,5
1681930604573,USP 4,A00,184304,McTague; Sarah,13,0,25,12
1681930605600,USP 100,A00,184315,Staff,16,0,25,9
1681930606702,USP 105,A00,184326,Staff,21,0,25,4
1681930607723,USP 151,A00,184327,Staff,17,0,25,8
1681930608744,USP 170,A00,184380,Hinds; Juli Beth,12,0,25,13
1681930609771,VIS 21B,A01,182660,Staff,28,0,31,3
1681930609771,VIS 21B,A02,182662,Staff,30,0,31,1
1681930610794,VIS 103D,A00,182663,Staff,74,0,75,1
1681930611820,VIS 105D,A00,182667,Li; Huai,14,0,22,8
1681930612849,VIS 122GS,A00,182668,Herbst; Matthew,20,0,20,0
1681930613875,VIS 128C,A00,182673,Staff,69,0,75,6
1681930614898,VIS 130,A00,182675,Staff,19,0,22,3
1681930615920,VIS 160A,A00,182678,Stalbaum; Brett,4,0,10,6
1681930617970,WCWP 10B,A00,201679,Staff,15,0,15,0
1681930617970,WCWP 10B,B00,201695,Staff,15,0,15,0
1681930619007,WCWP 100,A00,201716,Staff,12,0,15,3
1681930619007,WCWP 100,B00,201717,Staff,1,0,15,14
1681930621110,ANSC 105GS,A00,258289,Staff,0,0,0,0
1681930622133,ANSC 125GS,A00,258295,Staff,0,0,0,0
1681930623155,ANSC 150,A00,258267,Staff,28,0,40,12
1681930624179,ANSC 190GS,A00,258280,Staff,0,0,0,2
1681930625202,ANTH 1,A00,258264,Staff,38,0,40,2
1681930626246,ANTH 2,A01,258259,Staff,72,0,76,4
1681930627267,ANTH 23,A01,258228,Staff,35,0,40,5
1681930628292,ANTH 101,A01,258236,Staff,38,0,40,2
1681930629321,ANTH 102,A00,258272,Staff,59,0,60,1
1681930630346,ANTH 105,A00,258244,Staff,29,0,35,6
1681930631369,BENG 130,A00,253975,Staff,37,0,40,3
1681930632392,BIBC 102,A01,191866,Flagg; Matthew Paul,16,0,32,16
1681930632392,BIBC 102,A02,191867,Flagg; Matthew Paul,21,0,32,11
1681930632392,BIBC 102,A03,191868,Flagg; Matthew Paul,28,0,32,4
1681930632392,BIBC 102,A04,191936,Flagg; Matthew Paul,22,0,32,10
1681930632392,BIBC 102,A05,191937,Flagg; Matthew Paul,0,0,32,32
1681930633415,BICD 100,A01,191939,Cooper; Andrew Michael,27,0,32,5
1681930633415,BICD 100,A02,191940,Cooper; Andrew Michael,32,0,32,0
1681930633415,BICD 100,A03,191941,Cooper; Andrew Michael,32,0,32,0
1681930633415,BICD 100,A04,191942,Cooper; Andrew Michael,32,0,32,0
1681930633415,BICD 100,A05,191943,Cooper; Andrew Michael,32,0,32,0
1681930634439,BIEB 126,A01,191945,Cleland; Elsa Eleanor,0,4,32,32
1681930634439,BIEB 126,A02,191946,Cleland; Elsa Eleanor,26,0,32,6
1681930634439,BIEB 126,A03,191947,Cleland; Elsa Eleanor,29,0,32,3
1681930634439,BIEB 126,A04,191948,Cleland; Elsa Eleanor,17,0,32,15
1681930634439,BIEB 126,A05,191996,Cleland; Elsa Eleanor,28,0,32,4
1681930635465,BIEB 136GS,A00,191997,Shurin; Jonathan & Holway; David A.,0,0,0,9
1681930636491,BIEB 137GS,A01,191999,Shurin; Jonathan & Holway; David A.,0,0,0,8
1681930637517,BILD 1,A01,205385,Staff,30,0,32,2
1681930637517,BILD 1,A02,205386,Staff,30,0,32,2
1681930637517,BILD 1,A03,205387,Staff,31,0,32,1
1681930637517,BILD 1,A04,205388,Staff,25,0,32,7
1681930638540,BILD 2,A01,191774,Staff,27,0,32,5
1681930638540,BILD 2,A02,191775,Staff,30,0,32,2
1681930638540,BILD 2,A03,191777,Staff,30,0,32,2
1681930638540,BILD 2,A04,191856,Staff,30,0,32,2
1681930638540,BILD 2,A05,191857,Staff,31,0,32,1
1681930638540,BILD 2,A06,191858,Staff,32,0,32,0
1681930638540,BILD 2,A07,191859,Staff,31,0,32,1
1681930639564,BILD 3,A01,205391,Staff,27,0,32,5
1681930639564,BILD 3,A02,205393,Staff,32,0,32,0
1681930639564,BILD 3,A03,205394,Staff,27,0,32,5
1681930639564,BILD 3,A04,205395,Staff,32,0,32,0
1681930640587,BILD 20,A01,191861,Staff,32,0,32,0
1681930640587,BILD 20,A02,191862,Staff,32,0,32,0
1681930641625,BILD 30,A01,191864,Staff,31,0,32,1
1681930642648,BIMM 100,A01,192019,Staff,0,0,32,32
1681930642648,BIMM 100,A02,192020,Staff,17,0,32,15
1681930642648,BIMM 100,A03,192035,Staff,18,0,32,14
1681930643689,BIMM 110,A01,192037,Tat; John,0,0,32,32
1681930643689,BIMM 110,A02,192038,Tat; John,5,0,32,27
1681930644716,BIMM 120,A01,192040,Pickett; Brooke Elizabeth,0,0,32,32
1681930644716,BIMM 120,A02,192041,Pickett; Brooke Elizabeth,9,0,32,23
1681930644716,BIMM 120,A03,192042,Pickett; Brooke Elizabeth,13,0,32,19
1681930645752,BIPN 100,A01,192044,Armour; Jon Christopher,23,0,32,9
1681930645752,BIPN 100,A02,192059,Armour; Jon Christopher,30,0,32,2
1681930645752,BIPN 100,A03,192064,Armour; Jon Christopher,30,0,32,2
1681930645752,BIPN 100,A04,192073,Armour; Jon Christopher,26,0,32,6
1681930646776,BIPN 148,A01,205411,Leutgeb; Jill K.,14,0,32,18
1681930646776,BIPN 148,A02,205412,Leutgeb; Jill K.,31,0,32,1
1681930646776,BIPN 148,A03,205413,Leutgeb; Jill K.,30,0,32,2
1681930646776,BIPN 148,A04,205414,Leutgeb; Jill K.,30,0,32,2
1681930647804,BIPN 160,A01,192115,Marino; Marc J,15,0,32,17
1681930647804,BIPN 160,A02,192148,Marino; Marc J,27,0,32,5
1681930647804,BIPN 160,A03,192158,Marino; Marc J,31,0,32,1
1681930647804,BIPN 160,A04,192190,Marino; Marc J,32,0,32,0
1681930647804,BIPN 160,A05,192287,Marino; Marc J,32,0,32,0
1681930647804,BIPN 160,A06,192288,Marino; Marc J,32,0,32,0
1681930648835,BIPN 194,A00,206038,Leutgeb; Stefan,28,0,32,4
1681930649860,BISP 194,A00,192289,Nieh; James Charles,10,0,32,22
1681930649860,BISP 194,B00,245332,Staff,26,0,32,6
1681930650887,CAT 124,A01,202247,Staff,15,0,15,0
1681930651910,CAT 125,A00,202248,Staff,18,0,20,2
1681930651910,CAT 125,B00,202253,Staff,20,0,20,0
1681930651910,CAT 125,C00,202257,Staff,18,0,20,2
1681930652933,CAT 125GS,A01,202273,Bronstein; Phoebe Malan,20,0,20,0
1681930653974,CAT 125R,A00,202284,Staff,17,0,20,3
1681930653974,CAT 125R,C00,202286,Staff,5,0,20,15
1681930653974,CAT 125R,D00,202291,Staff,17,0,20,3
1681930653974,CAT 125R,E00,202295,Staff,13,0,20,7
1681930653974,CAT 125R,F00,202302,Staff,6,0,20,14
1681930654999,CENG 100,A00,204724,Opatkiewicz; Justin Paul,25,0,25,0
1681930656023,CGS 2A,A01,180420,Staff,30,0,36,6
1681930657049,CGS 101,A00,180421,Staff,15,0,20,5
1681930658071,CGS 112,A00,180422,Staff,9,0,16,7
1681930659096,CGS 113,A00,180423,Staff,18,0,20,2
1681930660122,CGS 137,A00,180424,Staff,12,0,12,0
1681930661144,CGS 147,A00,180425,Staff,10,0,10,0
1681930662172,CHEM 6A,A01,179556,Staff,92,0,100,8
1681930662172,CHEM 6A,A02,179558,Staff,0,0,0,0
1681930663195,CHEM 6B,A01,179560,Staff,100,0,100,0
1681930664217,CHEM 6C,A01,179565,Jazzar; Rodolphe,92,0,100,8
1681930665242,CHEM 7L,A01,179586,Schurmeier; Kimberly,10,0,24,14
1681930665242,CHEM 7L,A02,179587,Schurmeier; Kimberly,23,0,24,1
1681930665242,CHEM 7L,A03,179590,Schurmeier; Kimberly,22,0,24,2
1681930665242,CHEM 7L,A04,179591,Schurmeier; Kimberly,22,0,24,2
1681930665242,CHEM 7L,B01,179598,Schurmeier; Kimberly,15,0,24,9
1681930665242,CHEM 7L,B02,179599,Schurmeier; Kimberly,24,0,24,0
1681930665242,CHEM 7L,B03,179606,Schurmeier; Kimberly,22,0,24,2
1681930665242,CHEM 7L,B04,179607,Schurmeier; Kimberly,22,0,24,2
1681930666270,CHEM 11,A01,179609,Stallings; Dontarie M,87,0,100,13
1681930667306,CHEM 40A,A01,179621,Staff,38,0,50,12
1681930667306,CHEM 40A,A02,179622,Staff,46,0,50,4
1681930668329,CHEM 40B,A01,179630,Weizman; Haim,46,0,50,4
1681930668329,CHEM 40B,A02,179631,Weizman; Haim,43,0,50,7
1681930669353,CHEM 41A,A01,179660,Klosterman; Jeremy K,91,0,100,9
1681930670382,CHEM 43A,A01,179683,Klosterman; Jeremy K,0,0,24,24
1681930670382,CHEM 43A,A02,179688,Klosterman; Jeremy K,6,0,24,18
1681930670382,CHEM 43A,A03,179689,Klosterman; Jeremy K,17,0,24,7
1681930670382,CHEM 43A,A04,179691,Klosterman; Jeremy K,18,0,24,6
1681930671410,CHEM 114A,A01,179693,Stallings; Dontarie M,67,0,100,33
1681930672437,CHEM 143B,A01,179698,Weizman; Haim,16,0,24,8
1681930672437,CHEM 143B,A02,179700,Weizman; Haim,24,0,24,0
1681930673460,CHIN 169A,A00,179701,Wang; Xiao,20,0,20,0
1681930674492,COGS 2,A01,179750,Boyle; Mary E. T.,17,0,30,13
1681930675514,COGS 9,A01,179759,Jones; Cameron Robert,40,0,50,10
1681930676538,COGS 14A,A01,179854,Staff,11,0,50,39
1681930677570,COGS 14B,A01,179856,Staff,52,0,60,8
1681930678593,COGS 17,A01,179874,Staff,70,0,75,5
1681930679614,COGS 18,A01,179884,Staff,59,0,80,21
1681930680650,COGS 100,A01,179886,Staff,32,0,60,28
1681930681672,COGS 101B,A01,179892,Staff,0,2,30,30
1681930682699,COGS 101C,A01,179894,Staff,26,0,30,4
1681930683725,COGS 107A,A01,179896,Boyle; Mary E. T.,28,0,40,12
1681930684748,COGS 108,A01,179898,Simpkins; Charles Alexander,0,32,60,60
1681930685771,COGS 109,A01,179900,Staff,32,0,40,8
1681930686797,COGS 118A,A01,179946,Staff,5,0,40,35
1681930687829,COGS 153,A00,179978,Staff,0,6,30,30
1681930688858,COGS 156,A01,179981,Staff,21,0,30,9
1681930690905,COGS 172,A01,179987,Staff,10,0,30,20
1681930692958,COGS 186,A01,179991,Staff,11,0,30,19
1681930693981,COMM 10,A01,180001,Staff,11,0,25,14
1681930693981,COMM 10,A02,180004,Staff,20,0,25,5
1681930695006,COMM 100A,A01,180016,Staff,13,0,25,12
1681930695006,COMM 100A,A02,180020,Staff,24,0,25,1
1681930696029,COMM 101T,A00,180029,Halm; Gavin Patrick,19,0,35,16
1681930697053,COMM 106V,A00,180043,Staff,34,0,35,1
1681930698079,COMM 109P,A00,180044,Staff,30,0,35,5
1681930699105,COMM 113T,A00,180045,Havis; Allan,37,0,45,8
1681930700134,COMM 132,A00,180046,McKenna; Denise,20,0,30,10
1681930701158,COMM 143,A00,180047,Staff,16,0,30,14
1681930702181,COMM 190,A00,180048,Conner; Thomas Hartnell,16,0,23,7
1681930703203,CSE 8A,A50,180053,Cao; Yingjun,20,0,50,30
1681930703203,CSE 8A,B50,180180,Staff,50,0,50,0
1681930704225,CSE 11,A01,180190,Cao; Yingjun,21,0,50,29
1681930705252,CSE 20,A01,180192,Briones; Jor-el Thomas Caparas,21,0,30,9
1681930706284,CSE 21,A01,194538,Briones; Jor-el Thomas Caparas,49,0,60,11
1681930707314,CSE 30,A01,180324,Eldon; John,73,0,100,27
1681930708337,CSE 101,A01,201353,Staff,0,30,40,40
1681930709364,CSE 134B,A01,180326,Powell; Thomas Allan,73,0,100,27
1681930710459,CSE 140,A01,180328,Staff,23,0,75,52
1681930711481,CSE 140L,A01,180344,Eldon; John,48,0,100,52
1681930712505,CSE 150A,A01,180411,Staff,0,19,50,50
1681930713531,CSE 151A,A01,180414,Staff,0,14,50,50
1681930714563,CSE 175,A01,222521,Kumar; Rakesh,50,0,50,0
1681930715585,CSE 190,A00,201419,Staff,42,0,49,7
1681930716609,CSS 1,A01,194536,Staff,32,0,50,18
1681930717632,DSC 30,A01,202385,Staff,48,0,50,2
1681930718655,DSC 40A,A01,202387,Albuyeh; Rod,50,0,50,0
1681930719682,DSC 190,A01,202389,Silberman; Jack,21,0,21,0
1681930720715,DSGN 100,A01,179993,Staff,13,0,30,17
1681930721745,ECE 65,A50,180708,Staff,10,0,20,10
1681930721745,ECE 65,A51,180739,Staff,19,0,20,1
1681930722767,ECON 1,A01,180427,Famulari; Melissa,66,0,70,4
1681930723793,ECON 2,A01,180450,Levkoff; Steven B.,64,0,70,6
1681930724823,ECON 4,A01,203351,Anderson; John Charles,6,0,10,4
1681930725844,ECON 100A,A01,180472,Famulari; Melissa,59,0,70,11
1681930726866,ECON 120A,A01,180549,Staff,62,0,70,8
1681930727892,ECON 120B,A01,180655,Ma; Xinwei,38,0,70,32
1681930728914,ECON 129,A00,203333,Eckert; Fabian Paul,10,0,35,25
1681930729939,ECON 131,A00,180656,Staff,1,0,35,34
1681930730962,ECON 172B,A01,180672,Levkoff; Steven B.,31,0,35,4
1681930731984,ECON 178,A01,203342,Zhu; Ying,3,0,35,32
1681930733007,EDS 108GS,A00,202383,Wishard Guerra; Alison G.,20,0,20,0
1681930734032,EDS 111GS,A00,202347,Wishard Guerra; Alison G.,20,0,20,0
1681930735054,EDS 112,A01,202323,Staff,53,0,60,7
1681930736085,EDS 113,A00,202340,Staff,32,0,35,3
1681930737114,EDS 118,A00,201231,Staff,19,0,30,11
1681930738140,EDS 119,A00,204994,Staff,8,0,10,2
1681930739168,EDS 124BR,A00,202324,Eguchi; Emi,0,1,25,25
1681930740194,EDS 126,A01,203208,Jones; Makeba,26,0,30,4
1681930741220,EDS 135,A01,202333,Staff,17,0,20,3
1681930742251,EDS 180,A00,202311,Staff,47,0,50,3
1681930743277,ERC 190GS,A01,253747,Staff,28,0,28,0
1681930744317,ETHN 104,A00,180742,Staff,21,0,35,14
1681930745340,ETHN 118,A00,180745,Staff,26,0,35,9
1681930746365,ETHN 127,A00,180747,Staff,8,0,16,8
1681930747399,ETHN 137,A00,180880,Staff,11,0,12,1
1681930748434,ETHN 147,A00,180890,Staff,8,0,10,2
1681930749459,ETHN 154,A00,180891,Staff,6,0,8,2
1681930750489,ETHN 168,A00,180892,Staff,9,0,10,1
1681930751513,GLBH 20,A00,201051,Hannah; Seth Donal,0,6,0,1
1681930752541,GLBH 111,A01,209338,Burgos; Jose L.,0,0,0,0
1681930753563,GLBH 150,A00,258300,Staff,0,4,0,0
1681930754588,GLBH 181,A00,201207,Staff,7,0,40,33
1681930755612,HIEU 109,A00,180898,Staff,19,0,20,1
1681930756636,HIEU 111,A00,180899,Staff,0,2,20,20
1681930757663,HIEU 124,A00,180900,Staff,17,0,20,3
1681930758686,HILA 122,A00,180901,Staff,17,0,20,3
1681930759712,HILA 132,A00,180902,Vitz; Matthew,0,2,20,20
1681930760735,HILD 10,A01,180896,Staff,12,0,20,8
1681930761759,HILD 30GS,A00,180897,Edington; Claire Ellen,0,0,0,0
1681930762783,HISC 105,A00,180903,Staff,20,0,20,0
1681930763809,HISC 117,A00,180904,Staff,10,0,20,10
1681930764833,HIUS 108B,A00,181005,Staff,18,0,20,2
1681930765856,HIUS 113,A00,181093,Staff,1,0,20,19
1681930766894,HUM 3,A01,181190,Patterson; Patrick H.,35,0,50,15
1681930766894,HUM 3,B01,181195,Staff,45,0,50,5
1681930767924,HUM 3GS,A00,181196,Herbst; Matthew,0,0,0,0
1681930768948,HUM 4,A01,181227,West; Geoffrey Scott,33,0,50,17
1681930768948,HUM 4,B01,181282,Staff,41,0,50,9
1681930769977,HUM 4GS,A00,181377,Lyon; Antony J.,0,0,0,0
1681930771001,HUM 5,A01,181536,Zavodny; Tatiana Sophia,25,0,50,25
1681930771001,HUM 5,B01,181908,Staff,33,0,50,17
1681930772028,INTL 190,A00,181909,Segui; Alan S,0,0,0,8
1681930772028,INTL 190,B00,181961,Segui; Alan S,0,0,0,7
1681930773056,JAPN 20AR,A01,182113,Ross; Kayoko F,15,0,20,5
1681930774083,LATI 50,A01,202391,Martin-Cabrera; Luis,17,0,30,13
1681930774083,LATI 50,A02,202392,Martin-Cabrera; Luis,26,0,30,4
1681930775109,LATI 180,A00,202393,Kokinis; Troy Andreas,24,0,25,1
1681930776139,LIFR 1A,A00,182119,Staff,13,0,14,1
1681930777161,LIFR 1AX,A00,182324,Staff,13,0,14,1
1681930778186,LIFR 1B,A00,182259,Staff,12,0,14,2
1681930779209,LIFR 1BX,A00,182273,Staff,12,0,14,2
1681930780232,LIGN 8,A00,182330,Staff,127,0,150,23
1681930781254,LIGN 9GS,A00,182362,Staff,14,0,20,6
1681930782281,LIGN 119,A00,204992,Takahashi; Maho,11,0,15,4
1681930783304,LIGN 130,A01,182384,Staff,47,0,50,3
1681930784328,LIGN 149GS,A00,182390,Staff,14,0,20,6
1681930785353,LIGN 170,A00,182404,Staff,23,0,30,7
1681930786376,LISP 1D,A00,182281,Staff,7,0,14,7
1681930786376,LISP 1D,B00,182287,Staff,13,0,14,1
1681930786376,LISP 1D,C00,182295,Staff,10,0,14,4
1681930786376,LISP 1D,D00,182301,Staff,14,0,14,0
1681930787401,LISP 1DX,A00,182309,Staff,19,0,28,9
1681930787401,LISP 1DX,B00,182316,Staff,25,0,28,3
1681930788424,LTAF 120GS,A00,182412,Zhiri; Oumelbanine,20,0,20,0
1681930789448,LTCS 172GS,A00,182437,Bronstein; Phoebe Malan,20,0,20,0
1681930790478,LTEA 138,A00,182457,Staff,18,0,40,22
1681930791501,LTEN 114,A01,182490,Staff,23,0,25,2
1681930792525,LTEN 130GS,A00,182491,Lyon; Antony J.,20,0,20,0
1681930793548,LTEN 169,A00,182493,Cuong; Marisol,17,0,25,8
1681930794570,LTEN 178,A00,182501,Staff,14,0,15,1
1681930795593,LTEN 181,A00,182515,Staff,19,0,25,6
1681930796615,LTEN 185GS,A00,197655,Forbes; Camille,20,0,20,0
1681930797638,LTSP 100B,A00,202208,Bessett; Ryan Matthew,24,0,25,1
1681930798660,LTWL 100,A00,182516,Myerston Santana; Jacobo,20,0,30,10
1681930799685,LTWR 100GS,A00,182518,Forbes; Camille,20,0,20,0
1681930800726,LTWR 102,A00,182522,Staff,15,0,15,0
1681930800726,LTWR 102,B00,182525,Staff,14,0,15,1
1681930801750,LTWR 115,A00,182526,Staff,10,0,15,5
1681930802776,MAE 8,A01,182528,Pham; Hieu Tan,67,0,70,3
1681930803798,MAE 11,A00,182529,Bahadori; Mohammad Yousef,91,0,100,9
1681930804826,MAE 20,A00,182530,Evdokimenko; Ekaterina,67,0,70,3
1681930805848,MAE 30A,A00,182532,Staff,44,0,45,1
1681930806870,MAE 101A,A00,182533,Bahadori; Mohammad Yousef,94,0,100,6
1681930807893,MAE 101C,A00,182538,Staff,62,0,70,8
1681930808916,MAE 104,A00,182539,Staff,44,0,50,6
1681930809942,MAE 131A,A00,182540,Ghazinejad; Maziar,40,0,45,5
1681930810968,MAE 143A,A00,182548,Bewley; Thomas R,42,0,50,8
1681930811996,MAE 150,A00,182549,Staff,28,0,40,12
1681930813020,MAE 160,A00,182550,Evdokimenko; Ekaterina,41,0,60,19
1681930814120,MATH 3C,A01,182725,Staff,24,0,30,6
1681930815153,MATH 10A,A01,182729,Staff,24,0,30,6
1681930815153,MATH 10A,B01,182732,Staff,25,0,30,5
1681930816181,MATH 10B,A01,182737,Staff,16,0,30,14
1681930816181,MATH 10B,A02,182738,Staff,24,0,30,6
1681930816181,MATH 10B,B01,182744,Staff,25,0,30,5
1681930816181,MATH 10B,B02,182745,Staff,27,0,30,3
1681930817210,MATH 18,A01,182750,Anzaldo; Leesa B,28,0,30,2
1681930817210,MATH 18,A02,182751,Anzaldo; Leesa B,28,0,30,2
1681930817210,MATH 18,A03,182753,Anzaldo; Leesa B,27,0,30,3
1681930817210,MATH 18,A04,182757,Anzaldo; Leesa B,29,0,30,1
1681930817210,MATH 18,B01,182761,Anzaldo; Leesa B,27,0,30,3
1681930817210,MATH 18,B02,182764,Anzaldo; Leesa B,26,0,30,4
1681930817210,MATH 18,B03,182765,Anzaldo; Leesa B,29,0,30,1
1681930817210,MATH 18,B04,182766,Anzaldo; Leesa B,30,0,30,0
1681930818236,MATH 20A,A01,182771,Suk; Andrew Hoon,28,0,30,2
1681930819260,MATH 20B,A01,182775,Bach; Quang Tran,30,0,30,0
1681930819260,MATH 20B,A02,182777,Bach; Quang Tran,29,0,30,1
1681930819260,MATH 20B,B01,182780,Bach; Quang Tran,26,0,30,4
1681930819260,MATH 20B,B02,182782,Bach; Quang Tran,30,0,30,0
1681930820282,MATH 20C,A01,182787,Staff,24,0,30,6
1681930820282,MATH 20C,A02,182790,Staff,29,0,30,1
1681930820282,MATH 20C,B01,182792,Staff,23,0,30,7
1681930820282,MATH 20C,B02,182796,Staff,26,0,30,4
1681930821306,MATH 20D,A01,182799,Staff,27,0,30,3
1681930821306,MATH 20D,A02,182802,Staff,29,0,30,1
1681930821306,MATH 20D,A03,182803,Staff,30,0,30,0
1681930822332,MATH 20E,A01,182809,Verstraete; Jacques Allan,20,0,30,10
1681930822332,MATH 20E,A02,182811,Verstraete; Jacques Allan,28,0,30,2
1681930822332,MATH 20E,B01,182814,Verstraete; Jacques Allan,21,0,30,9
1681930822332,MATH 20E,B02,182815,Verstraete; Jacques Allan,29,0,30,1
1681930823360,MATH 103A,A01,182820,Staff,3,0,30,27
1681930823360,MATH 103A,A02,182821,Staff,27,0,30,3
1681930823360,MATH 103A,A03,182822,Staff,21,0,30,9
1681930823360,MATH 103A,B01,182825,Staff,21,0,30,9
1681930823360,MATH 103A,B02,182826,Staff,30,0,30,0
1681930823360,MATH 103A,B03,182830,Staff,30,0,30,0
1681930824385,MATH 109,A01,182836,Chow; Bennett,23,0,30,7
1681930824385,MATH 109,A02,182838,Chow; Bennett,28,0,30,2
1681930824385,MATH 109,A03,182894,Chow; Bennett,29,0,30,1
1681930824385,MATH 109,B01,182908,Chow; Bennett,27,0,30,3
1681930824385,MATH 109,B02,182909,Chow; Bennett,30,0,30,0
1681930824385,MATH 109,B03,182910,Chow; Bennett,26,0,30,4
1681930825409,MATH 142A,A01,182925,Staff,3,0,30,27
1681930825409,MATH 142A,A02,182935,Staff,23,0,30,7
1681930825409,MATH 142A,A03,182967,Staff,25,0,30,5
1681930825409,MATH 142A,B01,183125,Staff,22,0,30,8
1681930825409,MATH 142A,B02,183157,Staff,26,0,30,4
1681930825409,MATH 142A,B03,183158,Staff,29,0,30,1
1681930826437,MATH 183,A01,183160,Arias-Castro; Ery,22,0,30,8
1681930826437,MATH 183,A02,183161,Arias-Castro; Ery,29,0,30,1
1681930826437,MATH 183,B01,183163,Arias-Castro; Ery,26,0,30,4
1681930826437,MATH 183,B02,183164,Arias-Castro; Ery,28,0,30,2
1681930827474,MATH 193A,A01,183167,Staff,0,0,35,35
1681930827474,MATH 193A,A02,183168,Staff,23,0,35,12
1681930827474,MATH 193A,A03,183169,Staff,34,0,35,1
1681930827474,MATH 193A,A04,183170,Staff,26,0,35,9
1681930828501,MGT 4,A01,202395,Anderson; John Charles,76,0,80,4
1681930829523,MGT 5,A00,202396,Houskeeper; Robert,79,0,90,11
1681930830546,MGT 103,A00,202397,Eberhard; Craig A,49,0,90,41
1681930831571,MGT 131A,A00,202398,Houskeeper; Robert,81,0,90,9
1681930832594,MGT 135,A00,202399,Anderson; John Charles,81,0,90,9
1681930833618,MGT 162R,A00,202403,Gneezy; Uri,122,0,200,78
1681930834641,MGT 172,A00,202404,Hedges; Kathleen,29,0,90,61
1681930835666,MGT 181,A00,202405,Dunn; Louis Jean,79,0,90,11
1681930836690,MMW 14,A01,183200,Staff,0,0,28,28
1681930836690,MMW 14,A02,183201,Staff,25,0,28,3
1681930836690,MMW 14,A03,183202,Staff,24,0,28,4
1681930836690,MMW 14,A04,183203,Staff,25,0,28,3
1681930836690,MMW 14,A05,183204,Staff,26,0,28,2
1681930836690,MMW 14,A06,183205,Staff,27,0,28,1
1681930836690,MMW 14,B01,183207,Staff,26,0,28,2
1681930836690,MMW 14,B02,183208,Staff,28,0,28,0
1681930836690,MMW 14,B03,183209,Staff,28,0,28,0
1681930836690,MMW 14,B04,183210,Staff,28,0,28,0
1681930836690,MMW 14,B05,183211,Staff,28,0,28,0
1681930836690,MMW 14,B06,183212,Staff,27,0,28,1
1681930837713,MMW 14GS,A00,183213,Zhiri; Oumelbanine,28,0,28,0
1681930838739,MMW 15GS,B00,183215,Rahimi; Babak,28,0,28,0
1681930839766,MMW 121,A01,183217,Patterson; Patrick H.,8,0,28,20
1681930839766,MMW 121,A02,183218,Patterson; Patrick H.,25,0,28,3
1681930840790,MUS 1A,A01,182554,Staff,0,0,35,35
1681930841821,MUS 5,A01,182558,Staff,17,0,35,18
1681930842844,MUS 6,A01,182562,Staff,22,0,35,13
1681930843869,MUS 8GS,A00,182563,Borgo; David Garcia,25,0,25,0
1681930844901,MUS 13,A01,182567,Staff,23,0,25,2
1681930845924,MUS 15,A01,182570,Staff,31,0,35,4
1681930845924,MUS 15,B01,182575,Staff,7,0,35,28
1681930846954,MUS 80,A00,182578,Staff,22,0,25,3
1681930846954,MUS 80,B00,182581,Staff,20,0,25,5
1681930847977,MUS 113,A00,182582,Staff,25,0,25,0
1681930849005,MUS 114,A00,182583,Staff,1,0,25,24
1681930850029,MUS 150GS,A01,182588,Borgo; David Garcia,24,0,25,1
1681930851055,PHIL 1,A00,182590,Staff,34,0,40,6
1681930852082,PHIL 10,A01,182596,Grush; Rick Scott,30,0,35,5
1681930852082,PHIL 10,A02,182597,Grush; Rick Scott,33,0,35,2
1681930853103,PHIL 15,A01,182601,Staff,31,0,35,4
1681930853103,PHIL 15,A02,182602,Staff,33,0,35,2
1681930854130,PHIL 27,A01,182604,Staff,25,0,35,10
1681930854130,PHIL 27,A02,182607,Staff,35,0,35,0
1681930855157,PHIL 32,A01,182609,Staff,35,0,35,0
1681930855157,PHIL 32,A02,182612,Staff,35,0,35,0
1681930856183,PHIL 130,A00,182614,Staff,57,0,70,13
1681930857207,PHIL 136,A00,182616,Cohen; Jonathan David,64,0,70,6
1681930858234,PHIL 155,A00,182617,Vargas; Manuel Rogelio,57,0,70,13
1681930859262,PHIL 163,A01,182620,Staff,15,0,20,5
1681930859262,PHIL 163,A02,182624,Staff,10,0,20,10
1681930860298,PHIL 164,A00,182627,Staff,29,0,40,11
1681930861409,PHIL 173,A00,182628,Staff,35,0,40,5
1681930862450,PHYS 1A,A00,183221,Staff,53,0,60,7
1681930863474,PHYS 1AL,001,183222,Staff,25,0,30,5
1681930863474,PHYS 1AL,002,183223,Staff,24,0,30,6
1681930864530,PHYS 1B,A00,183231,Staff,40,0,60,20
1681930865571,PHYS 1BL,001,183232,Staff,15,0,30,15
1681930865571,PHYS 1BL,002,183233,Staff,27,0,30,3
1681930866594,PHYS 1C,A00,183240,Staff,21,0,60,39
1681930867617,PHYS 1CL,001,183241,Staff,8,0,30,22
1681930867617,PHYS 1CL,002,183242,Staff,22,0,30,8
1681930868646,PHYS 2AR,A01,183250,Staff,39,0,50,11
1681930869674,PHYS 2B,A01,183252,Staff,102,0,115,13
1681930870699,PHYS 2BL,A01,183254,Staff,21,0,24,3
1681930870699,PHYS 2BL,A02,183255,Staff,21,0,24,3
1681930871721,PHYS 2C,A01,183522,Staff,100,0,115,15
1681930872744,PHYS 4A,A01,183524,Staff,49,0,50,1
1681930873767,POLI 5,A00,183525,Staff,44,0,50,6
1681930874796,POLI 12,A00,183540,Staff,45,0,50,5
1681930875821,POLI 13R,A00,183541,Forman; Fonna,40,0,50,10
1681930876848,POLI 30,A00,183542,Mignozzetti; Umberto,48,0,50,2
1681930877872,POLI 100A,A00,183543,Staff,44,0,50,6
1681930878899,POLI 100E,A00,223598,Staff,32,0,35,3
1681930879924,POLI 103A,A00,183564,Kousser; Thad,35,0,50,15
1681930880951,POLI 104B,A00,201329,Staff,28,0,35,7
1681930881980,POLI 113BR,A00,183576,Hoston; Germaine,22,0,50,28
1681930883007,POLI 114BR,A00,183588,Staff,27,0,30,3
1681930884034,POLI 117R,A00,183595,Forman; Fonna,3,0,20,17
1681930885057,POLI 120H,A00,183596,Fisk; David Lee,14,0,20,6
1681930886081,POLI 130AA,A00,183597,Staff,13,0,20,7
1681930887107,POLI 134AA,A00,183598,Staff,19,0,20,1
1681930888139,POLI 135,A00,183599,Fisk; David Lee,19,0,25,6
1681930889162,POLI 142P,A00,183623,Staff,37,0,40,3
1681930890191,POLI 144D,A00,183624,Staff,22,0,25,3
1681930891227,POLI 151,A00,183625,Staff,15,0,20,5
1681930892250,POLI 162,A00,183626,Mignozzetti; Umberto,17,0,20,3
1681930893274,PSYC 1,A00,253748,Staff,85,0,90,5
1681930894297,PSYC 2,A00,183627,Moranton; Nirelia Melbina-,23,0,35,12
1681930895319,PSYC 3,A00,183628,Staff,43,0,45,2
1681930897373,PSYC 60,A01,183631,Lowe; Angela Beth,35,0,40,5
1681930898403,PSYC 70,A01,253757,Staff,36,0,45,9
1681930899425,PSYC 101,A00,183632,Heyman; Gail D.,42,0,60,18
1681930900447,PSYC 105,A00,183848,Lowe; Angela Beth,46,0,60,14
1681930901470,PSYC 106,A00,183849,Dobkins; Karen R.,39,0,60,21
1681930902495,PSYC 108,A00,253750,Staff,12,0,60,48
1681930903521,PSYC 114,A01,184275,Winkielman; Piotr,0,8,30,30
1681930904543,PSYC 122,A00,183856,Moranton; Nirelia Melbina-,0,16,30,30
1681930905569,PSYC 124,A00,183865,Chapman; Eddie Nathaniel,43,0,80,37
1681930906592,PSYC 137,A00,183880,Staff,17,0,25,8
1681930908640,PSYC 154,A00,183910,Lacefield; Katharine I,0,30,90,90
1681930910692,PSYC 162,A00,183946,Wixted; John T,38,0,90,52
1681930911721,PSYC 172,A00,183947,Gorman; Michael R.,5,0,30,25
1681930912747,PSYC 178,A00,183963,Glaser; Dale,14,0,40,26
1681930913773,PSYC 181GS,A00,183964,Anagnostaras; Stephan,10,0,10,0
1681930914796,PSYC 186GS,A01,257660,Staff,10,0,10,0
1681930915824,PSYC 193,B00,253749,Staff,22,0,25,3
1681930917954,PSYC 193L,A01,184122,Staff,33,0,35,2
1681930917954,PSYC 193L,C01,184167,Winkielman; Piotr,14,0,30,16
1681930918983,RELI 188GS,A00,182629,Rahimi; Babak,20,0,20,0
1681930920014,SE 101A,A00,182646,Staff,26,0,30,4
1681930921037,SE 101C,A00,182650,Staff,12,0,20,8
1681930922065,SE 110A,A00,182651,Staff,28,0,28,0
1681930923091,SE 130A,A00,182652,Staff,38,0,40,2
1681930924125,SIO 46GS,A00,182636,Cook; Geoffrey W,25,0,28,3
1681930925147,SIO 109R,A00,194459,Staff,0,1,20,20
1681930926169,SIO 121GS,A00,182639,Cook; Geoffrey W,25,0,28,3
1681930927194,SIO 132,A01,182642,Staff,30,0,40,10
1681930928217,SIO 139,A00,182644,Kacev; David,36,0,40,4
1681930929243,SOCI 2,A01,258404,Staff,33,0,36,3
1681930929243,SOCI 2,A02,258405,Staff,35,0,36,1
1681930930273,SOCI 60,A01,258408,Staff,29,0,30,1
1681930930273,SOCI 60,A02,258413,Staff,30,0,30,0
1681930931295,SOCI 100,A01,258415,Staff,29,0,30,1
1681930931295,SOCI 100,A02,258416,Staff,28,0,30,2
1681930937445,SOCI 127,A00,258421,Staff,19,0,30,11
1681930938468,SOCI 132,A00,258422,Staff,43,0,50,7
1681930939493,SOCI 133,A00,258423,Staff,26,0,30,4
1681930940527,SOCI 138GS,A00,258424,Staff,15,0,15,0
1681930941553,SOCI 145,A00,258425,Staff,23,0,30,7
1681930942587,SOCI 148,A00,258426,Staff,23,0,30,7
1681930943611,SOCI 153,A00,199217,Staff,29,0,30,1
1681930944643,SOCI 160,A00,258427,Staff,27,0,30,3
1681930945670,SOCI 160E,A00,258435,Staff,55,0,60,5
1681930946695,SOCI 189GS,A00,258436,Staff,15,0,15,0
1681930947729,SOCI 190GS,A00,258437,Staff,15,0,15,0
1681930948772,SYN 2,001,182658,Staff,8,0,16,8
1681930948772,SYN 2,002,201439,Staff,14,0,16,2
1681930948772,SYN 2,003,201443,Staff,16,0,16,0
1681930949798,SYN 100,A01,182657,Staff,13,0,20,7
1681930950834,TDAC 1,A00,184381,Salovey; Todd,16,0,20,4
1681930950834,TDAC 1,B00,184385,Harting; Carla Kelso,19,0,20,1
1681930950834,TDAC 1,C00,184394,Staff,18,0,20,2
1681930951856,TDAC 101,A00,184483,Harting; Carla Kelso,19,0,20,1
1681930952883,TDDE 111,A00,184496,Staff,14,0,15,1
1681930953907,TDDE 131,A00,184504,Staff,20,0,20,0
1681930953907,TDDE 131,B00,184505,Staff,17,0,18,1
1681930953907,TDDE 131,C00,184534,Staff,49,0,50,1
1681930953907,TDDE 131,D00,184564,Staff,15,0,15,0
1681930953907,TDDE 131,E00,204725,Staff,18,0,20,2
1681930954929,TDGE 1,A01,184414,Salovey; Todd,35,0,50,15
1681930955954,TDGE 5,A01,184419,Staff,23,0,24,1
1681930956978,TDGE 10,A00,184428,Fulton; Julia,27,0,50,23
1681930958000,TDGE 124,A00,184565,Fulton; Julia,0,2,50,50
1681930959027,TDGE 125,B00,184567,Meyer; Ursula,8,0,25,17
1681930960058,TDHT 101,A00,184568,Staff,21,0,25,4
1681930960058,TDHT 101,B00,184569,Staff,20,0,20,0
1681930961083,TDHT 114,A00,184570,Staff,49,0,50,1
1681930962109,TDMV 1,A00,184437,Arcidiacono; Kristin,21,0,30,9
1681930962109,TDMV 1,B00,184448,Caligagan; Maria T.,23,0,30,7
1681930963131,TDMV 2,A00,184449,Weinberg; Sadie,26,0,30,4
1681930963131,TDMV 2,B00,184453,Arcidiacono; Kristin,29,0,30,1
1681930964158,TDMV 110,A00,184571,Weinberg; Sadie,30,0,30,0
1681930965190,TDMV 142,A00,184572,Caligagan; Tony,26,0,30,4
1681930965190,TDMV 142,B00,184573,Caligagan; Maria T.,26,0,30,4
1681930966212,TDTR 20,A00,184482,Jun; Grace Shin Hae,25,0,25,0
1681930967238,USP 2,A01,184290,Hinds; Juli Beth,23,0,25,2
1681930968260,USP 3,A01,184295,Staff,20,0,25,5
1681930969287,USP 4,A00,184304,McTague; Sarah,13,0,25,12
1681930970318,USP 100,A00,184315,Staff,16,0,25,9
1681930971345,USP 105,A00,184326,Staff,21,0,25,4
1681930972372,USP 151,A00,184327,Staff,17,0,25,8
1681930973398,USP 170,A00,184380,Hinds; Juli Beth,12,0,25,13
1681930974426,VIS 21B,A01,182660,Staff,28,0,31,3
1681930974426,VIS 21B,A02,182662,Staff,30,0,31,1
1681930975457,VIS 103D,A00,182663,Staff,74,0,75,1
1681930976481,VIS 105D,A00,182667,Li; Huai,14,0,22,8
1681930977511,VIS 122GS,A00,182668,Herbst; Matthew,20,0,20,0
1681930978534,VIS 128C,A00,182673,Staff,69,0,75,6
1681930979559,VIS 130,A00,182675,Staff,19,0,22,3
1681930980583,VIS 160A,A00,182678,Stalbaum; Brett,4,0,10,6
1681930982629,WCWP 10B,A00,201679,Staff,15,0,15,0
1681930982629,WCWP 10B,B00,201695,Staff,15,0,15,0
1681930983657,WCWP 100,A00,201716,Staff,12,0,15,3
1681930983657,WCWP 100,B00,201717,Staff,1,0,15,14
1681930985754,ANSC 105GS,A00,258289,Staff,0,0,0,0
1681930986784,ANSC 125GS,A00,258295,Staff,0,0,0,0
1681930987814,ANSC 150,A00,258267,Staff,27,0,40,13
1681930988844,ANSC 190GS,A00,258280,Staff,0,0,0,2
1681930989869,ANTH 1,A00,258264,Staff,38,0,40,2
1681930990900,ANTH 2,A01,258259,Staff,72,0,76,4
1681930991923,ANTH 23,A01,258228,Staff,35,0,40,5
1681930992949,ANTH 101,A01,258236,Staff,38,0,40,2
1681930993975,ANTH 102,A00,258272,Staff,59,0,60,1
1681930994999,ANTH 105,A00,258244,Staff,28,0,35,7
1681930996023,BENG 130,A00,253975,Staff,37,0,40,3
1681930997047,BIBC 102,A01,191866,Flagg; Matthew Paul,16,0,32,16
1681930997047,BIBC 102,A02,191867,Flagg; Matthew Paul,21,0,32,11
1681930997047,BIBC 102,A03,191868,Flagg; Matthew Paul,28,0,32,4
1681930997047,BIBC 102,A04,191936,Flagg; Matthew Paul,22,0,32,10
1681930997047,BIBC 102,A05,191937,Flagg; Matthew Paul,0,0,32,32
1681930998075,BICD 100,A01,191939,Cooper; Andrew Michael,27,0,32,5
1681930998075,BICD 100,A02,191940,Cooper; Andrew Michael,32,0,32,0
1681930998075,BICD 100,A03,191941,Cooper; Andrew Michael,32,0,32,0
1681930998075,BICD 100,A04,191942,Cooper; Andrew Michael,32,0,32,0
1681930998075,BICD 100,A05,191943,Cooper; Andrew Michael,32,0,32,0
1681930999099,BIEB 126,A01,191945,Cleland; Elsa Eleanor,0,5,32,32
1681930999099,BIEB 126,A02,191946,Cleland; Elsa Eleanor,26,0,32,6
1681930999099,BIEB 126,A03,191947,Cleland; Elsa Eleanor,29,0,32,3
1681930999099,BIEB 126,A04,191948,Cleland; Elsa Eleanor,17,0,32,15
1681930999099,BIEB 126,A05,191996,Cleland; Elsa Eleanor,28,0,32,4
1681931000125,BIEB 136GS,A00,191997,Shurin; Jonathan & Holway; David A.,0,0,0,9
1681931001156,BIEB 137GS,A01,191999,Shurin; Jonathan & Holway; David A.,0,0,0,8
1681931002192,BILD 1,A01,205385,Staff,30,0,32,2
1681931002192,BILD 1,A02,205386,Staff,30,0,32,2
1681931002192,BILD 1,A03,205387,Staff,31,0,32,1
1681931002192,BILD 1,A04,205388,Staff,25,0,32,7
1681931003229,BILD 2,A01,191774,Staff,27,0,32,5
1681931003229,BILD 2,A02,191775,Staff,30,0,32,2
1681931003229,BILD 2,A03,191777,Staff,30,0,32,2
1681931003229,BILD 2,A04,191856,Staff,30,0,32,2
1681931003229,BILD 2,A05,191857,Staff,31,0,32,1
1681931003229,BILD 2,A06,191858,Staff,32,0,32,0
1681931003229,BILD 2,A07,191859,Staff,31,0,32,1
1681931004258,BILD 3,A01,205391,Staff,27,0,32,5
1681931004258,BILD 3,A02,205393,Staff,32,0,32,0
1681931004258,BILD 3,A03,205394,Staff,27,0,32,5
1681931004258,BILD 3,A04,205395,Staff,32,0,32,0
1681931005283,BILD 20,A01,191861,Staff,32,0,32,0
1681931005283,BILD 20,A02,191862,Staff,32,0,32,0
1681931006310,BILD 30,A01,191864,Staff,31,0,32,1
1681931007334,BIMM 100,A01,192019,Staff,0,0,32,32
1681931007334,BIMM 100,A02,192020,Staff,17,0,32,15
1681931007334,BIMM 100,A03,192035,Staff,17,0,32,15
1681931008360,BIMM 110,A01,192037,Tat; John,0,0,32,32
1681931008360,BIMM 110,A02,192038,Tat; John,5,0,32,27
1681931009385,BIMM 120,A01,192040,Pickett; Brooke Elizabeth,0,0,32,32
1681931009385,BIMM 120,A02,192041,Pickett; Brooke Elizabeth,7,0,32,25
1681931009385,BIMM 120,A03,192042,Pickett; Brooke Elizabeth,13,0,32,19
1681931010411,BIPN 100,A01,192044,Armour; Jon Christopher,23,0,32,9
1681931010411,BIPN 100,A02,192059,Armour; Jon Christopher,30,0,32,2
1681931010411,BIPN 100,A03,192064,Armour; Jon Christopher,30,0,32,2
1681931010411,BIPN 100,A04,192073,Armour; Jon Christopher,26,0,32,6
1681931011441,BIPN 148,A01,205411,Leutgeb; Jill K.,14,0,32,18
1681931011441,BIPN 148,A02,205412,Leutgeb; Jill K.,31,0,32,1
1681931011441,BIPN 148,A03,205413,Leutgeb; Jill K.,29,0,32,3
1681931011441,BIPN 148,A04,205414,Leutgeb; Jill K.,30,0,32,2
1681931012469,BIPN 160,A01,192115,Marino; Marc J,15,0,32,17
1681931012469,BIPN 160,A02,192148,Marino; Marc J,27,0,32,5
1681931012469,BIPN 160,A03,192158,Marino; Marc J,31,0,32,1
1681931012469,BIPN 160,A04,192190,Marino; Marc J,32,0,32,0
1681931012469,BIPN 160,A05,192287,Marino; Marc J,32,0,32,0
1681931012469,BIPN 160,A06,192288,Marino; Marc J,32,0,32,0
1681931013495,BIPN 194,A00,206038,Leutgeb; Stefan,28,0,32,4
1681931014523,BISP 194,A00,192289,Nieh; James Charles,10,0,32,22
1681931014523,BISP 194,B00,245332,Staff,26,0,32,6
1681931015548,CAT 124,A01,202247,Staff,15,0,15,0
1681931016572,CAT 125,A00,202248,Staff,18,0,20,2
1681931016572,CAT 125,B00,202253,Staff,20,0,20,0
1681931016572,CAT 125,C00,202257,Staff,18,0,20,2
1681931017597,CAT 125GS,A01,202273,Bronstein; Phoebe Malan,20,0,20,0
1681931018621,CAT 125R,A00,202284,Staff,17,0,20,3
1681931018621,CAT 125R,C00,202286,Staff,5,0,20,15
1681931018621,CAT 125R,D00,202291,Staff,17,0,20,3
1681931018621,CAT 125R,E00,202295,Staff,13,0,20,7
1681931018621,CAT 125R,F00,202302,Staff,6,0,20,14
1681931019645,CENG 100,A00,204724,Opatkiewicz; Justin Paul,25,0,25,0
1681931020667,CGS 2A,A01,180420,Staff,30,0,36,6
1681931021784,CGS 101,A00,180421,Staff,15,0,20,5
1681931022809,CGS 112,A00,180422,Staff,8,0,16,8
1681931023831,CGS 113,A00,180423,Staff,18,0,20,2
1681931024854,CGS 137,A00,180424,Staff,12,0,12,0
1681931025879,CGS 147,A00,180425,Staff,10,0,10,0
1681931026901,CHEM 6A,A01,179556,Staff,92,0,100,8
1681931026901,CHEM 6A,A02,179558,Staff,0,0,0,0
1681931027922,CHEM 6B,A01,179560,Staff,100,0,100,0
1681931028950,CHEM 6C,A01,179565,Jazzar; Rodolphe,92,0,100,8
1681931029979,CHEM 7L,A01,179586,Schurmeier; Kimberly,10,0,24,14
1681931029979,CHEM 7L,A02,179587,Schurmeier; Kimberly,23,0,24,1
1681931029979,CHEM 7L,A03,179590,Schurmeier; Kimberly,22,0,24,2
1681931029979,CHEM 7L,A04,179591,Schurmeier; Kimberly,22,0,24,2
1681931029979,CHEM 7L,B01,179598,Schurmeier; Kimberly,15,0,24,9
1681931029979,CHEM 7L,B02,179599,Schurmeier; Kimberly,24,0,24,0
1681931029979,CHEM 7L,B03,179606,Schurmeier; Kimberly,22,0,24,2
1681931029979,CHEM 7L,B04,179607,Schurmeier; Kimberly,22,0,24,2
1681931031003,CHEM 11,A01,179609,Stallings; Dontarie M,87,0,100,13
1681931032028,CHEM 40A,A01,179621,Staff,38,0,50,12
1681931032028,CHEM 40A,A02,179622,Staff,46,0,50,4
1681931033054,CHEM 40B,A01,179630,Weizman; Haim,46,0,50,4
1681931033054,CHEM 40B,A02,179631,Weizman; Haim,43,0,50,7
1681931034078,CHEM 41A,A01,179660,Klosterman; Jeremy K,91,0,100,9
1681931035109,CHEM 43A,A01,179683,Klosterman; Jeremy K,0,0,24,24
1681931035109,CHEM 43A,A02,179688,Klosterman; Jeremy K,5,0,24,19
1681931035109,CHEM 43A,A03,179689,Klosterman; Jeremy K,17,0,24,7
1681931035109,CHEM 43A,A04,179691,Klosterman; Jeremy K,18,0,24,6
1681931036134,CHEM 114A,A01,179693,Stallings; Dontarie M,66,0,100,34
1681931037159,CHEM 143B,A01,179698,Weizman; Haim,16,0,24,8
1681931037159,CHEM 143B,A02,179700,Weizman; Haim,23,0,24,1
1681931038182,CHIN 169A,A00,179701,Wang; Xiao,20,0,20,0
1681931039205,COGS 2,A01,179750,Boyle; Mary E. T.,17,0,30,13
1681931040244,COGS 9,A01,179759,Jones; Cameron Robert,40,0,50,10
1681931041266,COGS 14A,A01,179854,Staff,10,0,50,40
1681931042292,COGS 14B,A01,179856,Staff,52,0,60,8
1681931043315,COGS 17,A01,179874,Staff,70,0,75,5
1681931044340,COGS 18,A01,179884,Staff,59,0,80,21
1681931045362,COGS 100,A01,179886,Staff,31,0,60,29
1681931046396,COGS 101B,A01,179892,Staff,0,2,30,30
1681931047421,COGS 101C,A01,179894,Staff,26,0,30,4
1681931048447,COGS 107A,A01,179896,Boyle; Mary E. T.,28,0,40,12
1681931049476,COGS 108,A01,179898,Simpkins; Charles Alexander,0,32,60,60
1681931050502,COGS 109,A01,179900,Staff,32,0,40,8
1681931051527,COGS 118A,A01,179946,Staff,4,0,40,36
1681931052550,COGS 153,A00,179978,Staff,0,6,30,30
1681931053577,COGS 156,A01,179981,Staff,20,0,30,10
1681931055627,COGS 172,A01,179987,Staff,10,0,30,20
1681931057674,COGS 186,A01,179991,Staff,11,0,30,19
1681931058707,COMM 10,A01,180001,Staff,11,0,25,14
1681931058707,COMM 10,A02,180004,Staff,20,0,25,5
1681931059729,COMM 100A,A01,180016,Staff,13,0,25,12
1681931059729,COMM 100A,A02,180020,Staff,24,0,25,1
1681931060754,COMM 101T,A00,180029,Halm; Gavin Patrick,18,0,35,17
1681931061783,COMM 106V,A00,180043,Staff,34,0,35,1
1681931062807,COMM 109P,A00,180044,Staff,30,0,35,5
1681931063835,COMM 113T,A00,180045,Havis; Allan,36,0,45,9
1681931064858,COMM 132,A00,180046,McKenna; Denise,18,0,30,12
1681931065881,COMM 143,A00,180047,Staff,16,0,30,14
1681931066906,COMM 190,A00,180048,Conner; Thomas Hartnell,16,0,23,7
1681931067931,CSE 8A,A50,180053,Cao; Yingjun,20,0,50,30
1681931067931,CSE 8A,B50,180180,Staff,50,0,50,0
1681931068955,CSE 11,A01,180190,Cao; Yingjun,21,0,50,29
1681931069979,CSE 20,A01,180192,Briones; Jor-el Thomas Caparas,21,0,30,9
1681931071001,CSE 21,A01,194538,Briones; Jor-el Thomas Caparas,49,0,60,11
1681931072024,CSE 30,A01,180324,Eldon; John,73,0,100,27
1681931073051,CSE 101,A01,201353,Staff,0,30,40,40
1681931074078,CSE 134B,A01,180326,Powell; Thomas Allan,72,0,100,28
1681931075100,CSE 140,A01,180328,Staff,22,0,75,53
1681931076124,CSE 140L,A01,180344,Eldon; John,47,0,100,53
1681931077152,CSE 150A,A01,180411,Staff,0,19,50,50
1681931078177,CSE 151A,A01,180414,Staff,0,15,50,50
1681931079199,CSE 175,A01,222521,Kumar; Rakesh,50,0,50,0
1681931080225,CSE 190,A00,201419,Staff,42,0,49,7
1681931081248,CSS 1,A01,194536,Staff,32,0,50,18
1681931082275,DSC 30,A01,202385,Staff,48,0,50,2
1681931083305,DSC 40A,A01,202387,Albuyeh; Rod,50,0,50,0
1681931084328,DSC 190,A01,202389,Silberman; Jack,21,0,21,0
1681931085351,DSGN 100,A01,179993,Staff,13,0,30,17
1681931086374,ECE 65,A50,180708,Staff,10,0,20,10
1681931086374,ECE 65,A51,180739,Staff,19,0,20,1
1681931087397,ECON 1,A01,180427,Famulari; Melissa,66,0,70,4
1681931088424,ECON 2,A01,180450,Levkoff; Steven B.,64,0,70,6
1681931089454,ECON 4,A01,203351,Anderson; John Charles,6,0,10,4
1681931090476,ECON 100A,A01,180472,Famulari; Melissa,59,0,70,11
1681931091498,ECON 120A,A01,180549,Staff,61,0,70,9
1681931092521,ECON 120B,A01,180655,Ma; Xinwei,38,0,70,32
1681931093546,ECON 129,A00,203333,Eckert; Fabian Paul,9,0,35,26
1681931094571,ECON 131,A00,180656,Staff,0,0,35,35
1681931095597,ECON 172B,A01,180672,Levkoff; Steven B.,31,0,35,4
1681931096623,ECON 178,A01,203342,Zhu; Ying,3,0,35,32
1681931097645,EDS 108GS,A00,202383,Wishard Guerra; Alison G.,20,0,20,0
1681931098674,EDS 111GS,A00,202347,Wishard Guerra; Alison G.,20,0,20,0
1681931099696,EDS 112,A01,202323,Staff,53,0,60,7
1681931100725,EDS 113,A00,202340,Staff,32,0,35,3
1681931101761,EDS 118,A00,201231,Staff,19,0,30,11
1681931102784,EDS 119,A00,204994,Staff,8,0,10,2
1681931103807,EDS 124BR,A00,202324,Eguchi; Emi,0,1,25,25
1681931104833,EDS 126,A01,203208,Jones; Makeba,26,0,30,4
1681931105856,EDS 135,A01,202333,Staff,17,0,20,3
1681931106880,EDS 180,A00,202311,Staff,47,0,50,3
1681931107903,ERC 190GS,A01,253747,Staff,28,0,28,0
1681931108933,ETHN 104,A00,180742,Staff,21,0,35,14
1681931109963,ETHN 118,A00,180745,Staff,26,0,35,9
1681931110988,ETHN 127,A00,180747,Staff,8,0,16,8
1681931112011,ETHN 137,A00,180880,Staff,11,0,12,1
1681931113033,ETHN 147,A00,180890,Staff,8,0,10,2
1681931114058,ETHN 154,A00,180891,Staff,6,0,8,2
1681931115079,ETHN 168,A00,180892,Staff,9,0,10,1
1681931116105,GLBH 20,A00,201051,Hannah; Seth Donal,0,6,0,1
1681931117137,GLBH 111,A01,209338,Burgos; Jose L.,0,0,0,0
1681931118163,GLBH 150,A00,258300,Staff,0,4,0,0
1681931119185,GLBH 181,A00,201207,Staff,7,0,40,33
1681931120210,HIEU 109,A00,180898,Staff,19,0,20,1
1681931121232,HIEU 111,A00,180899,Staff,0,2,20,20
1681931122259,HIEU 124,A00,180900,Staff,17,0,20,3
1681931123285,HILA 122,A00,180901,Staff,17,0,20,3
1681931124311,HILA 132,A00,180902,Vitz; Matthew,0,2,20,20
1681931125413,HILD 10,A01,180896,Staff,12,0,20,8
1681931126436,HILD 30GS,A00,180897,Edington; Claire Ellen,0,0,0,0
1681931127463,HISC 105,A00,180903,Staff,20,0,20,0
1681931128486,HISC 117,A00,180904,Staff,10,0,20,10
1681931129508,HIUS 108B,A00,181005,Staff,18,0,20,2
1681931130534,HIUS 113,A00,181093,Staff,1,0,20,19
1681931131557,HUM 3,A01,181190,Patterson; Patrick H.,35,0,50,15
1681931131557,HUM 3,B01,181195,Staff,45,0,50,5
1681931132584,HUM 3GS,A00,181196,Herbst; Matthew,0,0,0,0
1681931133616,HUM 4,A01,181227,West; Geoffrey Scott,33,0,50,17
1681931133616,HUM 4,B01,181282,Staff,41,0,50,9
1681931134639,HUM 4GS,A00,181377,Lyon; Antony J.,0,0,0,0
1681931135666,HUM 5,A01,181536,Zavodny; Tatiana Sophia,24,0,50,26
1681931135666,HUM 5,B01,181908,Staff,33,0,50,17
1681931136691,INTL 190,A00,181909,Segui; Alan S,0,0,0,8
1681931136691,INTL 190,B00,181961,Segui; Alan S,0,0,0,7
1681931137715,JAPN 20AR,A01,182113,Ross; Kayoko F,15,0,20,5
1681931138738,LATI 50,A01,202391,Martin-Cabrera; Luis,17,0,30,13
1681931138738,LATI 50,A02,202392,Martin-Cabrera; Luis,26,0,30,4
1681931139761,LATI 180,A00,202393,Kokinis; Troy Andreas,24,0,25,1
1681931140786,LIFR 1A,A00,182119,Staff,13,0,14,1
1681931141810,LIFR 1AX,A00,182324,Staff,13,0,14,1
1681931142841,LIFR 1B,A00,182259,Staff,12,0,14,2
1681931143867,LIFR 1BX,A00,182273,Staff,12,0,14,2
1681931144889,LIGN 8,A00,182330,Staff,127,0,150,23
1681931145911,LIGN 9GS,A00,182362,Staff,14,0,20,6
1681931146935,LIGN 119,A00,204992,Takahashi; Maho,11,0,15,4
1681931147962,LIGN 130,A01,182384,Staff,47,0,50,3
1681931148992,LIGN 149GS,A00,182390,Staff,14,0,20,6
1681931150017,LIGN 170,A00,182404,Staff,23,0,30,7
1681931151043,LISP 1D,A00,182281,Staff,7,0,14,7
1681931151043,LISP 1D,B00,182287,Staff,13,0,14,1
1681931151043,LISP 1D,C00,182295,Staff,10,0,14,4
1681931151043,LISP 1D,D00,182301,Staff,14,0,14,0
1681931152066,LISP 1DX,A00,182309,Staff,19,0,28,9
1681931152066,LISP 1DX,B00,182316,Staff,25,0,28,3
1681931153091,LTAF 120GS,A00,182412,Zhiri; Oumelbanine,20,0,20,0
1681931154117,LTCS 172GS,A00,182437,Bronstein; Phoebe Malan,20,0,20,0
1681931155150,LTEA 138,A00,182457,Staff,18,0,40,22
1681931156178,LTEN 114,A01,182490,Staff,23,0,25,2
1681931157202,LTEN 130GS,A00,182491,Lyon; Antony J.,20,0,20,0
1681931158246,LTEN 169,A00,182493,Cuong; Marisol,17,0,25,8
1681931159271,LTEN 178,A00,182501,Staff,14,0,15,1
1681931160297,LTEN 181,A00,182515,Staff,19,0,25,6
1681931161328,LTEN 185GS,A00,197655,Forbes; Camille,20,0,20,0
1681931162357,LTSP 100B,A00,202208,Bessett; Ryan Matthew,24,0,25,1
1681931163379,LTWL 100,A00,182516,Myerston Santana; Jacobo,20,0,30,10
1681931164401,LTWR 100GS,A00,182518,Forbes; Camille,20,0,20,0
1681931165424,LTWR 102,A00,182522,Staff,15,0,15,0
1681931165424,LTWR 102,B00,182525,Staff,14,0,15,1
1681931166446,LTWR 115,A00,182526,Staff,10,0,15,5
1681931167483,MAE 8,A01,182528,Pham; Hieu Tan,67,0,70,3
1681931168506,MAE 11,A00,182529,Bahadori; Mohammad Yousef,91,0,100,9
1681931169533,MAE 20,A00,182530,Evdokimenko; Ekaterina,67,0,70,3
1681931170558,MAE 30A,A00,182532,Staff,44,0,45,1
1681931171592,MAE 101A,A00,182533,Bahadori; Mohammad Yousef,94,0,100,6
1681931172618,MAE 101C,A00,182538,Staff,62,0,70,8
1681931173643,MAE 104,A00,182539,Staff,44,0,50,6
1681931174670,MAE 131A,A00,182540,Ghazinejad; Maziar,40,0,45,5
1681931175693,MAE 143A,A00,182548,Bewley; Thomas R,42,0,50,8
1681931176715,MAE 150,A00,182549,Staff,28,0,40,12
1681931177741,MAE 160,A00,182550,Evdokimenko; Ekaterina,41,0,60,19
1681931178774,MATH 3C,A01,182725,Staff,24,0,30,6
1681931179801,MATH 10A,A01,182729,Staff,24,0,30,6
1681931179801,MATH 10A,B01,182732,Staff,25,0,30,5
1681931180824,MATH 10B,A01,182737,Staff,16,0,30,14
1681931180824,MATH 10B,A02,182738,Staff,24,0,30,6
1681931180824,MATH 10B,B01,182744,Staff,24,0,30,6
1681931180824,MATH 10B,B02,182745,Staff,27,0,30,3
1681931181847,MATH 18,A01,182750,Anzaldo; Leesa B,28,0,30,2
1681931181847,MATH 18,A02,182751,Anzaldo; Leesa B,28,0,30,2
1681931181847,MATH 18,A03,182753,Anzaldo; Leesa B,27,0,30,3
1681931181847,MATH 18,A04,182757,Anzaldo; Leesa B,29,0,30,1
1681931181847,MATH 18,B01,182761,Anzaldo; Leesa B,27,0,30,3
1681931181847,MATH 18,B02,182764,Anzaldo; Leesa B,26,0,30,4
1681931181847,MATH 18,B03,182765,Anzaldo; Leesa B,29,0,30,1
1681931181847,MATH 18,B04,182766,Anzaldo; Leesa B,30,0,30,0
1681931182874,MATH 20A,A01,182771,Suk; Andrew Hoon,28,0,30,2
1681931183908,MATH 20B,A01,182775,Bach; Quang Tran,30,0,30,0
1681931183908,MATH 20B,A02,182777,Bach; Quang Tran,29,0,30,1
1681931183908,MATH 20B,B01,182780,Bach; Quang Tran,26,0,30,4
1681931183908,MATH 20B,B02,182782,Bach; Quang Tran,30,0,30,0
1681931184953,MATH 20C,A01,182787,Staff,24,0,30,6
1681931184953,MATH 20C,A02,182790,Staff,29,0,30,1
1681931184953,MATH 20C,B01,182792,Staff,23,0,30,7
1681931184953,MATH 20C,B02,182796,Staff,26,0,30,4
1681931185984,MATH 20D,A01,182799,Staff,27,0,30,3
1681931185984,MATH 20D,A02,182802,Staff,29,0,30,1
1681931185984,MATH 20D,A03,182803,Staff,30,0,30,0
1681931187015,MATH 20E,A01,182809,Verstraete; Jacques Allan,20,0,30,10
1681931187015,MATH 20E,A02,182811,Verstraete; Jacques Allan,28,0,30,2
1681931187015,MATH 20E,B01,182814,Verstraete; Jacques Allan,21,0,30,9
1681931187015,MATH 20E,B02,182815,Verstraete; Jacques Allan,29,0,30,1
1681931188046,MATH 103A,A01,182820,Staff,3,0,30,27
1681931188046,MATH 103A,A02,182821,Staff,27,0,30,3
1681931188046,MATH 103A,A03,182822,Staff,20,0,30,10
1681931188046,MATH 103A,B01,182825,Staff,21,0,30,9
1681931188046,MATH 103A,B02,182826,Staff,30,0,30,0
1681931188046,MATH 103A,B03,182830,Staff,30,0,30,0
1681931189075,MATH 109,A01,182836,Chow; Bennett,23,0,30,7
1681931189075,MATH 109,A02,182838,Chow; Bennett,27,0,30,3
1681931189075,MATH 109,A03,182894,Chow; Bennett,29,0,30,1
1681931189075,MATH 109,B01,182908,Chow; Bennett,27,0,30,3
1681931189075,MATH 109,B02,182909,Chow; Bennett,30,0,30,0
1681931189075,MATH 109,B03,182910,Chow; Bennett,26,0,30,4
1681931190102,MATH 142A,A01,182925,Staff,3,0,30,27
1681931190102,MATH 142A,A02,182935,Staff,23,0,30,7
1681931190102,MATH 142A,A03,182967,Staff,25,0,30,5
1681931190102,MATH 142A,B01,183125,Staff,22,0,30,8
1681931190102,MATH 142A,B02,183157,Staff,26,0,30,4
1681931190102,MATH 142A,B03,183158,Staff,29,0,30,1
1681931191127,MATH 183,A01,183160,Arias-Castro; Ery,22,0,30,8
1681931191127,MATH 183,A02,183161,Arias-Castro; Ery,29,0,30,1
1681931191127,MATH 183,B01,183163,Arias-Castro; Ery,26,0,30,4
1681931191127,MATH 183,B02,183164,Arias-Castro; Ery,28,0,30,2
1681931192150,MATH 193A,A01,183167,Staff,0,0,35,35
1681931192150,MATH 193A,A02,183168,Staff,23,0,35,12
1681931192150,MATH 193A,A03,183169,Staff,34,0,35,1
1681931192150,MATH 193A,A04,183170,Staff,26,0,35,9
1681931193178,MGT 4,A01,202395,Anderson; John Charles,76,0,80,4
1681931194201,MGT 5,A00,202396,Houskeeper; Robert,79,0,90,11
1681931195225,MGT 103,A00,202397,Eberhard; Craig A,49,0,90,41
1681931196251,MGT 131A,A00,202398,Houskeeper; Robert,81,0,90,9
1681931197277,MGT 135,A00,202399,Anderson; John Charles,81,0,90,9
1681931198299,MGT 162R,A00,202403,Gneezy; Uri,120,0,200,80
1681931199332,MGT 172,A00,202404,Hedges; Kathleen,29,0,90,61
1681931200355,MGT 181,A00,202405,Dunn; Louis Jean,79,0,90,11
1681931201377,MMW 14,A01,183200,Staff,0,0,28,28
1681931201377,MMW 14,A02,183201,Staff,25,0,28,3
1681931201377,MMW 14,A03,183202,Staff,24,0,28,4
1681931201377,MMW 14,A04,183203,Staff,25,0,28,3
1681931201377,MMW 14,A05,183204,Staff,26,0,28,2
1681931201377,MMW 14,A06,183205,Staff,27,0,28,1
1681931201377,MMW 14,B01,183207,Staff,26,0,28,2
1681931201377,MMW 14,B02,183208,Staff,28,0,28,0
1681931201377,MMW 14,B03,183209,Staff,28,0,28,0
1681931201377,MMW 14,B04,183210,Staff,28,0,28,0
1681931201377,MMW 14,B05,183211,Staff,28,0,28,0
1681931201377,MMW 14,B06,183212,Staff,27,0,28,1
1681931202402,MMW 14GS,A00,183213,Zhiri; Oumelbanine,28,0,28,0
1681931203425,MMW 15GS,B00,183215,Rahimi; Babak,28,0,28,0
1681931204454,MMW 121,A01,183217,Patterson; Patrick H.,8,0,28,20
1681931204454,MMW 121,A02,183218,Patterson; Patrick H.,25,0,28,3
1681931205477,MUS 1A,A01,182554,Staff,0,0,35,35
1681931206499,MUS 5,A01,182558,Staff,17,0,35,18
1681931207525,MUS 6,A01,182562,Staff,22,0,35,13
1681931208546,MUS 8GS,A00,182563,Borgo; David Garcia,25,0,25,0
1681931209571,MUS 13,A01,182567,Staff,23,0,25,2
1681931210597,MUS 15,A01,182570,Staff,31,0,35,4
1681931210597,MUS 15,B01,182575,Staff,7,0,35,28
1681931211627,MUS 80,A00,182578,Staff,22,0,25,3
1681931211627,MUS 80,B00,182581,Staff,20,0,25,5
1681931212653,MUS 113,A00,182582,Staff,25,0,25,0
1681931213676,MUS 114,A00,182583,Staff,1,0,25,24
1681931214706,MUS 150GS,A01,182588,Borgo; David Garcia,24,0,25,1
1681931215729,PHIL 1,A00,182590,Staff,34,0,40,6
1681931216758,PHIL 10,A01,182596,Grush; Rick Scott,30,0,35,5
1681931216758,PHIL 10,A02,182597,Grush; Rick Scott,33,0,35,2
1681931217782,PHIL 15,A01,182601,Staff,31,0,35,4
1681931217782,PHIL 15,A02,182602,Staff,33,0,35,2
1681931218808,PHIL 27,A01,182604,Staff,25,0,35,10
1681931218808,PHIL 27,A02,182607,Staff,35,0,35,0
1681931219832,PHIL 32,A01,182609,Staff,35,0,35,0
1681931219832,PHIL 32,A02,182612,Staff,35,0,35,0
1681931220861,PHIL 130,A00,182614,Staff,57,0,70,13
1681931221884,PHIL 136,A00,182616,Cohen; Jonathan David,64,0,70,6
1681931222908,PHIL 155,A00,182617,Vargas; Manuel Rogelio,57,0,70,13
1681931223930,PHIL 163,A01,182620,Staff,15,0,20,5
1681931223930,PHIL 163,A02,182624,Staff,10,0,20,10
1681931224953,PHIL 164,A00,182627,Staff,28,0,40,12
1681931225984,PHIL 173,A00,182628,Staff,35,0,40,5
1681931227009,PHYS 1A,A00,183221,Staff,53,0,60,7
1681931228032,PHYS 1AL,001,183222,Staff,25,0,30,5
1681931228032,PHYS 1AL,002,183223,Staff,24,0,30,6
1681931229127,PHYS 1B,A00,183231,Staff,40,0,60,20
1681931230149,PHYS 1BL,001,183232,Staff,15,0,30,15
1681931230149,PHYS 1BL,002,183233,Staff,27,0,30,3
1681931231174,PHYS 1C,A00,183240,Staff,21,0,60,39
1681931232197,PHYS 1CL,001,183241,Staff,8,0,30,22
1681931232197,PHYS 1CL,002,183242,Staff,21,0,30,9
1681931233219,PHYS 2AR,A01,183250,Staff,39,0,50,11
1681931234245,PHYS 2B,A01,183252,Staff,102,0,115,13
1681931235268,PHYS 2BL,A01,183254,Staff,21,0,24,3
1681931235268,PHYS 2BL,A02,183255,Staff,21,0,24,3
1681931236292,PHYS 2C,A01,183522,Staff,100,0,115,15
1681931237315,PHYS 4A,A01,183524,Staff,49,0,50,1
1681931238337,POLI 5,A00,183525,Staff,44,0,50,6
1681931239362,POLI 12,A00,183540,Staff,45,0,50,5
1681931240388,POLI 13R,A00,183541,Forman; Fonna,40,0,50,10
1681931241414,POLI 30,A00,183542,Mignozzetti; Umberto,48,0,50,2
1681931242437,POLI 100A,A00,183543,Staff,44,0,50,6
1681931243464,POLI 100E,A00,223598,Staff,32,0,35,3
1681931244494,POLI 103A,A00,183564,Kousser; Thad,35,0,50,15
1681931245518,POLI 104B,A00,201329,Staff,28,0,35,7
1681931246543,POLI 113BR,A00,183576,Hoston; Germaine,22,0,50,28
1681931247566,POLI 114BR,A00,183588,Staff,27,0,30,3
1681931248589,POLI 117R,A00,183595,Forman; Fonna,3,0,20,17
1681931249611,POLI 120H,A00,183596,Fisk; David Lee,14,0,20,6
1681931250634,POLI 130AA,A00,183597,Staff,13,0,20,7
1681931251665,POLI 134AA,A00,183598,Staff,19,0,20,1
1681931252687,POLI 135,A00,183599,Fisk; David Lee,19,0,25,6
1681931253713,POLI 142P,A00,183623,Staff,37,0,40,3
1681931254739,POLI 144D,A00,183624,Staff,22,0,25,3
1681931255762,POLI 151,A00,183625,Staff,15,0,20,5
1681931256792,POLI 162,A00,183626,Mignozzetti; Umberto,17,0,20,3
1681931257821,PSYC 1,A00,253748,Staff,85,0,90,5
1681931258845,PSYC 2,A00,183627,Moranton; Nirelia Melbina-,23,0,35,12
1681931259869,PSYC 3,A00,183628,Staff,43,0,45,2
1681931261914,PSYC 60,A01,183631,Lowe; Angela Beth,35,0,40,5
1681931262936,PSYC 70,A01,253757,Staff,35,0,45,10
1681931263958,PSYC 101,A00,183632,Heyman; Gail D.,42,0,60,18
1681931264980,PSYC 105,A00,183848,Lowe; Angela Beth,45,0,60,15
1681931266002,PSYC 106,A00,183849,Dobkins; Karen R.,39,0,60,21
1681931267029,PSYC 108,A00,253750,Staff,12,0,60,48
1681931268051,PSYC 114,A01,184275,Winkielman; Piotr,0,8,30,30
1681931269087,PSYC 122,A00,183856,Moranton; Nirelia Melbina-,0,16,30,30
1681931270117,PSYC 124,A00,183865,Chapman; Eddie Nathaniel,43,0,80,37
1681931271144,PSYC 137,A00,183880,Staff,17,0,25,8
1681931273196,PSYC 154,A00,183910,Lacefield; Katharine I,0,30,90,90
1681931275248,PSYC 162,A00,183946,Wixted; John T,37,0,90,53
1681931276273,PSYC 172,A00,183947,Gorman; Michael R.,5,0,30,25
1681931277297,PSYC 178,A00,183963,Glaser; Dale,14,0,40,26
1681931278327,PSYC 181GS,A00,183964,Anagnostaras; Stephan,10,0,10,0
1681931279350,PSYC 186GS,A01,257660,Staff,10,0,10,0
1681931280374,PSYC 193,B00,253749,Staff,22,0,25,3
1681931282428,PSYC 193L,A01,184122,Staff,33,0,35,2
1681931282428,PSYC 193L,C01,184167,Winkielman; Piotr,14,0,30,16
1681931283453,RELI 188GS,A00,182629,Rahimi; Babak,20,0,20,0
1681931284487,SE 101A,A00,182646,Staff,26,0,30,4
1681931285510,SE 101C,A00,182650,Staff,12,0,20,8
1681931286536,SE 110A,A00,182651,Staff,28,0,28,0
1681931287561,SE 130A,A00,182652,Staff,38,0,40,2
1681931288588,SIO 46GS,A00,182636,Cook; Geoffrey W,24,0,28,4
1681931289611,SIO 109R,A00,194459,Staff,0,1,20,20
1681931290633,SIO 121GS,A00,182639,Cook; Geoffrey W,25,0,28,3
1681931291658,SIO 132,A01,182642,Staff,30,0,40,10
1681931292681,SIO 139,A00,182644,Kacev; David,36,0,40,4
1681931293719,SOCI 2,A01,258404,Staff,33,0,36,3
1681931293719,SOCI 2,A02,258405,Staff,35,0,36,1
1681931294744,SOCI 60,A01,258408,Staff,29,0,30,1
1681931294744,SOCI 60,A02,258413,Staff,30,0,30,0
1681931295766,SOCI 100,A01,258415,Staff,29,0,30,1
1681931295766,SOCI 100,A02,258416,Staff,28,0,30,2
1681931301926,SOCI 127,A00,258421,Staff,19,0,30,11
1681931302949,SOCI 132,A00,258422,Staff,43,0,50,7
1681931303975,SOCI 133,A00,258423,Staff,26,0,30,4
1681931304997,SOCI 138GS,A00,258424,Staff,15,0,15,0
1681931306022,SOCI 145,A00,258425,Staff,23,0,30,7
1681931307046,SOCI 148,A00,258426,Staff,23,0,30,7
1681931308072,SOCI 153,A00,199217,Staff,29,0,30,1
1681931309099,SOCI 160,A00,258427,Staff,27,0,30,3
1681931310125,SOCI 160E,A00,258435,Staff,55,0,60,5
1681931311148,SOCI 189GS,A00,258436,Staff,15,0,15,0
1681931312171,SOCI 190GS,A00,258437,Staff,15,0,15,0
1681931313193,SYN 2,001,182658,Staff,8,0,16,8
1681931313193,SYN 2,002,201439,Staff,14,0,16,2
1681931313193,SYN 2,003,201443,Staff,16,0,16,0
1681931314219,SYN 100,A01,182657,Staff,13,0,20,7
1681931315243,TDAC 1,A00,184381,Salovey; Todd,16,0,20,4
1681931315243,TDAC 1,B00,184385,Harting; Carla Kelso,19,0,20,1
1681931315243,TDAC 1,C00,184394,Staff,18,0,20,2
1681931316265,TDAC 101,A00,184483,Harting; Carla Kelso,19,0,20,1
1681931317289,TDDE 111,A00,184496,Staff,14,0,15,1
1681931318315,TDDE 131,A00,184504,Staff,20,0,20,0
1681931318315,TDDE 131,B00,184505,Staff,17,0,18,1
1681931318315,TDDE 131,C00,184534,Staff,49,0,50,1
1681931318315,TDDE 131,D00,184564,Staff,15,0,15,0
1681931318315,TDDE 131,E00,204725,Staff,18,0,20,2
1681931319340,TDGE 1,A01,184414,Salovey; Todd,35,0,50,15
1681931320362,TDGE 5,A01,184419,Staff,23,0,24,1
1681931321388,TDGE 10,A00,184428,Fulton; Julia,27,0,50,23
1681931322411,TDGE 124,A00,184565,Fulton; Julia,0,2,50,50
1681931323437,TDGE 125,B00,184567,Meyer; Ursula,8,0,25,17
1681931324459,TDHT 101,A00,184568,Staff,21,0,25,4
1681931324459,TDHT 101,B00,184569,Staff,20,0,20,0
1681931325481,TDHT 114,A00,184570,Staff,48,0,50,2
1681931326510,TDMV 1,A00,184437,Arcidiacono; Kristin,21,0,30,9
1681931326510,TDMV 1,B00,184448,Caligagan; Maria T.,23,0,30,7
1681931327532,TDMV 2,A00,184449,Weinberg; Sadie,26,0,30,4
1681931327532,TDMV 2,B00,184453,Arcidiacono; Kristin,29,0,30,1
1681931328554,TDMV 110,A00,184571,Weinberg; Sadie,30,0,30,0
1681931329578,TDMV 142,A00,184572,Caligagan; Tony,26,0,30,4
1681931329578,TDMV 142,B00,184573,Caligagan; Maria T.,26,0,30,4
1681931330603,TDTR 20,A00,184482,Jun; Grace Shin Hae,25,0,25,0
1681931331629,USP 2,A01,184290,Hinds; Juli Beth,23,0,25,2
1681931332727,USP 3,A01,184295,Staff,20,0,25,5
1681931333750,USP 4,A00,184304,McTague; Sarah,13,0,25,12
1681931334784,USP 100,A00,184315,Staff,16,0,25,9
1681931335809,USP 105,A00,184326,Staff,21,0,25,4
1681931336840,USP 151,A00,184327,Staff,17,0,25,8
1681931337873,USP 170,A00,184380,Hinds; Juli Beth,12,0,25,13
1681931338897,VIS 21B,A01,182660,Staff,28,0,31,3
1681931338897,VIS 21B,A02,182662,Staff,30,0,31,1
1681931339923,VIS 103D,A00,182663,Staff,74,0,75,1
1681931340946,VIS 105D,A00,182667,Li; Huai,14,0,22,8
1681931341969,VIS 122GS,A00,182668,Herbst; Matthew,20,0,20,0
1681931342993,VIS 128C,A00,182673,Staff,69,0,75,6
1681931344027,VIS 130,A00,182675,Staff,19,0,22,3
1681931345061,VIS 160A,A00,182678,Stalbaum; Brett,4,0,10,6
1681931347117,WCWP 10B,A00,201679,Staff,15,0,15,0
1681931347117,WCWP 10B,B00,201695,Staff,15,0,15,0
1681931348139,WCWP 100,A00,201716,Staff,12,0,15,3
1681931348139,WCWP 100,B00,201717,Staff,1,0,15,14
1681931350214,ANSC 105GS,A00,258289,Staff,0,0,0,0
1681931351239,ANSC 125GS,A00,258295,Staff,0,0,0,0
1681931352264,ANSC 150,A00,258267,Staff,27,0,40,13
1681931353288,ANSC 190GS,A00,258280,Staff,0,0,0,2
1681931354312,ANTH 1,A00,258264,Staff,38,0,40,2
1681931355344,ANTH 2,A01,258259,Staff,72,0,76,4
1681931356380,ANTH 23,A01,258228,Staff,35,0,40,5
1681931357405,ANTH 101,A01,258236,Staff,38,0,40,2
1681931358431,ANTH 102,A00,258272,Staff,59,0,60,1
1681931359464,ANTH 105,A00,258244,Staff,28,0,35,7
1681931360485,BENG 130,A00,253975,Staff,37,0,40,3
1681931361514,BIBC 102,A01,191866,Flagg; Matthew Paul,16,0,32,16
1681931361514,BIBC 102,A02,191867,Flagg; Matthew Paul,21,0,32,11
1681931361514,BIBC 102,A03,191868,Flagg; Matthew Paul,28,0,32,4
1681931361514,BIBC 102,A04,191936,Flagg; Matthew Paul,22,0,32,10
1681931361514,BIBC 102,A05,191937,Flagg; Matthew Paul,0,0,32,32
1681931362538,BICD 100,A01,191939,Cooper; Andrew Michael,27,0,32,5
1681931362538,BICD 100,A02,191940,Cooper; Andrew Michael,32,0,32,0
1681931362538,BICD 100,A03,191941,Cooper; Andrew Michael,32,0,32,0
1681931362538,BICD 100,A04,191942,Cooper; Andrew Michael,32,0,32,0
1681931362538,BICD 100,A05,191943,Cooper; Andrew Michael,32,0,32,0
1681931363560,BIEB 126,A01,191945,Cleland; Elsa Eleanor,0,5,32,32
1681931363560,BIEB 126,A02,191946,Cleland; Elsa Eleanor,26,0,32,6
1681931363560,BIEB 126,A03,191947,Cleland; Elsa Eleanor,29,0,32,3
1681931363560,BIEB 126,A04,191948,Cleland; Elsa Eleanor,17,0,32,15
1681931363560,BIEB 126,A05,191996,Cleland; Elsa Eleanor,28,0,32,4
1681931364587,BIEB 136GS,A00,191997,Shurin; Jonathan & Holway; David A.,0,0,0,9
1681931365610,BIEB 137GS,A01,191999,Shurin; Jonathan & Holway; David A.,0,0,0,8
1681931366649,BILD 1,A01,205385,Staff,30,0,32,2
1681931366649,BILD 1,A02,205386,Staff,30,0,32,2
1681931366649,BILD 1,A03,205387,Staff,31,0,32,1
1681931366649,BILD 1,A04,205388,Staff,25,0,32,7
1681931367686,BILD 2,A01,191774,Staff,27,0,32,5
1681931367686,BILD 2,A02,191775,Staff,30,0,32,2
1681931367686,BILD 2,A03,191777,Staff,30,0,32,2
1681931367686,BILD 2,A04,191856,Staff,30,0,32,2
1681931367686,BILD 2,A05,191857,Staff,31,0,32,1
1681931367686,BILD 2,A06,191858,Staff,32,0,32,0
1681931367686,BILD 2,A07,191859,Staff,31,0,32,1
1681931368713,BILD 3,A01,205391,Staff,27,0,32,5
1681931368713,BILD 3,A02,205393,Staff,32,0,32,0
1681931368713,BILD 3,A03,205394,Staff,27,0,32,5
1681931368713,BILD 3,A04,205395,Staff,32,0,32,0
1681931369735,BILD 20,A01,191861,Staff,32,0,32,0
1681931369735,BILD 20,A02,191862,Staff,32,0,32,0
1681931370759,BILD 30,A01,191864,Staff,31,0,32,1
1681931371781,BIMM 100,A01,192019,Staff,0,0,32,32
1681931371781,BIMM 100,A02,192020,Staff,16,0,32,16
1681931371781,BIMM 100,A03,192035,Staff,17,0,32,15
1681931372803,BIMM 110,A01,192037,Tat; John,0,0,32,32
1681931372803,BIMM 110,A02,192038,Tat; John,5,0,32,27
1681931373826,BIMM 120,A01,192040,Pickett; Brooke Elizabeth,0,0,32,32
1681931373826,BIMM 120,A02,192041,Pickett; Brooke Elizabeth,7,0,32,25
1681931373826,BIMM 120,A03,192042,Pickett; Brooke Elizabeth,13,0,32,19
1681931374856,BIPN 100,A01,192044,Armour; Jon Christopher,23,0,32,9
1681931374856,BIPN 100,A02,192059,Armour; Jon Christopher,30,0,32,2
1681931374856,BIPN 100,A03,192064,Armour; Jon Christopher,30,0,32,2
1681931374856,BIPN 100,A04,192073,Armour; Jon Christopher,26,0,32,6
1681931375879,BIPN 148,A01,205411,Leutgeb; Jill K.,14,0,32,18
1681931375879,BIPN 148,A02,205412,Leutgeb; Jill K.,31,0,32,1
1681931375879,BIPN 148,A03,205413,Leutgeb; Jill K.,29,0,32,3
1681931375879,BIPN 148,A04,205414,Leutgeb; Jill K.,30,0,32,2
1681931376906,BIPN 160,A01,192115,Marino; Marc J,15,0,32,17
1681931376906,BIPN 160,A02,192148,Marino; Marc J,27,0,32,5
1681931376906,BIPN 160,A03,192158,Marino; Marc J,31,0,32,1
1681931376906,BIPN 160,A04,192190,Marino; Marc J,32,0,32,0
1681931376906,BIPN 160,A05,192287,Marino; Marc J,32,0,32,0
1681931376906,BIPN 160,A06,192288,Marino; Marc J,32,0,32,0
1681931377934,BIPN 194,A00,206038,Leutgeb; Stefan,28,0,32,4
1681931378957,BISP 194,A00,192289,Nieh; James Charles,10,0,32,22
1681931378957,BISP 194,B00,245332,Staff,26,0,32,6
1681931379986,CAT 124,A01,202247,Staff,15,0,15,0
1681931381013,CAT 125,A00,202248,Staff,18,0,20,2
1681931381013,CAT 125,B00,202253,Staff,20,0,20,0
1681931381013,CAT 125,C00,202257,Staff,18,0,20,2
1681931382035,CAT 125GS,A01,202273,Bronstein; Phoebe Malan,20,0,20,0
1681931383058,CAT 125R,A00,202284,Staff,17,0,20,3
1681931383058,CAT 125R,C00,202286,Staff,5,0,20,15
1681931383058,CAT 125R,D00,202291,Staff,17,0,20,3
1681931383058,CAT 125R,E00,202295,Staff,13,0,20,7
1681931383058,CAT 125R,F00,202302,Staff,6,0,20,14
1681931384090,CENG 100,A00,204724,Opatkiewicz; Justin Paul,25,0,25,0
1681931385113,CGS 2A,A01,180420,Staff,30,0,36,6
1681931386136,CGS 101,A00,180421,Staff,15,0,20,5
1681931387161,CGS 112,A00,180422,Staff,8,0,16,8
1681931388183,CGS 113,A00,180423,Staff,18,0,20,2
1681931389221,CGS 137,A00,180424,Staff,12,0,12,0
1681931390245,CGS 147,A00,180425,Staff,10,0,10,0
1681931391268,CHEM 6A,A01,179556,Staff,92,0,100,8
1681931391268,CHEM 6A,A02,179558,Staff,0,0,0,0
1681931392293,CHEM 6B,A01,179560,Staff,100,0,100,0
1681931393316,CHEM 6C,A01,179565,Jazzar; Rodolphe,92,0,100,8
1681931394345,CHEM 7L,A01,179586,Schurmeier; Kimberly,10,0,24,14
1681931394345,CHEM 7L,A02,179587,Schurmeier; Kimberly,23,0,24,1
1681931394345,CHEM 7L,A03,179590,Schurmeier; Kimberly,22,0,24,2
1681931394345,CHEM 7L,A04,179591,Schurmeier; Kimberly,22,0,24,2
1681931394345,CHEM 7L,B01,179598,Schurmeier; Kimberly,15,0,24,9
1681931394345,CHEM 7L,B02,179599,Schurmeier; Kimberly,24,0,24,0
1681931394345,CHEM 7L,B03,179606,Schurmeier; Kimberly,22,0,24,2
1681931394345,CHEM 7L,B04,179607,Schurmeier; Kimberly,22,0,24,2
1681931395372,CHEM 11,A01,179609,Stallings; Dontarie M,87,0,100,13
1681931396400,CHEM 40A,A01,179621,Staff,38,0,50,12
1681931396400,CHEM 40A,A02,179622,Staff,46,0,50,4
1681931397425,CHEM 40B,A01,179630,Weizman; Haim,46,0,50,4
1681931397425,CHEM 40B,A02,179631,Weizman; Haim,43,0,50,7
1681931398447,CHEM 41A,A01,179660,Klosterman; Jeremy K,90,0,100,10
1681931399474,CHEM 43A,A01,179683,Klosterman; Jeremy K,0,0,24,24
1681931399474,CHEM 43A,A02,179688,Klosterman; Jeremy K,5,0,24,19
1681931399474,CHEM 43A,A03,179689,Klosterman; Jeremy K,17,0,24,7
1681931399474,CHEM 43A,A04,179691,Klosterman; Jeremy K,18,0,24,6
1681931400498,CHEM 114A,A01,179693,Stallings; Dontarie M,66,0,100,34
1681931401524,CHEM 143B,A01,179698,Weizman; Haim,16,0,24,8
1681931401524,CHEM 143B,A02,179700,Weizman; Haim,23,0,24,1
1681931402549,CHIN 169A,A00,179701,Wang; Xiao,20,0,20,0
1681931403575,COGS 2,A01,179750,Boyle; Mary E. T.,17,0,30,13
1681931404607,COGS 9,A01,179759,Jones; Cameron Robert,40,0,50,10
1681931405629,COGS 14A,A01,179854,Staff,9,0,50,41
1681931417362,COGS 14B,A01,179856,Staff,52,0,60,8
1681931418388,COGS 17,A01,179874,Staff,70,0,75,5
1681931419413,COGS 18,A01,179884,Staff,59,0,80,21
1681931420447,COGS 100,A01,179886,Staff,31,0,60,29
1681931421469,COGS 101B,A01,179892,Staff,0,2,30,30
1681931422494,COGS 101C,A01,179894,Staff,26,0,30,4
1681931423524,COGS 107A,A01,179896,Boyle; Mary E. T.,28,0,40,12
1681931424547,COGS 108,A01,179898,Simpkins; Charles Alexander,0,32,60,60
1681931425571,COGS 109,A01,179900,Staff,32,0,40,8
1681931426594,COGS 118A,A01,179946,Staff,4,0,40,36
1681931427617,COGS 153,A00,179978,Staff,0,7,30,30
1681931428643,COGS 156,A01,179981,Staff,20,0,30,10
1681931430690,COGS 172,A01,179987,Staff,10,0,30,20
1681931432736,COGS 186,A01,179991,Staff,11,0,30,19
1681931433758,COMM 10,A01,180001,Staff,11,0,25,14
1681931433758,COMM 10,A02,180004,Staff,20,0,25,5
1681931434783,COMM 100A,A01,180016,Staff,13,0,25,12
1681931434783,COMM 100A,A02,180020,Staff,24,0,25,1
1681931435806,COMM 101T,A00,180029,Halm; Gavin Patrick,18,0,35,17
1681931436832,COMM 106V,A00,180043,Staff,34,0,35,1
1681931437858,COMM 109P,A00,180044,Staff,30,0,35,5
1681931438881,COMM 113T,A00,180045,Havis; Allan,36,0,45,9
1681931439903,COMM 132,A00,180046,McKenna; Denise,18,0,30,12
1681931440929,COMM 143,A00,180047,Staff,16,0,30,14
1681931441953,COMM 190,A00,180048,Conner; Thomas Hartnell,16,0,23,7
1681931442976,CSE 8A,A50,180053,Cao; Yingjun,20,0,50,30
1681931442976,CSE 8A,B50,180180,Staff,50,0,50,0
1681931443998,CSE 11,A01,180190,Cao; Yingjun,21,0,50,29
1681931445032,CSE 20,A01,180192,Briones; Jor-el Thomas Caparas,21,0,30,9
1681931446073,CSE 21,A01,194538,Briones; Jor-el Thomas Caparas,49,0,60,11
1681931447177,CSE 30,A01,180324,Eldon; John,73,0,100,27
1681931448207,CSE 101,A01,201353,Staff,0,30,40,40
1681931449230,CSE 134B,A01,180326,Powell; Thomas Allan,71,0,100,29
1681931450255,CSE 140,A01,180328,Staff,22,0,75,53
1681931451282,CSE 140L,A01,180344,Eldon; John,47,0,100,53
1681931452312,CSE 150A,A01,180411,Staff,0,19,50,50
1681931453344,CSE 151A,A01,180414,Staff,0,15,50,50
1681931454367,CSE 175,A01,222521,Kumar; Rakesh,50,0,50,0
1681931455390,CSE 190,A00,201419,Staff,42,0,49,7
1681931456420,CSS 1,A01,194536,Staff,32,0,50,18
1681931457456,DSC 30,A01,202385,Staff,48,0,50,2
1681931458481,DSC 40A,A01,202387,Albuyeh; Rod,50,0,50,0
1681931459508,DSC 190,A01,202389,Silberman; Jack,21,0,21,0
1681931460537,DSGN 100,A01,179993,Staff,13,0,30,17
1681931461563,ECE 65,A50,180708,Staff,10,0,20,10
1681931461563,ECE 65,A51,180739,Staff,19,0,20,1
1681931462589,ECON 1,A01,180427,Famulari; Melissa,66,0,70,4
1681931463620,ECON 2,A01,180450,Levkoff; Steven B.,64,0,70,6
1681931464656,ECON 4,A01,203351,Anderson; John Charles,6,0,10,4
1681931465679,ECON 100A,A01,180472,Famulari; Melissa,59,0,70,11
1681931466705,ECON 120A,A01,180549,Staff,61,0,70,9
1681931467739,ECON 120B,A01,180655,Ma; Xinwei,38,0,70,32
1681931468764,ECON 129,A00,203333,Eckert; Fabian Paul,9,0,35,26
1681931469790,ECON 131,A00,180656,Staff,0,0,35,35
1681931470815,ECON 172B,A01,180672,Levkoff; Steven B.,31,0,35,4
1681931471845,ECON 178,A01,203342,Zhu; Ying,3,0,35,32
1681931472868,EDS 108GS,A00,202383,Wishard Guerra; Alison G.,20,0,20,0
1681931473894,EDS 111GS,A00,202347,Wishard Guerra; Alison G.,20,0,20,0
1681931474916,EDS 112,A01,202323,Staff,53,0,60,7
1681931475939,EDS 113,A00,202340,Staff,32,0,35,3
1681931476962,EDS 118,A00,201231,Staff,19,0,30,11
1681931477992,EDS 119,A00,204994,Staff,8,0,10,2
1681931479018,EDS 124BR,A00,202324,Eguchi; Emi,0,1,25,25
1681931480045,EDS 126,A01,203208,Jones; Makeba,26,0,30,4
1681931481077,EDS 135,A01,202333,Staff,17,0,20,3
1681931482101,EDS 180,A00,202311,Staff,47,0,50,3
1681931483123,ERC 190GS,A01,253747,Staff,28,0,28,0
1681931484146,ETHN 104,A00,180742,Staff,21,0,35,14
1681931485171,ETHN 118,A00,180745,Staff,26,0,35,9
1681931486193,ETHN 127,A00,180747,Staff,8,0,16,8
1681931487215,ETHN 137,A00,180880,Staff,11,0,12,1
1681931488249,ETHN 147,A00,180890,Staff,8,0,10,2
1681931489283,ETHN 154,A00,180891,Staff,5,0,8,3
1681931490306,ETHN 168,A00,180892,Staff,9,0,10,1
1681931491328,GLBH 20,A00,201051,Hannah; Seth Donal,0,6,0,1
1681931492352,GLBH 111,A01,209338,Burgos; Jose L.,0,0,0,0
1681931493385,GLBH 150,A00,258300,Staff,0,4,0,0
1681931494417,GLBH 181,A00,201207,Staff,7,0,40,33
1681931495439,HIEU 109,A00,180898,Staff,19,0,20,1
1681931496460,HIEU 111,A00,180899,Staff,0,2,20,20
1681931497486,HIEU 124,A00,180900,Staff,17,0,20,3
1681931498510,HILA 122,A00,180901,Staff,17,0,20,3
1681931499534,HILA 132,A00,180902,Vitz; Matthew,0,2,20,20
1681931500565,HILD 10,A01,180896,Staff,12,0,20,8
1681931501593,HILD 30GS,A00,180897,Edington; Claire Ellen,0,0,0,0
1681931502623,HISC 105,A00,180903,Staff,20,0,20,0
1681931503648,HISC 117,A00,180904,Staff,10,0,20,10
1681931504681,HIUS 108B,A00,181005,Staff,18,0,20,2
1681931505703,HIUS 113,A00,181093,Staff,1,0,20,19
1681931506736,HUM 3,A01,181190,Patterson; Patrick H.,34,0,50,16
1681931506736,HUM 3,B01,181195,Staff,45,0,50,5
1681931507772,HUM 3GS,A00,181196,Herbst; Matthew,0,0,0,0
1681931508801,HUM 4,A01,181227,West; Geoffrey Scott,33,0,50,17
1681931508801,HUM 4,B01,181282,Staff,41,0,50,9
1681931509823,HUM 4GS,A00,181377,Lyon; Antony J.,0,0,0,0
1681931510849,HUM 5,A01,181536,Zavodny; Tatiana Sophia,23,0,50,27
1681931510849,HUM 5,B01,181908,Staff,33,0,50,17
1681931511874,INTL 190,A00,181909,Segui; Alan S,0,0,0,8
1681931511874,INTL 190,B00,181961,Segui; Alan S,0,0,0,7
1681931512899,JAPN 20AR,A01,182113,Ross; Kayoko F,15,0,20,5
1681931513922,LATI 50,A01,202391,Martin-Cabrera; Luis,17,0,30,13
1681931513922,LATI 50,A02,202392,Martin-Cabrera; Luis,26,0,30,4
1681931514950,LATI 180,A00,202393,Kokinis; Troy Andreas,24,0,25,1
1681931515974,LIFR 1A,A00,182119,Staff,13,0,14,1
1681931516997,LIFR 1AX,A00,182324,Staff,13,0,14,1
1681931518019,LIFR 1B,A00,182259,Staff,12,0,14,2
1681931519051,LIFR 1BX,A00,182273,Staff,12,0,14,2
1681931520077,LIGN 8,A00,182330,Staff,126,0,150,24
1681931521101,LIGN 9GS,A00,182362,Staff,14,0,20,6
1681931522137,LIGN 119,A00,204992,Takahashi; Maho,11,0,15,4
1681931523162,LIGN 130,A01,182384,Staff,47,0,50,3
1681931524188,LIGN 149GS,A00,182390,Staff,14,0,20,6
1681931525213,LIGN 170,A00,182404,Staff,23,0,30,7
1681931526235,LISP 1D,A00,182281,Staff,7,0,14,7
1681931526235,LISP 1D,B00,182287,Staff,13,0,14,1
1681931526235,LISP 1D,C00,182295,Staff,10,0,14,4
1681931526235,LISP 1D,D00,182301,Staff,14,0,14,0
1681931527268,LISP 1DX,A00,182309,Staff,19,0,28,9
1681931527268,LISP 1DX,B00,182316,Staff,25,0,28,3
1681931528292,LTAF 120GS,A00,182412,Zhiri; Oumelbanine,20,0,20,0
1681931529333,LTCS 172GS,A00,182437,Bronstein; Phoebe Malan,20,0,20,0
1681931530356,LTEA 138,A00,182457,Staff,18,0,40,22
1681931531380,LTEN 114,A01,182490,Staff,23,0,25,2
1681931532403,LTEN 130GS,A00,182491,Lyon; Antony J.,20,0,20,0
1681931533425,LTEN 169,A00,182493,Cuong; Marisol,17,0,25,8
1681931534450,LTEN 178,A00,182501,Staff,14,0,15,1
1681931535473,LTEN 181,A00,182515,Staff,19,0,25,6
1681931536500,LTEN 185GS,A00,197655,Forbes; Camille,20,0,20,0
1681931537536,LTSP 100B,A00,202208,Bessett; Ryan Matthew,24,0,25,1
1681931538567,LTWL 100,A00,182516,Myerston Santana; Jacobo,20,0,30,10
1681931539589,LTWR 100GS,A00,182518,Forbes; Camille,20,0,20,0
1681931540622,LTWR 102,A00,182522,Staff,15,0,15,0
1681931540622,LTWR 102,B00,182525,Staff,14,0,15,1
1681931541645,LTWR 115,A00,182526,Staff,10,0,15,5
1681931542718,MAE 8,A01,182528,Pham; Hieu Tan,67,0,70,3
1681931543739,MAE 11,A00,182529,Bahadori; Mohammad Yousef,91,0,100,9
1681931544763,MAE 20,A00,182530,Evdokimenko; Ekaterina,67,0,70,3
1681931545786,MAE 30A,A00,182532,Staff,44,0,45,1
1681931546814,MAE 101A,A00,182533,Bahadori; Mohammad Yousef,93,0,100,7
1681931547851,MAE 101C,A00,182538,Staff,62,0,70,8
1681931548884,MAE 104,A00,182539,Staff,44,0,50,6
1681931549907,MAE 131A,A00,182540,Ghazinejad; Maziar,40,0,45,5
1681931551003,MAE 143A,A00,182548,Bewley; Thomas R,42,0,50,8
1681931552025,MAE 150,A00,182549,Staff,28,0,40,12
1681931553048,MAE 160,A00,182550,Evdokimenko; Ekaterina,40,0,60,20
1681931554077,MATH 3C,A01,182725,Staff,24,0,30,6
1681931555105,MATH 10A,A01,182729,Staff,24,0,30,6
1681931555105,MATH 10A,B01,182732,Staff,25,0,30,5
1681931556132,MATH 10B,A01,182737,Staff,16,0,30,14
1681931556132,MATH 10B,A02,182738,Staff,24,0,30,6
1681931556132,MATH 10B,B01,182744,Staff,24,0,30,6
1681931556132,MATH 10B,B02,182745,Staff,27,0,30,3
1681931557156,MATH 18,A01,182750,Anzaldo; Leesa B,28,0,30,2
1681931557156,MATH 18,A02,182751,Anzaldo; Leesa B,28,0,30,2
1681931557156,MATH 18,A03,182753,Anzaldo; Leesa B,27,0,30,3
1681931557156,MATH 18,A04,182757,Anzaldo; Leesa B,29,0,30,1
1681931557156,MATH 18,B01,182761,Anzaldo; Leesa B,27,0,30,3
1681931557156,MATH 18,B02,182764,Anzaldo; Leesa B,26,0,30,4
1681931557156,MATH 18,B03,182765,Anzaldo; Leesa B,29,0,30,1
1681931557156,MATH 18,B04,182766,Anzaldo; Leesa B,30,0,30,0
1681931558179,MATH 20A,A01,182771,Suk; Andrew Hoon,28,0,30,2
1681931559207,MATH 20B,A01,182775,Bach; Quang Tran,30,0,30,0
1681931559207,MATH 20B,A02,182777,Bach; Quang Tran,29,0,30,1
1681931559207,MATH 20B,B01,182780,Bach; Quang Tran,26,0,30,4
1681931559207,MATH 20B,B02,182782,Bach; Quang Tran,30,0,30,0
1681931560230,MATH 20C,A01,182787,Staff,24,0,30,6
1681931560230,MATH 20C,A02,182790,Staff,29,0,30,1
1681931560230,MATH 20C,B01,182792,Staff,23,0,30,7
1681931560230,MATH 20C,B02,182796,Staff,26,0,30,4
1681931561258,MATH 20D,A01,182799,Staff,27,0,30,3
1681931561258,MATH 20D,A02,182802,Staff,29,0,30,1
1681931561258,MATH 20D,A03,182803,Staff,30,0,30,0
1681931562287,MATH 20E,A01,182809,Verstraete; Jacques Allan,20,0,30,10
1681931562287,MATH 20E,A02,182811,Verstraete; Jacques Allan,28,0,30,2
1681931562287,MATH 20E,B01,182814,Verstraete; Jacques Allan,21,0,30,9
1681931562287,MATH 20E,B02,182815,Verstraete; Jacques Allan,29,0,30,1
1681931563310,MATH 103A,A01,182820,Staff,3,0,30,27
1681931563310,MATH 103A,A02,182821,Staff,27,0,30,3
1681931563310,MATH 103A,A03,182822,Staff,20,0,30,10
1681931563310,MATH 103A,B01,182825,Staff,21,0,30,9
1681931563310,MATH 103A,B02,182826,Staff,30,0,30,0
1681931563310,MATH 103A,B03,182830,Staff,30,0,30,0
1681931564338,MATH 109,A01,182836,Chow; Bennett,23,0,30,7
1681931564338,MATH 109,A02,182838,Chow; Bennett,27,0,30,3
1681931564338,MATH 109,A03,182894,Chow; Bennett,29,0,30,1
1681931564338,MATH 109,B01,182908,Chow; Bennett,27,0,30,3
1681931564338,MATH 109,B02,182909,Chow; Bennett,30,0,30,0
1681931564338,MATH 109,B03,182910,Chow; Bennett,26,0,30,4
1681931565363,MATH 142A,A01,182925,Staff,3,0,30,27
1681931565363,MATH 142A,A02,182935,Staff,23,0,30,7
1681931565363,MATH 142A,A03,182967,Staff,25,0,30,5
1681931565363,MATH 142A,B01,183125,Staff,22,0,30,8
1681931565363,MATH 142A,B02,183157,Staff,26,0,30,4
1681931565363,MATH 142A,B03,183158,Staff,29,0,30,1
1681931566390,MATH 183,A01,183160,Arias-Castro; Ery,22,0,30,8
1681931566390,MATH 183,A02,183161,Arias-Castro; Ery,28,0,30,2
1681931566390,MATH 183,B01,183163,Arias-Castro; Ery,26,0,30,4
1681931566390,MATH 183,B02,183164,Arias-Castro; Ery,28,0,30,2
1681931567413,MATH 193A,A01,183167,Staff,0,0,35,35
1681931567413,MATH 193A,A02,183168,Staff,23,0,35,12
1681931567413,MATH 193A,A03,183169,Staff,34,0,35,1
1681931567413,MATH 193A,A04,183170,Staff,26,0,35,9
1681931568435,MGT 4,A01,202395,Anderson; John Charles,76,0,80,4
1681931569461,MGT 5,A00,202396,Houskeeper; Robert,79,0,90,11
1681931570483,MGT 103,A00,202397,Eberhard; Craig A,49,0,90,41
1681931571509,MGT 131A,A00,202398,Houskeeper; Robert,81,0,90,9
1681931572532,MGT 135,A00,202399,Anderson; John Charles,81,0,90,9
1681931573561,MGT 162R,A00,202403,Gneezy; Uri,120,0,200,80
1681931574589,MGT 172,A00,202404,Hedges; Kathleen,28,0,90,62
1681931575614,MGT 181,A00,202405,Dunn; Louis Jean,79,0,90,11
1681931576646,MMW 14,A01,183200,Staff,0,0,28,28
1681931576646,MMW 14,A02,183201,Staff,25,0,28,3
1681931576646,MMW 14,A03,183202,Staff,24,0,28,4
1681931576646,MMW 14,A04,183203,Staff,25,0,28,3
1681931576646,MMW 14,A05,183204,Staff,26,0,28,2
1681931576646,MMW 14,A06,183205,Staff,27,0,28,1
1681931576646,MMW 14,B01,183207,Staff,26,0,28,2
1681931576646,MMW 14,B02,183208,Staff,28,0,28,0
1681931576646,MMW 14,B03,183209,Staff,28,0,28,0
1681931576646,MMW 14,B04,183210,Staff,28,0,28,0
1681931576646,MMW 14,B05,183211,Staff,28,0,28,0
1681931576646,MMW 14,B06,183212,Staff,27,0,28,1
1681931577670,MMW 14GS,A00,183213,Zhiri; Oumelbanine,28,0,28,0
1681931578699,MMW 15GS,B00,183215,Rahimi; Babak,28,0,28,0
1681931579724,MMW 121,A01,183217,Patterson; Patrick H.,8,0,28,20
1681931579724,MMW 121,A02,183218,Patterson; Patrick H.,25,0,28,3
1681931580750,MUS 1A,A01,182554,Staff,0,0,35,35
1681931581779,MUS 5,A01,182558,Staff,16,0,35,19
1681931582806,MUS 6,A01,182562,Staff,22,0,35,13
1681931583828,MUS 8GS,A00,182563,Borgo; David Garcia,25,0,25,0
1681931584851,MUS 13,A01,182567,Staff,23,0,25,2
1681931585877,MUS 15,A01,182570,Staff,31,0,35,4
1681931585877,MUS 15,B01,182575,Staff,7,0,35,28
1681931586904,MUS 80,A00,182578,Staff,22,0,25,3
1681931586904,MUS 80,B00,182581,Staff,20,0,25,5
1681931587926,MUS 113,A00,182582,Staff,25,0,25,0
1681931588951,MUS 114,A00,182583,Staff,1,0,25,24
1681931589974,MUS 150GS,A01,182588,Borgo; David Garcia,24,0,25,1
1681931591004,PHIL 1,A00,182590,Staff,34,0,40,6
1681931592029,PHIL 10,A01,182596,Grush; Rick Scott,30,0,35,5
1681931592029,PHIL 10,A02,182597,Grush; Rick Scott,33,0,35,2
1681931593054,PHIL 15,A01,182601,Staff,31,0,35,4
1681931593054,PHIL 15,A02,182602,Staff,33,0,35,2
1681931594077,PHIL 27,A01,182604,Staff,25,0,35,10
1681931594077,PHIL 27,A02,182607,Staff,35,0,35,0
1681931595112,PHIL 32,A01,182609,Staff,35,0,35,0
1681931595112,PHIL 32,A02,182612,Staff,35,0,35,0
1681931596139,PHIL 130,A00,182614,Staff,57,0,70,13
1681931597166,PHIL 136,A00,182616,Cohen; Jonathan David,64,0,70,6
1681931598194,PHIL 155,A00,182617,Vargas; Manuel Rogelio,57,0,70,13
1681931599216,PHIL 163,A01,182620,Staff,15,0,20,5
1681931599216,PHIL 163,A02,182624,Staff,10,0,20,10
1681931600240,PHIL 164,A00,182627,Staff,29,0,40,11
1681931601264,PHIL 173,A00,182628,Staff,35,0,40,5
1681931602289,PHYS 1A,A00,183221,Staff,53,0,60,7
1681931603311,PHYS 1AL,001,183222,Staff,25,0,30,5
1681931603311,PHYS 1AL,002,183223,Staff,24,0,30,6
1681931604334,PHYS 1B,A00,183231,Staff,40,0,60,20
1681931605357,PHYS 1BL,001,183232,Staff,15,0,30,15
1681931605357,PHYS 1BL,002,183233,Staff,27,0,30,3
1681931606379,PHYS 1C,A00,183240,Staff,20,0,60,40
1681931607403,PHYS 1CL,001,183241,Staff,8,0,30,22
1681931607403,PHYS 1CL,002,183242,Staff,21,0,30,9
1681931608427,PHYS 2AR,A01,183250,Staff,39,0,50,11
1681931609448,PHYS 2B,A01,183252,Staff,101,0,115,14
1681931610470,PHYS 2BL,A01,183254,Staff,21,0,24,3
1681931610470,PHYS 2BL,A02,183255,Staff,21,0,24,3
1681931611495,PHYS 2C,A01,183522,Staff,100,0,115,15
1681931612516,PHYS 4A,A01,183524,Staff,49,0,50,1
1681931613540,POLI 5,A00,183525,Staff,44,0,50,6
1681931614566,POLI 12,A00,183540,Staff,45,0,50,5
1681931615593,POLI 13R,A00,183541,Forman; Fonna,40,0,50,10
1681931616617,POLI 30,A00,183542,Mignozzetti; Umberto,48,0,50,2
1681931617640,POLI 100A,A00,183543,Staff,44,0,50,6
1681931618669,POLI 100E,A00,223598,Staff,32,0,35,3
1681931619695,POLI 103A,A00,183564,Kousser; Thad,34,0,50,16
1681931620724,POLI 104B,A00,201329,Staff,27,0,35,8
1681931621749,POLI 113BR,A00,183576,Hoston; Germaine,22,0,50,28
1681931622780,POLI 114BR,A00,183588,Staff,26,0,30,4
1681931623803,POLI 117R,A00,183595,Forman; Fonna,3,0,20,17
1681931624831,POLI 120H,A00,183596,Fisk; David Lee,13,0,20,7
1681931625856,POLI 130AA,A00,183597,Staff,13,0,20,7
1681931626880,POLI 134AA,A00,183598,Staff,19,0,20,1
1681931627915,POLI 135,A00,183599,Fisk; David Lee,19,0,25,6
1681931628940,POLI 142P,A00,183623,Staff,37,0,40,3
1681931629962,POLI 144D,A00,183624,Staff,22,0,25,3
1681931630988,POLI 151,A00,183625,Staff,14,0,20,6
1681931632016,POLI 162,A00,183626,Mignozzetti; Umberto,17,0,20,3
1681931633051,PSYC 1,A00,253748,Staff,85,0,90,5
1681931634077,PSYC 2,A00,183627,Moranton; Nirelia Melbina-,23,0,35,12
1681931635099,PSYC 3,A00,183628,Staff,43,0,45,2
1681931637151,PSYC 60,A01,183631,Lowe; Angela Beth,35,0,40,5
1681931638174,PSYC 70,A01,253757,Staff,34,0,45,11
1681931639200,PSYC 101,A00,183632,Heyman; Gail D.,42,0,60,18
1681931640223,PSYC 105,A00,183848,Lowe; Angela Beth,45,0,60,15
1681931641259,PSYC 106,A00,183849,Dobkins; Karen R.,39,0,60,21
1681931642288,PSYC 108,A00,253750,Staff,12,0,60,48
1681931643326,PSYC 114,A01,184275,Winkielman; Piotr,0,8,30,30
1681931644349,PSYC 122,A00,183856,Moranton; Nirelia Melbina-,0,16,30,30
1681931645377,PSYC 124,A00,183865,Chapman; Eddie Nathaniel,43,0,80,37
1681931646403,PSYC 137,A00,183880,Staff,17,0,25,8
1681931648454,PSYC 154,A00,183910,Lacefield; Katharine I,0,30,90,90
1681931650506,PSYC 162,A00,183946,Wixted; John T,37,0,90,53
1681931651531,PSYC 172,A00,183947,Gorman; Michael R.,5,0,30,25
1681931652570,PSYC 178,A00,183963,Glaser; Dale,14,0,40,26
1681931653595,PSYC 181GS,A00,183964,Anagnostaras; Stephan,10,0,10,0
1681931654692,PSYC 186GS,A01,257660,Staff,10,0,10,0
1681931655714,PSYC 193,B00,253749,Staff,22,0,25,3
1681931657763,PSYC 193L,A01,184122,Staff,33,0,35,2
1681931657763,PSYC 193L,C01,184167,Winkielman; Piotr,14,0,30,16
1681931658788,RELI 188GS,A00,182629,Rahimi; Babak,20,0,20,0
1681931659817,SE 101A,A00,182646,Staff,26,0,30,4
1681931660843,SE 101C,A00,182650,Staff,12,0,20,8
1681931661866,SE 110A,A00,182651,Staff,28,0,28,0
1681931662891,SE 130A,A00,182652,Staff,38,0,40,2
1681931663918,SIO 46GS,A00,182636,Cook; Geoffrey W,24,0,28,4
1681931664940,SIO 109R,A00,194459,Staff,0,1,20,20
1681931665972,SIO 121GS,A00,182639,Cook; Geoffrey W,24,0,28,4
1681931666993,SIO 132,A01,182642,Staff,30,0,40,10
1681931668015,SIO 139,A00,182644,Kacev; David,36,0,40,4
1681931669054,SOCI 2,A01,258404,Staff,33,0,36,3
1681931669054,SOCI 2,A02,258405,Staff,35,0,36,1
1681931670077,SOCI 60,A01,258408,Staff,29,0,30,1
1681931670077,SOCI 60,A02,258413,Staff,30,0,30,0
1681931671111,SOCI 100,A01,258415,Staff,29,0,30,1
1681931671111,SOCI 100,A02,258416,Staff,28,0,30,2
1681931677255,SOCI 127,A00,258421,Staff,19,0,30,11
1681931678277,SOCI 132,A00,258422,Staff,43,0,50,7
1681931679302,SOCI 133,A00,258423,Staff,26,0,30,4
1681931680325,SOCI 138GS,A00,258424,Staff,15,0,15,0
1681931681353,SOCI 145,A00,258425,Staff,23,0,30,7
1681931682375,SOCI 148,A00,258426,Staff,23,0,30,7
1681931683405,SOCI 153,A00,199217,Staff,29,0,30,1
1681931684438,SOCI 160,A00,258427,Staff,27,0,30,3
1681931685460,SOCI 160E,A00,258435,Staff,55,0,60,5
1681931686483,SOCI 189GS,A00,258436,Staff,15,0,15,0
1681931687508,SOCI 190GS,A00,258437,Staff,15,0,15,0
1681931688540,SYN 2,001,182658,Staff,8,0,16,8
1681931688540,SYN 2,002,201439,Staff,13,0,16,3
1681931688540,SYN 2,003,201443,Staff,16,0,16,0
1681931689565,SYN 100,A01,182657,Staff,12,0,20,8
1681931690591,TDAC 1,A00,184381,Salovey; Todd,16,0,20,4
1681931690591,TDAC 1,B00,184385,Harting; Carla Kelso,19,0,20,1
1681931690591,TDAC 1,C00,184394,Staff,18,0,20,2
1681931691613,TDAC 101,A00,184483,Harting; Carla Kelso,19,0,20,1
1681931692639,TDDE 111,A00,184496,Staff,14,0,15,1
1681931693671,TDDE 131,A00,184504,Staff,20,0,20,0
1681931693671,TDDE 131,B00,184505,Staff,17,0,18,1
1681931693671,TDDE 131,C00,184534,Staff,49,0,50,1
1681931693671,TDDE 131,D00,184564,Staff,15,0,15,0
1681931693671,TDDE 131,E00,204725,Staff,18,0,20,2
1681931694694,TDGE 1,A01,184414,Salovey; Todd,35,0,50,15
1681931695719,TDGE 5,A01,184419,Staff,23,0,24,1
1681931696749,TDGE 10,A00,184428,Fulton; Julia,27,0,50,23
1681931697773,TDGE 124,A00,184565,Fulton; Julia,0,2,50,50
1681931698796,TDGE 125,B00,184567,Meyer; Ursula,8,0,25,17
1681931699822,TDHT 101,A00,184568,Staff,21,0,25,4
1681931699822,TDHT 101,B00,184569,Staff,20,0,20,0
1681931700845,TDHT 114,A00,184570,Staff,48,0,50,2
1681931701873,TDMV 1,A00,184437,Arcidiacono; Kristin,21,0,30,9
1681931701873,TDMV 1,B00,184448,Caligagan; Maria T.,23,0,30,7
1681931702900,TDMV 2,A00,184449,Weinberg; Sadie,26,0,30,4
1681931702900,TDMV 2,B00,184453,Arcidiacono; Kristin,29,0,30,1
1681931703927,TDMV 110,A00,184571,Weinberg; Sadie,30,0,30,0
1681931704952,TDMV 142,A00,184572,Caligagan; Tony,26,0,30,4
1681931704952,TDMV 142,B00,184573,Caligagan; Maria T.,26,0,30,4
1681931705979,TDTR 20,A00,184482,Jun; Grace Shin Hae,25,0,25,0
1681931707005,USP 2,A01,184290,Hinds; Juli Beth,23,0,25,2
1681931708026,USP 3,A01,184295,Staff,20,0,25,5
1681931709054,USP 4,A00,184304,McTague; Sarah,13,0,25,12
1681931710085,USP 100,A00,184315,Staff,16,0,25,9
1681931711110,USP 105,A00,184326,Staff,21,0,25,4
1681931712135,USP 151,A00,184327,Staff,17,0,25,8
1681931713167,USP 170,A00,184380,Hinds; Juli Beth,12,0,25,13
1681931714189,VIS 21B,A01,182660,Staff,28,0,31,3
1681931714189,VIS 21B,A02,182662,Staff,30,0,31,1
1681931715213,VIS 103D,A00,182663,Staff,74,0,75,1
1681931716242,VIS 105D,A00,182667,Li; Huai,14,0,22,8
1681931717263,VIS 122GS,A00,182668,Herbst; Matthew,20,0,20,0
1681931718300,VIS 128C,A00,182673,Staff,69,0,75,6
1681931719323,VIS 130,A00,182675,Staff,19,0,22,3
1681931720346,VIS 160A,A00,182678,Stalbaum; Brett,4,0,10,6
1681931722391,WCWP 10B,A00,201679,Staff,15,0,15,0
1681931722391,WCWP 10B,B00,201695,Staff,15,0,15,0
1681931723427,WCWP 100,A00,201716,Staff,12,0,15,3
1681931723427,WCWP 100,B00,201717,Staff,1,0,15,14
1681931725489,ANSC 105GS,A00,258289,Staff,0,0,0,0
1681931726513,ANSC 125GS,A00,258295,Staff,0,0,0,0
1681931727541,ANSC 150,A00,258267,Staff,27,0,40,13
1681931728571,ANSC 190GS,A00,258280,Staff,0,0,0,2
1681931729593,ANTH 1,A00,258264,Staff,38,0,40,2
1681931730617,ANTH 2,A01,258259,Staff,72,0,76,4
1681931731640,ANTH 23,A01,258228,Staff,35,0,40,5
1681931732662,ANTH 101,A01,258236,Staff,38,0,40,2
1681931733684,ANTH 102,A00,258272,Staff,59,0,60,1
1681931734707,ANTH 105,A00,258244,Staff,28,0,35,7
1681931735741,BENG 130,A00,253975,Staff,37,0,40,3
1681931736763,BIBC 102,A01,191866,Flagg; Matthew Paul,16,0,32,16
1681931736763,BIBC 102,A02,191867,Flagg; Matthew Paul,21,0,32,11
1681931736763,BIBC 102,A03,191868,Flagg; Matthew Paul,27,0,32,5
1681931736763,BIBC 102,A04,191936,Flagg; Matthew Paul,21,0,32,11
1681931736763,BIBC 102,A05,191937,Flagg; Matthew Paul,0,0,32,32
1681931737788,BICD 100,A01,191939,Cooper; Andrew Michael,27,0,32,5
1681931737788,BICD 100,A02,191940,Cooper; Andrew Michael,32,0,32,0
1681931737788,BICD 100,A03,191941,Cooper; Andrew Michael,32,0,32,0
1681931737788,BICD 100,A04,191942,Cooper; Andrew Michael,32,0,32,0
1681931737788,BICD 100,A05,191943,Cooper; Andrew Michael,32,0,32,0
1681931738811,BIEB 126,A01,191945,Cleland; Elsa Eleanor,0,4,32,32
1681931738811,BIEB 126,A02,191946,Cleland; Elsa Eleanor,26,0,32,6
1681931738811,BIEB 126,A03,191947,Cleland; Elsa Eleanor,29,0,32,3
1681931738811,BIEB 126,A04,191948,Cleland; Elsa Eleanor,16,0,32,16
1681931738811,BIEB 126,A05,191996,Cleland; Elsa Eleanor,28,0,32,4
1681931739836,BIEB 136GS,A00,191997,Shurin; Jonathan & Holway; David A.,0,0,0,9
1681931740862,BIEB 137GS,A01,191999,Shurin; Jonathan & Holway; David A.,0,0,0,8
1681931741887,BILD 1,A01,205385,Staff,30,0,32,2
1681931741887,BILD 1,A02,205386,Staff,30,0,32,2
1681931741887,BILD 1,A03,205387,Staff,31,0,32,1
1681931741887,BILD 1,A04,205388,Staff,25,0,32,7
1681931742912,BILD 2,A01,191774,Staff,27,0,32,5
1681931742912,BILD 2,A02,191775,Staff,30,0,32,2
1681931742912,BILD 2,A03,191777,Staff,29,0,32,3
1681931742912,BILD 2,A04,191856,Staff,30,0,32,2
1681931742912,BILD 2,A05,191857,Staff,31,0,32,1
1681931742912,BILD 2,A06,191858,Staff,32,0,32,0
1681931742912,BILD 2,A07,191859,Staff,31,0,32,1
1681931743938,BILD 3,A01,205391,Staff,27,0,32,5
1681931743938,BILD 3,A02,205393,Staff,32,0,32,0
1681931743938,BILD 3,A03,205394,Staff,27,0,32,5
1681931743938,BILD 3,A04,205395,Staff,32,0,32,0
1681931744960,BILD 20,A01,191861,Staff,32,0,32,0
1681931744960,BILD 20,A02,191862,Staff,32,0,32,0
1681931745986,BILD 30,A01,191864,Staff,31,0,32,1
1681931747017,BIMM 100,A01,192019,Staff,0,0,32,32
1681931747017,BIMM 100,A02,192020,Staff,16,0,32,16
1681931747017,BIMM 100,A03,192035,Staff,17,0,32,15
1681931748041,BIMM 110,A01,192037,Tat; John,0,0,32,32
1681931748041,BIMM 110,A02,192038,Tat; John,5,0,32,27
1681931749063,BIMM 120,A01,192040,Pickett; Brooke Elizabeth,0,0,32,32
1681931749063,BIMM 120,A02,192041,Pickett; Brooke Elizabeth,7,0,32,25
1681931749063,BIMM 120,A03,192042,Pickett; Brooke Elizabeth,13,0,32,19
1681931750090,BIPN 100,A01,192044,Armour; Jon Christopher,23,0,32,9
1681931750090,BIPN 100,A02,192059,Armour; Jon Christopher,30,0,32,2
1681931750090,BIPN 100,A03,192064,Armour; Jon Christopher,30,0,32,2
1681931750090,BIPN 100,A04,192073,Armour; Jon Christopher,26,0,32,6
1681931751138,BIPN 148,A01,205411,Leutgeb; Jill K.,14,0,32,18
1681931751138,BIPN 148,A02,205412,Leutgeb; Jill K.,31,0,32,1
1681931751138,BIPN 148,A03,205413,Leutgeb; Jill K.,29,0,32,3
1681931751138,BIPN 148,A04,205414,Leutgeb; Jill K.,30,0,32,2
1681931752169,BIPN 160,A01,192115,Marino; Marc J,15,0,32,17
1681931752169,BIPN 160,A02,192148,Marino; Marc J,27,0,32,5
1681931752169,BIPN 160,A03,192158,Marino; Marc J,31,0,32,1
1681931752169,BIPN 160,A04,192190,Marino; Marc J,32,0,32,0
1681931752169,BIPN 160,A05,192287,Marino; Marc J,32,0,32,0
1681931752169,BIPN 160,A06,192288,Marino; Marc J,32,0,32,0
1681931753194,BIPN 194,A00,206038,Leutgeb; Stefan,28,0,32,4
1681931754221,BISP 194,A00,192289,Nieh; James Charles,10,0,32,22
1681931754221,BISP 194,B00,245332,Staff,26,0,32,6
1681931755243,CAT 124,A01,202247,Staff,15,0,15,0
1681931756267,CAT 125,A00,202248,Staff,18,0,20,2
1681931756267,CAT 125,B00,202253,Staff,20,0,20,0
1681931756267,CAT 125,C00,202257,Staff,18,0,20,2
1681931757291,CAT 125GS,A01,202273,Bronstein; Phoebe Malan,20,0,20,0
1681931758385,CAT 125R,A00,202284,Staff,17,0,20,3
1681931758385,CAT 125R,C00,202286,Staff,5,0,20,15
1681931758385,CAT 125R,D00,202291,Staff,17,0,20,3
1681931758385,CAT 125R,E00,202295,Staff,13,0,20,7
1681931758385,CAT 125R,F00,202302,Staff,6,0,20,14
1681931759411,CENG 100,A00,204724,Opatkiewicz; Justin Paul,24,0,25,1
1681931760437,CGS 2A,A01,180420,Staff,30,0,36,6
1681931761460,CGS 101,A00,180421,Staff,15,0,20,5
1681931762486,CGS 112,A00,180422,Staff,8,0,16,8
1681931763512,CGS 113,A00,180423,Staff,18,0,20,2
1681931764541,CGS 137,A00,180424,Staff,12,0,12,0
1681931765570,CGS 147,A00,180425,Staff,10,0,10,0
1681931766596,CHEM 6A,A01,179556,Staff,92,0,100,8
1681931766596,CHEM 6A,A02,179558,Staff,0,0,0,0
1681931767621,CHEM 6B,A01,179560,Staff,100,0,100,0
1681931768647,CHEM 6C,A01,179565,Jazzar; Rodolphe,92,0,100,8
1681931769673,CHEM 7L,A01,179586,Schurmeier; Kimberly,10,0,24,14
1681931769673,CHEM 7L,A02,179587,Schurmeier; Kimberly,23,0,24,1
1681931769673,CHEM 7L,A03,179590,Schurmeier; Kimberly,22,0,24,2
1681931769673,CHEM 7L,A04,179591,Schurmeier; Kimberly,22,0,24,2
1681931769673,CHEM 7L,B01,179598,Schurmeier; Kimberly,15,0,24,9
1681931769673,CHEM 7L,B02,179599,Schurmeier; Kimberly,23,0,24,1
1681931769673,CHEM 7L,B03,179606,Schurmeier; Kimberly,22,0,24,2
1681931769673,CHEM 7L,B04,179607,Schurmeier; Kimberly,22,0,24,2
1681931770699,CHEM 11,A01,179609,Stallings; Dontarie M,87,0,100,13
1681931771721,CHEM 40A,A01,179621,Staff,38,0,50,12
1681931771721,CHEM 40A,A02,179622,Staff,46,0,50,4
1681931772746,CHEM 40B,A01,179630,Weizman; Haim,46,0,50,4
1681931772746,CHEM 40B,A02,179631,Weizman; Haim,43,0,50,7
1681931773778,CHEM 41A,A01,179660,Klosterman; Jeremy K,90,0,100,10
1681931774805,CHEM 43A,A01,179683,Klosterman; Jeremy K,0,0,24,24
1681931774805,CHEM 43A,A02,179688,Klosterman; Jeremy K,5,0,24,19
1681931774805,CHEM 43A,A03,179689,Klosterman; Jeremy K,17,0,24,7
1681931774805,CHEM 43A,A04,179691,Klosterman; Jeremy K,17,0,24,7
1681931775827,CHEM 114A,A01,179693,Stallings; Dontarie M,65,0,100,35
1681931776854,CHEM 143B,A01,179698,Weizman; Haim,16,0,24,8
1681931776854,CHEM 143B,A02,179700,Weizman; Haim,23,0,24,1
1681931777880,CHIN 169A,A00,179701,Wang; Xiao,20,0,20,0
1681931778905,COGS 2,A01,179750,Boyle; Mary E. T.,17,0,30,13
1681931779929,COGS 9,A01,179759,Jones; Cameron Robert,40,0,50,10
1681931780952,COGS 14A,A01,179854,Staff,9,0,50,41
1681931781978,COGS 14B,A01,179856,Staff,52,0,60,8
1681931783002,COGS 17,A01,179874,Staff,70,0,75,5
1681931784028,COGS 18,A01,179884,Staff,59,0,80,21
1681931785050,COGS 100,A01,179886,Staff,31,0,60,29
1681931786076,COGS 101B,A01,179892,Staff,0,2,30,30
1681931787099,COGS 101C,A01,179894,Staff,26,0,30,4
1681931788138,COGS 107A,A01,179896,Boyle; Mary E. T.,28,0,40,12
1681931789161,COGS 108,A01,179898,Simpkins; Charles Alexander,0,32,60,60
1681931790190,COGS 109,A01,179900,Staff,32,0,40,8
1681931791214,COGS 118A,A01,179946,Staff,4,0,40,36
1681931792239,COGS 153,A00,179978,Staff,0,7,30,30
1681931793262,COGS 156,A01,179981,Staff,20,0,30,10
1681931795317,COGS 172,A01,179987,Staff,10,0,30,20
1681931797366,COGS 186,A01,179991,Staff,11,0,30,19
1681931798389,COMM 10,A01,180001,Staff,11,0,25,14
1681931798389,COMM 10,A02,180004,Staff,20,0,25,5
1681931799413,COMM 100A,A01,180016,Staff,13,0,25,12
1681931799413,COMM 100A,A02,180020,Staff,24,0,25,1
1681931800436,COMM 101T,A00,180029,Halm; Gavin Patrick,18,0,35,17
1681931801457,COMM 106V,A00,180043,Staff,34,0,35,1
1681931802482,COMM 109P,A00,180044,Staff,30,0,35,5
1681931803506,COMM 113T,A00,180045,Havis; Allan,36,0,45,9
1681931804532,COMM 132,A00,180046,McKenna; Denise,18,0,30,12
1681931805556,COMM 143,A00,180047,Staff,16,0,30,14
1681931806584,COMM 190,A00,180048,Conner; Thomas Hartnell,16,0,23,7
1681931807610,CSE 8A,A50,180053,Cao; Yingjun,20,0,50,30
1681931807610,CSE 8A,B50,180180,Staff,50,0,50,0
1681931808634,CSE 11,A01,180190,Cao; Yingjun,21,0,50,29
1681931809656,CSE 20,A01,180192,Briones; Jor-el Thomas Caparas,21,0,30,9
1681931810681,CSE 21,A01,194538,Briones; Jor-el Thomas Caparas,49,0,60,11
1681931811708,CSE 30,A01,180324,Eldon; John,72,0,100,28
1681931812731,CSE 101,A01,201353,Staff,0,30,40,40
1681931813758,CSE 134B,A01,180326,Powell; Thomas Allan,71,0,100,29
1681931814787,CSE 140,A01,180328,Staff,22,0,75,53
1681931815810,CSE 140L,A01,180344,Eldon; John,47,0,100,53
1681931816841,CSE 150A,A01,180411,Staff,0,19,50,50
1681931817866,CSE 151A,A01,180414,Staff,0,15,50,50
1681931818893,CSE 175,A01,222521,Kumar; Rakesh,50,0,50,0
1681931819917,CSE 190,A00,201419,Staff,42,0,49,7
1681931820941,CSS 1,A01,194536,Staff,32,0,50,18
1681931821966,DSC 30,A01,202385,Staff,48,0,50,2
1681931822989,DSC 40A,A01,202387,Albuyeh; Rod,50,0,50,0
1681931824034,DSC 190,A01,202389,Silberman; Jack,21,0,21,0
1681931825056,DSGN 100,A01,179993,Staff,13,0,30,17
1681931826080,ECE 65,A50,180708,Staff,10,0,20,10
1681931826080,ECE 65,A51,180739,Staff,19,0,20,1
1681931827109,ECON 1,A01,180427,Famulari; Melissa,66,0,70,4
1681931828131,ECON 2,A01,180450,Levkoff; Steven B.,63,0,70,7
1681931829153,ECON 4,A01,203351,Anderson; John Charles,6,0,10,4
1681931830179,ECON 100A,A01,180472,Famulari; Melissa,59,0,70,11
1681931831202,ECON 120A,A01,180549,Staff,61,0,70,9
1681931832225,ECON 120B,A01,180655,Ma; Xinwei,38,0,70,32
1681931833249,ECON 129,A00,203333,Eckert; Fabian Paul,9,0,35,26
1681931834274,ECON 131,A00,180656,Staff,0,0,35,35
1681931835297,ECON 172B,A01,180672,Levkoff; Steven B.,31,0,35,4
1681931836324,ECON 178,A01,203342,Zhu; Ying,2,0,35,33
1681931837346,EDS 108GS,A00,202383,Wishard Guerra; Alison G.,20,0,20,0
1681931838371,EDS 111GS,A00,202347,Wishard Guerra; Alison G.,20,0,20,0
1681931839394,EDS 112,A01,202323,Staff,53,0,60,7
1681931840417,EDS 113,A00,202340,Staff,32,0,35,3
1681931841442,EDS 118,A00,201231,Staff,19,0,30,11
1681931842464,EDS 119,A00,204994,Staff,8,0,10,2
1681931843490,EDS 124BR,A00,202324,Eguchi; Emi,0,1,25,25
1681931844514,EDS 126,A01,203208,Jones; Makeba,26,0,30,4
1681931845540,EDS 135,A01,202333,Staff,17,0,20,3
1681931846565,EDS 180,A00,202311,Staff,47,0,50,3
1681931847588,ERC 190GS,A01,253747,Staff,28,0,28,0
1681931848612,ETHN 104,A00,180742,Staff,19,0,35,16
1681931849633,ETHN 118,A00,180745,Staff,26,0,35,9
1681931850655,ETHN 127,A00,180747,Staff,8,0,16,8
1681931851680,ETHN 137,A00,180880,Staff,11,0,12,1
1681931852703,ETHN 147,A00,180890,Staff,8,0,10,2
1681931853731,ETHN 154,A00,180891,Staff,5,0,8,3
1681931854759,ETHN 168,A00,180892,Staff,9,0,10,1
1681931855783,GLBH 20,A00,201051,Hannah; Seth Donal,0,7,0,1
1681931856809,GLBH 111,A01,209338,Burgos; Jose L.,0,0,0,0
1681931857832,GLBH 150,A00,258300,Staff,0,4,0,0
1681931858855,GLBH 181,A00,201207,Staff,7,0,40,33
1681931859878,HIEU 109,A00,180898,Staff,19,0,20,1
1681931860901,HIEU 111,A00,180899,Staff,0,2,20,20
1681931862000,HIEU 124,A00,180900,Staff,17,0,20,3
1681931863025,HILA 122,A00,180901,Staff,17,0,20,3
1681931864055,HILA 132,A00,180902,Vitz; Matthew,0,2,20,20
1681931865082,HILD 10,A01,180896,Staff,12,0,20,8
1681931866104,HILD 30GS,A00,180897,Edington; Claire Ellen,0,0,0,0
1681931867126,HISC 105,A00,180903,Staff,20,0,20,0
1681931868151,HISC 117,A00,180904,Staff,10,0,20,10
1681931869173,HIUS 108B,A00,181005,Staff,18,0,20,2
1681931870207,HIUS 113,A00,181093,Staff,1,0,20,19
1681931871239,HUM 3,A01,181190,Patterson; Patrick H.,34,0,50,16
1681931871239,HUM 3,B01,181195,Staff,45,0,50,5
1681931872269,HUM 3GS,A00,181196,Herbst; Matthew,0,0,0,0
1681931873298,HUM 4,A01,181227,West; Geoffrey Scott,33,0,50,17
1681931873298,HUM 4,B01,181282,Staff,41,0,50,9
1681931874323,HUM 4GS,A00,181377,Lyon; Antony J.,0,0,0,0
1681931875346,HUM 5,A01,181536,Zavodny; Tatiana Sophia,23,0,50,27
1681931875346,HUM 5,B01,181908,Staff,32,0,50,18
1681931876373,INTL 190,A00,181909,Segui; Alan S,0,0,0,8
1681931876373,INTL 190,B00,181961,Segui; Alan S,0,0,0,7
1681931877399,JAPN 20AR,A01,182113,Ross; Kayoko F,15,0,20,5
1681931878425,LATI 50,A01,202391,Martin-Cabrera; Luis,17,0,30,13
1681931878425,LATI 50,A02,202392,Martin-Cabrera; Luis,26,0,30,4
1681931879455,LATI 180,A00,202393,Kokinis; Troy Andreas,24,0,25,1
1681931880477,LIFR 1A,A00,182119,Staff,13,0,14,1
1681931881517,LIFR 1AX,A00,182324,Staff,13,0,14,1
1681931882544,LIFR 1B,A00,182259,Staff,12,0,14,2
1681931883577,LIFR 1BX,A00,182273,Staff,12,0,14,2
1681931884601,LIGN 8,A00,182330,Staff,126,0,150,24
1681931885623,LIGN 9GS,A00,182362,Staff,14,0,20,6
1681931886656,LIGN 119,A00,204992,Takahashi; Maho,11,0,15,4
1681931887683,LIGN 130,A01,182384,Staff,47,0,50,3
1681931888722,LIGN 149GS,A00,182390,Staff,14,0,20,6
1681931889745,LIGN 170,A00,182404,Staff,23,0,30,7
1681931890768,LISP 1D,A00,182281,Staff,7,0,14,7
1681931890768,LISP 1D,B00,182287,Staff,13,0,14,1
1681931890768,LISP 1D,C00,182295,Staff,10,0,14,4
1681931890768,LISP 1D,D00,182301,Staff,14,0,14,0
1681931891794,LISP 1DX,A00,182309,Staff,19,0,28,9
1681931891794,LISP 1DX,B00,182316,Staff,25,0,28,3
1681931892822,LTAF 120GS,A00,182412,Zhiri; Oumelbanine,20,0,20,0
1681931893845,LTCS 172GS,A00,182437,Bronstein; Phoebe Malan,20,0,20,0
1681931894881,LTEA 138,A00,182457,Staff,18,0,40,22
1681931895907,LTEN 114,A01,182490,Staff,23,0,25,2
1681931896933,LTEN 130GS,A00,182491,Lyon; Antony J.,20,0,20,0
1681931897961,LTEN 169,A00,182493,Cuong; Marisol,17,0,25,8
1681931898984,LTEN 178,A00,182501,Staff,14,0,15,1
1681931900006,LTEN 181,A00,182515,Staff,19,0,25,6
1681931901029,LTEN 185GS,A00,197655,Forbes; Camille,20,0,20,0
1681931902055,LTSP 100B,A00,202208,Bessett; Ryan Matthew,24,0,25,1
1681931903082,LTWL 100,A00,182516,Myerston Santana; Jacobo,20,0,30,10
1681931904122,LTWR 100GS,A00,182518,Forbes; Camille,20,0,20,0
1681931905144,LTWR 102,A00,182522,Staff,15,0,15,0
1681931905144,LTWR 102,B00,182525,Staff,14,0,15,1
1681931906181,LTWR 115,A00,182526,Staff,10,0,15,5
1681931907207,MAE 8,A01,182528,Pham; Hieu Tan,67,0,70,3
1681931908231,MAE 11,A00,182529,Bahadori; Mohammad Yousef,91,0,100,9
1681931909254,MAE 20,A00,182530,Evdokimenko; Ekaterina,67,0,70,3
1681931910280,MAE 30A,A00,182532,Staff,44,0,45,1
1681931911305,MAE 101A,A00,182533,Bahadori; Mohammad Yousef,93,0,100,7
1681931912331,MAE 101C,A00,182538,Staff,62,0,70,8
1681931913360,MAE 104,A00,182539,Staff,44,0,50,6
1681931914384,MAE 131A,A00,182540,Ghazinejad; Maziar,40,0,45,5
1681931915410,MAE 143A,A00,182548,Bewley; Thomas R,42,0,50,8
1681931916444,MAE 150,A00,182549,Staff,28,0,40,12
1681931917474,MAE 160,A00,182550,Evdokimenko; Ekaterina,40,0,60,20
1681931918497,MATH 3C,A01,182725,Staff,24,0,30,6
1681931919520,MATH 10A,A01,182729,Staff,24,0,30,6
1681931919520,MATH 10A,B01,182732,Staff,25,0,30,5
1681931920554,MATH 10B,A01,182737,Staff,16,0,30,14
1681931920554,MATH 10B,A02,182738,Staff,24,0,30,6
1681931920554,MATH 10B,B01,182744,Staff,24,0,30,6
1681931920554,MATH 10B,B02,182745,Staff,27,0,30,3
1681931921582,MATH 18,A01,182750,Anzaldo; Leesa B,28,0,30,2
1681931921582,MATH 18,A02,182751,Anzaldo; Leesa B,28,0,30,2
1681931921582,MATH 18,A03,182753,Anzaldo; Leesa B,27,0,30,3
1681931921582,MATH 18,A04,182757,Anzaldo; Leesa B,29,0,30,1
1681931921582,MATH 18,B01,182761,Anzaldo; Leesa B,27,0,30,3
1681931921582,MATH 18,B02,182764,Anzaldo; Leesa B,26,0,30,4
1681931921582,MATH 18,B03,182765,Anzaldo; Leesa B,29,0,30,1
1681931921582,MATH 18,B04,182766,Anzaldo; Leesa B,30,0,30,0
1681931922612,MATH 20A,A01,182771,Suk; Andrew Hoon,28,0,30,2
1681931923635,MATH 20B,A01,182775,Bach; Quang Tran,30,0,30,0
1681931923635,MATH 20B,A02,182777,Bach; Quang Tran,29,0,30,1
1681931923635,MATH 20B,B01,182780,Bach; Quang Tran,26,0,30,4
1681931923635,MATH 20B,B02,182782,Bach; Quang Tran,30,0,30,0
1681931924658,MATH 20C,A01,182787,Staff,24,0,30,6
1681931924658,MATH 20C,A02,182790,Staff,29,0,30,1
1681931924658,MATH 20C,B01,182792,Staff,23,0,30,7
1681931924658,MATH 20C,B02,182796,Staff,26,0,30,4
1681931925686,MATH 20D,A01,182799,Staff,27,0,30,3
1681931925686,MATH 20D,A02,182802,Staff,29,0,30,1
1681931925686,MATH 20D,A03,182803,Staff,30,0,30,0
1681931926708,MATH 20E,A01,182809,Verstraete; Jacques Allan,20,0,30,10
1681931926708,MATH 20E,A02,182811,Verstraete; Jacques Allan,28,0,30,2
1681931926708,MATH 20E,B01,182814,Verstraete; Jacques Allan,21,0,30,9
1681931926708,MATH 20E,B02,182815,Verstraete; Jacques Allan,29,0,30,1
1681931927731,MATH 103A,A01,182820,Staff,3,0,30,27
1681931927731,MATH 103A,A02,182821,Staff,27,0,30,3
1681931927731,MATH 103A,A03,182822,Staff,20,0,30,10
1681931927731,MATH 103A,B01,182825,Staff,21,0,30,9
1681931927731,MATH 103A,B02,182826,Staff,30,0,30,0
1681931927731,MATH 103A,B03,182830,Staff,30,0,30,0
1681931928761,MATH 109,A01,182836,Chow; Bennett,23,0,30,7
1681931928761,MATH 109,A02,182838,Chow; Bennett,27,0,30,3
1681931928761,MATH 109,A03,182894,Chow; Bennett,29,0,30,1
1681931928761,MATH 109,B01,182908,Chow; Bennett,27,0,30,3
1681931928761,MATH 109,B02,182909,Chow; Bennett,30,0,30,0
1681931928761,MATH 109,B03,182910,Chow; Bennett,26,0,30,4
1681931929787,MATH 142A,A01,182925,Staff,3,0,30,27
1681931929787,MATH 142A,A02,182935,Staff,23,0,30,7
1681931929787,MATH 142A,A03,182967,Staff,25,0,30,5
1681931929787,MATH 142A,B01,183125,Staff,22,0,30,8
1681931929787,MATH 142A,B02,183157,Staff,26,0,30,4
1681931929787,MATH 142A,B03,183158,Staff,29,0,30,1
1681931930811,MATH 183,A01,183160,Arias-Castro; Ery,22,0,30,8
1681931930811,MATH 183,A02,183161,Arias-Castro; Ery,28,0,30,2
1681931930811,MATH 183,B01,183163,Arias-Castro; Ery,26,0,30,4
1681931930811,MATH 183,B02,183164,Arias-Castro; Ery,28,0,30,2
1681931931834,MATH 193A,A01,183167,Staff,0,0,35,35
1681931931834,MATH 193A,A02,183168,Staff,23,0,35,12
1681931931834,MATH 193A,A03,183169,Staff,34,0,35,1
1681931931834,MATH 193A,A04,183170,Staff,26,0,35,9
1681931932857,MGT 4,A01,202395,Anderson; John Charles,76,0,80,4
1681931933884,MGT 5,A00,202396,Houskeeper; Robert,79,0,90,11
1681931934906,MGT 103,A00,202397,Eberhard; Craig A,49,0,90,41
1681931935936,MGT 131A,A00,202398,Houskeeper; Robert,81,0,90,9
1681931936959,MGT 135,A00,202399,Anderson; John Charles,81,0,90,9
1681931937985,MGT 162R,A00,202403,Gneezy; Uri,120,0,200,80
1681931939009,MGT 172,A00,202404,Hedges; Kathleen,28,0,90,62
1681931940033,MGT 181,A00,202405,Dunn; Louis Jean,79,0,90,11
1681931941060,MMW 14,A01,183200,Staff,0,0,28,28
1681931941060,MMW 14,A02,183201,Staff,25,0,28,3
1681931941060,MMW 14,A03,183202,Staff,24,0,28,4
1681931941060,MMW 14,A04,183203,Staff,25,0,28,3
1681931941060,MMW 14,A05,183204,Staff,26,0,28,2
1681931941060,MMW 14,A06,183205,Staff,27,0,28,1
1681931941060,MMW 14,B01,183207,Staff,26,0,28,2
1681931941060,MMW 14,B02,183208,Staff,28,0,28,0
1681931941060,MMW 14,B03,183209,Staff,28,0,28,0
1681931941060,MMW 14,B04,183210,Staff,28,0,28,0
1681931941060,MMW 14,B05,183211,Staff,28,0,28,0
1681931941060,MMW 14,B06,183212,Staff,27,0,28,1
1681931942082,MMW 14GS,A00,183213,Zhiri; Oumelbanine,28,0,28,0
1681931943108,MMW 15GS,B00,183215,Rahimi; Babak,28,0,28,0
1681931944132,MMW 121,A01,183217,Patterson; Patrick H.,8,0,28,20
1681931944132,MMW 121,A02,183218,Patterson; Patrick H.,25,0,28,3
1681931945155,MUS 1A,A01,182554,Staff,0,0,35,35
1681931946181,MUS 5,A01,182558,Staff,16,0,35,19
1681931947212,MUS 6,A01,182562,Staff,22,0,35,13
1681931948236,MUS 8GS,A00,182563,Borgo; David Garcia,25,0,25,0
1681931949262,MUS 13,A01,182567,Staff,23,0,25,2
1681931950285,MUS 15,A01,182570,Staff,31,0,35,4
1681931950285,MUS 15,B01,182575,Staff,7,0,35,28
1681931951318,MUS 80,A00,182578,Staff,22,0,25,3
1681931951318,MUS 80,B00,182581,Staff,20,0,25,5
1681931952342,MUS 113,A00,182582,Staff,25,0,25,0
1681931953367,MUS 114,A00,182583,Staff,1,0,25,24
1681931954393,MUS 150GS,A01,182588,Borgo; David Garcia,24,0,25,1
1681931955416,PHIL 1,A00,182590,Staff,34,0,40,6
1681931956449,PHIL 10,A01,182596,Grush; Rick Scott,30,0,35,5
1681931956449,PHIL 10,A02,182597,Grush; Rick Scott,33,0,35,2
1681931957471,PHIL 15,A01,182601,Staff,31,0,35,4
1681931957471,PHIL 15,A02,182602,Staff,33,0,35,2
1681931958493,PHIL 27,A01,182604,Staff,25,0,35,10
1681931958493,PHIL 27,A02,182607,Staff,35,0,35,0
1681931959520,PHIL 32,A01,182609,Staff,35,0,35,0
1681931959520,PHIL 32,A02,182612,Staff,35,0,35,0
1681931960544,PHIL 130,A00,182614,Staff,57,0,70,13
1681931961573,PHIL 136,A00,182616,Cohen; Jonathan David,64,0,70,6
1681931962596,PHIL 155,A00,182617,Vargas; Manuel Rogelio,57,0,70,13
1681931963619,PHIL 163,A01,182620,Staff,15,0,20,5
1681931963619,PHIL 163,A02,182624,Staff,10,0,20,10
1681931964646,PHIL 164,A00,182627,Staff,29,0,40,11
1681931965749,PHIL 173,A00,182628,Staff,35,0,40,5
1681931966770,PHYS 1A,A00,183221,Staff,53,0,60,7
1681931967794,PHYS 1AL,001,183222,Staff,25,0,30,5
1681931967794,PHYS 1AL,002,183223,Staff,24,0,30,6
1681931968819,PHYS 1B,A00,183231,Staff,40,0,60,20
1681931969844,PHYS 1BL,001,183232,Staff,15,0,30,15
1681931969844,PHYS 1BL,002,183233,Staff,27,0,30,3
1681931970867,PHYS 1C,A00,183240,Staff,20,0,60,40
1681931971889,PHYS 1CL,001,183241,Staff,8,0,30,22
1681931971889,PHYS 1CL,002,183242,Staff,21,0,30,9
1681931972911,PHYS 2AR,A01,183250,Staff,39,0,50,11
1681931973937,PHYS 2B,A01,183252,Staff,101,0,115,14
1681931974959,PHYS 2BL,A01,183254,Staff,21,0,24,3
1681931974959,PHYS 2BL,A02,183255,Staff,21,0,24,3
1681931975986,PHYS 2C,A01,183522,Staff,100,0,115,15
1681931977008,PHYS 4A,A01,183524,Staff,49,0,50,1
1681931978031,POLI 5,A00,183525,Staff,44,0,50,6
1681931979054,POLI 12,A00,183540,Staff,45,0,50,5
1681931980084,POLI 13R,A00,183541,Forman; Fonna,40,0,50,10
1681931981109,POLI 30,A00,183542,Mignozzetti; Umberto,48,0,50,2
1681931982131,POLI 100A,A00,183543,Staff,43,0,50,7
1681931983153,POLI 100E,A00,223598,Staff,32,0,35,3
1681931984177,POLI 103A,A00,183564,Kousser; Thad,34,0,50,16
1681931985199,POLI 104B,A00,201329,Staff,27,0,35,8
1681931986222,POLI 113BR,A00,183576,Hoston; Germaine,22,0,50,28
1681931987248,POLI 114BR,A00,183588,Staff,26,0,30,4
1681931988270,POLI 117R,A00,183595,Forman; Fonna,3,0,20,17
1681931989312,POLI 120H,A00,183596,Fisk; David Lee,13,0,20,7
1681931990337,POLI 130AA,A00,183597,Staff,13,0,20,7
1681931991360,POLI 134AA,A00,183598,Staff,19,0,20,1
1681931992397,POLI 135,A00,183599,Fisk; David Lee,19,0,25,6
1681931993433,POLI 142P,A00,183623,Staff,37,0,40,3
1681931994465,POLI 144D,A00,183624,Staff,22,0,25,3
1681931995488,POLI 151,A00,183625,Staff,14,0,20,6
1681931996521,POLI 162,A00,183626,Mignozzetti; Umberto,17,0,20,3
1681931997555,PSYC 1,A00,253748,Staff,85,0,90,5
1681931998586,PSYC 2,A00,183627,Moranton; Nirelia Melbina-,23,0,35,12
1681931999614,PSYC 3,A00,183628,Staff,43,0,45,2
1681932001666,PSYC 60,A01,183631,Lowe; Angela Beth,35,0,40,5
1681932002703,PSYC 70,A01,253757,Staff,34,0,45,11
1681932003726,PSYC 101,A00,183632,Heyman; Gail D.,41,0,60,19
1681932004754,PSYC 105,A00,183848,Lowe; Angela Beth,45,0,60,15
1681932005777,PSYC 106,A00,183849,Dobkins; Karen R.,39,0,60,21
1681932006802,PSYC 108,A00,253750,Staff,12,0,60,48
1681932007825,PSYC 114,A01,184275,Winkielman; Piotr,0,8,30,30
1681932008852,PSYC 122,A00,183856,Moranton; Nirelia Melbina-,0,16,30,30
1681932009900,PSYC 124,A00,183865,Chapman; Eddie Nathaniel,43,0,80,37
1681932010924,PSYC 137,A00,183880,Staff,17,0,25,8
1681932012986,PSYC 154,A00,183910,Lacefield; Katharine I,0,30,90,90
1681932015036,PSYC 162,A00,183946,Wixted; John T,38,0,90,52
1681932016057,PSYC 172,A00,183947,Gorman; Michael R.,5,0,30,25
1681932017086,PSYC 178,A00,183963,Glaser; Dale,14,0,40,26
1681932018116,PSYC 181GS,A00,183964,Anagnostaras; Stephan,10,0,10,0
1681932019145,PSYC 186GS,A01,257660,Staff,10,0,10,0
1681932020179,PSYC 193,B00,253749,Staff,22,0,25,3
1681932022233,PSYC 193L,A01,184122,Staff,33,0,35,2
1681932022233,PSYC 193L,C01,184167,Winkielman; Piotr,14,0,30,16
1681932023255,RELI 188GS,A00,182629,Rahimi; Babak,20,0,20,0
1681932024279,SE 101A,A00,182646,Staff,26,0,30,4
1681932025304,SE 101C,A00,182650,Staff,12,0,20,8
1681932026332,SE 110A,A00,182651,Staff,28,0,28,0
1681932027355,SE 130A,A00,182652,Staff,38,0,40,2
1681932028378,SIO 46GS,A00,182636,Cook; Geoffrey W,24,0,28,4
1681932029400,SIO 109R,A00,194459,Staff,0,1,20,20
1681932030425,SIO 121GS,A00,182639,Cook; Geoffrey W,24,0,28,4
1681932031451,SIO 132,A01,182642,Staff,30,0,40,10
1681932032473,SIO 139,A00,182644,Kacev; David,36,0,40,4
1681932033496,SOCI 2,A01,258404,Staff,33,0,36,3
1681932033496,SOCI 2,A02,258405,Staff,35,0,36,1
1681932034526,SOCI 60,A01,258408,Staff,29,0,30,1
1681932034526,SOCI 60,A02,258413,Staff,30,0,30,0
1681932035550,SOCI 100,A01,258415,Staff,28,0,30,2
1681932035550,SOCI 100,A02,258416,Staff,28,0,30,2
1681932041712,SOCI 127,A00,258421,Staff,19,0,30,11
1681932042739,SOCI 132,A00,258422,Staff,42,0,50,8
1681932043762,SOCI 133,A00,258423,Staff,26,0,30,4
1681932044784,SOCI 138GS,A00,258424,Staff,15,0,15,0
1681932045807,SOCI 145,A00,258425,Staff,23,0,30,7
1681932046832,SOCI 148,A00,258426,Staff,23,0,30,7
1681932047856,SOCI 153,A00,199217,Staff,29,0,30,1
1681932048879,SOCI 160,A00,258427,Staff,27,0,30,3
1681932049902,SOCI 160E,A00,258435,Staff,55,0,60,5
1681932050930,SOCI 189GS,A00,258436,Staff,15,0,15,0
1681932051956,SOCI 190GS,A00,258437,Staff,15,0,15,0
1681932052987,SYN 2,001,182658,Staff,8,0,16,8
1681932052987,SYN 2,002,201439,Staff,13,0,16,3
1681932052987,SYN 2,003,201443,Staff,16,0,16,0
1681932054015,SYN 100,A01,182657,Staff,12,0,20,8
1681932055047,TDAC 1,A00,184381,Salovey; Todd,16,0,20,4
1681932055047,TDAC 1,B00,184385,Harting; Carla Kelso,19,0,20,1
1681932055047,TDAC 1,C00,184394,Staff,18,0,20,2
1681932056076,TDAC 101,A00,184483,Harting; Carla Kelso,19,0,20,1
1681932057106,TDDE 111,A00,184496,Staff,14,0,15,1
1681932058130,TDDE 131,A00,184504,Staff,20,0,20,0
1681932058130,TDDE 131,B00,184505,Staff,17,0,18,1
1681932058130,TDDE 131,C00,184534,Staff,49,0,50,1
1681932058130,TDDE 131,D00,184564,Staff,15,0,15,0
1681932058130,TDDE 131,E00,204725,Staff,18,0,20,2
1681932059153,TDGE 1,A01,184414,Salovey; Todd,35,0,50,15
1681932060179,TDGE 5,A01,184419,Staff,23,0,24,1
1681932061221,TDGE 10,A00,184428,Fulton; Julia,27,0,50,23
1681932062243,TDGE 124,A00,184565,Fulton; Julia,0,3,50,50
1681932063267,TDGE 125,B00,184567,Meyer; Ursula,8,0,25,17
1681932064298,TDHT 101,A00,184568,Staff,21,0,25,4
1681932064298,TDHT 101,B00,184569,Staff,20,0,20,0
1681932065321,TDHT 114,A00,184570,Staff,48,0,50,2
1681932066345,TDMV 1,A00,184437,Arcidiacono; Kristin,21,0,30,9
1681932066345,TDMV 1,B00,184448,Caligagan; Maria T.,23,0,30,7
1681932067372,TDMV 2,A00,184449,Weinberg; Sadie,26,0,30,4
1681932067372,TDMV 2,B00,184453,Arcidiacono; Kristin,29,0,30,1
1681932068394,TDMV 110,A00,184571,Weinberg; Sadie,30,0,30,0
1681932069494,TDMV 142,A00,184572,Caligagan; Tony,26,0,30,4
1681932069494,TDMV 142,B00,184573,Caligagan; Maria T.,26,0,30,4
1681932070516,TDTR 20,A00,184482,Jun; Grace Shin Hae,25,0,25,0
1681932071538,USP 2,A01,184290,Hinds; Juli Beth,23,0,25,2
1681932072573,USP 3,A01,184295,Staff,20,0,25,5
1681932073605,USP 4,A00,184304,McTague; Sarah,13,0,25,12
1681932074636,USP 100,A00,184315,Staff,16,0,25,9
1681932075661,USP 105,A00,184326,Staff,21,0,25,4
1681932076683,USP 151,A00,184327,Staff,17,0,25,8
1681932077713,USP 170,A00,184380,Hinds; Juli Beth,12,0,25,13
1681932078738,VIS 21B,A01,182660,Staff,28,0,31,3
1681932078738,VIS 21B,A02,182662,Staff,30,0,31,1
1681932079761,VIS 103D,A00,182663,Staff,74,0,75,1
1681932080787,VIS 105D,A00,182667,Li; Huai,14,0,22,8
1681932081813,VIS 122GS,A00,182668,Herbst; Matthew,20,0,20,0
1681932082838,VIS 128C,A00,182673,Staff,69,0,75,6
1681932083863,VIS 130,A00,182675,Staff,19,0,22,3
1681932084886,VIS 160A,A00,182678,Stalbaum; Brett,4,0,10,6
1681932086946,WCWP 10B,A00,201679,Staff,15,0,15,0
1681932086946,WCWP 10B,B00,201695,Staff,15,0,15,0
1681932087977,WCWP 100,A00,201716,Staff,12,0,15,3
1681932087977,WCWP 100,B00,201717,Staff,1,0,15,14
1681932090071,ANSC 105GS,A00,258289,Staff,0,0,0,0
1681932091099,ANSC 125GS,A00,258295,Staff,0,0,0,0
1681932092129,ANSC 150,A00,258267,Staff,27,0,40,13
1681932093157,ANSC 190GS,A00,258280,Staff,0,0,0,2
1681932094183,ANTH 1,A00,258264,Staff,38,0,40,2
1681932095209,ANTH 2,A01,258259,Staff,72,0,76,4
1681932096233,ANTH 23,A01,258228,Staff,35,0,40,5
1681932097260,ANTH 101,A01,258236,Staff,38,0,40,2
1681932098284,ANTH 102,A00,258272,Staff,59,0,60,1
1681932099307,ANTH 105,A00,258244,Staff,28,0,35,7
1681932100330,BENG 130,A00,253975,Staff,37,0,40,3
1681932101359,BIBC 102,A01,191866,Flagg; Matthew Paul,16,0,32,16
1681932101359,BIBC 102,A02,191867,Flagg; Matthew Paul,21,0,32,11
1681932101359,BIBC 102,A03,191868,Flagg; Matthew Paul,27,0,32,5
1681932101359,BIBC 102,A04,191936,Flagg; Matthew Paul,20,0,32,12
1681932101359,BIBC 102,A05,191937,Flagg; Matthew Paul,0,0,32,32
1681932102382,BICD 100,A01,191939,Cooper; Andrew Michael,27,0,32,5
1681932102382,BICD 100,A02,191940,Cooper; Andrew Michael,32,0,32,0
1681932102382,BICD 100,A03,191941,Cooper; Andrew Michael,32,0,32,0
1681932102382,BICD 100,A04,191942,Cooper; Andrew Michael,32,0,32,0
1681932102382,BICD 100,A05,191943,Cooper; Andrew Michael,32,0,32,0
1681932103418,BIEB 126,A01,191945,Cleland; Elsa Eleanor,0,4,32,32
1681932103418,BIEB 126,A02,191946,Cleland; Elsa Eleanor,26,0,32,6
1681932103418,BIEB 126,A03,191947,Cleland; Elsa Eleanor,29,0,32,3
1681932103418,BIEB 126,A04,191948,Cleland; Elsa Eleanor,16,0,32,16
1681932103418,BIEB 126,A05,191996,Cleland; Elsa Eleanor,28,0,32,4
1681932104452,BIEB 136GS,A00,191997,Shurin; Jonathan & Holway; David A.,0,0,0,9
1681932105478,BIEB 137GS,A01,191999,Shurin; Jonathan & Holway; David A.,0,0,0,8
1681932106506,BILD 1,A01,205385,Staff,30,0,32,2
1681932106506,BILD 1,A02,205386,Staff,30,0,32,2
1681932106506,BILD 1,A03,205387,Staff,31,0,32,1
1681932106506,BILD 1,A04,205388,Staff,25,0,32,7
1681932107529,BILD 2,A01,191774,Staff,27,0,32,5
1681932107529,BILD 2,A02,191775,Staff,30,0,32,2
1681932107529,BILD 2,A03,191777,Staff,29,0,32,3
1681932107529,BILD 2,A04,191856,Staff,30,0,32,2
1681932107529,BILD 2,A05,191857,Staff,31,0,32,1
1681932107529,BILD 2,A06,191858,Staff,32,0,32,0
1681932107529,BILD 2,A07,191859,Staff,31,0,32,1
1681932108554,BILD 3,A01,205391,Staff,27,0,32,5
1681932108554,BILD 3,A02,205393,Staff,32,0,32,0
1681932108554,BILD 3,A03,205394,Staff,27,0,32,5
1681932108554,BILD 3,A04,205395,Staff,32,0,32,0
1681932109584,BILD 20,A01,191861,Staff,32,0,32,0
1681932109584,BILD 20,A02,191862,Staff,32,0,32,0
1681932110616,BILD 30,A01,191864,Staff,31,0,32,1
1681932111641,BIMM 100,A01,192019,Staff,0,0,32,32
1681932111641,BIMM 100,A02,192020,Staff,15,0,32,17
1681932111641,BIMM 100,A03,192035,Staff,17,0,32,15
1681932112674,BIMM 110,A01,192037,Tat; John,0,0,32,32
1681932112674,BIMM 110,A02,192038,Tat; John,4,0,32,28
1681932113700,BIMM 120,A01,192040,Pickett; Brooke Elizabeth,0,0,32,32
1681932113700,BIMM 120,A02,192041,Pickett; Brooke Elizabeth,7,0,32,25
1681932113700,BIMM 120,A03,192042,Pickett; Brooke Elizabeth,13,0,32,19
1681932114722,BIPN 100,A01,192044,Armour; Jon Christopher,23,0,32,9
1681932114722,BIPN 100,A02,192059,Armour; Jon Christopher,30,0,32,2
1681932114722,BIPN 100,A03,192064,Armour; Jon Christopher,30,0,32,2
1681932114722,BIPN 100,A04,192073,Armour; Jon Christopher,26,0,32,6
1681932115748,BIPN 148,A01,205411,Leutgeb; Jill K.,14,0,32,18
1681932115748,BIPN 148,A02,205412,Leutgeb; Jill K.,31,0,32,1
1681932115748,BIPN 148,A03,205413,Leutgeb; Jill K.,29,0,32,3
1681932115748,BIPN 148,A04,205414,Leutgeb; Jill K.,30,0,32,2
1681932116785,BIPN 160,A01,192115,Marino; Marc J,15,0,32,17
1681932116785,BIPN 160,A02,192148,Marino; Marc J,27,0,32,5
1681932116785,BIPN 160,A03,192158,Marino; Marc J,31,0,32,1
1681932116785,BIPN 160,A04,192190,Marino; Marc J,32,0,32,0
1681932116785,BIPN 160,A05,192287,Marino; Marc J,32,0,32,0
1681932116785,BIPN 160,A06,192288,Marino; Marc J,32,0,32,0
1681932117816,BIPN 194,A00,206038,Leutgeb; Stefan,28,0,32,4
1681932118841,BISP 194,A00,192289,Nieh; James Charles,9,0,32,23
1681932118841,BISP 194,B00,245332,Staff,26,0,32,6
1681932119865,CAT 124,A01,202247,Staff,15,0,15,0
1681932120896,CAT 125,A00,202248,Staff,18,0,20,2
1681932120896,CAT 125,B00,202253,Staff,20,0,20,0
1681932120896,CAT 125,C00,202257,Staff,18,0,20,2
1681932121922,CAT 125GS,A01,202273,Bronstein; Phoebe Malan,20,0,20,0
1681932122944,CAT 125R,A00,202284,Staff,17,0,20,3
1681932122944,CAT 125R,C00,202286,Staff,5,0,20,15
1681932122944,CAT 125R,D00,202291,Staff,17,0,20,3
1681932122944,CAT 125R,E00,202295,Staff,13,0,20,7
1681932122944,CAT 125R,F00,202302,Staff,6,0,20,14
1681932123971,CENG 100,A00,204724,Opatkiewicz; Justin Paul,24,0,25,1
1681932124997,CGS 2A,A01,180420,Staff,30,0,36,6
1681932126021,CGS 101,A00,180421,Staff,15,0,20,5
1681932127046,CGS 112,A00,180422,Staff,8,0,16,8
1681932128080,CGS 113,A00,180423,Staff,18,0,20,2
1681932129111,CGS 137,A00,180424,Staff,12,0,12,0
1681932130133,CGS 147,A00,180425,Staff,10,0,10,0
1681932131159,CHEM 6A,A01,179556,Staff,92,0,100,8
1681932131159,CHEM 6A,A02,179558,Staff,0,0,0,0
1681932132189,CHEM 6B,A01,179560,Staff,100,0,100,0
1681932133217,CHEM 6C,A01,179565,Jazzar; Rodolphe,91,0,100,9
1681932134256,CHEM 7L,A01,179586,Schurmeier; Kimberly,10,0,24,14
1681932134256,CHEM 7L,A02,179587,Schurmeier; Kimberly,23,0,24,1
1681932134256,CHEM 7L,A03,179590,Schurmeier; Kimberly,22,0,24,2
1681932134256,CHEM 7L,A04,179591,Schurmeier; Kimberly,22,0,24,2
1681932134256,CHEM 7L,B01,179598,Schurmeier; Kimberly,14,0,24,10
1681932134256,CHEM 7L,B02,179599,Schurmeier; Kimberly,23,0,24,1
1681932134256,CHEM 7L,B03,179606,Schurmeier; Kimberly,22,0,24,2
1681932134256,CHEM 7L,B04,179607,Schurmeier; Kimberly,22,0,24,2
1681932135287,CHEM 11,A01,179609,Stallings; Dontarie M,86,0,100,14
1681932136310,CHEM 40A,A01,179621,Staff,38,0,50,12
1681932136310,CHEM 40A,A02,179622,Staff,46,0,50,4
1681932137340,CHEM 40B,A01,179630,Weizman; Haim,46,0,50,4
1681932137340,CHEM 40B,A02,179631,Weizman; Haim,43,0,50,7
1681932138366,CHEM 41A,A01,179660,Klosterman; Jeremy K,90,0,100,10
1681932139395,CHEM 43A,A01,179683,Klosterman; Jeremy K,0,0,24,24
1681932139395,CHEM 43A,A02,179688,Klosterman; Jeremy K,5,0,24,19
1681932139395,CHEM 43A,A03,179689,Klosterman; Jeremy K,17,0,24,7
1681932139395,CHEM 43A,A04,179691,Klosterman; Jeremy K,17,0,24,7
1681932140421,CHEM 114A,A01,179693,Stallings; Dontarie M,65,0,100,35
1681932141443,CHEM 143B,A01,179698,Weizman; Haim,16,0,24,8
1681932141443,CHEM 143B,A02,179700,Weizman; Haim,23,0,24,1
1681932142465,CHIN 169A,A00,179701,Wang; Xiao,20,0,20,0
1681932143489,COGS 2,A01,179750,Boyle; Mary E. T.,16,0,30,14
1681932144512,COGS 9,A01,179759,Jones; Cameron Robert,40,0,50,10
1681932145537,COGS 14A,A01,179854,Staff,9,0,50,41
1681932146560,COGS 14B,A01,179856,Staff,52,0,60,8
1681932147590,COGS 17,A01,179874,Staff,70,0,75,5
1681932148613,COGS 18,A01,179884,Staff,59,0,80,21
1681932149635,COGS 100,A01,179886,Staff,31,0,60,29
1681932150657,COGS 101B,A01,179892,Staff,0,2,30,30
1681932151685,COGS 101C,A01,179894,Staff,26,0,30,4
1681932152708,COGS 107A,A01,179896,Boyle; Mary E. T.,28,0,40,12
1681932153730,COGS 108,A01,179898,Simpkins; Charles Alexander,0,32,60,60
1681932154755,COGS 109,A01,179900,Staff,32,0,40,8
1681932155786,COGS 118A,A01,179946,Staff,4,0,40,36
1681932156809,COGS 153,A00,179978,Staff,0,7,30,30
1681932157835,COGS 156,A01,179981,Staff,20,0,30,10
1681932159882,COGS 172,A01,179987,Staff,10,0,30,20
1681932161937,COGS 186,A01,179991,Staff,11,0,30,19
1681932162962,COMM 10,A01,180001,Staff,11,0,25,14
1681932162962,COMM 10,A02,180004,Staff,20,0,25,5
1681932163985,COMM 100A,A01,180016,Staff,13,0,25,12
1681932163985,COMM 100A,A02,180020,Staff,24,0,25,1
1681932165013,COMM 101T,A00,180029,Halm; Gavin Patrick,17,0,35,18
1681932166034,COMM 106V,A00,180043,Staff,34,0,35,1
1681932167129,COMM 109P,A00,180044,Staff,30,0,35,5
1681932168155,COMM 113T,A00,180045,Havis; Allan,35,0,45,10
1681932169180,COMM 132,A00,180046,McKenna; Denise,18,0,30,12
1681932170209,COMM 143,A00,180047,Staff,16,0,30,14
1681932171235,COMM 190,A00,180048,Conner; Thomas Hartnell,16,0,23,7
1681932172259,CSE 8A,A50,180053,Cao; Yingjun,20,0,50,30
1681932172259,CSE 8A,B50,180180,Staff,50,0,50,0
1681932173358,CSE 11,A01,180190,Cao; Yingjun,21,0,50,29
1681932174385,CSE 20,A01,180192,Briones; Jor-el Thomas Caparas,21,0,30,9
1681932175407,CSE 21,A01,194538,Briones; Jor-el Thomas Caparas,49,0,60,11
1681932176438,CSE 30,A01,180324,Eldon; John,72,0,100,28
1681932177461,CSE 101,A01,201353,Staff,0,30,40,40
1681932178485,CSE 134B,A01,180326,Powell; Thomas Allan,71,0,100,29
1681932179508,CSE 140,A01,180328,Staff,21,0,75,54
1681932180534,CSE 140L,A01,180344,Eldon; John,46,0,100,54
1681932181577,CSE 150A,A01,180411,Staff,0,20,50,50
1681932182599,CSE 151A,A01,180414,Staff,0,15,50,50
1681932183621,CSE 175,A01,222521,Kumar; Rakesh,50,0,50,0
1681932184647,CSE 190,A00,201419,Staff,42,0,49,7
1681932185670,CSS 1,A01,194536,Staff,32,0,50,18
1681932186696,DSC 30,A01,202385,Staff,48,0,50,2
1681932187723,DSC 40A,A01,202387,Albuyeh; Rod,50,0,50,0
1681932188748,DSC 190,A01,202389,Silberman; Jack,21,0,21,0
1681932189776,DSGN 100,A01,179993,Staff,13,0,30,17
1681932190802,ECE 65,A50,180708,Staff,10,0,20,10
1681932190802,ECE 65,A51,180739,Staff,19,0,20,1
1681932191825,ECON 1,A01,180427,Famulari; Melissa,66,0,70,4
1681932192847,ECON 2,A01,180450,Levkoff; Steven B.,63,0,70,7
1681932193871,ECON 4,A01,203351,Anderson; John Charles,6,0,10,4
1681932194894,ECON 100A,A01,180472,Famulari; Melissa,59,0,70,11
1681932195920,ECON 120A,A01,180549,Staff,61,0,70,9
1681932196943,ECON 120B,A01,180655,Ma; Xinwei,37,0,70,33
1681932197975,ECON 129,A00,203333,Eckert; Fabian Paul,8,0,35,27
1681932198997,ECON 131,A00,180656,Staff,0,1,35,35
1681932200022,ECON 172B,A01,180672,Levkoff; Steven B.,31,0,35,4
1681932201048,ECON 178,A01,203342,Zhu; Ying,2,0,35,33
1681932202087,EDS 108GS,A00,202383,Wishard Guerra; Alison G.,20,0,20,0
1681932203113,EDS 111GS,A00,202347,Wishard Guerra; Alison G.,20,0,20,0
1681932204149,EDS 112,A01,202323,Staff,53,0,60,7
1681932205179,EDS 113,A00,202340,Staff,32,0,35,3
1681932206211,EDS 118,A00,201231,Staff,19,0,30,11
1681932207238,EDS 119,A00,204994,Staff,8,0,10,2
1681932208264,EDS 124BR,A00,202324,Eguchi; Emi,0,2,25,25
1681932209287,EDS 126,A01,203208,Jones; Makeba,26,0,30,4
1681932210310,EDS 135,A01,202333,Staff,17,0,20,3
1681932211333,EDS 180,A00,202311,Staff,47,0,50,3
1681932212357,ERC 190GS,A01,253747,Staff,28,0,28,0
1681932213381,ETHN 104,A00,180742,Staff,20,0,35,15
1681932214404,ETHN 118,A00,180745,Staff,26,0,35,9
1681932215427,ETHN 127,A00,180747,Staff,8,0,16,8
1681932216452,ETHN 137,A00,180880,Staff,11,0,12,1
1681932217477,ETHN 147,A00,180890,Staff,8,0,10,2
1681932218516,ETHN 154,A00,180891,Staff,5,0,8,3
1681932219542,ETHN 168,A00,180892,Staff,9,0,10,1
1681932220565,GLBH 20,A00,201051,Hannah; Seth Donal,0,7,0,1
1681932221587,GLBH 111,A01,209338,Burgos; Jose L.,0,0,0,0
1681932222610,GLBH 150,A00,258300,Staff,0,4,0,0
1681932223636,GLBH 181,A00,201207,Staff,5,0,40,35
1681932224658,HIEU 109,A00,180898,Staff,19,0,20,1
1681932225692,HIEU 111,A00,180899,Staff,0,2,20,20
1681932226719,HIEU 124,A00,180900,Staff,17,0,20,3
1681932227748,HILA 122,A00,180901,Staff,17,0,20,3
1681932228778,HILA 132,A00,180902,Vitz; Matthew,0,2,20,20
1681932229799,HILD 10,A01,180896,Staff,12,0,20,8
1681932230824,HILD 30GS,A00,180897,Edington; Claire Ellen,0,0,0,0
1681932231849,HISC 105,A00,180903,Staff,20,0,20,0
1681932232878,HISC 117,A00,180904,Staff,10,0,20,10
1681932233905,HIUS 108B,A00,181005,Staff,18,0,20,2
1681932234930,HIUS 113,A00,181093,Staff,1,0,20,19
1681932235956,HUM 3,A01,181190,Patterson; Patrick H.,34,0,50,16
1681932235956,HUM 3,B01,181195,Staff,45,0,50,5
1681932236981,HUM 3GS,A00,181196,Herbst; Matthew,0,0,0,0
1681932238007,HUM 4,A01,181227,West; Geoffrey Scott,33,0,50,17
1681932238007,HUM 4,B01,181282,Staff,41,0,50,9
1681932239039,HUM 4GS,A00,181377,Lyon; Antony J.,0,0,0,0
1681932240067,HUM 5,A01,181536,Zavodny; Tatiana Sophia,23,0,50,27
1681932240067,HUM 5,B01,181908,Staff,32,0,50,18
1681932241090,INTL 190,A00,181909,Segui; Alan S,0,0,0,8
1681932241090,INTL 190,B00,181961,Segui; Alan S,0,0,0,7
1681932242117,JAPN 20AR,A01,182113,Ross; Kayoko F,15,0,20,5
1681932243139,LATI 50,A01,202391,Martin-Cabrera; Luis,17,0,30,13
1681932243139,LATI 50,A02,202392,Martin-Cabrera; Luis,26,0,30,4
1681932244170,LATI 180,A00,202393,Kokinis; Troy Andreas,24,0,25,1
1681932245192,LIFR 1A,A00,182119,Staff,13,0,14,1
1681932246216,LIFR 1AX,A00,182324,Staff,13,0,14,1
1681932247241,LIFR 1B,A00,182259,Staff,12,0,14,2
1681932248270,LIFR 1BX,A00,182273,Staff,12,0,14,2
1681932249294,LIGN 8,A00,182330,Staff,126,0,150,24
1681932250316,LIGN 9GS,A00,182362,Staff,14,0,20,6
1681932251339,LIGN 119,A00,204992,Takahashi; Maho,11,0,15,4
1681932252378,LIGN 130,A01,182384,Staff,47,0,50,3
1681932253404,LIGN 149GS,A00,182390,Staff,14,0,20,6
1681932254438,LIGN 170,A00,182404,Staff,23,0,30,7
1681932255466,LISP 1D,A00,182281,Staff,7,0,14,7
1681932255466,LISP 1D,B00,182287,Staff,13,0,14,1
1681932255466,LISP 1D,C00,182295,Staff,10,0,14,4
1681932255466,LISP 1D,D00,182301,Staff,14,0,14,0
1681932256496,LISP 1DX,A00,182309,Staff,19,0,28,9
1681932256496,LISP 1DX,B00,182316,Staff,25,0,28,3
1681932257518,LTAF 120GS,A00,182412,Zhiri; Oumelbanine,20,0,20,0
1681932258541,LTCS 172GS,A00,182437,Bronstein; Phoebe Malan,20,0,20,0
1681932259564,LTEA 138,A00,182457,Staff,18,0,40,22
1681932260586,LTEN 114,A01,182490,Staff,23,0,25,2
1681932261611,LTEN 130GS,A00,182491,Lyon; Antony J.,20,0,20,0
1681932262634,LTEN 169,A00,182493,Cuong; Marisol,17,0,25,8
1681932263659,LTEN 178,A00,182501,Staff,14,0,15,1
1681932264697,LTEN 181,A00,182515,Staff,19,0,25,6
1681932265719,LTEN 185GS,A00,197655,Forbes; Camille,20,0,20,0
1681932266752,LTSP 100B,A00,202208,Bessett; Ryan Matthew,24,0,25,1
1681932267775,LTWL 100,A00,182516,Myerston Santana; Jacobo,20,0,30,10
1681932268800,LTWR 100GS,A00,182518,Forbes; Camille,20,0,20,0
1681932269825,LTWR 102,A00,182522,Staff,15,0,15,0
1681932269825,LTWR 102,B00,182525,Staff,14,0,15,1
1681932270849,LTWR 115,A00,182526,Staff,10,0,15,5
1681932271877,MAE 8,A01,182528,Pham; Hieu Tan,67,0,70,3
1681932272902,MAE 11,A00,182529,Bahadori; Mohammad Yousef,91,0,100,9
1681932273927,MAE 20,A00,182530,Evdokimenko; Ekaterina,67,0,70,3
1681932274955,MAE 30A,A00,182532,Staff,44,0,45,1
1681932275982,MAE 101A,A00,182533,Bahadori; Mohammad Yousef,93,0,100,7
1681932277081,MAE 101C,A00,182538,Staff,62,0,70,8
1681932278112,MAE 104,A00,182539,Staff,44,0,50,6
1681932279137,MAE 131A,A00,182540,Ghazinejad; Maziar,40,0,45,5
1681932280182,MAE 143A,A00,182548,Bewley; Thomas R,42,0,50,8
1681932281219,MAE 150,A00,182549,Staff,28,0,40,12
1681932282242,MAE 160,A00,182550,Evdokimenko; Ekaterina,40,0,60,20
1681932283266,MATH 3C,A01,182725,Staff,24,0,30,6
1681932284292,MATH 10A,A01,182729,Staff,24,0,30,6
1681932284292,MATH 10A,B01,182732,Staff,25,0,30,5
1681932285316,MATH 10B,A01,182737,Staff,16,0,30,14
1681932285316,MATH 10B,A02,182738,Staff,24,0,30,6
1681932285316,MATH 10B,B01,182744,Staff,24,0,30,6
1681932285316,MATH 10B,B02,182745,Staff,27,0,30,3
1681932286342,MATH 18,A01,182750,Anzaldo; Leesa B,28,0,30,2
1681932286342,MATH 18,A02,182751,Anzaldo; Leesa B,28,0,30,2
1681932286342,MATH 18,A03,182753,Anzaldo; Leesa B,27,0,30,3
1681932286342,MATH 18,A04,182757,Anzaldo; Leesa B,29,0,30,1
1681932286342,MATH 18,B01,182761,Anzaldo; Leesa B,27,0,30,3
1681932286342,MATH 18,B02,182764,Anzaldo; Leesa B,26,0,30,4
1681932286342,MATH 18,B03,182765,Anzaldo; Leesa B,29,0,30,1
1681932286342,MATH 18,B04,182766,Anzaldo; Leesa B,30,0,30,0
1681932287371,MATH 20A,A01,182771,Suk; Andrew Hoon,28,0,30,2
1681932288400,MATH 20B,A01,182775,Bach; Quang Tran,30,0,30,0
1681932288400,MATH 20B,A02,182777,Bach; Quang Tran,29,0,30,1
1681932288400,MATH 20B,B01,182780,Bach; Quang Tran,26,0,30,4
1681932288400,MATH 20B,B02,182782,Bach; Quang Tran,30,0,30,0
1681932289427,MATH 20C,A01,182787,Staff,24,0,30,6
1681932289427,MATH 20C,A02,182790,Staff,29,0,30,1
1681932289427,MATH 20C,B01,182792,Staff,23,0,30,7
1681932289427,MATH 20C,B02,182796,Staff,26,0,30,4
1681932290453,MATH 20D,A01,182799,Staff,27,0,30,3
1681932290453,MATH 20D,A02,182802,Staff,29,0,30,1
1681932290453,MATH 20D,A03,182803,Staff,30,0,30,0
1681932291475,MATH 20E,A01,182809,Verstraete; Jacques Allan,20,0,30,10
1681932291475,MATH 20E,A02,182811,Verstraete; Jacques Allan,27,0,30,3
1681932291475,MATH 20E,B01,182814,Verstraete; Jacques Allan,21,0,30,9
1681932291475,MATH 20E,B02,182815,Verstraete; Jacques Allan,29,0,30,1
1681932292508,MATH 103A,A01,182820,Staff,3,0,30,27
1681932292508,MATH 103A,A02,182821,Staff,27,0,30,3
1681932292508,MATH 103A,A03,182822,Staff,20,0,30,10
1681932292508,MATH 103A,B01,182825,Staff,21,0,30,9
1681932292508,MATH 103A,B02,182826,Staff,30,0,30,0
1681932292508,MATH 103A,B03,182830,Staff,30,0,30,0
1681932293533,MATH 109,A01,182836,Chow; Bennett,23,0,30,7
1681932293533,MATH 109,A02,182838,Chow; Bennett,27,0,30,3
1681932293533,MATH 109,A03,182894,Chow; Bennett,29,0,30,1
1681932293533,MATH 109,B01,182908,Chow; Bennett,26,0,30,4
1681932293533,MATH 109,B02,182909,Chow; Bennett,30,0,30,0
1681932293533,MATH 109,B03,182910,Chow; Bennett,26,0,30,4
1681932294567,MATH 142A,A01,182925,Staff,3,0,30,27
1681932294567,MATH 142A,A02,182935,Staff,23,0,30,7
1681932294567,MATH 142A,A03,182967,Staff,24,0,30,6
1681932294567,MATH 142A,B01,183125,Staff,22,0,30,8
1681932294567,MATH 142A,B02,183157,Staff,26,0,30,4
1681932294567,MATH 142A,B03,183158,Staff,29,0,30,1
1681932295593,MATH 183,A01,183160,Arias-Castro; Ery,22,0,30,8
1681932295593,MATH 183,A02,183161,Arias-Castro; Ery,28,0,30,2
1681932295593,MATH 183,B01,183163,Arias-Castro; Ery,26,0,30,4
1681932295593,MATH 183,B02,183164,Arias-Castro; Ery,28,0,30,2
1681932296615,MATH 193A,A01,183167,Staff,0,0,35,35
1681932296615,MATH 193A,A02,183168,Staff,23,0,35,12
1681932296615,MATH 193A,A03,183169,Staff,34,0,35,1
1681932296615,MATH 193A,A04,183170,Staff,26,0,35,9
1681932297641,MGT 4,A01,202395,Anderson; John Charles,76,0,80,4
1681932298668,MGT 5,A00,202396,Houskeeper; Robert,79,0,90,11
1681932299690,MGT 103,A00,202397,Eberhard; Craig A,48,0,90,42
1681932300715,MGT 131A,A00,202398,Houskeeper; Robert,81,0,90,9
1681932301740,MGT 135,A00,202399,Anderson; John Charles,81,0,90,9
1681932302765,MGT 162R,A00,202403,Gneezy; Uri,118,0,200,82
1681932303791,MGT 172,A00,202404,Hedges; Kathleen,27,0,90,63
1681932304817,MGT 181,A00,202405,Dunn; Louis Jean,79,0,90,11
1681932305843,MMW 14,A01,183200,Staff,0,0,28,28
1681932305843,MMW 14,A02,183201,Staff,25,0,28,3
1681932305843,MMW 14,A03,183202,Staff,24,0,28,4
1681932305843,MMW 14,A04,183203,Staff,25,0,28,3
1681932305843,MMW 14,A05,183204,Staff,26,0,28,2
1681932305843,MMW 14,A06,183205,Staff,27,0,28,1
1681932305843,MMW 14,B01,183207,Staff,26,0,28,2
1681932305843,MMW 14,B02,183208,Staff,28,0,28,0
1681932305843,MMW 14,B03,183209,Staff,28,0,28,0
1681932305843,MMW 14,B04,183210,Staff,28,0,28,0
1681932305843,MMW 14,B05,183211,Staff,28,0,28,0
1681932305843,MMW 14,B06,183212,Staff,27,0,28,1
1681932306865,MMW 14GS,A00,183213,Zhiri; Oumelbanine,28,0,28,0
1681932307888,MMW 15GS,B00,183215,Rahimi; Babak,28,0,28,0
1681932308911,MMW 121,A01,183217,Patterson; Patrick H.,7,0,28,21
1681932308911,MMW 121,A02,183218,Patterson; Patrick H.,25,0,28,3
1681932309938,MUS 1A,A01,182554,Staff,0,0,35,35
1681932310961,MUS 5,A01,182558,Staff,16,0,35,19
1681932311994,MUS 6,A01,182562,Staff,22,0,35,13
1681932313023,MUS 8GS,A00,182563,Borgo; David Garcia,25,0,25,0
1681932314049,MUS 13,A01,182567,Staff,23,0,25,2
1681932315071,MUS 15,A01,182570,Staff,31,0,35,4
1681932315071,MUS 15,B01,182575,Staff,7,0,35,28
1681932316094,MUS 80,A00,182578,Staff,22,0,25,3
1681932316094,MUS 80,B00,182581,Staff,20,0,25,5
1681932317119,MUS 113,A00,182582,Staff,25,0,25,0
1681932318142,MUS 114,A00,182583,Staff,0,0,25,25
1681932319173,MUS 150GS,A01,182588,Borgo; David Garcia,24,0,25,1
1681932320198,PHIL 1,A00,182590,Staff,34,0,40,6
1681932321234,PHIL 10,A01,182596,Grush; Rick Scott,30,0,35,5
1681932321234,PHIL 10,A02,182597,Grush; Rick Scott,33,0,35,2
1681932322262,PHIL 15,A01,182601,Staff,31,0,35,4
1681932322262,PHIL 15,A02,182602,Staff,33,0,35,2
1681932323293,PHIL 27,A01,182604,Staff,25,0,35,10
1681932323293,PHIL 27,A02,182607,Staff,34,0,35,1
1681932324316,PHIL 32,A01,182609,Staff,35,0,35,0
1681932324316,PHIL 32,A02,182612,Staff,35,0,35,0
1681932325338,PHIL 130,A00,182614,Staff,57,0,70,13
1681932326360,PHIL 136,A00,182616,Cohen; Jonathan David,64,0,70,6
1681932327382,PHIL 155,A00,182617,Vargas; Manuel Rogelio,57,0,70,13
1681932328405,PHIL 163,A01,182620,Staff,15,0,20,5
1681932328405,PHIL 163,A02,182624,Staff,10,0,20,10
1681932329436,PHIL 164,A00,182627,Staff,29,0,40,11
1681932330458,PHIL 173,A00,182628,Staff,35,0,40,5
1681932331483,PHYS 1A,A00,183221,Staff,52,0,60,8
1681932332510,PHYS 1AL,001,183222,Staff,24,0,30,6
1681932332510,PHYS 1AL,002,183223,Staff,24,0,30,6
1681932333535,PHYS 1B,A00,183231,Staff,40,0,60,20
1681932334563,PHYS 1BL,001,183232,Staff,15,0,30,15
1681932334563,PHYS 1BL,002,183233,Staff,27,0,30,3
1681932335594,PHYS 1C,A00,183240,Staff,20,0,60,40
1681932336621,PHYS 1CL,001,183241,Staff,8,0,30,22
1681932336621,PHYS 1CL,002,183242,Staff,21,0,30,9
1681932337647,PHYS 2AR,A01,183250,Staff,39,0,50,11
1681932338672,PHYS 2B,A01,183252,Staff,101,0,115,14
1681932339698,PHYS 2BL,A01,183254,Staff,21,0,24,3
1681932339698,PHYS 2BL,A02,183255,Staff,21,0,24,3
1681932340722,PHYS 2C,A01,183522,Staff,100,0,115,15
1681932341747,PHYS 4A,A01,183524,Staff,49,0,50,1
1681932342770,POLI 5,A00,183525,Staff,43,0,50,7
1681932343792,POLI 12,A00,183540,Staff,45,0,50,5
1681932344819,POLI 13R,A00,183541,Forman; Fonna,40,0,50,10
1681932345841,POLI 30,A00,183542,Mignozzetti; Umberto,48,0,50,2
1681932346866,POLI 100A,A00,183543,Staff,43,0,50,7
1681932347889,POLI 100E,A00,223598,Staff,32,0,35,3
1681932348919,POLI 103A,A00,183564,Kousser; Thad,34,0,50,16
1681932349947,POLI 104B,A00,201329,Staff,27,0,35,8
1681932350971,POLI 113BR,A00,183576,Hoston; Germaine,22,0,50,28
1681932351995,POLI 114BR,A00,183588,Staff,26,0,30,4
1681932353020,POLI 117R,A00,183595,Forman; Fonna,3,0,20,17
1681932354042,POLI 120H,A00,183596,Fisk; David Lee,13,0,20,7
1681932355068,POLI 130AA,A00,183597,Staff,13,0,20,7
1681932356101,POLI 134AA,A00,183598,Staff,19,0,20,1
1681932357128,POLI 135,A00,183599,Fisk; David Lee,19,0,25,6
1681932358151,POLI 142P,A00,183623,Staff,37,0,40,3
1681932359173,POLI 144D,A00,183624,Staff,22,0,25,3
1681932360198,POLI 151,A00,183625,Staff,14,0,20,6
1681932361223,POLI 162,A00,183626,Mignozzetti; Umberto,17,0,20,3
1681932362248,PSYC 1,A00,253748,Staff,85,0,90,5
1681932363278,PSYC 2,A00,183627,Moranton; Nirelia Melbina-,23,0,35,12
1681932364302,PSYC 3,A00,183628,Staff,43,0,45,2
1681932366347,PSYC 60,A01,183631,Lowe; Angela Beth,35,0,40,5
1681932367373,PSYC 70,A01,253757,Staff,34,0,45,11
1681932368396,PSYC 101,A00,183632,Heyman; Gail D.,41,0,60,19
1681932369419,PSYC 105,A00,183848,Lowe; Angela Beth,45,0,60,15
1681932370457,PSYC 106,A00,183849,Dobkins; Karen R.,39,0,60,21
1681932371479,PSYC 108,A00,253750,Staff,11,0,60,49
1681932372502,PSYC 114,A01,184275,Winkielman; Piotr,0,8,30,30
1681932373527,PSYC 122,A00,183856,Moranton; Nirelia Melbina-,0,16,30,30
1681932374550,PSYC 124,A00,183865,Chapman; Eddie Nathaniel,42,0,80,38
1681932375574,PSYC 137,A00,183880,Staff,17,0,25,8
1681932377623,PSYC 154,A00,183910,Lacefield; Katharine I,0,31,90,90
1681932379673,PSYC 162,A00,183946,Wixted; John T,38,0,90,52
1681932380785,PSYC 172,A00,183947,Gorman; Michael R.,5,0,30,25
1681932381818,PSYC 178,A00,183963,Glaser; Dale,14,0,40,26
1681932382847,PSYC 181GS,A00,183964,Anagnostaras; Stephan,10,0,10,0
1681932383871,PSYC 186GS,A01,257660,Staff,10,0,10,0
1681932384905,PSYC 193,B00,253749,Staff,22,0,25,3
1681932386954,PSYC 193L,A01,184122,Staff,33,0,35,2
1681932386954,PSYC 193L,C01,184167,Winkielman; Piotr,14,0,30,16
1681932387978,RELI 188GS,A00,182629,Rahimi; Babak,20,0,20,0
1681932389002,SE 101A,A00,182646,Staff,25,0,30,5
1681932390025,SE 101C,A00,182650,Staff,11,0,20,9
1681932391051,SE 110A,A00,182651,Staff,28,0,28,0
1681932392073,SE 130A,A00,182652,Staff,38,0,40,2
1681932393099,SIO 46GS,A00,182636,Cook; Geoffrey W,24,0,28,4
1681932394125,SIO 109R,A00,194459,Staff,0,1,20,20
1681932395150,SIO 121GS,A00,182639,Cook; Geoffrey W,24,0,28,4
1681932396173,SIO 132,A01,182642,Staff,30,0,40,10
1681932397197,SIO 139,A00,182644,Kacev; David,36,0,40,4
1681932398223,SOCI 2,A01,258404,Staff,33,0,36,3
1681932398223,SOCI 2,A02,258405,Staff,35,0,36,1
1681932399249,SOCI 60,A01,258408,Staff,29,0,30,1
1681932399249,SOCI 60,A02,258413,Staff,30,0,30,0
1681932400272,SOCI 100,A01,258415,Staff,28,0,30,2
1681932400272,SOCI 100,A02,258416,Staff,28,0,30,2
1681932406418,SOCI 127,A00,258421,Staff,19,0,30,11
1681932407441,SOCI 132,A00,258422,Staff,42,0,50,8
1681932408465,SOCI 133,A00,258423,Staff,26,0,30,4
1681932409486,SOCI 138GS,A00,258424,Staff,15,0,15,0
1681932410509,SOCI 145,A00,258425,Staff,23,0,30,7
1681932411532,SOCI 148,A00,258426,Staff,23,0,30,7
1681932412564,SOCI 153,A00,199217,Staff,29,0,30,1
1681932413593,SOCI 160,A00,258427,Staff,27,0,30,3
1681932414618,SOCI 160E,A00,258435,Staff,55,0,60,5
1681932415641,SOCI 189GS,A00,258436,Staff,15,0,15,0
1681932416665,SOCI 190GS,A00,258437,Staff,15,0,15,0
1681932417688,SYN 2,001,182658,Staff,8,0,16,8
1681932417688,SYN 2,002,201439,Staff,13,0,16,3
1681932417688,SYN 2,003,201443,Staff,16,0,16,0
1681932418725,SYN 100,A01,182657,Staff,12,0,20,8
1681932419749,TDAC 1,A00,184381,Salovey; Todd,16,0,20,4
1681932419749,TDAC 1,B00,184385,Harting; Carla Kelso,19,0,20,1
1681932419749,TDAC 1,C00,184394,Staff,18,0,20,2
1681932420775,TDAC 101,A00,184483,Harting; Carla Kelso,19,0,20,1
1681932421807,TDDE 111,A00,184496,Staff,14,0,15,1
1681932422835,TDDE 131,A00,184504,Staff,20,0,20,0
1681932422835,TDDE 131,B00,184505,Staff,17,0,18,1
1681932422835,TDDE 131,C00,184534,Staff,49,0,50,1
1681932422835,TDDE 131,D00,184564,Staff,15,0,15,0
1681932422835,TDDE 131,E00,204725,Staff,18,0,20,2
1681932423859,TDGE 1,A01,184414,Salovey; Todd,34,0,50,16
1681932424882,TDGE 5,A01,184419,Staff,23,0,24,1
1681932425908,TDGE 10,A00,184428,Fulton; Julia,27,0,50,23
1681932426930,TDGE 124,A00,184565,Fulton; Julia,0,3,50,50
1681932427956,TDGE 125,B00,184567,Meyer; Ursula,8,0,25,17
1681932428979,TDHT 101,A00,184568,Staff,21,0,25,4
1681932428979,TDHT 101,B00,184569,Staff,20,0,20,0
1681932430002,TDHT 114,A00,184570,Staff,48,0,50,2
1681932431025,TDMV 1,A00,184437,Arcidiacono; Kristin,21,0,30,9
1681932431025,TDMV 1,B00,184448,Caligagan; Maria T.,23,0,30,7
1681932432048,TDMV 2,A00,184449,Weinberg; Sadie,26,0,30,4
1681932432048,TDMV 2,B00,184453,Arcidiacono; Kristin,29,0,30,1
1681932433075,TDMV 110,A00,184571,Weinberg; Sadie,30,0,30,0
1681932434098,TDMV 142,A00,184572,Caligagan; Tony,26,0,30,4
1681932434098,TDMV 142,B00,184573,Caligagan; Maria T.,26,0,30,4
1681932435124,TDTR 20,A00,184482,Jun; Grace Shin Hae,25,0,25,0
1681932436148,USP 2,A01,184290,Hinds; Juli Beth,23,0,25,2
1681932437171,USP 3,A01,184295,Staff,20,0,25,5
1681932438193,USP 4,A00,184304,McTague; Sarah,13,0,25,12
1681932439217,USP 100,A00,184315,Staff,16,0,25,9
1681932440248,USP 105,A00,184326,Staff,21,0,25,4
1681932441271,USP 151,A00,184327,Staff,17,0,25,8
1681932442294,USP 170,A00,184380,Hinds; Juli Beth,12,0,25,13
1681932443322,VIS 21B,A01,182660,Staff,28,0,31,3
1681932443322,VIS 21B,A02,182662,Staff,30,0,31,1
1681932444346,VIS 103D,A00,182663,Staff,74,0,75,1
1681932445370,VIS 105D,A00,182667,Li; Huai,14,0,22,8
1681932446392,VIS 122GS,A00,182668,Herbst; Matthew,20,0,20,0
1681932447414,VIS 128C,A00,182673,Staff,69,0,75,6
1681932448437,VIS 130,A00,182675,Staff,19,0,22,3
1681932449474,VIS 160A,A00,182678,Stalbaum; Brett,4,0,10,6
1681932451522,WCWP 10B,A00,201679,Staff,15,0,15,0
1681932451522,WCWP 10B,B00,201695,Staff,15,0,15,0
1681932452547,WCWP 100,A00,201716,Staff,12,0,15,3
1681932452547,WCWP 100,B00,201717,Staff,0,0,15,15
1681932454652,ANSC 105GS,A00,258289,Staff,0,0,0,0
1681932455674,ANSC 125GS,A00,258295,Staff,0,0,0,0
1681932456697,ANSC 150,A00,258267,Staff,27,0,40,13
1681932457723,ANSC 190GS,A00,258280,Staff,0,0,0,2
1681932458744,ANTH 1,A00,258264,Staff,38,0,40,2
1681932459767,ANTH 2,A01,258259,Staff,72,0,76,4
1681932460799,ANTH 23,A01,258228,Staff,35,0,40,5
1681932461823,ANTH 101,A01,258236,Staff,38,0,40,2
1681932462849,ANTH 102,A00,258272,Staff,59,0,60,1
1681932463874,ANTH 105,A00,258244,Staff,28,0,35,7
1681932464907,BENG 130,A00,253975,Staff,37,0,40,3
1681932465931,BIBC 102,A01,191866,Flagg; Matthew Paul,16,0,32,16
1681932465931,BIBC 102,A02,191867,Flagg; Matthew Paul,21,0,32,11
1681932465931,BIBC 102,A03,191868,Flagg; Matthew Paul,27,0,32,5
1681932465931,BIBC 102,A04,191936,Flagg; Matthew Paul,20,0,32,12
1681932465931,BIBC 102,A05,191937,Flagg; Matthew Paul,0,0,32,32
1681932466958,BICD 100,A01,191939,Cooper; Andrew Michael,27,0,32,5
1681932466958,BICD 100,A02,191940,Cooper; Andrew Michael,32,0,32,0
1681932466958,BICD 100,A03,191941,Cooper; Andrew Michael,32,0,32,0
1681932466958,BICD 100,A04,191942,Cooper; Andrew Michael,32,0,32,0
1681932466958,BICD 100,A05,191943,Cooper; Andrew Michael,32,0,32,0
1681932467984,BIEB 126,A01,191945,Cleland; Elsa Eleanor,0,4,32,32
1681932467984,BIEB 126,A02,191946,Cleland; Elsa Eleanor,26,0,32,6
1681932467984,BIEB 126,A03,191947,Cleland; Elsa Eleanor,29,0,32,3
1681932467984,BIEB 126,A04,191948,Cleland; Elsa Eleanor,16,0,32,16
1681932467984,BIEB 126,A05,191996,Cleland; Elsa Eleanor,28,0,32,4
1681932469008,BIEB 136GS,A00,191997,Shurin; Jonathan & Holway; David A.,0,0,0,9
1681932470032,BIEB 137GS,A01,191999,Shurin; Jonathan & Holway; David A.,0,0,0,8
1681932471058,BILD 1,A01,205385,Staff,30,0,32,2
1681932471058,BILD 1,A02,205386,Staff,30,0,32,2
1681932471058,BILD 1,A03,205387,Staff,31,0,32,1
1681932471058,BILD 1,A04,205388,Staff,25,0,32,7
1681932472081,BILD 2,A01,191774,Staff,27,0,32,5
1681932472081,BILD 2,A02,191775,Staff,30,0,32,2
1681932472081,BILD 2,A03,191777,Staff,29,0,32,3
1681932472081,BILD 2,A04,191856,Staff,30,0,32,2
1681932472081,BILD 2,A05,191857,Staff,31,0,32,1
1681932472081,BILD 2,A06,191858,Staff,32,0,32,0
1681932472081,BILD 2,A07,191859,Staff,31,0,32,1
1681932473104,BILD 3,A01,205391,Staff,27,0,32,5
1681932473104,BILD 3,A02,205393,Staff,32,0,32,0
1681932473104,BILD 3,A03,205394,Staff,26,0,32,6
1681932473104,BILD 3,A04,205395,Staff,32,0,32,0
1681932474127,BILD 20,A01,191861,Staff,32,0,32,0
1681932474127,BILD 20,A02,191862,Staff,32,0,32,0
1681932475150,BILD 30,A01,191864,Staff,31,0,32,1
1681932476175,BIMM 100,A01,192019,Staff,0,0,32,32
1681932476175,BIMM 100,A02,192020,Staff,15,0,32,17
1681932476175,BIMM 100,A03,192035,Staff,17,0,32,15
1681932477200,BIMM 110,A01,192037,Tat; John,0,0,32,32
1681932477200,BIMM 110,A02,192038,Tat; John,4,0,32,28
1681932478226,BIMM 120,A01,192040,Pickett; Brooke Elizabeth,0,0,32,32
1681932478226,BIMM 120,A02,192041,Pickett; Brooke Elizabeth,7,0,32,25
1681932478226,BIMM 120,A03,192042,Pickett; Brooke Elizabeth,14,0,32,18
1681932479250,BIPN 100,A01,192044,Armour; Jon Christopher,23,0,32,9
1681932479250,BIPN 100,A02,192059,Armour; Jon Christopher,30,0,32,2
1681932479250,BIPN 100,A03,192064,Armour; Jon Christopher,30,0,32,2
1681932479250,BIPN 100,A04,192073,Armour; Jon Christopher,26,0,32,6
1681932480281,BIPN 148,A01,205411,Leutgeb; Jill K.,14,0,32,18
1681932480281,BIPN 148,A02,205412,Leutgeb; Jill K.,31,0,32,1
1681932480281,BIPN 148,A03,205413,Leutgeb; Jill K.,29,0,32,3
1681932480281,BIPN 148,A04,205414,Leutgeb; Jill K.,30,0,32,2
1681932481303,BIPN 160,A01,192115,Marino; Marc J,15,0,32,17
1681932481303,BIPN 160,A02,192148,Marino; Marc J,27,0,32,5
1681932481303,BIPN 160,A03,192158,Marino; Marc J,31,0,32,1
1681932481303,BIPN 160,A04,192190,Marino; Marc J,32,0,32,0
1681932481303,BIPN 160,A05,192287,Marino; Marc J,32,0,32,0
1681932481303,BIPN 160,A06,192288,Marino; Marc J,32,0,32,0
1681932482326,BIPN 194,A00,206038,Leutgeb; Stefan,28,0,32,4
1681932483352,BISP 194,A00,192289,Nieh; James Charles,9,0,32,23
1681932483352,BISP 194,B00,245332,Staff,26,0,32,6
1681932484449,CAT 124,A01,202247,Staff,15,0,15,0
1681932485472,CAT 125,A00,202248,Staff,18,0,20,2
1681932485472,CAT 125,B00,202253,Staff,20,0,20,0
1681932485472,CAT 125,C00,202257,Staff,18,0,20,2
1681932486494,CAT 125GS,A01,202273,Bronstein; Phoebe Malan,20,0,20,0
1681932487525,CAT 125R,A00,202284,Staff,17,0,20,3
1681932487525,CAT 125R,C00,202286,Staff,4,0,20,16
1681932487525,CAT 125R,D00,202291,Staff,16,0,20,4
1681932487525,CAT 125R,E00,202295,Staff,13,0,20,7
1681932487525,CAT 125R,F00,202302,Staff,6,0,20,14
1681932488550,CENG 100,A00,204724,Opatkiewicz; Justin Paul,23,0,25,2
1681932489576,CGS 2A,A01,180420,Staff,30,0,36,6
1681932490598,CGS 101,A00,180421,Staff,15,0,20,5
1681932491622,CGS 112,A00,180422,Staff,8,0,16,8
1681932492646,CGS 113,A00,180423,Staff,18,0,20,2
1681932493672,CGS 137,A00,180424,Staff,12,0,12,0
1681932494694,CGS 147,A00,180425,Staff,10,0,10,0
1681932495721,CHEM 6A,A01,179556,Staff,92,0,100,8
1681932495721,CHEM 6A,A02,179558,Staff,0,0,0,0
1681932496747,CHEM 6B,A01,179560,Staff,100,0,100,0
1681932497780,CHEM 6C,A01,179565,Jazzar; Rodolphe,91,0,100,9
1681932498810,CHEM 7L,A01,179586,Schurmeier; Kimberly,10,0,24,14
1681932498810,CHEM 7L,A02,179587,Schurmeier; Kimberly,23,0,24,1
1681932498810,CHEM 7L,A03,179590,Schurmeier; Kimberly,22,0,24,2
1681932498810,CHEM 7L,A04,179591,Schurmeier; Kimberly,22,0,24,2
1681932498810,CHEM 7L,B01,179598,Schurmeier; Kimberly,14,0,24,10
1681932498810,CHEM 7L,B02,179599,Schurmeier; Kimberly,23,0,24,1
1681932498810,CHEM 7L,B03,179606,Schurmeier; Kimberly,22,0,24,2
1681932498810,CHEM 7L,B04,179607,Schurmeier; Kimberly,22,0,24,2
1681932499837,CHEM 11,A01,179609,Stallings; Dontarie M,86,0,100,14
1681932500868,CHEM 40A,A01,179621,Staff,38,0,50,12
1681932500868,CHEM 40A,A02,179622,Staff,46,0,50,4
1681932501892,CHEM 40B,A01,179630,Weizman; Haim,45,0,50,5
1681932501892,CHEM 40B,A02,179631,Weizman; Haim,43,0,50,7
1681932502918,CHEM 41A,A01,179660,Klosterman; Jeremy K,90,0,100,10
1681932503943,CHEM 43A,A01,179683,Klosterman; Jeremy K,0,0,24,24
1681932503943,CHEM 43A,A02,179688,Klosterman; Jeremy K,5,0,24,19
1681932503943,CHEM 43A,A03,179689,Klosterman; Jeremy K,17,0,24,7
1681932503943,CHEM 43A,A04,179691,Klosterman; Jeremy K,17,0,24,7
1681932504967,CHEM 114A,A01,179693,Stallings; Dontarie M,64,0,100,36
1681932505991,CHEM 143B,A01,179698,Weizman; Haim,16,0,24,8
1681932505991,CHEM 143B,A02,179700,Weizman; Haim,23,0,24,1
1681932507013,CHIN 169A,A00,179701,Wang; Xiao,20,0,20,0
1681932508035,COGS 2,A01,179750,Boyle; Mary E. T.,16,0,30,14
1681932509063,COGS 9,A01,179759,Jones; Cameron Robert,40,0,50,10
1681932510085,COGS 14A,A01,179854,Staff,9,0,50,41
1681932511111,COGS 14B,A01,179856,Staff,52,0,60,8
1681932512139,COGS 17,A01,179874,Staff,70,0,75,5
1681932513163,COGS 18,A01,179884,Staff,59,0,80,21
1681932514193,COGS 100,A01,179886,Staff,31,0,60,29
1681932515222,COGS 101B,A01,179892,Staff,0,3,30,30
1681932516245,COGS 101C,A01,179894,Staff,26,0,30,4
1681932517270,COGS 107A,A01,179896,Boyle; Mary E. T.,28,0,40,12
1681932518299,COGS 108,A01,179898,Simpkins; Charles Alexander,0,33,60,60
1681932519329,COGS 109,A01,179900,Staff,32,0,40,8
1681932520352,COGS 118A,A01,179946,Staff,4,0,40,36
1681932521378,COGS 153,A00,179978,Staff,0,7,30,30
1681932522405,COGS 156,A01,179981,Staff,20,0,30,10
1681932524478,COGS 172,A01,179987,Staff,10,0,30,20
1681932526528,COGS 186,A01,179991,Staff,11,0,30,19
1681932527549,COMM 10,A01,180001,Staff,11,0,25,14
1681932527549,COMM 10,A02,180004,Staff,20,0,25,5
1681932528572,COMM 100A,A01,180016,Staff,13,0,25,12
1681932528572,COMM 100A,A02,180020,Staff,24,0,25,1
1681932529598,COMM 101T,A00,180029,Halm; Gavin Patrick,17,0,35,18
1681932530624,COMM 106V,A00,180043,Staff,34,0,35,1
1681932531646,COMM 109P,A00,180044,Staff,30,0,35,5
1681932532672,COMM 113T,A00,180045,Havis; Allan,35,0,45,10
1681932533694,COMM 132,A00,180046,McKenna; Denise,18,0,30,12
1681932534717,COMM 143,A00,180047,Staff,16,0,30,14
1681932535742,COMM 190,A00,180048,Conner; Thomas Hartnell,16,0,23,7
1681932536766,CSE 8A,A50,180053,Cao; Yingjun,20,0,50,30
1681932536766,CSE 8A,B50,180180,Staff,50,0,50,0
1681932537798,CSE 11,A01,180190,Cao; Yingjun,21,0,50,29
1681932538821,CSE 20,A01,180192,Briones; Jor-el Thomas Caparas,21,0,30,9
1681932539846,CSE 21,A01,194538,Briones; Jor-el Thomas Caparas,49,0,60,11
1681932540882,CSE 30,A01,180324,Eldon; John,71,0,100,29
1681932541916,CSE 101,A01,201353,Staff,0,30,40,40
1681932542943,CSE 134B,A01,180326,Powell; Thomas Allan,70,0,100,30
1681932543972,CSE 140,A01,180328,Staff,21,0,75,54
1681932544999,CSE 140L,A01,180344,Eldon; John,46,0,100,54
1681932546025,CSE 150A,A01,180411,Staff,0,20,50,50
1681932547047,CSE 151A,A01,180414,Staff,0,15,50,50
1681932548074,CSE 175,A01,222521,Kumar; Rakesh,50,0,50,0
1681932549110,CSE 190,A00,201419,Staff,42,0,49,7
1681932550133,CSS 1,A01,194536,Staff,32,0,50,18
1681932551155,DSC 30,A01,202385,Staff,48,0,50,2
1681932552180,DSC 40A,A01,202387,Albuyeh; Rod,50,0,50,0
1681932553208,DSC 190,A01,202389,Silberman; Jack,21,0,21,0
1681932554230,DSGN 100,A01,179993,Staff,13,0,30,17
1681932555253,ECE 65,A50,180708,Staff,10,0,20,10
1681932555253,ECE 65,A51,180739,Staff,19,0,20,1
1681932556275,ECON 1,A01,180427,Famulari; Melissa,66,0,70,4
1681932557301,ECON 2,A01,180450,Levkoff; Steven B.,63,0,70,7
1681932558325,ECON 4,A01,203351,Anderson; John Charles,6,0,10,4
1681932559348,ECON 100A,A01,180472,Famulari; Melissa,59,0,70,11
1681932560373,ECON 120A,A01,180549,Staff,61,0,70,9
1681932561401,ECON 120B,A01,180655,Ma; Xinwei,35,0,70,35
1681932562433,ECON 129,A00,203333,Eckert; Fabian Paul,8,0,35,27
1681932563459,ECON 131,A00,180656,Staff,0,1,35,35
1681932564491,ECON 172B,A01,180672,Levkoff; Steven B.,31,0,35,4
1681932565515,ECON 178,A01,203342,Zhu; Ying,2,0,35,33
1681932566537,EDS 108GS,A00,202383,Wishard Guerra; Alison G.,20,0,20,0
1681932567565,EDS 111GS,A00,202347,Wishard Guerra; Alison G.,20,0,20,0
1681932568591,EDS 112,A01,202323,Staff,53,0,60,7
1681932569613,EDS 113,A00,202340,Staff,32,0,35,3
1681932570636,EDS 118,A00,201231,Staff,19,0,30,11
1681932571658,EDS 119,A00,204994,Staff,8,0,10,2
1681932572682,EDS 124BR,A00,202324,Eguchi; Emi,0,2,25,25
1681932573704,EDS 126,A01,203208,Jones; Makeba,26,0,30,4
1681932574735,EDS 135,A01,202333,Staff,17,0,20,3
1681932575756,EDS 180,A00,202311,Staff,47,0,50,3
1681932576781,ERC 190GS,A01,253747,Staff,28,0,28,0
1681932577806,ETHN 104,A00,180742,Staff,20,0,35,15
1681932578829,ETHN 118,A00,180745,Staff,26,0,35,9
1681932579854,ETHN 127,A00,180747,Staff,8,0,16,8
1681932580878,ETHN 137,A00,180880,Staff,11,0,12,1
1681932581900,ETHN 147,A00,180890,Staff,8,0,10,2
1681932582923,ETHN 154,A00,180891,Staff,5,0,8,3
1681932583946,ETHN 168,A00,180892,Staff,9,0,10,1
1681932584975,GLBH 20,A00,201051,Hannah; Seth Donal,0,7,0,1
1681932585999,GLBH 111,A01,209338,Burgos; Jose L.,0,0,0,0
1681932587022,GLBH 150,A00,258300,Staff,0,4,0,0
1681932588135,GLBH 181,A00,201207,Staff,5,0,40,35
1681932589165,HIEU 109,A00,180898,Staff,19,0,20,1
1681932590190,HIEU 111,A00,180899,Staff,0,2,20,20
1681932591221,HIEU 124,A00,180900,Staff,16,0,20,4
1681932592244,HILA 122,A00,180901,Staff,17,0,20,3
1681932593275,HILA 132,A00,180902,Vitz; Matthew,0,2,20,20
1681932594304,HILD 10,A01,180896,Staff,12,0,20,8
1681932595329,HILD 30GS,A00,180897,Edington; Claire Ellen,0,0,0,0
1681932596353,HISC 105,A00,180903,Staff,20,0,20,0
1681932597377,HISC 117,A00,180904,Staff,10,0,20,10
1681932598401,HIUS 108B,A00,181005,Staff,18,0,20,2
1681932599426,HIUS 113,A00,181093,Staff,1,0,20,19
1681932600453,HUM 3,A01,181190,Patterson; Patrick H.,33,0,50,17
1681932600453,HUM 3,B01,181195,Staff,45,0,50,5
1681932601475,HUM 3GS,A00,181196,Herbst; Matthew,0,0,0,0
1681932602510,HUM 4,A01,181227,West; Geoffrey Scott,33,0,50,17
1681932602510,HUM 4,B01,181282,Staff,41,0,50,9
1681932603534,HUM 4GS,A00,181377,Lyon; Antony J.,0,0,0,0
1681932604570,HUM 5,A01,181536,Zavodny; Tatiana Sophia,24,0,50,26
1681932604570,HUM 5,B01,181908,Staff,32,0,50,18
1681932605596,INTL 190,A00,181909,Segui; Alan S,0,0,0,8
1681932605596,INTL 190,B00,181961,Segui; Alan S,0,0,0,7
1681932606623,JAPN 20AR,A01,182113,Ross; Kayoko F,15,0,20,5
1681932607646,LATI 50,A01,202391,Martin-Cabrera; Luis,17,0,30,13
1681932607646,LATI 50,A02,202392,Martin-Cabrera; Luis,26,0,30,4
1681932608669,LATI 180,A00,202393,Kokinis; Troy Andreas,24,0,25,1
1681932609694,LIFR 1A,A00,182119,Staff,13,0,14,1
1681932610725,LIFR 1AX,A00,182324,Staff,13,0,14,1
1681932611765,LIFR 1B,A00,182259,Staff,12,0,14,2
1681932612797,LIFR 1BX,A00,182273,Staff,12,0,14,2
1681932613821,LIGN 8,A00,182330,Staff,126,0,150,24
1681932614849,LIGN 9GS,A00,182362,Staff,14,0,20,6
1681932615876,LIGN 119,A00,204992,Takahashi; Maho,11,0,15,4
1681932616901,LIGN 130,A01,182384,Staff,47,0,50,3
1681932617924,LIGN 149GS,A00,182390,Staff,14,0,20,6
1681932618947,LIGN 170,A00,182404,Staff,23,0,30,7
1681932619984,LISP 1D,A00,182281,Staff,7,0,14,7
1681932619984,LISP 1D,B00,182287,Staff,13,0,14,1
1681932619984,LISP 1D,C00,182295,Staff,10,0,14,4
1681932619984,LISP 1D,D00,182301,Staff,14,0,14,0
1681932621014,LISP 1DX,A00,182309,Staff,19,0,28,9
1681932621014,LISP 1DX,B00,182316,Staff,25,0,28,3
1681932622038,LTAF 120GS,A00,182412,Zhiri; Oumelbanine,20,0,20,0
1681932623066,LTCS 172GS,A00,182437,Bronstein; Phoebe Malan,20,0,20,0
1681932624093,LTEA 138,A00,182457,Staff,17,0,40,23
1681932625126,LTEN 114,A01,182490,Staff,23,0,25,2
1681932626156,LTEN 130GS,A00,182491,Lyon; Antony J.,20,0,20,0
1681932627180,LTEN 169,A00,182493,Cuong; Marisol,17,0,25,8
1681932628212,LTEN 178,A00,182501,Staff,14,0,15,1
1681932629245,LTEN 181,A00,182515,Staff,19,0,25,6
1681932630271,LTEN 185GS,A00,197655,Forbes; Camille,20,0,20,0
1681932631293,LTSP 100B,A00,202208,Bessett; Ryan Matthew,24,0,25,1
1681932632318,LTWL 100,A00,182516,Myerston Santana; Jacobo,20,0,30,10
1681932633355,LTWR 100GS,A00,182518,Forbes; Camille,20,0,20,0
1681932634377,LTWR 102,A00,182522,Staff,15,0,15,0
1681932634377,LTWR 102,B00,182525,Staff,14,0,15,1
1681932635401,LTWR 115,A00,182526,Staff,10,0,15,5
1681932636430,MAE 8,A01,182528,Pham; Hieu Tan,67,0,70,3
1681932637456,MAE 11,A00,182529,Bahadori; Mohammad Yousef,91,0,100,9
1681932638483,MAE 20,A00,182530,Evdokimenko; Ekaterina,67,0,70,3
1681932639506,MAE 30A,A00,182532,Staff,44,0,45,1
1681932640541,MAE 101A,A00,182533,Bahadori; Mohammad Yousef,93,0,100,7
1681932641563,MAE 101C,A00,182538,Staff,62,0,70,8
1681932642585,MAE 104,A00,182539,Staff,44,0,50,6
1681932643613,MAE 131A,A00,182540,Ghazinejad; Maziar,40,0,45,5
1681932644638,MAE 143A,A00,182548,Bewley; Thomas R,42,0,50,8
1681932645661,MAE 150,A00,182549,Staff,28,0,40,12
1681932646684,MAE 160,A00,182550,Evdokimenko; Ekaterina,40,0,60,20
1681932647707,MATH 3C,A01,182725,Staff,24,0,30,6
1681932648735,MATH 10A,A01,182729,Staff,24,0,30,6
1681932648735,MATH 10A,B01,182732,Staff,25,0,30,5
1681932649771,MATH 10B,A01,182737,Staff,16,0,30,14
1681932649771,MATH 10B,A02,182738,Staff,24,0,30,6
1681932649771,MATH 10B,B01,182744,Staff,24,0,30,6
1681932649771,MATH 10B,B02,182745,Staff,27,0,30,3
1681932650799,MATH 18,A01,182750,Anzaldo; Leesa B,28,0,30,2
1681932650799,MATH 18,A02,182751,Anzaldo; Leesa B,28,0,30,2
1681932650799,MATH 18,A03,182753,Anzaldo; Leesa B,27,0,30,3
1681932650799,MATH 18,A04,182757,Anzaldo; Leesa B,29,0,30,1
1681932650799,MATH 18,B01,182761,Anzaldo; Leesa B,27,0,30,3
1681932650799,MATH 18,B02,182764,Anzaldo; Leesa B,26,0,30,4
1681932650799,MATH 18,B03,182765,Anzaldo; Leesa B,29,0,30,1
1681932650799,MATH 18,B04,182766,Anzaldo; Leesa B,30,0,30,0
1681932651827,MATH 20A,A01,182771,Suk; Andrew Hoon,28,0,30,2
1681932652856,MATH 20B,A01,182775,Bach; Quang Tran,30,0,30,0
1681932652856,MATH 20B,A02,182777,Bach; Quang Tran,29,0,30,1
1681932652856,MATH 20B,B01,182780,Bach; Quang Tran,26,0,30,4
1681932652856,MATH 20B,B02,182782,Bach; Quang Tran,30,0,30,0
1681932653888,MATH 20C,A01,182787,Staff,24,0,30,6
1681932653888,MATH 20C,A02,182790,Staff,29,0,30,1
1681932653888,MATH 20C,B01,182792,Staff,23,0,30,7
1681932653888,MATH 20C,B02,182796,Staff,26,0,30,4
1681932654910,MATH 20D,A01,182799,Staff,27,0,30,3
1681932654910,MATH 20D,A02,182802,Staff,29,0,30,1
1681932654910,MATH 20D,A03,182803,Staff,30,0,30,0
1681932655944,MATH 20E,A01,182809,Verstraete; Jacques Allan,20,0,30,10
1681932655944,MATH 20E,A02,182811,Verstraete; Jacques Allan,27,0,30,3
1681932655944,MATH 20E,B01,182814,Verstraete; Jacques Allan,21,0,30,9
1681932655944,MATH 20E,B02,182815,Verstraete; Jacques Allan,29,0,30,1
1681932656969,MATH 103A,A01,182820,Staff,3,0,30,27
1681932656969,MATH 103A,A02,182821,Staff,27,0,30,3
1681932656969,MATH 103A,A03,182822,Staff,20,0,30,10
1681932656969,MATH 103A,B01,182825,Staff,21,0,30,9
1681932656969,MATH 103A,B02,182826,Staff,30,0,30,0
1681932656969,MATH 103A,B03,182830,Staff,30,0,30,0
1681932657993,MATH 109,A01,182836,Chow; Bennett,23,0,30,7
1681932657993,MATH 109,A02,182838,Chow; Bennett,27,0,30,3
1681932657993,MATH 109,A03,182894,Chow; Bennett,29,0,30,1
1681932657993,MATH 109,B01,182908,Chow; Bennett,26,0,30,4
1681932657993,MATH 109,B02,182909,Chow; Bennett,30,0,30,0
1681932657993,MATH 109,B03,182910,Chow; Bennett,26,0,30,4
1681932659020,MATH 142A,A01,182925,Staff,3,0,30,27
1681932659020,MATH 142A,A02,182935,Staff,23,0,30,7
1681932659020,MATH 142A,A03,182967,Staff,24,0,30,6
1681932659020,MATH 142A,B01,183125,Staff,22,0,30,8
1681932659020,MATH 142A,B02,183157,Staff,26,0,30,4
1681932659020,MATH 142A,B03,183158,Staff,29,0,30,1
1681932660048,MATH 183,A01,183160,Arias-Castro; Ery,22,0,30,8
1681932660048,MATH 183,A02,183161,Arias-Castro; Ery,28,0,30,2
1681932660048,MATH 183,B01,183163,Arias-Castro; Ery,26,0,30,4
1681932660048,MATH 183,B02,183164,Arias-Castro; Ery,28,0,30,2
1681932661072,MATH 193A,A01,183167,Staff,0,0,35,35
1681932661072,MATH 193A,A02,183168,Staff,23,0,35,12
1681932661072,MATH 193A,A03,183169,Staff,34,0,35,1
1681932661072,MATH 193A,A04,183170,Staff,26,0,35,9
1681932662096,MGT 4,A01,202395,Anderson; John Charles,76,0,80,4
1681932663126,MGT 5,A00,202396,Houskeeper; Robert,79,0,90,11
1681932664163,MGT 103,A00,202397,Eberhard; Craig A,48,0,90,42
1681932665191,MGT 131A,A00,202398,Houskeeper; Robert,81,0,90,9
1681932666214,MGT 135,A00,202399,Anderson; John Charles,81,0,90,9
1681932667242,MGT 162R,A00,202403,Gneezy; Uri,118,0,200,82
1681932668280,MGT 172,A00,202404,Hedges; Kathleen,26,0,90,64
1681932669303,MGT 181,A00,202405,Dunn; Louis Jean,79,0,90,11
1681932670326,MMW 14,A01,183200,Staff,0,0,28,28
1681932670326,MMW 14,A02,183201,Staff,25,0,28,3
1681932670326,MMW 14,A03,183202,Staff,24,0,28,4
1681932670326,MMW 14,A04,183203,Staff,25,0,28,3
1681932670326,MMW 14,A05,183204,Staff,26,0,28,2
1681932670326,MMW 14,A06,183205,Staff,27,0,28,1
1681932670326,MMW 14,B01,183207,Staff,26,0,28,2
1681932670326,MMW 14,B02,183208,Staff,28,0,28,0
1681932670326,MMW 14,B03,183209,Staff,28,0,28,0
1681932670326,MMW 14,B04,183210,Staff,28,0,28,0
1681932670326,MMW 14,B05,183211,Staff,28,0,28,0
1681932670326,MMW 14,B06,183212,Staff,27,0,28,1
1681932671351,MMW 14GS,A00,183213,Zhiri; Oumelbanine,28,0,28,0
1681932672373,MMW 15GS,B00,183215,Rahimi; Babak,28,0,28,0
1681932673399,MMW 121,A01,183217,Patterson; Patrick H.,7,0,28,21
1681932673399,MMW 121,A02,183218,Patterson; Patrick H.,25,0,28,3
1681932674421,MUS 1A,A01,182554,Staff,0,0,35,35
1681932675446,MUS 5,A01,182558,Staff,16,0,35,19
1681932676472,MUS 6,A01,182562,Staff,22,0,35,13
1681932677496,MUS 8GS,A00,182563,Borgo; David Garcia,25,0,25,0
1681932678519,MUS 13,A01,182567,Staff,23,0,25,2
1681932679549,MUS 15,A01,182570,Staff,31,0,35,4
1681932679549,MUS 15,B01,182575,Staff,7,0,35,28
1681932680575,MUS 80,A00,182578,Staff,22,0,25,3
1681932680575,MUS 80,B00,182581,Staff,20,0,25,5
1681932681599,MUS 113,A00,182582,Staff,25,0,25,0
1681932682622,MUS 114,A00,182583,Staff,0,0,25,25
1681932683653,MUS 150GS,A01,182588,Borgo; David Garcia,24,0,25,1
1681932684683,PHIL 1,A00,182590,Staff,34,0,40,6
1681932685709,PHIL 10,A01,182596,Grush; Rick Scott,30,0,35,5
1681932685709,PHIL 10,A02,182597,Grush; Rick Scott,33,0,35,2
1681932686735,PHIL 15,A01,182601,Staff,31,0,35,4
1681932686735,PHIL 15,A02,182602,Staff,33,0,35,2
1681932687758,PHIL 27,A01,182604,Staff,25,0,35,10
1681932687758,PHIL 27,A02,182607,Staff,34,0,35,1
1681932688781,PHIL 32,A01,182609,Staff,35,0,35,0
1681932688781,PHIL 32,A02,182612,Staff,35,0,35,0
1681932689809,PHIL 130,A00,182614,Staff,57,0,70,13
1681932690841,PHIL 136,A00,182616,Cohen; Jonathan David,64,0,70,6
1681932691939,PHIL 155,A00,182617,Vargas; Manuel Rogelio,57,0,70,13
1681932692963,PHIL 163,A01,182620,Staff,15,0,20,5
1681932692963,PHIL 163,A02,182624,Staff,10,0,20,10
1681932693993,PHIL 164,A00,182627,Staff,29,0,40,11
1681932695016,PHIL 173,A00,182628,Staff,35,0,40,5
1681932696043,PHYS 1A,A00,183221,Staff,52,0,60,8
1681932697070,PHYS 1AL,001,183222,Staff,24,0,30,6
1681932697070,PHYS 1AL,002,183223,Staff,24,0,30,6
1681932698102,PHYS 1B,A00,183231,Staff,40,0,60,20
1681932699125,PHYS 1BL,001,183232,Staff,15,0,30,15
1681932699125,PHYS 1BL,002,183233,Staff,27,0,30,3
1681932700148,PHYS 1C,A00,183240,Staff,20,0,60,40
1681932701170,PHYS 1CL,001,183241,Staff,8,0,30,22
1681932701170,PHYS 1CL,002,183242,Staff,21,0,30,9
1681932702193,PHYS 2AR,A01,183250,Staff,39,0,50,11
1681932703216,PHYS 2B,A01,183252,Staff,101,0,115,14
1681932704244,PHYS 2BL,A01,183254,Staff,21,0,24,3
1681932704244,PHYS 2BL,A02,183255,Staff,21,0,24,3
1681932705272,PHYS 2C,A01,183522,Staff,100,0,115,15
1681932706300,PHYS 4A,A01,183524,Staff,49,0,50,1
1681932707322,POLI 5,A00,183525,Staff,43,0,50,7
1681932708345,POLI 12,A00,183540,Staff,45,0,50,5
1681932709370,POLI 13R,A00,183541,Forman; Fonna,40,0,50,10
1681932710397,POLI 30,A00,183542,Mignozzetti; Umberto,48,0,50,2
1681932711420,POLI 100A,A00,183543,Staff,43,0,50,7
1681932712445,POLI 100E,A00,223598,Staff,32,0,35,3
1681932713470,POLI 103A,A00,183564,Kousser; Thad,34,0,50,16
1681932714494,POLI 104B,A00,201329,Staff,27,0,35,8
1681932715519,POLI 113BR,A00,183576,Hoston; Germaine,22,0,50,28
1681932716549,POLI 114BR,A00,183588,Staff,26,0,30,4
1681932717572,POLI 117R,A00,183595,Forman; Fonna,3,0,20,17
1681932718597,POLI 120H,A00,183596,Fisk; David Lee,13,0,20,7
1681932719619,POLI 130AA,A00,183597,Staff,13,0,20,7
1681932720642,POLI 134AA,A00,183598,Staff,19,0,20,1
1681932721667,POLI 135,A00,183599,Fisk; David Lee,19,0,25,6
1681932722692,POLI 142P,A00,183623,Staff,37,0,40,3
1681932723717,POLI 144D,A00,183624,Staff,22,0,25,3
1681932724741,POLI 151,A00,183625,Staff,14,0,20,6
1681932725771,POLI 162,A00,183626,Mignozzetti; Umberto,17,0,20,3
1681932726796,PSYC 1,A00,253748,Staff,85,0,90,5
1681932727825,PSYC 2,A00,183627,Moranton; Nirelia Melbina-,23,0,35,12
1681932728849,PSYC 3,A00,183628,Staff,42,0,45,3
1681932730899,PSYC 60,A01,183631,Lowe; Angela Beth,35,0,40,5
1681932731922,PSYC 70,A01,253757,Staff,34,0,45,11
1681932732944,PSYC 101,A00,183632,Heyman; Gail D.,40,0,60,20
1681932733979,PSYC 105,A00,183848,Lowe; Angela Beth,45,0,60,15
1681932735003,PSYC 106,A00,183849,Dobkins; Karen R.,39,0,60,21
1681932736027,PSYC 108,A00,253750,Staff,10,0,60,50
1681932737049,PSYC 114,A01,184275,Winkielman; Piotr,0,8,30,30
1681932738085,PSYC 122,A00,183856,Moranton; Nirelia Melbina-,0,16,30,30
1681932739110,PSYC 124,A00,183865,Chapman; Eddie Nathaniel,42,0,80,38
1681932740140,PSYC 137,A00,183880,Staff,16,0,25,9
1681932742190,PSYC 154,A00,183910,Lacefield; Katharine I,0,31,90,90
1681932744238,PSYC 162,A00,183946,Wixted; John T,38,0,90,52
1681932745265,PSYC 172,A00,183947,Gorman; Michael R.,5,0,30,25
1681932746289,PSYC 178,A00,183963,Glaser; Dale,14,0,40,26
1681932747311,PSYC 181GS,A00,183964,Anagnostaras; Stephan,10,0,10,0
1681932748335,PSYC 186GS,A01,257660,Staff,10,0,10,0
1681932749366,PSYC 193,B00,253749,Staff,22,0,25,3
1681932751418,PSYC 193L,A01,184122,Staff,33,0,35,2
1681932751418,PSYC 193L,C01,184167,Winkielman; Piotr,14,0,30,16
1681932752444,RELI 188GS,A00,182629,Rahimi; Babak,20,0,20,0
1681932753466,SE 101A,A00,182646,Staff,25,0,30,5
1681932754488,SE 101C,A00,182650,Staff,10,0,20,10
1681932755516,SE 110A,A00,182651,Staff,28,0,28,0
1681932756538,SE 130A,A00,182652,Staff,38,0,40,2
1681932757560,SIO 46GS,A00,182636,Cook; Geoffrey W,24,0,28,4
1681932758581,SIO 109R,A00,194459,Staff,0,2,20,20
1681932759602,SIO 121GS,A00,182639,Cook; Geoffrey W,24,0,28,4
1681932760625,SIO 132,A01,182642,Staff,30,0,40,10
1681932761651,SIO 139,A00,182644,Kacev; David,36,0,40,4
1681932762687,SOCI 2,A01,258404,Staff,33,0,36,3
1681932762687,SOCI 2,A02,258405,Staff,35,0,36,1
1681932763714,SOCI 60,A01,258408,Staff,29,0,30,1
1681932763714,SOCI 60,A02,258413,Staff,30,0,30,0
1681932764744,SOCI 100,A01,258415,Staff,28,0,30,2
1681932764744,SOCI 100,A02,258416,Staff,28,0,30,2
1681932770914,SOCI 127,A00,258421,Staff,19,0,30,11
1681932771942,SOCI 132,A00,258422,Staff,42,0,50,8
1681932772966,SOCI 133,A00,258423,Staff,26,0,30,4
1681932773991,SOCI 138GS,A00,258424,Staff,15,0,15,0
1681932775014,SOCI 145,A00,258425,Staff,23,0,30,7
1681932776037,SOCI 148,A00,258426,Staff,23,0,30,7
1681932777060,SOCI 153,A00,199217,Staff,29,0,30,1
1681932778085,SOCI 160,A00,258427,Staff,27,0,30,3
1681932779118,SOCI 160E,A00,258435,Staff,55,0,60,5
1681932780144,SOCI 189GS,A00,258436,Staff,15,0,15,0
1681932781169,SOCI 190GS,A00,258437,Staff,15,0,15,0
1681932782193,SYN 2,001,182658,Staff,8,0,16,8
1681932782193,SYN 2,002,201439,Staff,13,0,16,3
1681932782193,SYN 2,003,201443,Staff,16,0,16,0
1681932783216,SYN 100,A01,182657,Staff,12,0,20,8
1681932784245,TDAC 1,A00,184381,Salovey; Todd,16,0,20,4
1681932784245,TDAC 1,B00,184385,Harting; Carla Kelso,19,0,20,1
1681932784245,TDAC 1,C00,184394,Staff,18,0,20,2
1681932785272,TDAC 101,A00,184483,Harting; Carla Kelso,19,0,20,1
1681932786295,TDDE 111,A00,184496,Staff,14,0,15,1
1681932787319,TDDE 131,A00,184504,Staff,20,0,20,0
1681932787319,TDDE 131,B00,184505,Staff,17,0,18,1
1681932787319,TDDE 131,C00,184534,Staff,49,0,50,1
1681932787319,TDDE 131,D00,184564,Staff,15,0,15,0
1681932787319,TDDE 131,E00,204725,Staff,18,0,20,2
1681932788345,TDGE 1,A01,184414,Salovey; Todd,34,0,50,16
1681932789382,TDGE 5,A01,184419,Staff,23,0,24,1
1681932790404,TDGE 10,A00,184428,Fulton; Julia,27,0,50,23
1681932791427,TDGE 124,A00,184565,Fulton; Julia,0,3,50,50
1681932792450,TDGE 125,B00,184567,Meyer; Ursula,7,0,25,18
1681932793474,TDHT 101,A00,184568,Staff,21,0,25,4
1681932793474,TDHT 101,B00,184569,Staff,19,0,20,1
1681932794501,TDHT 114,A00,184570,Staff,48,0,50,2
1681932795610,TDMV 1,A00,184437,Arcidiacono; Kristin,21,0,30,9
1681932795610,TDMV 1,B00,184448,Caligagan; Maria T.,23,0,30,7
1681932796633,TDMV 2,A00,184449,Weinberg; Sadie,26,0,30,4
1681932796633,TDMV 2,B00,184453,Arcidiacono; Kristin,29,0,30,1
1681932797655,TDMV 110,A00,184571,Weinberg; Sadie,30,0,30,0
1681932798681,TDMV 142,A00,184572,Caligagan; Tony,26,0,30,4
1681932798681,TDMV 142,B00,184573,Caligagan; Maria T.,26,0,30,4
1681932799706,TDTR 20,A00,184482,Jun; Grace Shin Hae,25,0,25,0
1681932800733,USP 2,A01,184290,Hinds; Juli Beth,23,0,25,2
1681932801759,USP 3,A01,184295,Staff,20,0,25,5
1681932802782,USP 4,A00,184304,McTague; Sarah,13,0,25,12
1681932803805,USP 100,A00,184315,Staff,16,0,25,9
1681932804827,USP 105,A00,184326,Staff,21,0,25,4
1681932805854,USP 151,A00,184327,Staff,17,0,25,8
1681932806885,USP 170,A00,184380,Hinds; Juli Beth,12,0,25,13
1681932807923,VIS 21B,A01,182660,Staff,28,0,31,3
1681932807923,VIS 21B,A02,182662,Staff,30,0,31,1
1681932808951,VIS 103D,A00,182663,Staff,74,0,75,1
1681932809974,VIS 105D,A00,182667,Li; Huai,14,0,22,8
1681932810997,VIS 122GS,A00,182668,Herbst; Matthew,20,0,20,0
1681932812027,VIS 128C,A00,182673,Staff,68,0,75,7
1681932813050,VIS 130,A00,182675,Staff,19,0,22,3
1681932814072,VIS 160A,A00,182678,Stalbaum; Brett,4,0,10,6
1681932816124,WCWP 10B,A00,201679,Staff,15,0,15,0
1681932816124,WCWP 10B,B00,201695,Staff,15,0,15,0
1681932817150,WCWP 100,A00,201716,Staff,12,0,15,3
1681932817150,WCWP 100,B00,201717,Staff,0,0,15,15
1681932819209,ANSC 105GS,A00,258289,Staff,0,0,0,0
1681932820231,ANSC 125GS,A00,258295,Staff,0,0,0,0
1681932821255,ANSC 150,A00,258267,Staff,27,0,40,13
1681932822284,ANSC 190GS,A00,258280,Staff,0,0,0,2
1681932823310,ANTH 1,A00,258264,Staff,38,0,40,2
1681932824333,ANTH 2,A01,258259,Staff,72,0,76,4
1681932825359,ANTH 23,A01,258228,Staff,35,0,40,5
1681932826389,ANTH 101,A01,258236,Staff,38,0,40,2
1681932827417,ANTH 102,A00,258272,Staff,59,0,60,1
1681932828442,ANTH 105,A00,258244,Staff,28,0,35,7
1681932829469,BENG 130,A00,253975,Staff,37,0,40,3
1681932830491,BIBC 102,A01,191866,Flagg; Matthew Paul,16,0,32,16
1681932830491,BIBC 102,A02,191867,Flagg; Matthew Paul,21,0,32,11
1681932830491,BIBC 102,A03,191868,Flagg; Matthew Paul,27,0,32,5
1681932830491,BIBC 102,A04,191936,Flagg; Matthew Paul,20,0,32,12
1681932830491,BIBC 102,A05,191937,Flagg; Matthew Paul,0,0,32,32
1681932831513,BICD 100,A01,191939,Cooper; Andrew Michael,27,0,32,5
1681932831513,BICD 100,A02,191940,Cooper; Andrew Michael,32,0,32,0
1681932831513,BICD 100,A03,191941,Cooper; Andrew Michael,32,0,32,0
1681932831513,BICD 100,A04,191942,Cooper; Andrew Michael,32,0,32,0
1681932831513,BICD 100,A05,191943,Cooper; Andrew Michael,32,0,32,0
1681932832540,BIEB 126,A01,191945,Cleland; Elsa Eleanor,0,5,32,32
1681932832540,BIEB 126,A02,191946,Cleland; Elsa Eleanor,26,0,32,6
1681932832540,BIEB 126,A03,191947,Cleland; Elsa Eleanor,29,0,32,3
1681932832540,BIEB 126,A04,191948,Cleland; Elsa Eleanor,16,0,32,16
1681932832540,BIEB 126,A05,191996,Cleland; Elsa Eleanor,28,0,32,4
1681932833565,BIEB 136GS,A00,191997,Shurin; Jonathan & Holway; David A.,0,0,0,9
1681932834588,BIEB 137GS,A01,191999,Shurin; Jonathan & Holway; David A.,0,0,0,8
1681932835616,BILD 1,A01,205385,Staff,30,0,32,2
1681932835616,BILD 1,A02,205386,Staff,30,0,32,2
1681932835616,BILD 1,A03,205387,Staff,31,0,32,1
1681932835616,BILD 1,A04,205388,Staff,25,0,32,7
1681932836642,BILD 2,A01,191774,Staff,26,0,32,6
1681932836642,BILD 2,A02,191775,Staff,30,0,32,2
1681932836642,BILD 2,A03,191777,Staff,29,0,32,3
1681932836642,BILD 2,A04,191856,Staff,30,0,32,2
1681932836642,BILD 2,A05,191857,Staff,31,0,32,1
1681932836642,BILD 2,A06,191858,Staff,32,0,32,0
1681932836642,BILD 2,A07,191859,Staff,31,0,32,1
1681932837664,BILD 3,A01,205391,Staff,27,0,32,5
1681932837664,BILD 3,A02,205393,Staff,32,0,32,0
1681932837664,BILD 3,A03,205394,Staff,26,0,32,6
1681932837664,BILD 3,A04,205395,Staff,32,0,32,0
1681932838700,BILD 20,A01,191861,Staff,32,0,32,0
1681932838700,BILD 20,A02,191862,Staff,32,0,32,0
1681932839725,BILD 30,A01,191864,Staff,31,0,32,1
1681932840752,BIMM 100,A01,192019,Staff,0,0,32,32
1681932840752,BIMM 100,A02,192020,Staff,14,0,32,18
1681932840752,BIMM 100,A03,192035,Staff,17,0,32,15
1681932841774,BIMM 110,A01,192037,Tat; John,0,0,32,32
1681932841774,BIMM 110,A02,192038,Tat; John,4,0,32,28
1681932842801,BIMM 120,A01,192040,Pickett; Brooke Elizabeth,0,0,32,32
1681932842801,BIMM 120,A02,192041,Pickett; Brooke Elizabeth,7,0,32,25
1681932842801,BIMM 120,A03,192042,Pickett; Brooke Elizabeth,14,0,32,18
1681932843824,BIPN 100,A01,192044,Armour; Jon Christopher,23,0,32,9
1681932843824,BIPN 100,A02,192059,Armour; Jon Christopher,30,0,32,2
1681932843824,BIPN 100,A03,192064,Armour; Jon Christopher,30,0,32,2
1681932843824,BIPN 100,A04,192073,Armour; Jon Christopher,26,0,32,6
1681932844850,BIPN 148,A01,205411,Leutgeb; Jill K.,14,0,32,18
1681932844850,BIPN 148,A02,205412,Leutgeb; Jill K.,31,0,32,1
1681932844850,BIPN 148,A03,205413,Leutgeb; Jill K.,29,0,32,3
1681932844850,BIPN 148,A04,205414,Leutgeb; Jill K.,30,0,32,2
1681932845875,BIPN 160,A01,192115,Marino; Marc J,15,0,32,17
1681932845875,BIPN 160,A02,192148,Marino; Marc J,27,0,32,5
1681932845875,BIPN 160,A03,192158,Marino; Marc J,31,0,32,1
1681932845875,BIPN 160,A04,192190,Marino; Marc J,32,0,32,0
1681932845875,BIPN 160,A05,192287,Marino; Marc J,32,0,32,0
1681932845875,BIPN 160,A06,192288,Marino; Marc J,32,0,32,0
1681932846897,BIPN 194,A00,206038,Leutgeb; Stefan,28,0,32,4
1681932847931,BISP 194,A00,192289,Nieh; James Charles,9,0,32,23
1681932847931,BISP 194,B00,245332,Staff,26,0,32,6
1681932848962,CAT 124,A01,202247,Staff,15,0,15,0
1681932849986,CAT 125,A00,202248,Staff,18,0,20,2
1681932849986,CAT 125,B00,202253,Staff,20,0,20,0
1681932849986,CAT 125,C00,202257,Staff,18,0,20,2
1681932851009,CAT 125GS,A01,202273,Bronstein; Phoebe Malan,20,0,20,0
1681932852036,CAT 125R,A00,202284,Staff,17,0,20,3
1681932852036,CAT 125R,C00,202286,Staff,4,0,20,16
1681932852036,CAT 125R,D00,202291,Staff,15,0,20,5
1681932852036,CAT 125R,E00,202295,Staff,13,0,20,7
1681932852036,CAT 125R,F00,202302,Staff,6,0,20,14
1681932853066,CENG 100,A00,204724,Opatkiewicz; Justin Paul,23,0,25,2
1681932854095,CGS 2A,A01,180420,Staff,30,0,36,6
1681932855129,CGS 101,A00,180421,Staff,15,0,20,5
1681932856158,CGS 112,A00,180422,Staff,8,0,16,8
1681932857181,CGS 113,A00,180423,Staff,18,0,20,2
1681932858203,CGS 137,A00,180424,Staff,12,0,12,0
1681932859226,CGS 147,A00,180425,Staff,10,0,10,0
1681932860258,CHEM 6A,A01,179556,Staff,92,0,100,8
1681932860258,CHEM 6A,A02,179558,Staff,0,0,0,0
1681932861285,CHEM 6B,A01,179560,Staff,100,0,100,0
1681932862314,CHEM 6C,A01,179565,Jazzar; Rodolphe,91,0,100,9
1681932863353,CHEM 7L,A01,179586,Schurmeier; Kimberly,10,0,24,14
1681932863353,CHEM 7L,A02,179587,Schurmeier; Kimberly,22,0,24,2
1681932863353,CHEM 7L,A03,179590,Schurmeier; Kimberly,22,0,24,2
1681932863353,CHEM 7L,A04,179591,Schurmeier; Kimberly,22,0,24,2
1681932863353,CHEM 7L,B01,179598,Schurmeier; Kimberly,14,0,24,10
1681932863353,CHEM 7L,B02,179599,Schurmeier; Kimberly,23,0,24,1
1681932863353,CHEM 7L,B03,179606,Schurmeier; Kimberly,22,0,24,2
1681932863353,CHEM 7L,B04,179607,Schurmeier; Kimberly,22,0,24,2
1681932864380,CHEM 11,A01,179609,Stallings; Dontarie M,86,0,100,14
1681932865406,CHEM 40A,A01,179621,Staff,38,0,50,12
1681932865406,CHEM 40A,A02,179622,Staff,46,0,50,4
1681932866432,CHEM 40B,A01,179630,Weizman; Haim,45,0,50,5
1681932866432,CHEM 40B,A02,179631,Weizman; Haim,43,0,50,7
1681932867455,CHEM 41A,A01,179660,Klosterman; Jeremy K,90,0,100,10
1681932868485,CHEM 43A,A01,179683,Klosterman; Jeremy K,0,0,24,24
1681932868485,CHEM 43A,A02,179688,Klosterman; Jeremy K,5,0,24,19
1681932868485,CHEM 43A,A03,179689,Klosterman; Jeremy K,17,0,24,7
1681932868485,CHEM 43A,A04,179691,Klosterman; Jeremy K,17,0,24,7
1681932869513,CHEM 114A,A01,179693,Stallings; Dontarie M,64,0,100,36
1681932870537,CHEM 143B,A01,179698,Weizman; Haim,16,0,24,8
1681932870537,CHEM 143B,A02,179700,Weizman; Haim,23,0,24,1
1681932871560,CHIN 169A,A00,179701,Wang; Xiao,20,0,20,0
1681932872586,COGS 2,A01,179750,Boyle; Mary E. T.,16,0,30,14
1681932873617,COGS 9,A01,179759,Jones; Cameron Robert,40,0,50,10
1681932874643,COGS 14A,A01,179854,Staff,7,0,50,43
1681932875671,COGS 14B,A01,179856,Staff,50,0,60,10
1681932876700,COGS 17,A01,179874,Staff,70,0,75,5
1681932877722,COGS 18,A01,179884,Staff,59,0,80,21
1681932878745,COGS 100,A01,179886,Staff,29,0,60,31
1681932879773,COGS 101B,A01,179892,Staff,0,4,30,30
1681932880800,COGS 101C,A01,179894,Staff,26,0,30,4
1681932881826,COGS 107A,A01,179896,Boyle; Mary E. T.,28,0,40,12
1681932882855,COGS 108,A01,179898,Simpkins; Charles Alexander,0,34,60,60
1681932883882,COGS 109,A01,179900,Staff,32,0,40,8
1681932884915,COGS 118A,A01,179946,Staff,3,0,40,37
1681932885938,COGS 153,A00,179978,Staff,0,7,30,30
1681932886965,COGS 156,A01,179981,Staff,19,0,30,11
1681932889013,COGS 172,A01,179987,Staff,9,0,30,21
1681932891059,COGS 186,A01,179991,Staff,11,0,30,19
1681932892090,COMM 10,A01,180001,Staff,11,0,25,14
1681932892090,COMM 10,A02,180004,Staff,20,0,25,5
1681932893116,COMM 100A,A01,180016,Staff,13,0,25,12
1681932893116,COMM 100A,A02,180020,Staff,24,0,25,1
1681932894139,COMM 101T,A00,180029,Halm; Gavin Patrick,16,0,35,19
1681932895166,COMM 106V,A00,180043,Staff,34,0,35,1
1681932896190,COMM 109P,A00,180044,Staff,29,0,35,6
1681932897214,COMM 113T,A00,180045,Havis; Allan,35,0,45,10
1681932898237,COMM 132,A00,180046,McKenna; Denise,17,0,30,13
1681932899358,COMM 143,A00,180047,Staff,16,0,30,14
1681932900383,COMM 190,A00,180048,Conner; Thomas Hartnell,15,0,23,8
1681932901412,CSE 8A,A50,180053,Cao; Yingjun,20,0,50,30
1681932901412,CSE 8A,B50,180180,Staff,50,0,50,0
1681932902440,CSE 11,A01,180190,Cao; Yingjun,20,0,50,30
1681932903467,CSE 20,A01,180192,Briones; Jor-el Thomas Caparas,20,0,30,10
1681932904498,CSE 21,A01,194538,Briones; Jor-el Thomas Caparas,49,0,60,11
1681932905527,CSE 30,A01,180324,Eldon; John,71,0,100,29
1681932906551,CSE 101,A01,201353,Staff,0,31,40,40
1681932907576,CSE 134B,A01,180326,Powell; Thomas Allan,70,0,100,30
1681932908598,CSE 140,A01,180328,Staff,21,0,75,54
1681932909624,CSE 140L,A01,180344,Eldon; John,46,0,100,54
1681932910660,CSE 150A,A01,180411,Staff,0,20,50,50
1681932911684,CSE 151A,A01,180414,Staff,0,15,50,50
1681932912707,CSE 175,A01,222521,Kumar; Rakesh,50,0,50,0
1681932913730,CSE 190,A00,201419,Staff,42,0,49,7
1681932914753,CSS 1,A01,194536,Staff,32,0,50,18
1681932915779,DSC 30,A01,202385,Staff,48,0,50,2
1681932916805,DSC 40A,A01,202387,Albuyeh; Rod,50,0,50,0
1681932917831,DSC 190,A01,202389,Silberman; Jack,21,0,21,0
1681932918853,DSGN 100,A01,179993,Staff,13,0,30,17
1681932919882,ECE 65,A50,180708,Staff,10,0,20,10
1681932919882,ECE 65,A51,180739,Staff,19,0,20,1
1681932920907,ECON 1,A01,180427,Famulari; Melissa,66,0,70,4
1681932921932,ECON 2,A01,180450,Levkoff; Steven B.,63,0,70,7
1681932922954,ECON 4,A01,203351,Anderson; John Charles,6,0,10,4
1681932923979,ECON 100A,A01,180472,Famulari; Melissa,59,0,70,11
1681932925008,ECON 120A,A01,180549,Staff,60,0,70,10
1681932926031,ECON 120B,A01,180655,Ma; Xinwei,34,0,70,36
1681932927058,ECON 129,A00,203333,Eckert; Fabian Paul,7,0,35,28
1681932928083,ECON 131,A00,180656,Staff,0,1,35,35
1681932929106,ECON 172B,A01,180672,Levkoff; Steven B.,31,0,35,4
1681932930128,ECON 178,A01,203342,Zhu; Ying,2,0,35,33
1681932931160,EDS 108GS,A00,202383,Wishard Guerra; Alison G.,20,0,20,0
1681932932182,EDS 111GS,A00,202347,Wishard Guerra; Alison G.,20,0,20,0
1681932933204,EDS 112,A01,202323,Staff,53,0,60,7
1681932934229,EDS 113,A00,202340,Staff,32,0,35,3
1681932935256,EDS 118,A00,201231,Staff,19,0,30,11
1681932936279,EDS 119,A00,204994,Staff,8,0,10,2
1681932937304,EDS 124BR,A00,202324,Eguchi; Emi,0,2,25,25
1681932938330,EDS 126,A01,203208,Jones; Makeba,26,0,30,4
1681932939357,EDS 135,A01,202333,Staff,17,0,20,3
1681932940389,EDS 180,A00,202311,Staff,47,0,50,3
1681932941411,ERC 190GS,A01,253747,Staff,28,0,28,0
1681932942434,ETHN 104,A00,180742,Staff,20,0,35,15
1681932943460,ETHN 118,A00,180745,Staff,26,0,35,9
1681932944483,ETHN 127,A00,180747,Staff,8,0,16,8
1681932945510,ETHN 137,A00,180880,Staff,11,0,12,1
1681932946532,ETHN 147,A00,180890,Staff,8,0,10,2
1681932947557,ETHN 154,A00,180891,Staff,4,0,8,4
1681932948579,ETHN 168,A00,180892,Staff,9,0,10,1
1681932949602,GLBH 20,A00,201051,Hannah; Seth Donal,0,7,0,1
1681932950628,GLBH 111,A01,209338,Burgos; Jose L.,0,0,0,0
1681932951652,GLBH 150,A00,258300,Staff,0,4,0,0
1681932952677,GLBH 181,A00,201207,Staff,4,0,40,36
1681932953698,HIEU 109,A00,180898,Staff,19,0,20,1
1681932954725,HIEU 111,A00,180899,Staff,0,2,20,20
1681932955747,HIEU 124,A00,180900,Staff,16,0,20,4
1681932956778,HILA 122,A00,180901,Staff,17,0,20,3
1681932957799,HILA 132,A00,180902,Vitz; Matthew,0,3,20,20
1681932958824,HILD 10,A01,180896,Staff,12,0,20,8
1681932959849,HILD 30GS,A00,180897,Edington; Claire Ellen,0,0,0,0
1681932960875,HISC 105,A00,180903,Staff,20,0,20,0
1681932961916,HISC 117,A00,180904,Staff,10,0,20,10
1681932962938,HIUS 108B,A00,181005,Staff,18,0,20,2
1681932963961,HIUS 113,A00,181093,Staff,0,0,20,20
1681932964994,HUM 3,A01,181190,Patterson; Patrick H.,33,0,50,17
1681932964994,HUM 3,B01,181195,Staff,44,0,50,6
1681932966017,HUM 3GS,A00,181196,Herbst; Matthew,0,0,0,0
1681932967041,HUM 4,A01,181227,West; Geoffrey Scott,33,0,50,17
1681932967041,HUM 4,B01,181282,Staff,41,0,50,9
1681932968063,HUM 4GS,A00,181377,Lyon; Antony J.,0,0,0,0
1681932969086,HUM 5,A01,181536,Zavodny; Tatiana Sophia,24,0,50,26
1681932969086,HUM 5,B01,181908,Staff,32,0,50,18
1681932970110,INTL 190,A00,181909,Segui; Alan S,0,0,0,8
1681932970110,INTL 190,B00,181961,Segui; Alan S,0,0,0,7
1681932971145,JAPN 20AR,A01,182113,Ross; Kayoko F,15,0,20,5
1681932972172,LATI 50,A01,202391,Martin-Cabrera; Luis,17,0,30,13
1681932972172,LATI 50,A02,202392,Martin-Cabrera; Luis,26,0,30,4
1681932973195,LATI 180,A00,202393,Kokinis; Troy Andreas,24,0,25,1
1681932974217,LIFR 1A,A00,182119,Staff,13,0,14,1
1681932975240,LIFR 1AX,A00,182324,Staff,13,0,14,1
1681932976262,LIFR 1B,A00,182259,Staff,12,0,14,2
1681932977286,LIFR 1BX,A00,182273,Staff,12,0,14,2
1681932978333,LIGN 8,A00,182330,Staff,125,0,150,25
1681932979355,LIGN 9GS,A00,182362,Staff,14,0,20,6
1681932980385,LIGN 119,A00,204992,Takahashi; Maho,11,0,15,4
1681932981410,LIGN 130,A01,182384,Staff,47,0,50,3
1681932982432,LIGN 149GS,A00,182390,Staff,14,0,20,6
1681932983457,LIGN 170,A00,182404,Staff,23,0,30,7
1681932984481,LISP 1D,A00,182281,Staff,6,0,14,8
1681932984481,LISP 1D,B00,182287,Staff,13,0,14,1
1681932984481,LISP 1D,C00,182295,Staff,10,0,14,4
1681932984481,LISP 1D,D00,182301,Staff,14,0,14,0
1681932985505,LISP 1DX,A00,182309,Staff,18,0,28,10
1681932985505,LISP 1DX,B00,182316,Staff,25,0,28,3
1681932986527,LTAF 120GS,A00,182412,Zhiri; Oumelbanine,20,0,20,0
1681932987549,LTCS 172GS,A00,182437,Bronstein; Phoebe Malan,20,0,20,0
1681932988573,LTEA 138,A00,182457,Staff,17,0,40,23
1681932989594,LTEN 114,A01,182490,Staff,23,0,25,2
1681932990617,LTEN 130GS,A00,182491,Lyon; Antony J.,20,0,20,0
1681932991641,LTEN 169,A00,182493,Cuong; Marisol,17,0,25,8
1681932992670,LTEN 178,A00,182501,Staff,14,0,15,1
1681932993692,LTEN 181,A00,182515,Staff,19,0,25,6
1681932994715,LTEN 185GS,A00,197655,Forbes; Camille,20,0,20,0
1681932995742,LTSP 100B,A00,202208,Bessett; Ryan Matthew,24,0,25,1
1681932996765,LTWL 100,A00,182516,Myerston Santana; Jacobo,20,0,30,10
1681932997794,LTWR 100GS,A00,182518,Forbes; Camille,20,0,20,0
1681932998820,LTWR 102,A00,182522,Staff,15,0,15,0
1681932998820,LTWR 102,B00,182525,Staff,14,0,15,1
1681932999842,LTWR 115,A00,182526,Staff,10,0,15,5
1681933000870,MAE 8,A01,182528,Pham; Hieu Tan,67,0,70,3
1681933001896,MAE 11,A00,182529,Bahadori; Mohammad Yousef,90,0,100,10
1681933002998,MAE 20,A00,182530,Evdokimenko; Ekaterina,67,0,70,3
1681933004028,MAE 30A,A00,182532,Staff,44,0,45,1
1681933005051,MAE 101A,A00,182533,Bahadori; Mohammad Yousef,93,0,100,7
1681933006082,MAE 101C,A00,182538,Staff,62,0,70,8
1681933007107,MAE 104,A00,182539,Staff,44,0,50,6
1681933008129,MAE 131A,A00,182540,Ghazinejad; Maziar,40,0,45,5
1681933009155,MAE 143A,A00,182548,Bewley; Thomas R,42,0,50,8
1681933010177,MAE 150,A00,182549,Staff,28,0,40,12
1681933011199,MAE 160,A00,182550,Evdokimenko; Ekaterina,39,0,60,21
1681933012225,MATH 3C,A01,182725,Staff,24,0,30,6
1681933013248,MATH 10A,A01,182729,Staff,24,0,30,6
1681933013248,MATH 10A,B01,182732,Staff,25,0,30,5
1681933014372,MATH 10B,A01,182737,Staff,15,0,30,15
1681933014372,MATH 10B,A02,182738,Staff,24,0,30,6
1681933014372,MATH 10B,B01,182744,Staff,24,0,30,6
1681933014372,MATH 10B,B02,182745,Staff,27,0,30,3
1681933015397,MATH 18,A01,182750,Anzaldo; Leesa B,28,0,30,2
1681933015397,MATH 18,A02,182751,Anzaldo; Leesa B,28,0,30,2
1681933015397,MATH 18,A03,182753,Anzaldo; Leesa B,27,0,30,3
1681933015397,MATH 18,A04,182757,Anzaldo; Leesa B,29,0,30,1
1681933015397,MATH 18,B01,182761,Anzaldo; Leesa B,27,0,30,3
1681933015397,MATH 18,B02,182764,Anzaldo; Leesa B,27,0,30,3
1681933015397,MATH 18,B03,182765,Anzaldo; Leesa B,29,0,30,1
1681933015397,MATH 18,B04,182766,Anzaldo; Leesa B,30,0,30,0
1681933016425,MATH 20A,A01,182771,Suk; Andrew Hoon,27,0,30,3
1681933017448,MATH 20B,A01,182775,Bach; Quang Tran,30,0,30,0
1681933017448,MATH 20B,A02,182777,Bach; Quang Tran,29,0,30,1
1681933017448,MATH 20B,B01,182780,Bach; Quang Tran,26,0,30,4
1681933017448,MATH 20B,B02,182782,Bach; Quang Tran,30,0,30,0
1681933018475,MATH 20C,A01,182787,Staff,24,0,30,6
1681933018475,MATH 20C,A02,182790,Staff,29,0,30,1
1681933018475,MATH 20C,B01,182792,Staff,23,0,30,7
1681933018475,MATH 20C,B02,182796,Staff,26,0,30,4
1681933019498,MATH 20D,A01,182799,Staff,27,0,30,3
1681933019498,MATH 20D,A02,182802,Staff,29,0,30,1
1681933019498,MATH 20D,A03,182803,Staff,30,0,30,0
1681933020523,MATH 20E,A01,182809,Verstraete; Jacques Allan,19,0,30,11
1681933020523,MATH 20E,A02,182811,Verstraete; Jacques Allan,27,0,30,3
1681933020523,MATH 20E,B01,182814,Verstraete; Jacques Allan,21,0,30,9
1681933020523,MATH 20E,B02,182815,Verstraete; Jacques Allan,29,0,30,1
1681933021591,MATH 103A,A01,182820,Staff,3,0,30,27
1681933021591,MATH 103A,A02,182821,Staff,26,0,30,4
1681933021591,MATH 103A,A03,182822,Staff,20,0,30,10
1681933021591,MATH 103A,B01,182825,Staff,21,0,30,9
1681933021591,MATH 103A,B02,182826,Staff,30,0,30,0
1681933021591,MATH 103A,B03,182830,Staff,30,0,30,0
1681933022614,MATH 109,A01,182836,Chow; Bennett,23,0,30,7
1681933022614,MATH 109,A02,182838,Chow; Bennett,27,0,30,3
1681933022614,MATH 109,A03,182894,Chow; Bennett,29,0,30,1
1681933022614,MATH 109,B01,182908,Chow; Bennett,26,0,30,4
1681933022614,MATH 109,B02,182909,Chow; Bennett,30,0,30,0
1681933022614,MATH 109,B03,182910,Chow; Bennett,26,0,30,4
1681933023640,MATH 142A,A01,182925,Staff,3,0,30,27
1681933023640,MATH 142A,A02,182935,Staff,23,0,30,7
1681933023640,MATH 142A,A03,182967,Staff,24,0,30,6
1681933023640,MATH 142A,B01,183125,Staff,22,0,30,8
1681933023640,MATH 142A,B02,183157,Staff,26,0,30,4
1681933023640,MATH 142A,B03,183158,Staff,29,0,30,1
1681933024662,MATH 183,A01,183160,Arias-Castro; Ery,22,0,30,8
1681933024662,MATH 183,A02,183161,Arias-Castro; Ery,28,0,30,2
1681933024662,MATH 183,B01,183163,Arias-Castro; Ery,26,0,30,4
1681933024662,MATH 183,B02,183164,Arias-Castro; Ery,28,0,30,2
1681933025685,MATH 193A,A01,183167,Staff,0,0,35,35
1681933025685,MATH 193A,A02,183168,Staff,23,0,35,12
1681933025685,MATH 193A,A03,183169,Staff,34,0,35,1
1681933025685,MATH 193A,A04,183170,Staff,26,0,35,9
1681933026710,MGT 4,A01,202395,Anderson; John Charles,76,0,80,4
1681933027733,MGT 5,A00,202396,Houskeeper; Robert,79,0,90,11
1681933028758,MGT 103,A00,202397,Eberhard; Craig A,47,0,90,43
1681933029780,MGT 131A,A00,202398,Houskeeper; Robert,81,0,90,9
1681933030803,MGT 135,A00,202399,Anderson; John Charles,81,0,90,9
1681933031826,MGT 162R,A00,202403,Gneezy; Uri,118,0,200,82
1681933032855,MGT 172,A00,202404,Hedges; Kathleen,23,0,90,67
1681933033877,MGT 181,A00,202405,Dunn; Louis Jean,78,0,90,12
1681933034911,MMW 14,A01,183200,Staff,0,0,28,28
1681933034911,MMW 14,A02,183201,Staff,25,0,28,3
1681933034911,MMW 14,A03,183202,Staff,24,0,28,4
1681933034911,MMW 14,A04,183203,Staff,25,0,28,3
1681933034911,MMW 14,A05,183204,Staff,26,0,28,2
1681933034911,MMW 14,A06,183205,Staff,27,0,28,1
1681933034911,MMW 14,B01,183207,Staff,26,0,28,2
1681933034911,MMW 14,B02,183208,Staff,28,0,28,0
1681933034911,MMW 14,B03,183209,Staff,28,0,28,0
1681933034911,MMW 14,B04,183210,Staff,28,0,28,0
1681933034911,MMW 14,B05,183211,Staff,28,0,28,0
1681933034911,MMW 14,B06,183212,Staff,27,0,28,1
1681933035934,MMW 14GS,A00,183213,Zhiri; Oumelbanine,28,0,28,0
1681933036956,MMW 15GS,B00,183215,Rahimi; Babak,28,0,28,0
1681933037979,MMW 121,A01,183217,Patterson; Patrick H.,7,0,28,21
1681933037979,MMW 121,A02,183218,Patterson; Patrick H.,25,0,28,3
1681933039005,MUS 1A,A01,182554,Staff,0,0,35,35
1681933040031,MUS 5,A01,182558,Staff,16,0,35,19
1681933041057,MUS 6,A01,182562,Staff,22,0,35,13
1681933042080,MUS 8GS,A00,182563,Borgo; David Garcia,25,0,25,0
1681933043104,MUS 13,A01,182567,Staff,23,0,25,2
1681933044130,MUS 15,A01,182570,Staff,31,0,35,4
1681933044130,MUS 15,B01,182575,Staff,7,0,35,28
1681933045152,MUS 80,A00,182578,Staff,22,0,25,3
1681933045152,MUS 80,B00,182581,Staff,20,0,25,5
1681933046181,MUS 113,A00,182582,Staff,25,0,25,0
1681933047203,MUS 114,A00,182583,Staff,0,0,25,25
1681933048225,MUS 150GS,A01,182588,Borgo; David Garcia,24,0,25,1
1681933049247,PHIL 1,A00,182590,Staff,34,0,40,6
1681933050270,PHIL 10,A01,182596,Grush; Rick Scott,30,0,35,5
1681933050270,PHIL 10,A02,182597,Grush; Rick Scott,33,0,35,2
1681933051293,PHIL 15,A01,182601,Staff,31,0,35,4
1681933051293,PHIL 15,A02,182602,Staff,33,0,35,2
1681933052321,PHIL 27,A01,182604,Staff,25,0,35,10
1681933052321,PHIL 27,A02,182607,Staff,34,0,35,1
1681933053348,PHIL 32,A01,182609,Staff,35,0,35,0
1681933053348,PHIL 32,A02,182612,Staff,35,0,35,0
1681933054374,PHIL 130,A00,182614,Staff,57,0,70,13
1681933055397,PHIL 136,A00,182616,Cohen; Jonathan David,64,0,70,6
1681933056428,PHIL 155,A00,182617,Vargas; Manuel Rogelio,57,0,70,13
1681933057454,PHIL 163,A01,182620,Staff,15,0,20,5
1681933057454,PHIL 163,A02,182624,Staff,10,0,20,10
1681933058479,PHIL 164,A00,182627,Staff,29,0,40,11
1681933059511,PHIL 173,A00,182628,Staff,35,0,40,5
1681933060537,PHYS 1A,A00,183221,Staff,52,0,60,8
1681933061566,PHYS 1AL,001,183222,Staff,24,0,30,6
1681933061566,PHYS 1AL,002,183223,Staff,24,0,30,6
1681933062588,PHYS 1B,A00,183231,Staff,40,0,60,20
1681933063615,PHYS 1BL,001,183232,Staff,15,0,30,15
1681933063615,PHYS 1BL,002,183233,Staff,27,0,30,3
1681933064640,PHYS 1C,A00,183240,Staff,20,0,60,40
1681933065664,PHYS 1CL,001,183241,Staff,8,0,30,22
1681933065664,PHYS 1CL,002,183242,Staff,21,0,30,9
1681933066689,PHYS 2AR,A01,183250,Staff,39,0,50,11
1681933067711,PHYS 2B,A01,183252,Staff,101,0,115,14
1681933068735,PHYS 2BL,A01,183254,Staff,21,0,24,3
1681933068735,PHYS 2BL,A02,183255,Staff,21,0,24,3
1681933069763,PHYS 2C,A01,183522,Staff,100,0,115,15
1681933070795,PHYS 4A,A01,183524,Staff,49,0,50,1
1681933071818,POLI 5,A00,183525,Staff,43,0,50,7
1681933072849,POLI 12,A00,183540,Staff,45,0,50,5
1681933073872,POLI 13R,A00,183541,Forman; Fonna,40,0,50,10
1681933074903,POLI 30,A00,183542,Mignozzetti; Umberto,48,0,50,2
1681933075927,POLI 100A,A00,183543,Staff,43,0,50,7
1681933076950,POLI 100E,A00,223598,Staff,32,0,35,3
1681933077987,POLI 103A,A00,183564,Kousser; Thad,34,0,50,16
1681933079017,POLI 104B,A00,201329,Staff,27,0,35,8
1681933080051,POLI 113BR,A00,183576,Hoston; Germaine,22,0,50,28
1681933081077,POLI 114BR,A00,183588,Staff,26,0,30,4
1681933082105,POLI 117R,A00,183595,Forman; Fonna,3,0,20,17
1681933083146,POLI 120H,A00,183596,Fisk; David Lee,13,0,20,7
1681933084183,POLI 130AA,A00,183597,Staff,13,0,20,7
1681933085209,POLI 134AA,A00,183598,Staff,19,0,20,1
1681933086235,POLI 135,A00,183599,Fisk; David Lee,19,0,25,6
1681933087257,POLI 142P,A00,183623,Staff,37,0,40,3
1681933088280,POLI 144D,A00,183624,Staff,22,0,25,3
1681933089305,POLI 151,A00,183625,Staff,14,0,20,6
1681933090331,POLI 162,A00,183626,Mignozzetti; Umberto,17,0,20,3
1681933091354,PSYC 1,A00,253748,Staff,85,0,90,5
1681933092377,PSYC 2,A00,183627,Moranton; Nirelia Melbina-,23,0,35,12
1681933093404,PSYC 3,A00,183628,Staff,42,0,45,3
1681933095457,PSYC 60,A01,183631,Lowe; Angela Beth,35,0,40,5
1681933096488,PSYC 70,A01,253757,Staff,34,0,45,11
1681933097513,PSYC 101,A00,183632,Heyman; Gail D.,40,0,60,20
1681933098540,PSYC 105,A00,183848,Lowe; Angela Beth,44,0,60,16
1681933099565,PSYC 106,A00,183849,Dobkins; Karen R.,38,0,60,22
1681933100590,PSYC 108,A00,253750,Staff,10,0,60,50
1681933101616,PSYC 114,A01,184275,Winkielman; Piotr,0,8,30,30
1681933102638,PSYC 122,A00,183856,Moranton; Nirelia Melbina-,0,16,30,30
1681933103664,PSYC 124,A00,183865,Chapman; Eddie Nathaniel,42,0,80,38
1681933104687,PSYC 137,A00,183880,Staff,16,0,25,9
1681933106822,PSYC 154,A00,183910,Lacefield; Katharine I,0,31,90,90
1681933108871,PSYC 162,A00,183946,Wixted; John T,38,0,90,52
1681933109898,PSYC 172,A00,183947,Gorman; Michael R.,4,0,30,26
1681933110922,PSYC 178,A00,183963,Glaser; Dale,14,0,40,26
1681933111944,PSYC 181GS,A00,183964,Anagnostaras; Stephan,10,0,10,0
1681933112970,PSYC 186GS,A01,257660,Staff,10,0,10,0
1681933113993,PSYC 193,B00,253749,Staff,22,0,25,3
1681933116050,PSYC 193L,A01,184122,Staff,33,0,35,2
1681933116050,PSYC 193L,C01,184167,Winkielman; Piotr,14,0,30,16
1681933117074,RELI 188GS,A00,182629,Rahimi; Babak,20,0,20,0
1681933118108,SE 101A,A00,182646,Staff,25,0,30,5
1681933119131,SE 101C,A00,182650,Staff,10,0,20,10
1681933120153,SE 110A,A00,182651,Staff,28,0,28,0
1681933121178,SE 130A,A00,182652,Staff,38,0,40,2
1681933122205,SIO 46GS,A00,182636,Cook; Geoffrey W,24,0,28,4
1681933123233,SIO 109R,A00,194459,Staff,0,2,20,20
1681933124258,SIO 121GS,A00,182639,Cook; Geoffrey W,24,0,28,4
1681933125283,SIO 132,A01,182642,Staff,30,0,40,10
1681933126305,SIO 139,A00,182644,Kacev; David,36,0,40,4
1681933127327,SOCI 2,A01,258404,Staff,33,0,36,3
1681933127327,SOCI 2,A02,258405,Staff,35,0,36,1
1681933128358,SOCI 60,A01,258408,Staff,29,0,30,1
1681933128358,SOCI 60,A02,258413,Staff,30,0,30,0
1681933129380,SOCI 100,A01,258415,Staff,28,0,30,2
1681933129380,SOCI 100,A02,258416,Staff,28,0,30,2
1681933135522,SOCI 127,A00,258421,Staff,18,0,30,12
1681933136548,SOCI 132,A00,258422,Staff,42,0,50,8
1681933137570,SOCI 133,A00,258423,Staff,26,0,30,4
1681933138597,SOCI 138GS,A00,258424,Staff,15,0,15,0
1681933139624,SOCI 145,A00,258425,Staff,23,0,30,7
1681933140646,SOCI 148,A00,258426,Staff,23,0,30,7
1681933141668,SOCI 153,A00,199217,Staff,29,0,30,1
1681933142691,SOCI 160,A00,258427,Staff,27,0,30,3
1681933143714,SOCI 160E,A00,258435,Staff,55,0,60,5
1681933144737,SOCI 189GS,A00,258436,Staff,15,0,15,0
1681933145772,SOCI 190GS,A00,258437,Staff,15,0,15,0
1681933146794,SYN 2,001,182658,Staff,8,0,16,8
1681933146794,SYN 2,002,201439,Staff,13,0,16,3
1681933146794,SYN 2,003,201443,Staff,16,0,16,0
1681933147817,SYN 100,A01,182657,Staff,11,0,20,9
1681933148840,TDAC 1,A00,184381,Salovey; Todd,16,0,20,4
1681933148840,TDAC 1,B00,184385,Harting; Carla Kelso,19,0,20,1
1681933148840,TDAC 1,C00,184394,Staff,18,0,20,2
1681933149871,TDAC 101,A00,184483,Harting; Carla Kelso,19,0,20,1
1681933150897,TDDE 111,A00,184496,Staff,14,0,15,1
1681933151919,TDDE 131,A00,184504,Staff,20,0,20,0
1681933151919,TDDE 131,B00,184505,Staff,17,0,18,1
1681933151919,TDDE 131,C00,184534,Staff,49,0,50,1
1681933151919,TDDE 131,D00,184564,Staff,15,0,15,0
1681933151919,TDDE 131,E00,204725,Staff,18,0,20,2
1681933152945,TDGE 1,A01,184414,Salovey; Todd,34,0,50,16
1681933153968,TDGE 5,A01,184419,Staff,23,0,24,1
1681933154989,TDGE 10,A00,184428,Fulton; Julia,27,0,50,23
1681933156011,TDGE 124,A00,184565,Fulton; Julia,0,3,50,50
1681933157037,TDGE 125,B00,184567,Meyer; Ursula,7,0,25,18
1681933158061,TDHT 101,A00,184568,Staff,21,0,25,4
1681933158061,TDHT 101,B00,184569,Staff,20,0,20,0
1681933159083,TDHT 114,A00,184570,Staff,47,0,50,3
1681933160108,TDMV 1,A00,184437,Arcidiacono; Kristin,21,0,30,9
1681933160108,TDMV 1,B00,184448,Caligagan; Maria T.,23,0,30,7
1681933161134,TDMV 2,A00,184449,Weinberg; Sadie,26,0,30,4
1681933161134,TDMV 2,B00,184453,Arcidiacono; Kristin,29,0,30,1
1681933162156,TDMV 110,A00,184571,Weinberg; Sadie,30,0,30,0
1681933163179,TDMV 142,A00,184572,Caligagan; Tony,26,0,30,4
1681933163179,TDMV 142,B00,184573,Caligagan; Maria T.,26,0,30,4
1681933164201,TDTR 20,A00,184482,Jun; Grace Shin Hae,25,0,25,0
1681933165224,USP 2,A01,184290,Hinds; Juli Beth,23,0,25,2
1681933166246,USP 3,A01,184295,Staff,20,0,25,5
1681933167272,USP 4,A00,184304,McTague; Sarah,13,0,25,12
1681933168298,USP 100,A00,184315,Staff,16,0,25,9
1681933169324,USP 105,A00,184326,Staff,21,0,25,4
1681933170348,USP 151,A00,184327,Staff,17,0,25,8
1681933171373,USP 170,A00,184380,Hinds; Juli Beth,12,0,25,13
1681933172399,VIS 21B,A01,182660,Staff,28,0,31,3
1681933172399,VIS 21B,A02,182662,Staff,30,0,31,1
1681933173420,VIS 103D,A00,182663,Staff,74,0,75,1
1681933174445,VIS 105D,A00,182667,Li; Huai,14,0,22,8
1681933175477,VIS 122GS,A00,182668,Herbst; Matthew,20,0,20,0
1681933176499,VIS 128C,A00,182673,Staff,68,0,75,7
1681933177522,VIS 130,A00,182675,Staff,19,0,22,3
1681933178548,VIS 160A,A00,182678,Stalbaum; Brett,4,0,10,6
1681933180601,WCWP 10B,A00,201679,Staff,15,0,15,0
1681933180601,WCWP 10B,B00,201695,Staff,15,0,15,0
1681933181633,WCWP 100,A00,201716,Staff,12,0,15,3
1681933181633,WCWP 100,B00,201717,Staff,0,0,15,15
1681933183704,ANSC 105GS,A00,258289,Staff,0,0,0,0
1681933184727,ANSC 125GS,A00,258295,Staff,0,0,0,0
1681933185750,ANSC 150,A00,258267,Staff,27,0,40,13
1681933186776,ANSC 190GS,A00,258280,Staff,0,0,0,2
1681933187800,ANTH 1,A00,258264,Staff,38,0,40,2
1681933188830,ANTH 2,A01,258259,Staff,72,0,76,4
1681933189852,ANTH 23,A01,258228,Staff,35,0,40,5
1681933190878,ANTH 101,A01,258236,Staff,38,0,40,2
1681933191904,ANTH 102,A00,258272,Staff,59,0,60,1
1681933192930,ANTH 105,A00,258244,Staff,28,0,35,7
1681933193953,BENG 130,A00,253975,Staff,37,0,40,3
1681933194978,BIBC 102,A01,191866,Flagg; Matthew Paul,16,0,32,16
1681933194978,BIBC 102,A02,191867,Flagg; Matthew Paul,21,0,32,11
1681933194978,BIBC 102,A03,191868,Flagg; Matthew Paul,27,0,32,5
1681933194978,BIBC 102,A04,191936,Flagg; Matthew Paul,20,0,32,12
1681933194978,BIBC 102,A05,191937,Flagg; Matthew Paul,0,0,32,32
1681933196002,BICD 100,A01,191939,Cooper; Andrew Michael,27,0,32,5
1681933196002,BICD 100,A02,191940,Cooper; Andrew Michael,32,0,32,0
1681933196002,BICD 100,A03,191941,Cooper; Andrew Michael,32,0,32,0
1681933196002,BICD 100,A04,191942,Cooper; Andrew Michael,32,0,32,0
1681933196002,BICD 100,A05,191943,Cooper; Andrew Michael,32,0,32,0
1681933197073,BIEB 126,A01,191945,Cleland; Elsa Eleanor,0,5,32,32
1681933197073,BIEB 126,A02,191946,Cleland; Elsa Eleanor,26,0,32,6
1681933197073,BIEB 126,A03,191947,Cleland; Elsa Eleanor,29,0,32,3
1681933197073,BIEB 126,A04,191948,Cleland; Elsa Eleanor,15,0,32,17
1681933197073,BIEB 126,A05,191996,Cleland; Elsa Eleanor,28,0,32,4
1681933198099,BIEB 136GS,A00,191997,Shurin; Jonathan & Holway; David A.,0,0,0,9
1681933199125,BIEB 137GS,A01,191999,Shurin; Jonathan & Holway; David A.,0,0,0,8
1681933200158,BILD 1,A01,205385,Staff,30,0,32,2
1681933200158,BILD 1,A02,205386,Staff,30,0,32,2
1681933200158,BILD 1,A03,205387,Staff,31,0,32,1
1681933200158,BILD 1,A04,205388,Staff,25,0,32,7
1681933201196,BILD 2,A01,191774,Staff,26,0,32,6
1681933201196,BILD 2,A02,191775,Staff,30,0,32,2
1681933201196,BILD 2,A03,191777,Staff,29,0,32,3
1681933201196,BILD 2,A04,191856,Staff,30,0,32,2
1681933201196,BILD 2,A05,191857,Staff,31,0,32,1
1681933201196,BILD 2,A06,191858,Staff,32,0,32,0
1681933201196,BILD 2,A07,191859,Staff,31,0,32,1
1681933202218,BILD 3,A01,205391,Staff,27,0,32,5
1681933202218,BILD 3,A02,205393,Staff,32,0,32,0
1681933202218,BILD 3,A03,205394,Staff,26,0,32,6
1681933202218,BILD 3,A04,205395,Staff,32,0,32,0
1681933203249,BILD 20,A01,191861,Staff,32,0,32,0
1681933203249,BILD 20,A02,191862,Staff,32,0,32,0
1681933204273,BILD 30,A01,191864,Staff,31,0,32,1
1681933205305,BIMM 100,A01,192019,Staff,0,0,32,32
1681933205305,BIMM 100,A02,192020,Staff,14,0,32,18
1681933205305,BIMM 100,A03,192035,Staff,17,0,32,15
1681933206331,BIMM 110,A01,192037,Tat; John,0,0,32,32
1681933206331,BIMM 110,A02,192038,Tat; John,4,0,32,28
1681933207362,BIMM 120,A01,192040,Pickett; Brooke Elizabeth,0,0,32,32
1681933207362,BIMM 120,A02,192041,Pickett; Brooke Elizabeth,7,0,32,25
1681933207362,BIMM 120,A03,192042,Pickett; Brooke Elizabeth,14,0,32,18
1681933208395,BIPN 100,A01,192044,Armour; Jon Christopher,23,0,32,9
1681933208395,BIPN 100,A02,192059,Armour; Jon Christopher,30,0,32,2
1681933208395,BIPN 100,A03,192064,Armour; Jon Christopher,30,0,32,2
1681933208395,BIPN 100,A04,192073,Armour; Jon Christopher,26,0,32,6
1681933209419,BIPN 148,A01,205411,Leutgeb; Jill K.,14,0,32,18
1681933209419,BIPN 148,A02,205412,Leutgeb; Jill K.,31,0,32,1
1681933209419,BIPN 148,A03,205413,Leutgeb; Jill K.,29,0,32,3
1681933209419,BIPN 148,A04,205414,Leutgeb; Jill K.,30,0,32,2
1681933210520,BIPN 160,A01,192115,Marino; Marc J,15,0,32,17
1681933210520,BIPN 160,A02,192148,Marino; Marc J,27,0,32,5
1681933210520,BIPN 160,A03,192158,Marino; Marc J,31,0,32,1
1681933210520,BIPN 160,A04,192190,Marino; Marc J,32,0,32,0
1681933210520,BIPN 160,A05,192287,Marino; Marc J,32,0,32,0
1681933210520,BIPN 160,A06,192288,Marino; Marc J,32,0,32,0
1681933211546,BIPN 194,A00,206038,Leutgeb; Stefan,28,0,32,4
1681933212571,BISP 194,A00,192289,Nieh; James Charles,9,0,32,23
1681933212571,BISP 194,B00,245332,Staff,26,0,32,6
1681933213594,CAT 124,A01,202247,Staff,15,0,15,0
1681933214617,CAT 125,A00,202248,Staff,18,0,20,2
1681933214617,CAT 125,B00,202253,Staff,20,0,20,0
1681933214617,CAT 125,C00,202257,Staff,18,0,20,2
1681933215641,CAT 125GS,A01,202273,Bronstein; Phoebe Malan,20,0,20,0
1681933216676,CAT 125R,A00,202284,Staff,17,0,20,3
1681933216676,CAT 125R,C00,202286,Staff,4,0,20,16
1681933216676,CAT 125R,D00,202291,Staff,15,0,20,5
1681933216676,CAT 125R,E00,202295,Staff,13,0,20,7
1681933216676,CAT 125R,F00,202302,Staff,6,0,20,14
1681933217712,CENG 100,A00,204724,Opatkiewicz; Justin Paul,23,0,25,2
1681933218740,CGS 2A,A01,180420,Staff,29,0,36,7
1681933219762,CGS 101,A00,180421,Staff,14,0,20,6
1681933220789,CGS 112,A00,180422,Staff,8,0,16,8
1681933221814,CGS 113,A00,180423,Staff,18,0,20,2
1681933222843,CGS 137,A00,180424,Staff,12,0,12,0
1681933223865,CGS 147,A00,180425,Staff,10,0,10,0
1681933224890,CHEM 6A,A01,179556,Staff,92,0,100,8
1681933224890,CHEM 6A,A02,179558,Staff,0,0,0,0
1681933225914,CHEM 6B,A01,179560,Staff,100,0,100,0
1681933226944,CHEM 6C,A01,179565,Jazzar; Rodolphe,90,0,100,10
1681933227976,CHEM 7L,A01,179586,Schurmeier; Kimberly,10,0,24,14
1681933227976,CHEM 7L,A02,179587,Schurmeier; Kimberly,22,0,24,2
1681933227976,CHEM 7L,A03,179590,Schurmeier; Kimberly,22,0,24,2
1681933227976,CHEM 7L,A04,179591,Schurmeier; Kimberly,22,0,24,2
1681933227976,CHEM 7L,B01,179598,Schurmeier; Kimberly,14,0,24,10
1681933227976,CHEM 7L,B02,179599,Schurmeier; Kimberly,23,0,24,1
1681933227976,CHEM 7L,B03,179606,Schurmeier; Kimberly,22,0,24,2
1681933227976,CHEM 7L,B04,179607,Schurmeier; Kimberly,22,0,24,2
1681933229004,CHEM 11,A01,179609,Stallings; Dontarie M,86,0,100,14
1681933230034,CHEM 40A,A01,179621,Staff,38,0,50,12
1681933230034,CHEM 40A,A02,179622,Staff,46,0,50,4
1681933231057,CHEM 40B,A01,179630,Weizman; Haim,45,0,50,5
1681933231057,CHEM 40B,A02,179631,Weizman; Haim,43,0,50,7
1681933232085,CHEM 41A,A01,179660,Klosterman; Jeremy K,90,0,100,10
1681933233108,CHEM 43A,A01,179683,Klosterman; Jeremy K,0,0,24,24
1681933233108,CHEM 43A,A02,179688,Klosterman; Jeremy K,5,0,24,19
1681933233108,CHEM 43A,A03,179689,Klosterman; Jeremy K,17,0,24,7
1681933233108,CHEM 43A,A04,179691,Klosterman; Jeremy K,17,0,24,7
1681933234131,CHEM 114A,A01,179693,Stallings; Dontarie M,64,0,100,36
1681933235158,CHEM 143B,A01,179698,Weizman; Haim,16,0,24,8
1681933235158,CHEM 143B,A02,179700,Weizman; Haim,23,0,24,1
1681933236187,CHIN 169A,A00,179701,Wang; Xiao,20,0,20,0
1681933237210,COGS 2,A01,179750,Boyle; Mary E. T.,16,0,30,14
1681933238233,COGS 9,A01,179759,Jones; Cameron Robert,40,0,50,10
1681933239257,COGS 14A,A01,179854,Staff,7,0,50,43
1681933240287,COGS 14B,A01,179856,Staff,50,0,60,10
1681933241310,COGS 17,A01,179874,Staff,70,0,75,5
1681933242332,COGS 18,A01,179884,Staff,59,0,80,21
1681933243354,COGS 100,A01,179886,Staff,29,0,60,31
1681933244381,COGS 101B,A01,179892,Staff,0,4,30,30
1681933245403,COGS 101C,A01,179894,Staff,26,0,30,4
1681933246432,COGS 107A,A01,179896,Boyle; Mary E. T.,28,0,40,12
1681933247457,COGS 108,A01,179898,Simpkins; Charles Alexander,0,34,60,60
1681933248483,COGS 109,A01,179900,Staff,32,0,40,8
1681933249508,COGS 118A,A01,179946,Staff,3,0,40,37
1681933250535,COGS 153,A00,179978,Staff,0,7,30,30
1681933251557,COGS 156,A01,179981,Staff,19,0,30,11
1681933253613,COGS 172,A01,179987,Staff,9,0,30,21
1681933255661,COGS 186,A01,179991,Staff,11,0,30,19
1681933256684,COMM 10,A01,180001,Staff,11,0,25,14
1681933256684,COMM 10,A02,180004,Staff,20,0,25,5
1681933257709,COMM 100A,A01,180016,Staff,13,0,25,12
1681933257709,COMM 100A,A02,180020,Staff,24,0,25,1
1681933258731,COMM 101T,A00,180029,Halm; Gavin Patrick,16,0,35,19
1681933259756,COMM 106V,A00,180043,Staff,34,0,35,1
1681933260781,COMM 109P,A00,180044,Staff,29,0,35,6
1681933261812,COMM 113T,A00,180045,Havis; Allan,35,0,45,10
1681933262838,COMM 132,A00,180046,McKenna; Denise,16,0,30,14
1681933263861,COMM 143,A00,180047,Staff,15,0,30,15
1681933264884,COMM 190,A00,180048,Conner; Thomas Hartnell,15,0,23,8
1681933265910,CSE 8A,A50,180053,Cao; Yingjun,20,0,50,30
1681933265910,CSE 8A,B50,180180,Staff,50,0,50,0
1681933266933,CSE 11,A01,180190,Cao; Yingjun,19,0,50,31
1681933267971,CSE 20,A01,180192,Briones; Jor-el Thomas Caparas,20,0,30,10
1681933269005,CSE 21,A01,194538,Briones; Jor-el Thomas Caparas,49,0,60,11
1681933270031,CSE 30,A01,180324,Eldon; John,71,0,100,29
1681933271055,CSE 101,A01,201353,Staff,0,31,40,40
1681933272130,CSE 134B,A01,180326,Powell; Thomas Allan,70,0,100,30
1681933273156,CSE 140,A01,180328,Staff,20,0,75,55
1681933274180,CSE 140L,A01,180344,Eldon; John,45,0,100,55
1681933275204,CSE 150A,A01,180411,Staff,0,21,50,50
1681933276239,CSE 151A,A01,180414,Staff,0,16,50,50
1681933277264,CSE 175,A01,222521,Kumar; Rakesh,50,0,50,0
1681933278287,CSE 190,A00,201419,Staff,42,0,49,7
1681933279310,CSS 1,A01,194536,Staff,32,0,50,18
1681933280337,DSC 30,A01,202385,Staff,48,0,50,2
1681933281363,DSC 40A,A01,202387,Albuyeh; Rod,50,0,50,0
1681933282386,DSC 190,A01,202389,Silberman; Jack,21,0,21,0
1681933283409,DSGN 100,A01,179993,Staff,13,0,30,17
1681933284434,ECE 65,A50,180708,Staff,10,0,20,10
1681933284434,ECE 65,A51,180739,Staff,19,0,20,1
1681933285459,ECON 1,A01,180427,Famulari; Melissa,66,0,70,4
1681933286483,ECON 2,A01,180450,Levkoff; Steven B.,63,0,70,7
1681933287505,ECON 4,A01,203351,Anderson; John Charles,6,0,10,4
1681933288529,ECON 100A,A01,180472,Famulari; Melissa,59,0,70,11
1681933289550,ECON 120A,A01,180549,Staff,60,0,70,10
1681933290579,ECON 120B,A01,180655,Ma; Xinwei,33,0,70,37
1681933291602,ECON 129,A00,203333,Eckert; Fabian Paul,7,0,35,28
1681933292624,ECON 131,A00,180656,Staff,0,2,35,35
1681933293646,ECON 172B,A01,180672,Levkoff; Steven B.,31,0,35,4
1681933294669,ECON 178,A01,203342,Zhu; Ying,2,0,35,33
1681933295693,EDS 108GS,A00,202383,Wishard Guerra; Alison G.,20,0,20,0
1681933296716,EDS 111GS,A00,202347,Wishard Guerra; Alison G.,20,0,20,0
1681933297742,EDS 112,A01,202323,Staff,53,0,60,7
1681933298769,EDS 113,A00,202340,Staff,31,0,35,4
1681933299790,EDS 118,A00,201231,Staff,19,0,30,11
1681933300815,EDS 119,A00,204994,Staff,8,0,10,2
1681933301837,EDS 124BR,A00,202324,Eguchi; Emi,0,2,25,25
1681933302860,EDS 126,A01,203208,Jones; Makeba,26,0,30,4
1681933303882,EDS 135,A01,202333,Staff,17,0,20,3
1681933304903,EDS 180,A00,202311,Staff,47,0,50,3
1681933305938,ERC 190GS,A01,253747,Staff,28,0,28,0
1681933306965,ETHN 104,A00,180742,Staff,20,0,35,15
1681933307990,ETHN 118,A00,180745,Staff,26,0,35,9
1681933309013,ETHN 127,A00,180747,Staff,8,0,16,8
1681933310035,ETHN 137,A00,180880,Staff,11,0,12,1
1681933311060,ETHN 147,A00,180890,Staff,8,0,10,2
1681933312081,ETHN 154,A00,180891,Staff,4,0,8,4
1681933313109,ETHN 168,A00,180892,Staff,9,0,10,1
1681933314212,GLBH 20,A00,201051,Hannah; Seth Donal,0,7,0,1
1681933315236,GLBH 111,A01,209338,Burgos; Jose L.,0,0,0,0
1681933316258,GLBH 150,A00,258300,Staff,0,4,0,0
1681933317284,GLBH 181,A00,201207,Staff,4,0,40,36
1681933318307,HIEU 109,A00,180898,Staff,19,0,20,1
1681933319328,HIEU 111,A00,180899,Staff,0,2,20,20
1681933320357,HIEU 124,A00,180900,Staff,16,0,20,4
1681933321380,HILA 122,A00,180901,Staff,17,0,20,3
1681933322406,HILA 132,A00,180902,Vitz; Matthew,0,3,20,20
1681933323429,HILD 10,A01,180896,Staff,12,0,20,8
1681933324451,HILD 30GS,A00,180897,Edington; Claire Ellen,0,0,0,0
1681933325472,HISC 105,A00,180903,Staff,20,0,20,0
1681933326495,HISC 117,A00,180904,Staff,10,0,20,10
1681933327519,HIUS 108B,A00,181005,Staff,18,0,20,2
1681933328541,HIUS 113,A00,181093,Staff,0,0,20,20
1681933329568,HUM 3,A01,181190,Patterson; Patrick H.,33,0,50,17
1681933329568,HUM 3,B01,181195,Staff,44,0,50,6
1681933330599,HUM 3GS,A00,181196,Herbst; Matthew,0,0,0,0
1681933331621,HUM 4,A01,181227,West; Geoffrey Scott,33,0,50,17
1681933331621,HUM 4,B01,181282,Staff,41,0,50,9
1681933332643,HUM 4GS,A00,181377,Lyon; Antony J.,0,0,0,0
1681933333666,HUM 5,A01,181536,Zavodny; Tatiana Sophia,22,0,50,28
1681933333666,HUM 5,B01,181908,Staff,32,0,50,18
1681933334691,INTL 190,A00,181909,Segui; Alan S,0,0,0,8
1681933334691,INTL 190,B00,181961,Segui; Alan S,0,0,0,7
1681933335714,JAPN 20AR,A01,182113,Ross; Kayoko F,15,0,20,5
1681933336741,LATI 50,A01,202391,Martin-Cabrera; Luis,16,0,30,14
1681933336741,LATI 50,A02,202392,Martin-Cabrera; Luis,26,0,30,4
1681933337766,LATI 180,A00,202393,Kokinis; Troy Andreas,24,0,25,1
1681933338789,LIFR 1A,A00,182119,Staff,13,0,14,1
1681933339832,LIFR 1AX,A00,182324,Staff,13,0,14,1
1681933340857,LIFR 1B,A00,182259,Staff,11,0,14,3
1681933341881,LIFR 1BX,A00,182273,Staff,11,0,14,3
1681933342904,LIGN 8,A00,182330,Staff,125,0,150,25
1681933343929,LIGN 9GS,A00,182362,Staff,14,0,20,6
1681933344955,LIGN 119,A00,204992,Takahashi; Maho,11,0,15,4
1681933345979,LIGN 130,A01,182384,Staff,47,0,50,3
1681933347012,LIGN 149GS,A00,182390,Staff,14,0,20,6
1681933348038,LIGN 170,A00,182404,Staff,23,0,30,7
1681933349069,LISP 1D,A00,182281,Staff,6,0,14,8
1681933349069,LISP 1D,B00,182287,Staff,13,0,14,1
1681933349069,LISP 1D,C00,182295,Staff,10,0,14,4
1681933349069,LISP 1D,D00,182301,Staff,14,0,14,0
1681933350098,LISP 1DX,A00,182309,Staff,18,0,28,10
1681933350098,LISP 1DX,B00,182316,Staff,25,0,28,3
1681933351121,LTAF 120GS,A00,182412,Zhiri; Oumelbanine,20,0,20,0
1681933352154,LTCS 172GS,A00,182437,Bronstein; Phoebe Malan,20,0,20,0
1681933353180,LTEA 138,A00,182457,Staff,17,0,40,23
1681933354205,LTEN 114,A01,182490,Staff,23,0,25,2
1681933355227,LTEN 130GS,A00,182491,Lyon; Antony J.,20,0,20,0
1681933356256,LTEN 169,A00,182493,Cuong; Marisol,17,0,25,8
1681933357278,LTEN 178,A00,182501,Staff,14,0,15,1
1681933358302,LTEN 181,A00,182515,Staff,19,0,25,6
1681933359327,LTEN 185GS,A00,197655,Forbes; Camille,20,0,20,0
1681933360349,LTSP 100B,A00,202208,Bessett; Ryan Matthew,24,0,25,1
1681933361375,LTWL 100,A00,182516,Myerston Santana; Jacobo,20,0,30,10
1681933362398,LTWR 100GS,A00,182518,Forbes; Camille,20,0,20,0
1681933363421,LTWR 102,A00,182522,Staff,15,0,15,0
1681933363421,LTWR 102,B00,182525,Staff,14,0,15,1
1681933364445,LTWR 115,A00,182526,Staff,10,0,15,5
1681933365472,MAE 8,A01,182528,Pham; Hieu Tan,66,0,70,4
1681933366495,MAE 11,A00,182529,Bahadori; Mohammad Yousef,90,0,100,10
1681933367521,MAE 20,A00,182530,Evdokimenko; Ekaterina,67,0,70,3
1681933368545,MAE 30A,A00,182532,Staff,44,0,45,1
1681933369567,MAE 101A,A00,182533,Bahadori; Mohammad Yousef,93,0,100,7
1681933370604,MAE 101C,A00,182538,Staff,62,0,70,8
1681933371631,MAE 104,A00,182539,Staff,44,0,50,6
1681933372654,MAE 131A,A00,182540,Ghazinejad; Maziar,40,0,45,5
1681933373677,MAE 143A,A00,182548,Bewley; Thomas R,42,0,50,8
1681933374708,MAE 150,A00,182549,Staff,28,0,40,12
1681933375731,MAE 160,A00,182550,Evdokimenko; Ekaterina,39,0,60,21
1681933376755,MATH 3C,A01,182725,Staff,24,0,30,6
1681933377780,MATH 10A,A01,182729,Staff,24,0,30,6
1681933377780,MATH 10A,B01,182732,Staff,25,0,30,5
1681933378804,MATH 10B,A01,182737,Staff,15,0,30,15
1681933378804,MATH 10B,A02,182738,Staff,24,0,30,6
1681933378804,MATH 10B,B01,182744,Staff,24,0,30,6
1681933378804,MATH 10B,B02,182745,Staff,27,0,30,3
1681933379833,MATH 18,A01,182750,Anzaldo; Leesa B,28,0,30,2
1681933379833,MATH 18,A02,182751,Anzaldo; Leesa B,28,0,30,2
1681933379833,MATH 18,A03,182753,Anzaldo; Leesa B,27,0,30,3
1681933379833,MATH 18,A04,182757,Anzaldo; Leesa B,29,0,30,1
1681933379833,MATH 18,B01,182761,Anzaldo; Leesa B,27,0,30,3
1681933379833,MATH 18,B02,182764,Anzaldo; Leesa B,27,0,30,3
1681933379833,MATH 18,B03,182765,Anzaldo; Leesa B,29,0,30,1
1681933379833,MATH 18,B04,182766,Anzaldo; Leesa B,30,0,30,0
1681933380859,MATH 20A,A01,182771,Suk; Andrew Hoon,27,0,30,3
1681933381885,MATH 20B,A01,182775,Bach; Quang Tran,30,0,30,0
1681933381885,MATH 20B,A02,182777,Bach; Quang Tran,29,0,30,1
1681933381885,MATH 20B,B01,182780,Bach; Quang Tran,26,0,30,4
1681933381885,MATH 20B,B02,182782,Bach; Quang Tran,30,0,30,0
1681933382909,MATH 20C,A01,182787,Staff,24,0,30,6
1681933382909,MATH 20C,A02,182790,Staff,29,0,30,1
1681933382909,MATH 20C,B01,182792,Staff,23,0,30,7
1681933382909,MATH 20C,B02,182796,Staff,26,0,30,4
1681933383932,MATH 20D,A01,182799,Staff,27,0,30,3
1681933383932,MATH 20D,A02,182802,Staff,29,0,30,1
1681933383932,MATH 20D,A03,182803,Staff,30,0,30,0
1681933384956,MATH 20E,A01,182809,Verstraete; Jacques Allan,18,0,30,12
1681933384956,MATH 20E,A02,182811,Verstraete; Jacques Allan,27,0,30,3
1681933384956,MATH 20E,B01,182814,Verstraete; Jacques Allan,21,0,30,9
1681933384956,MATH 20E,B02,182815,Verstraete; Jacques Allan,27,0,30,3
1681933385982,MATH 103A,A01,182820,Staff,3,0,30,27
1681933385982,MATH 103A,A02,182821,Staff,26,0,30,4
1681933385982,MATH 103A,A03,182822,Staff,20,0,30,10
1681933385982,MATH 103A,B01,182825,Staff,21,0,30,9
1681933385982,MATH 103A,B02,182826,Staff,30,0,30,0
1681933385982,MATH 103A,B03,182830,Staff,30,0,30,0
1681933387017,MATH 109,A01,182836,Chow; Bennett,23,0,30,7
1681933387017,MATH 109,A02,182838,Chow; Bennett,27,0,30,3
1681933387017,MATH 109,A03,182894,Chow; Bennett,29,0,30,1
1681933387017,MATH 109,B01,182908,Chow; Bennett,26,0,30,4
1681933387017,MATH 109,B02,182909,Chow; Bennett,30,0,30,0
1681933387017,MATH 109,B03,182910,Chow; Bennett,26,0,30,4
1681933388042,MATH 142A,A01,182925,Staff,3,0,30,27
1681933388042,MATH 142A,A02,182935,Staff,23,0,30,7
1681933388042,MATH 142A,A03,182967,Staff,24,0,30,6
1681933388042,MATH 142A,B01,183125,Staff,22,0,30,8
1681933388042,MATH 142A,B02,183157,Staff,26,0,30,4
1681933388042,MATH 142A,B03,183158,Staff,29,0,30,1
1681933389065,MATH 183,A01,183160,Arias-Castro; Ery,22,0,30,8
1681933389065,MATH 183,A02,183161,Arias-Castro; Ery,28,0,30,2
1681933389065,MATH 183,B01,183163,Arias-Castro; Ery,26,0,30,4
1681933389065,MATH 183,B02,183164,Arias-Castro; Ery,28,0,30,2
1681933390088,MATH 193A,A01,183167,Staff,0,0,35,35
1681933390088,MATH 193A,A02,183168,Staff,22,0,35,13
1681933390088,MATH 193A,A03,183169,Staff,34,0,35,1
1681933390088,MATH 193A,A04,183170,Staff,26,0,35,9
1681933391110,MGT 4,A01,202395,Anderson; John Charles,76,0,80,4
1681933392134,MGT 5,A00,202396,Houskeeper; Robert,79,0,90,11
1681933393159,MGT 103,A00,202397,Eberhard; Craig A,47,0,90,43
1681933394182,MGT 131A,A00,202398,Houskeeper; Robert,81,0,90,9
1681933395216,MGT 135,A00,202399,Anderson; John Charles,81,0,90,9
1681933396245,MGT 162R,A00,202403,Gneezy; Uri,116,0,200,84
1681933397267,MGT 172,A00,202404,Hedges; Kathleen,22,0,90,68
1681933398293,MGT 181,A00,202405,Dunn; Louis Jean,77,0,90,13
1681933399324,MMW 14,A01,183200,Staff,0,0,28,28
1681933399324,MMW 14,A02,183201,Staff,25,0,28,3
1681933399324,MMW 14,A03,183202,Staff,24,0,28,4
1681933399324,MMW 14,A04,183203,Staff,25,0,28,3
1681933399324,MMW 14,A05,183204,Staff,26,0,28,2
1681933399324,MMW 14,A06,183205,Staff,27,0,28,1
1681933399324,MMW 14,B01,183207,Staff,26,0,28,2
1681933399324,MMW 14,B02,183208,Staff,28,0,28,0
1681933399324,MMW 14,B03,183209,Staff,28,0,28,0
1681933399324,MMW 14,B04,183210,Staff,28,0,28,0
1681933399324,MMW 14,B05,183211,Staff,28,0,28,0
1681933399324,MMW 14,B06,183212,Staff,27,0,28,1
1681933400348,MMW 14GS,A00,183213,Zhiri; Oumelbanine,28,0,28,0
1681933401370,MMW 15GS,B00,183215,Rahimi; Babak,28,0,28,0
1681933402397,MMW 121,A01,183217,Patterson; Patrick H.,7,0,28,21
1681933402397,MMW 121,A02,183218,Patterson; Patrick H.,25,0,28,3
1681933403425,MUS 1A,A01,182554,Staff,0,0,35,35
1681933404451,MUS 5,A01,182558,Staff,16,0,35,19
1681933405476,MUS 6,A01,182562,Staff,22,0,35,13
1681933406498,MUS 8GS,A00,182563,Borgo; David Garcia,25,0,25,0
1681933407520,MUS 13,A01,182567,Staff,23,0,25,2
1681933408551,MUS 15,A01,182570,Staff,31,0,35,4
1681933408551,MUS 15,B01,182575,Staff,7,0,35,28
1681933409573,MUS 80,A00,182578,Staff,22,0,25,3
1681933409573,MUS 80,B00,182581,Staff,20,0,25,5
1681933410597,MUS 113,A00,182582,Staff,25,0,25,0
1681933411622,MUS 114,A00,182583,Staff,0,1,25,25
1681933412646,MUS 150GS,A01,182588,Borgo; David Garcia,24,0,25,1
1681933413669,PHIL 1,A00,182590,Staff,34,0,40,6
1681933414692,PHIL 10,A01,182596,Grush; Rick Scott,30,0,35,5
1681933414692,PHIL 10,A02,182597,Grush; Rick Scott,33,0,35,2
1681933415715,PHIL 15,A01,182601,Staff,31,0,35,4
1681933415715,PHIL 15,A02,182602,Staff,33,0,35,2
1681933416751,PHIL 27,A01,182604,Staff,25,0,35,10
1681933416751,PHIL 27,A02,182607,Staff,33,0,35,2
1681933417866,PHIL 32,A01,182609,Staff,35,0,35,0
1681933417866,PHIL 32,A02,182612,Staff,35,0,35,0
1681933418888,PHIL 130,A00,182614,Staff,57,0,70,13
1681933419914,PHIL 136,A00,182616,Cohen; Jonathan David,64,0,70,6
1681933420939,PHIL 155,A00,182617,Vargas; Manuel Rogelio,57,0,70,13
1681933421962,PHIL 163,A01,182620,Staff,15,0,20,5
1681933421962,PHIL 163,A02,182624,Staff,10,0,20,10
1681933422984,PHIL 164,A00,182627,Staff,29,0,40,11
1681933424006,PHIL 173,A00,182628,Staff,35,0,40,5
1681933425029,PHYS 1A,A00,183221,Staff,52,0,60,8
1681933426051,PHYS 1AL,001,183222,Staff,24,0,30,6
1681933426051,PHYS 1AL,002,183223,Staff,24,0,30,6
1681933427074,PHYS 1B,A00,183231,Staff,40,0,60,20
1681933428099,PHYS 1BL,001,183232,Staff,15,0,30,15
1681933428099,PHYS 1BL,002,183233,Staff,27,0,30,3
1681933429129,PHYS 1C,A00,183240,Staff,20,0,60,40
1681933430155,PHYS 1CL,001,183241,Staff,8,0,30,22
1681933430155,PHYS 1CL,002,183242,Staff,21,0,30,9
1681933431183,PHYS 2AR,A01,183250,Staff,39,0,50,11
1681933432210,PHYS 2B,A01,183252,Staff,101,0,115,14
1681933433241,PHYS 2BL,A01,183254,Staff,21,0,24,3
1681933433241,PHYS 2BL,A02,183255,Staff,21,0,24,3
1681933434266,PHYS 2C,A01,183522,Staff,100,0,115,15
1681933435301,PHYS 4A,A01,183524,Staff,49,0,50,1
1681933436327,POLI 5,A00,183525,Staff,43,0,50,7
1681933437353,POLI 12,A00,183540,Staff,45,0,50,5
1681933438379,POLI 13R,A00,183541,Forman; Fonna,40,0,50,10
1681933439405,POLI 30,A00,183542,Mignozzetti; Umberto,48,0,50,2
1681933440429,POLI 100A,A00,183543,Staff,43,0,50,7
1681933441455,POLI 100E,A00,223598,Staff,32,0,35,3
1681933442477,POLI 103A,A00,183564,Kousser; Thad,34,0,50,16
1681933443502,POLI 104B,A00,201329,Staff,27,0,35,8
1681933444525,POLI 113BR,A00,183576,Hoston; Germaine,22,0,50,28
1681933445557,POLI 114BR,A00,183588,Staff,26,0,30,4
1681933446579,POLI 117R,A00,183595,Forman; Fonna,3,0,20,17
1681933447602,POLI 120H,A00,183596,Fisk; David Lee,13,0,20,7
1681933448627,POLI 130AA,A00,183597,Staff,13,0,20,7
1681933449653,POLI 134AA,A00,183598,Staff,19,0,20,1
1681933450678,POLI 135,A00,183599,Fisk; David Lee,19,0,25,6
1681933451700,POLI 142P,A00,183623,Staff,37,0,40,3
1681933452723,POLI 144D,A00,183624,Staff,22,0,25,3
1681933453749,POLI 151,A00,183625,Staff,14,0,20,6
1681933454773,POLI 162,A00,183626,Mignozzetti; Umberto,17,0,20,3
1681933455795,PSYC 1,A00,253748,Staff,85,0,90,5
1681933456817,PSYC 2,A00,183627,Moranton; Nirelia Melbina-,22,0,35,13
1681933457842,PSYC 3,A00,183628,Staff,42,0,45,3
1681933459890,PSYC 60,A01,183631,Lowe; Angela Beth,35,0,40,5
1681933460919,PSYC 70,A01,253757,Staff,34,0,45,11
1681933461946,PSYC 101,A00,183632,Heyman; Gail D.,40,0,60,20
1681933462972,PSYC 105,A00,183848,Lowe; Angela Beth,44,0,60,16
1681933463995,PSYC 106,A00,183849,Dobkins; Karen R.,37,0,60,23
1681933465019,PSYC 108,A00,253750,Staff,10,0,60,50
1681933466045,PSYC 114,A01,184275,Winkielman; Piotr,0,8,30,30
1681933467069,PSYC 122,A00,183856,Moranton; Nirelia Melbina-,0,16,30,30
1681933468092,PSYC 124,A00,183865,Chapman; Eddie Nathaniel,42,0,80,38
1681933469114,PSYC 137,A00,183880,Staff,16,0,25,9
1681933471170,PSYC 154,A00,183910,Lacefield; Katharine I,0,31,90,90
1681933473221,PSYC 162,A00,183946,Wixted; John T,38,0,90,52
1681933474244,PSYC 172,A00,183947,Gorman; Michael R.,4,0,30,26
1681933475266,PSYC 178,A00,183963,Glaser; Dale,14,0,40,26
1681933476291,PSYC 181GS,A00,183964,Anagnostaras; Stephan,10,0,10,0
1681933477315,PSYC 186GS,A01,257660,Staff,10,0,10,0
1681933478341,PSYC 193,B00,253749,Staff,22,0,25,3
1681933480387,PSYC 193L,A01,184122,Staff,33,0,35,2
1681933480387,PSYC 193L,C01,184167,Winkielman; Piotr,14,0,30,16
1681933481409,RELI 188GS,A00,182629,Rahimi; Babak,20,0,20,0
1681933482457,SE 101A,A00,182646,Staff,25,0,30,5
1681933483488,SE 101C,A00,182650,Staff,10,0,20,10
1681933484523,SE 110A,A00,182651,Staff,28,0,28,0
1681933485553,SE 130A,A00,182652,Staff,38,0,40,2
1681933486578,SIO 46GS,A00,182636,Cook; Geoffrey W,24,0,28,4
1681933487613,SIO 109R,A00,194459,Staff,0,2,20,20
1681933488638,SIO 121GS,A00,182639,Cook; Geoffrey W,24,0,28,4
1681933489661,SIO 132,A01,182642,Staff,30,0,40,10
1681933490686,SIO 139,A00,182644,Kacev; David,36,0,40,4
1681933491711,SOCI 2,A01,258404,Staff,33,0,36,3
1681933491711,SOCI 2,A02,258405,Staff,35,0,36,1
1681933492735,SOCI 60,A01,258408,Staff,29,0,30,1
1681933492735,SOCI 60,A02,258413,Staff,30,0,30,0
1681933493764,SOCI 100,A01,258415,Staff,28,0,30,2
1681933493764,SOCI 100,A02,258416,Staff,28,0,30,2
1681933499906,SOCI 127,A00,258421,Staff,18,0,30,12
1681933500929,SOCI 132,A00,258422,Staff,42,0,50,8
1681933501950,SOCI 133,A00,258423,Staff,26,0,30,4
1681933502977,SOCI 138GS,A00,258424,Staff,15,0,15,0
1681933504007,SOCI 145,A00,258425,Staff,23,0,30,7
1681933505032,SOCI 148,A00,258426,Staff,23,0,30,7
1681933506053,SOCI 153,A00,199217,Staff,29,0,30,1
1681933507075,SOCI 160,A00,258427,Staff,27,0,30,3
1681933508098,SOCI 160E,A00,258435,Staff,55,0,60,5
1681933509121,SOCI 189GS,A00,258436,Staff,15,0,15,0
1681933510143,SOCI 190GS,A00,258437,Staff,15,0,15,0
1681933511167,SYN 2,001,182658,Staff,8,0,16,8
1681933511167,SYN 2,002,201439,Staff,13,0,16,3
1681933511167,SYN 2,003,201443,Staff,16,0,16,0
1681933512193,SYN 100,A01,182657,Staff,11,0,20,9
1681933513226,TDAC 1,A00,184381,Salovey; Todd,16,0,20,4
1681933513226,TDAC 1,B00,184385,Harting; Carla Kelso,19,0,20,1
1681933513226,TDAC 1,C00,184394,Staff,18,0,20,2
1681933514253,TDAC 101,A00,184483,Harting; Carla Kelso,19,0,20,1
1681933515274,TDDE 111,A00,184496,Staff,14,0,15,1
1681933516301,TDDE 131,A00,184504,Staff,20,0,20,0
1681933516301,TDDE 131,B00,184505,Staff,17,0,18,1
1681933516301,TDDE 131,C00,184534,Staff,49,0,50,1
1681933516301,TDDE 131,D00,184564,Staff,15,0,15,0
1681933516301,TDDE 131,E00,204725,Staff,18,0,20,2
1681933517324,TDGE 1,A01,184414,Salovey; Todd,34,0,50,16
1681933518346,TDGE 5,A01,184419,Staff,23,0,24,1
1681933519371,TDGE 10,A00,184428,Fulton; Julia,27,0,50,23
1681933520395,TDGE 124,A00,184565,Fulton; Julia,0,3,50,50
1681933521497,TDGE 125,B00,184567,Meyer; Ursula,7,0,25,18
1681933522523,TDHT 101,A00,184568,Staff,21,0,25,4
1681933522523,TDHT 101,B00,184569,Staff,20,0,20,0
1681933523544,TDHT 114,A00,184570,Staff,48,0,50,2
1681933524569,TDMV 1,A00,184437,Arcidiacono; Kristin,21,0,30,9
1681933524569,TDMV 1,B00,184448,Caligagan; Maria T.,23,0,30,7
1681933525594,TDMV 2,A00,184449,Weinberg; Sadie,26,0,30,4
1681933525594,TDMV 2,B00,184453,Arcidiacono; Kristin,29,0,30,1
1681933526615,TDMV 110,A00,184571,Weinberg; Sadie,30,0,30,0
1681933527638,TDMV 142,A00,184572,Caligagan; Tony,26,0,30,4
1681933527638,TDMV 142,B00,184573,Caligagan; Maria T.,26,0,30,4
1681933528664,TDTR 20,A00,184482,Jun; Grace Shin Hae,25,0,25,0
1681933529692,USP 2,A01,184290,Hinds; Juli Beth,23,0,25,2
1681933530718,USP 3,A01,184295,Staff,20,0,25,5
1681933531743,USP 4,A00,184304,McTague; Sarah,13,0,25,12
1681933532768,USP 100,A00,184315,Staff,16,0,25,9
1681933533790,USP 105,A00,184326,Staff,21,0,25,4
1681933534817,USP 151,A00,184327,Staff,17,0,25,8
1681933535842,USP 170,A00,184380,Hinds; Juli Beth,12,0,25,13
1681933536886,VIS 21B,A01,182660,Staff,28,0,31,3
1681933536886,VIS 21B,A02,182662,Staff,30,0,31,1
1681933537909,VIS 103D,A00,182663,Staff,74,0,75,1
1681933538932,VIS 105D,A00,182667,Li; Huai,14,0,22,8
1681933539954,VIS 122GS,A00,182668,Herbst; Matthew,20,0,20,0
1681933540977,VIS 128C,A00,182673,Staff,68,0,75,7
1681933542003,VIS 130,A00,182675,Staff,19,0,22,3
1681933543028,VIS 160A,A00,182678,Stalbaum; Brett,4,0,10,6
1681933545074,WCWP 10B,A00,201679,Staff,15,0,15,0
1681933545074,WCWP 10B,B00,201695,Staff,15,0,15,0
1681933546100,WCWP 100,A00,201716,Staff,12,0,15,3
1681933546100,WCWP 100,B00,201717,Staff,0,0,15,15
1681933548194,ANSC 105GS,A00,258289,Staff,0,0,0,0
1681933549225,ANSC 125GS,A00,258295,Staff,0,0,0,0
1681933550249,ANSC 150,A00,258267,Staff,27,0,40,13
1681933551274,ANSC 190GS,A00,258280,Staff,0,0,0,2
1681933552304,ANTH 1,A00,258264,Staff,38,0,40,2
1681933553329,ANTH 2,A01,258259,Staff,72,0,76,4
1681933554353,ANTH 23,A01,258228,Staff,35,0,40,5
1681933555376,ANTH 101,A01,258236,Staff,38,0,40,2
1681933556401,ANTH 102,A00,258272,Staff,59,0,60,1
1681933557425,ANTH 105,A00,258244,Staff,28,0,35,7
1681933558450,BENG 130,A00,253975,Staff,37,0,40,3
1681933559475,BIBC 102,A01,191866,Flagg; Matthew Paul,16,0,32,16
1681933559475,BIBC 102,A02,191867,Flagg; Matthew Paul,21,0,32,11
1681933559475,BIBC 102,A03,191868,Flagg; Matthew Paul,27,0,32,5
1681933559475,BIBC 102,A04,191936,Flagg; Matthew Paul,19,0,32,13
1681933559475,BIBC 102,A05,191937,Flagg; Matthew Paul,0,0,32,32
1681933560497,BICD 100,A01,191939,Cooper; Andrew Michael,27,0,32,5
1681933560497,BICD 100,A02,191940,Cooper; Andrew Michael,32,0,32,0
1681933560497,BICD 100,A03,191941,Cooper; Andrew Michael,32,0,32,0
1681933560497,BICD 100,A04,191942,Cooper; Andrew Michael,32,0,32,0
1681933560497,BICD 100,A05,191943,Cooper; Andrew Michael,32,0,32,0
1681933561522,BIEB 126,A01,191945,Cleland; Elsa Eleanor,0,5,32,32
1681933561522,BIEB 126,A02,191946,Cleland; Elsa Eleanor,26,0,32,6
1681933561522,BIEB 126,A03,191947,Cleland; Elsa Eleanor,29,0,32,3
1681933561522,BIEB 126,A04,191948,Cleland; Elsa Eleanor,15,0,32,17
1681933561522,BIEB 126,A05,191996,Cleland; Elsa Eleanor,28,0,32,4
1681933562546,BIEB 136GS,A00,191997,Shurin; Jonathan & Holway; David A.,0,0,0,9
1681933563575,BIEB 137GS,A01,191999,Shurin; Jonathan & Holway; David A.,0,0,0,8
1681933564603,BILD 1,A01,205385,Staff,30,0,32,2
1681933564603,BILD 1,A02,205386,Staff,30,0,32,2
1681933564603,BILD 1,A03,205387,Staff,31,0,32,1
1681933564603,BILD 1,A04,205388,Staff,25,0,32,7
1681933565626,BILD 2,A01,191774,Staff,26,0,32,6
1681933565626,BILD 2,A02,191775,Staff,30,0,32,2
1681933565626,BILD 2,A03,191777,Staff,29,0,32,3
1681933565626,BILD 2,A04,191856,Staff,30,0,32,2
1681933565626,BILD 2,A05,191857,Staff,31,0,32,1
1681933565626,BILD 2,A06,191858,Staff,32,0,32,0
1681933565626,BILD 2,A07,191859,Staff,31,0,32,1
1681933566655,BILD 3,A01,205391,Staff,27,0,32,5
1681933566655,BILD 3,A02,205393,Staff,32,0,32,0
1681933566655,BILD 3,A03,205394,Staff,26,0,32,6
1681933566655,BILD 3,A04,205395,Staff,32,0,32,0
1681933567685,BILD 20,A01,191861,Staff,32,0,32,0
1681933567685,BILD 20,A02,191862,Staff,32,0,32,0
1681933568716,BILD 30,A01,191864,Staff,31,0,32,1
1681933569744,BIMM 100,A01,192019,Staff,0,0,32,32
1681933569744,BIMM 100,A02,192020,Staff,12,0,32,20
1681933569744,BIMM 100,A03,192035,Staff,18,0,32,14
1681933570767,BIMM 110,A01,192037,Tat; John,0,0,32,32
1681933570767,BIMM 110,A02,192038,Tat; John,4,0,32,28
1681933571790,BIMM 120,A01,192040,Pickett; Brooke Elizabeth,0,0,32,32
1681933571790,BIMM 120,A02,192041,Pickett; Brooke Elizabeth,7,0,32,25
1681933571790,BIMM 120,A03,192042,Pickett; Brooke Elizabeth,14,0,32,18
1681933572822,BIPN 100,A01,192044,Armour; Jon Christopher,23,0,32,9
1681933572822,BIPN 100,A02,192059,Armour; Jon Christopher,30,0,32,2
1681933572822,BIPN 100,A03,192064,Armour; Jon Christopher,30,0,32,2
1681933572822,BIPN 100,A04,192073,Armour; Jon Christopher,26,0,32,6
1681933573846,BIPN 148,A01,205411,Leutgeb; Jill K.,14,0,32,18
1681933573846,BIPN 148,A02,205412,Leutgeb; Jill K.,31,0,32,1
1681933573846,BIPN 148,A03,205413,Leutgeb; Jill K.,29,0,32,3
1681933573846,BIPN 148,A04,205414,Leutgeb; Jill K.,30,0,32,2
1681933574869,BIPN 160,A01,192115,Marino; Marc J,15,0,32,17
1681933574869,BIPN 160,A02,192148,Marino; Marc J,27,0,32,5
1681933574869,BIPN 160,A03,192158,Marino; Marc J,31,0,32,1
1681933574869,BIPN 160,A04,192190,Marino; Marc J,32,0,32,0
1681933574869,BIPN 160,A05,192287,Marino; Marc J,32,0,32,0
1681933574869,BIPN 160,A06,192288,Marino; Marc J,32,0,32,0
1681933575901,BIPN 194,A00,206038,Leutgeb; Stefan,28,0,32,4
1681933576924,BISP 194,A00,192289,Nieh; James Charles,8,0,32,24
1681933576924,BISP 194,B00,245332,Staff,26,0,32,6
1681933577950,CAT 124,A01,202247,Staff,15,0,15,0
1681933578975,CAT 125,A00,202248,Staff,18,0,20,2
1681933578975,CAT 125,B00,202253,Staff,20,0,20,0
1681933578975,CAT 125,C00,202257,Staff,18,0,20,2
1681933579999,CAT 125GS,A01,202273,Bronstein; Phoebe Malan,20,0,20,0
1681933581022,CAT 125R,A00,202284,Staff,17,0,20,3
1681933581022,CAT 125R,C00,202286,Staff,4,0,20,16
1681933581022,CAT 125R,D00,202291,Staff,15,0,20,5
1681933581022,CAT 125R,E00,202295,Staff,13,0,20,7
1681933581022,CAT 125R,F00,202302,Staff,6,0,20,14
1681933582046,CENG 100,A00,204724,Opatkiewicz; Justin Paul,23,0,25,2
1681933583068,CGS 2A,A01,180420,Staff,29,0,36,7
1681933584094,CGS 101,A00,180421,Staff,14,0,20,6
1681933585119,CGS 112,A00,180422,Staff,8,0,16,8
1681933586142,CGS 113,A00,180423,Staff,18,0,20,2
1681933587164,CGS 137,A00,180424,Staff,12,0,12,0
1681933588190,CGS 147,A00,180425,Staff,10,0,10,0
1681933589216,CHEM 6A,A01,179556,Staff,92,0,100,8
1681933589216,CHEM 6A,A02,179558,Staff,0,0,0,0
1681933590242,CHEM 6B,A01,179560,Staff,100,0,100,0
1681933591265,CHEM 6C,A01,179565,Jazzar; Rodolphe,90,0,100,10
1681933592296,CHEM 7L,A01,179586,Schurmeier; Kimberly,10,0,24,14
1681933592296,CHEM 7L,A02,179587,Schurmeier; Kimberly,22,0,24,2
1681933592296,CHEM 7L,A03,179590,Schurmeier; Kimberly,22,0,24,2
1681933592296,CHEM 7L,A04,179591,Schurmeier; Kimberly,22,0,24,2
1681933592296,CHEM 7L,B01,179598,Schurmeier; Kimberly,14,0,24,10
1681933592296,CHEM 7L,B02,179599,Schurmeier; Kimberly,23,0,24,1
1681933592296,CHEM 7L,B03,179606,Schurmeier; Kimberly,22,0,24,2
1681933592296,CHEM 7L,B04,179607,Schurmeier; Kimberly,22,0,24,2
1681933593318,CHEM 11,A01,179609,Stallings; Dontarie M,86,0,100,14
1681933594345,CHEM 40A,A01,179621,Staff,38,0,50,12
1681933594345,CHEM 40A,A02,179622,Staff,45,0,50,5
1681933595369,CHEM 40B,A01,179630,Weizman; Haim,45,0,50,5
1681933595369,CHEM 40B,A02,179631,Weizman; Haim,43,0,50,7
1681933596396,CHEM 41A,A01,179660,Klosterman; Jeremy K,90,0,100,10
1681933597430,CHEM 43A,A01,179683,Klosterman; Jeremy K,0,0,24,24
1681933597430,CHEM 43A,A02,179688,Klosterman; Jeremy K,5,0,24,19
1681933597430,CHEM 43A,A03,179689,Klosterman; Jeremy K,17,0,24,7
1681933597430,CHEM 43A,A04,179691,Klosterman; Jeremy K,17,0,24,7
1681933598464,CHEM 114A,A01,179693,Stallings; Dontarie M,64,0,100,36
1681933599486,CHEM 143B,A01,179698,Weizman; Haim,16,0,24,8
1681933599486,CHEM 143B,A02,179700,Weizman; Haim,23,0,24,1
1681933600512,CHIN 169A,A00,179701,Wang; Xiao,20,0,20,0
1681933601543,COGS 2,A01,179750,Boyle; Mary E. T.,16,0,30,14
1681933602572,COGS 9,A01,179759,Jones; Cameron Robert,40,0,50,10
1681933603608,COGS 14A,A01,179854,Staff,6,0,50,44
1681933604629,COGS 14B,A01,179856,Staff,50,0,60,10
1681933605653,COGS 17,A01,179874,Staff,69,0,75,6
1681933606675,COGS 18,A01,179884,Staff,59,0,80,21
1681933607697,COGS 100,A01,179886,Staff,29,0,60,31
1681933608720,COGS 101B,A01,179892,Staff,0,4,30,30
1681933609745,COGS 101C,A01,179894,Staff,26,0,30,4
1681933610777,COGS 107A,A01,179896,Boyle; Mary E. T.,28,0,40,12
1681933611802,COGS 108,A01,179898,Simpkins; Charles Alexander,0,34,60,60
1681933612831,COGS 109,A01,179900,Staff,32,0,40,8
1681933613858,COGS 118A,A01,179946,Staff,3,0,40,37
1681933614880,COGS 153,A00,179978,Staff,0,7,30,30
1681933615902,COGS 156,A01,179981,Staff,19,0,30,11
1681933617952,COGS 172,A01,179987,Staff,9,0,30,21
1681933620006,COGS 186,A01,179991,Staff,11,0,30,19
1681933621031,COMM 10,A01,180001,Staff,11,0,25,14
1681933621031,COMM 10,A02,180004,Staff,20,0,25,5
1681933622054,COMM 100A,A01,180016,Staff,13,0,25,12
1681933622054,COMM 100A,A02,180020,Staff,24,0,25,1
1681933623078,COMM 101T,A00,180029,Halm; Gavin Patrick,16,0,35,19
1681933624109,COMM 106V,A00,180043,Staff,34,0,35,1
1681933625237,COMM 109P,A00,180044,Staff,29,0,35,6
1681933626263,COMM 113T,A00,180045,Havis; Allan,35,0,45,10
1681933627287,COMM 132,A00,180046,McKenna; Denise,16,0,30,14
1681933628313,COMM 143,A00,180047,Staff,15,0,30,15
1681933629338,COMM 190,A00,180048,Conner; Thomas Hartnell,15,0,23,8
1681933630364,CSE 8A,A50,180053,Cao; Yingjun,19,0,50,31
1681933630364,CSE 8A,B50,180180,Staff,50,0,50,0
1681933631389,CSE 11,A01,180190,Cao; Yingjun,18,0,50,32
1681933632411,CSE 20,A01,180192,Briones; Jor-el Thomas Caparas,20,0,30,10
1681933633437,CSE 21,A01,194538,Briones; Jor-el Thomas Caparas,49,0,60,11
1681933634459,CSE 30,A01,180324,Eldon; John,71,0,100,29
1681933635482,CSE 101,A01,201353,Staff,0,31,40,40
1681933636510,CSE 134B,A01,180326,Powell; Thomas Allan,70,0,100,30
1681933637535,CSE 140,A01,180328,Staff,20,0,75,55
1681933638558,CSE 140L,A01,180344,Eldon; John,45,0,100,55
1681933639585,CSE 150A,A01,180411,Staff,0,21,50,50
1681933640607,CSE 151A,A01,180414,Staff,0,16,50,50
1681933641634,CSE 175,A01,222521,Kumar; Rakesh,50,0,50,0
1681933642659,CSE 190,A00,201419,Staff,42,0,49,7
1681933643688,CSS 1,A01,194536,Staff,31,0,50,19
1681933644714,DSC 30,A01,202385,Staff,48,0,50,2
1681933645737,DSC 40A,A01,202387,Albuyeh; Rod,50,0,50,0
1681933646758,DSC 190,A01,202389,Silberman; Jack,21,0,21,0
1681933647781,DSGN 100,A01,179993,Staff,13,0,30,17
1681933648807,ECE 65,A50,180708,Staff,10,0,20,10
1681933648807,ECE 65,A51,180739,Staff,19,0,20,1
1681933649836,ECON 1,A01,180427,Famulari; Melissa,66,0,70,4
1681933650865,ECON 2,A01,180450,Levkoff; Steven B.,62,0,70,8
1681933651890,ECON 4,A01,203351,Anderson; John Charles,6,0,10,4
1681933652915,ECON 100A,A01,180472,Famulari; Melissa,59,0,70,11
1681933653938,ECON 120A,A01,180549,Staff,60,0,70,10
1681933654964,ECON 120B,A01,180655,Ma; Xinwei,33,0,70,37
1681933655989,ECON 129,A00,203333,Eckert; Fabian Paul,7,0,35,28
1681933657013,ECON 131,A00,180656,Staff,0,2,35,35
1681933658036,ECON 172B,A01,180672,Levkoff; Steven B.,30,0,35,5
1681933659058,ECON 178,A01,203342,Zhu; Ying,2,0,35,33
1681933660081,EDS 108GS,A00,202383,Wishard Guerra; Alison G.,20,0,20,0
1681933661105,EDS 111GS,A00,202347,Wishard Guerra; Alison G.,20,0,20,0
1681933662127,EDS 112,A01,202323,Staff,53,0,60,7
1681933663153,EDS 113,A00,202340,Staff,31,0,35,4
1681933664176,EDS 118,A00,201231,Staff,19,0,30,11
1681933665209,EDS 119,A00,204994,Staff,8,0,10,2
1681933666234,EDS 124BR,A00,202324,Eguchi; Emi,0,2,25,25
1681933667265,EDS 126,A01,203208,Jones; Makeba,26,0,30,4
1681933668289,EDS 135,A01,202333,Staff,17,0,20,3
1681933669312,EDS 180,A00,202311,Staff,47,0,50,3
1681933670340,ERC 190GS,A01,253747,Staff,28,0,28,0
1681933671369,ETHN 104,A00,180742,Staff,20,0,35,15
1681933672390,ETHN 118,A00,180745,Staff,26,0,35,9
1681933673412,ETHN 127,A00,180747,Staff,8,0,16,8
1681933674442,ETHN 137,A00,180880,Staff,11,0,12,1
1681933675471,ETHN 147,A00,180890,Staff,8,0,10,2
1681933676503,ETHN 154,A00,180891,Staff,4,0,8,4
1681933677529,ETHN 168,A00,180892,Staff,9,0,10,1
1681933678551,GLBH 20,A00,201051,Hannah; Seth Donal,0,7,0,1
1681933679573,GLBH 111,A01,209338,Burgos; Jose L.,0,0,0,0
1681933680595,GLBH 150,A00,258300,Staff,0,4,0,0
1681933681618,GLBH 181,A00,201207,Staff,4,0,40,36
1681933682641,HIEU 109,A00,180898,Staff,19,0,20,1
1681933683664,HIEU 111,A00,180899,Staff,0,2,20,20
1681933684690,HIEU 124,A00,180900,Staff,16,0,20,4
1681933685719,HILA 122,A00,180901,Staff,17,0,20,3
1681933686743,HILA 132,A00,180902,Vitz; Matthew,0,3,20,20
1681933687765,HILD 10,A01,180896,Staff,12,0,20,8
1681933688787,HILD 30GS,A00,180897,Edington; Claire Ellen,0,0,0,0
1681933689812,HISC 105,A00,180903,Staff,20,0,20,0
1681933690833,HISC 117,A00,180904,Staff,10,0,20,10
1681933691873,HIUS 108B,A00,181005,Staff,18,0,20,2
1681933692899,HIUS 113,A00,181093,Staff,0,0,20,20
1681933693922,HUM 3,A01,181190,Patterson; Patrick H.,33,0,50,17
1681933693922,HUM 3,B01,181195,Staff,44,0,50,6
1681933694950,HUM 3GS,A00,181196,Herbst; Matthew,0,0,0,0
1681933695978,HUM 4,A01,181227,West; Geoffrey Scott,33,0,50,17
1681933695978,HUM 4,B01,181282,Staff,41,0,50,9
1681933697005,HUM 4GS,A00,181377,Lyon; Antony J.,0,0,0,0
1681933698030,HUM 5,A01,181536,Zavodny; Tatiana Sophia,22,0,50,28
1681933698030,HUM 5,B01,181908,Staff,32,0,50,18
1681933699052,INTL 190,A00,181909,Segui; Alan S,0,0,0,8
1681933699052,INTL 190,B00,181961,Segui; Alan S,0,0,0,7
1681933700075,JAPN 20AR,A01,182113,Ross; Kayoko F,15,0,20,5
1681933701098,LATI 50,A01,202391,Martin-Cabrera; Luis,16,0,30,14
1681933701098,LATI 50,A02,202392,Martin-Cabrera; Luis,26,0,30,4
1681933702121,LATI 180,A00,202393,Kokinis; Troy Andreas,24,0,25,1
1681933703143,LIFR 1A,A00,182119,Staff,13,0,14,1
1681933704164,LIFR 1AX,A00,182324,Staff,13,0,14,1
1681933705199,LIFR 1B,A00,182259,Staff,11,0,14,3
1681933706221,LIFR 1BX,A00,182273,Staff,11,0,14,3
1681933707243,LIGN 8,A00,182330,Staff,125,0,150,25
1681933708267,LIGN 9GS,A00,182362,Staff,14,0,20,6
1681933709293,LIGN 119,A00,204992,Takahashi; Maho,11,0,15,4
1681933710318,LIGN 130,A01,182384,Staff,47,0,50,3
1681933711343,LIGN 149GS,A00,182390,Staff,14,0,20,6
1681933712369,LIGN 170,A00,182404,Staff,23,0,30,7
1681933713395,LISP 1D,A00,182281,Staff,6,0,14,8
1681933713395,LISP 1D,B00,182287,Staff,13,0,14,1
1681933713395,LISP 1D,C00,182295,Staff,10,0,14,4
1681933713395,LISP 1D,D00,182301,Staff,14,0,14,0
1681933714422,LISP 1DX,A00,182309,Staff,18,0,28,10
1681933714422,LISP 1DX,B00,182316,Staff,25,0,28,3
1681933715448,LTAF 120GS,A00,182412,Zhiri; Oumelbanine,20,0,20,0
1681933716471,LTCS 172GS,A00,182437,Bronstein; Phoebe Malan,20,0,20,0
1681933717496,LTEA 138,A00,182457,Staff,16,0,40,24
1681933718522,LTEN 114,A01,182490,Staff,23,0,25,2
1681933719546,LTEN 130GS,A00,182491,Lyon; Antony J.,20,0,20,0
1681933720569,LTEN 169,A00,182493,Cuong; Marisol,17,0,25,8
1681933721593,LTEN 178,A00,182501,Staff,14,0,15,1
1681933722616,LTEN 181,A00,182515,Staff,19,0,25,6
1681933723640,LTEN 185GS,A00,197655,Forbes; Camille,20,0,20,0
1681933724664,LTSP 100B,A00,202208,Bessett; Ryan Matthew,24,0,25,1
1681933725690,LTWL 100,A00,182516,Myerston Santana; Jacobo,20,0,30,10
1681933726716,LTWR 100GS,A00,182518,Forbes; Camille,20,0,20,0
1681933727738,LTWR 102,A00,182522,Staff,15,0,15,0
1681933727738,LTWR 102,B00,182525,Staff,14,0,15,1
1681933728856,LTWR 115,A00,182526,Staff,10,0,15,5
1681933729883,MAE 8,A01,182528,Pham; Hieu Tan,66,0,70,4
1681933730911,MAE 11,A00,182529,Bahadori; Mohammad Yousef,89,0,100,11
1681933731933,MAE 20,A00,182530,Evdokimenko; Ekaterina,67,0,70,3
1681933732962,MAE 30A,A00,182532,Staff,44,0,45,1
1681933733994,MAE 101A,A00,182533,Bahadori; Mohammad Yousef,93,0,100,7
1681933735028,MAE 101C,A00,182538,Staff,62,0,70,8
1681933736056,MAE 104,A00,182539,Staff,44,0,50,6
1681933737079,MAE 131A,A00,182540,Ghazinejad; Maziar,40,0,45,5
1681933738106,MAE 143A,A00,182548,Bewley; Thomas R,42,0,50,8
1681933739135,MAE 150,A00,182549,Staff,28,0,40,12
1681933740157,MAE 160,A00,182550,Evdokimenko; Ekaterina,39,0,60,21
1681933741181,MATH 3C,A01,182725,Staff,24,0,30,6
1681933742204,MATH 10A,A01,182729,Staff,24,0,30,6
1681933742204,MATH 10A,B01,182732,Staff,25,0,30,5
1681933743232,MATH 10B,A01,182737,Staff,15,0,30,15
1681933743232,MATH 10B,A02,182738,Staff,24,0,30,6
1681933743232,MATH 10B,B01,182744,Staff,24,0,30,6
1681933743232,MATH 10B,B02,182745,Staff,27,0,30,3
1681933744258,MATH 18,A01,182750,Anzaldo; Leesa B,28,0,30,2
1681933744258,MATH 18,A02,182751,Anzaldo; Leesa B,28,0,30,2
1681933744258,MATH 18,A03,182753,Anzaldo; Leesa B,27,0,30,3
1681933744258,MATH 18,A04,182757,Anzaldo; Leesa B,29,0,30,1
1681933744258,MATH 18,B01,182761,Anzaldo; Leesa B,27,0,30,3
1681933744258,MATH 18,B02,182764,Anzaldo; Leesa B,27,0,30,3
1681933744258,MATH 18,B03,182765,Anzaldo; Leesa B,29,0,30,1
1681933744258,MATH 18,B04,182766,Anzaldo; Leesa B,30,0,30,0
1681933745281,MATH 20A,A01,182771,Suk; Andrew Hoon,27,0,30,3
1681933746308,MATH 20B,A01,182775,Bach; Quang Tran,30,0,30,0
1681933746308,MATH 20B,A02,182777,Bach; Quang Tran,29,0,30,1
1681933746308,MATH 20B,B01,182780,Bach; Quang Tran,26,0,30,4
1681933746308,MATH 20B,B02,182782,Bach; Quang Tran,30,0,30,0
1681933747333,MATH 20C,A01,182787,Staff,24,0,30,6
1681933747333,MATH 20C,A02,182790,Staff,29,0,30,1
1681933747333,MATH 20C,B01,182792,Staff,23,0,30,7
1681933747333,MATH 20C,B02,182796,Staff,26,0,30,4
1681933748354,MATH 20D,A01,182799,Staff,27,0,30,3
1681933748354,MATH 20D,A02,182802,Staff,29,0,30,1
1681933748354,MATH 20D,A03,182803,Staff,30,0,30,0
1681933749376,MATH 20E,A01,182809,Verstraete; Jacques Allan,18,0,30,12
1681933749376,MATH 20E,A02,182811,Verstraete; Jacques Allan,27,0,30,3
1681933749376,MATH 20E,B01,182814,Verstraete; Jacques Allan,21,0,30,9
1681933749376,MATH 20E,B02,182815,Verstraete; Jacques Allan,27,0,30,3
1681933750398,MATH 103A,A01,182820,Staff,3,0,30,27
1681933750398,MATH 103A,A02,182821,Staff,26,0,30,4
1681933750398,MATH 103A,A03,182822,Staff,20,0,30,10
1681933750398,MATH 103A,B01,182825,Staff,21,0,30,9
1681933750398,MATH 103A,B02,182826,Staff,30,0,30,0
1681933750398,MATH 103A,B03,182830,Staff,30,0,30,0
1681933751426,MATH 109,A01,182836,Chow; Bennett,23,0,30,7
1681933751426,MATH 109,A02,182838,Chow; Bennett,27,0,30,3
1681933751426,MATH 109,A03,182894,Chow; Bennett,29,0,30,1
1681933751426,MATH 109,B01,182908,Chow; Bennett,26,0,30,4
1681933751426,MATH 109,B02,182909,Chow; Bennett,30,0,30,0
1681933751426,MATH 109,B03,182910,Chow; Bennett,26,0,30,4
1681933752456,MATH 142A,A01,182925,Staff,3,0,30,27
1681933752456,MATH 142A,A02,182935,Staff,23,0,30,7
1681933752456,MATH 142A,A03,182967,Staff,24,0,30,6
1681933752456,MATH 142A,B01,183125,Staff,22,0,30,8
1681933752456,MATH 142A,B02,183157,Staff,26,0,30,4
1681933752456,MATH 142A,B03,183158,Staff,29,0,30,1
1681933753478,MATH 183,A01,183160,Arias-Castro; Ery,22,0,30,8
1681933753478,MATH 183,A02,183161,Arias-Castro; Ery,28,0,30,2
1681933753478,MATH 183,B01,183163,Arias-Castro; Ery,26,0,30,4
1681933753478,MATH 183,B02,183164,Arias-Castro; Ery,28,0,30,2
1681933754506,MATH 193A,A01,183167,Staff,0,1,35,35
1681933754506,MATH 193A,A02,183168,Staff,22,0,35,13
1681933754506,MATH 193A,A03,183169,Staff,33,0,35,2
1681933754506,MATH 193A,A04,183170,Staff,26,0,35,9
1681933755536,MGT 4,A01,202395,Anderson; John Charles,76,0,80,4
1681933756559,MGT 5,A00,202396,Houskeeper; Robert,78,0,90,12
1681933757580,MGT 103,A00,202397,Eberhard; Craig A,47,0,90,43
1681933758603,MGT 131A,A00,202398,Houskeeper; Robert,81,0,90,9
1681933759632,MGT 135,A00,202399,Anderson; John Charles,81,0,90,9
1681933760654,MGT 162R,A00,202403,Gneezy; Uri,116,0,200,84
1681933761679,MGT 172,A00,202404,Hedges; Kathleen,22,0,90,68
1681933762701,MGT 181,A00,202405,Dunn; Louis Jean,77,0,90,13
1681933763727,MMW 14,A01,183200,Staff,0,0,28,28
1681933763727,MMW 14,A02,183201,Staff,25,0,28,3
1681933763727,MMW 14,A03,183202,Staff,24,0,28,4
1681933763727,MMW 14,A04,183203,Staff,25,0,28,3
1681933763727,MMW 14,A05,183204,Staff,26,0,28,2
1681933763727,MMW 14,A06,183205,Staff,27,0,28,1
1681933763727,MMW 14,B01,183207,Staff,26,0,28,2
1681933763727,MMW 14,B02,183208,Staff,28,0,28,0
1681933763727,MMW 14,B03,183209,Staff,28,0,28,0
1681933763727,MMW 14,B04,183210,Staff,28,0,28,0
1681933763727,MMW 14,B05,183211,Staff,28,0,28,0
1681933763727,MMW 14,B06,183212,Staff,27,0,28,1
1681933764752,MMW 14GS,A00,183213,Zhiri; Oumelbanine,28,0,28,0
1681933765774,MMW 15GS,B00,183215,Rahimi; Babak,28,0,28,0
1681933766801,MMW 121,A01,183217,Patterson; Patrick H.,7,0,28,21
1681933766801,MMW 121,A02,183218,Patterson; Patrick H.,25,0,28,3
1681933767823,MUS 1A,A01,182554,Staff,0,0,35,35
1681933768846,MUS 5,A01,182558,Staff,16,0,35,19
1681933769875,MUS 6,A01,182562,Staff,22,0,35,13
1681933770898,MUS 8GS,A00,182563,Borgo; David Garcia,25,0,25,0
1681933771921,MUS 13,A01,182567,Staff,23,0,25,2
1681933772955,MUS 15,A01,182570,Staff,31,0,35,4
1681933772955,MUS 15,B01,182575,Staff,7,0,35,28
1681933773978,MUS 80,A00,182578,Staff,22,0,25,3
1681933773978,MUS 80,B00,182581,Staff,20,0,25,5
1681933775000,MUS 113,A00,182582,Staff,25,0,25,0
1681933776025,MUS 114,A00,182583,Staff,0,1,25,25
1681933777054,MUS 150GS,A01,182588,Borgo; David Garcia,24,0,25,1
1681933778078,PHIL 1,A00,182590,Staff,34,0,40,6
1681933779104,PHIL 10,A01,182596,Grush; Rick Scott,30,0,35,5
1681933779104,PHIL 10,A02,182597,Grush; Rick Scott,33,0,35,2
1681933780126,PHIL 15,A01,182601,Staff,31,0,35,4
1681933780126,PHIL 15,A02,182602,Staff,33,0,35,2
1681933781158,PHIL 27,A01,182604,Staff,25,0,35,10
1681933781158,PHIL 27,A02,182607,Staff,33,0,35,2
1681933782181,PHIL 32,A01,182609,Staff,35,0,35,0
1681933782181,PHIL 32,A02,182612,Staff,35,0,35,0
1681933783204,PHIL 130,A00,182614,Staff,57,0,70,13
1681933784229,PHIL 136,A00,182616,Cohen; Jonathan David,64,0,70,6
1681933785252,PHIL 155,A00,182617,Vargas; Manuel Rogelio,57,0,70,13
1681933786279,PHIL 163,A01,182620,Staff,15,0,20,5
1681933786279,PHIL 163,A02,182624,Staff,10,0,20,10
1681933787305,PHIL 164,A00,182627,Staff,29,0,40,11
1681933788339,PHIL 173,A00,182628,Staff,35,0,40,5
1681933789363,PHYS 1A,A00,183221,Staff,52,0,60,8
1681933790385,PHYS 1AL,001,183222,Staff,24,0,30,6
1681933790385,PHYS 1AL,002,183223,Staff,24,0,30,6
1681933791409,PHYS 1B,A00,183231,Staff,40,0,60,20
1681933792433,PHYS 1BL,001,183232,Staff,15,0,30,15
1681933792433,PHYS 1BL,002,183233,Staff,27,0,30,3
1681933793455,PHYS 1C,A00,183240,Staff,20,0,60,40
1681933794481,PHYS 1CL,001,183241,Staff,8,0,30,22
1681933794481,PHYS 1CL,002,183242,Staff,21,0,30,9
1681933795504,PHYS 2AR,A01,183250,Staff,39,0,50,11
1681933796541,PHYS 2B,A01,183252,Staff,101,0,115,14
1681933797567,PHYS 2BL,A01,183254,Staff,21,0,24,3
1681933797567,PHYS 2BL,A02,183255,Staff,21,0,24,3
1681933798590,PHYS 2C,A01,183522,Staff,100,0,115,15
1681933799612,PHYS 4A,A01,183524,Staff,49,0,50,1
1681933800636,POLI 5,A00,183525,Staff,43,0,50,7
1681933801661,POLI 12,A00,183540,Staff,45,0,50,5
1681933802682,POLI 13R,A00,183541,Forman; Fonna,40,0,50,10
1681933803713,POLI 30,A00,183542,Mignozzetti; Umberto,48,0,50,2
1681933804736,POLI 100A,A00,183543,Staff,43,0,50,7
1681933805759,POLI 100E,A00,223598,Staff,32,0,35,3
1681933806782,POLI 103A,A00,183564,Kousser; Thad,34,0,50,16
1681933807812,POLI 104B,A00,201329,Staff,27,0,35,8
1681933808841,POLI 113BR,A00,183576,Hoston; Germaine,22,0,50,28
1681933809869,POLI 114BR,A00,183588,Staff,26,0,30,4
1681933810895,POLI 117R,A00,183595,Forman; Fonna,3,0,20,17
1681933811927,POLI 120H,A00,183596,Fisk; David Lee,13,0,20,7
1681933812952,POLI 130AA,A00,183597,Staff,13,0,20,7
1681933813978,POLI 134AA,A00,183598,Staff,19,0,20,1
1681933815002,POLI 135,A00,183599,Fisk; David Lee,19,0,25,6
1681933816024,POLI 142P,A00,183623,Staff,37,0,40,3
1681933817049,POLI 144D,A00,183624,Staff,22,0,25,3
1681933818079,POLI 151,A00,183625,Staff,14,0,20,6
1681933819102,POLI 162,A00,183626,Mignozzetti; Umberto,17,0,20,3
1681933820127,PSYC 1,A00,253748,Staff,85,0,90,5
1681933821152,PSYC 2,A00,183627,Moranton; Nirelia Melbina-,22,0,35,13
1681933822176,PSYC 3,A00,183628,Staff,42,0,45,3
1681933824229,PSYC 60,A01,183631,Lowe; Angela Beth,35,0,40,5
1681933825255,PSYC 70,A01,253757,Staff,34,0,45,11
1681933826276,PSYC 101,A00,183632,Heyman; Gail D.,40,0,60,20
1681933827299,PSYC 105,A00,183848,Lowe; Angela Beth,44,0,60,16
1681933828322,PSYC 106,A00,183849,Dobkins; Karen R.,37,0,60,23
1681933829353,PSYC 108,A00,253750,Staff,9,0,60,51
1681933830375,PSYC 114,A01,184275,Winkielman; Piotr,0,8,30,30
1681933831398,PSYC 122,A00,183856,Moranton; Nirelia Melbina-,0,16,30,30
1681933832499,PSYC 124,A00,183865,Chapman; Eddie Nathaniel,42,0,80,38
1681933833525,PSYC 137,A00,183880,Staff,16,0,25,9
1681933835573,PSYC 154,A00,183910,Lacefield; Katharine I,0,31,90,90
1681933837618,PSYC 162,A00,183946,Wixted; John T,38,0,90,52
1681933838640,PSYC 172,A00,183947,Gorman; Michael R.,4,0,30,26
1681933839663,PSYC 178,A00,183963,Glaser; Dale,14,0,40,26
1681933840684,PSYC 181GS,A00,183964,Anagnostaras; Stephan,10,0,10,0
1681933841709,PSYC 186GS,A01,257660,Staff,10,0,10,0
1681933842731,PSYC 193,B00,253749,Staff,22,0,25,3
1681933844780,PSYC 193L,A01,184122,Staff,33,0,35,2
1681933844780,PSYC 193L,C01,184167,Winkielman; Piotr,14,0,30,16
1681933845803,RELI 188GS,A00,182629,Rahimi; Babak,20,0,20,0
1681933846827,SE 101A,A00,182646,Staff,25,0,30,5
1681933847858,SE 101C,A00,182650,Staff,10,0,20,10
1681933848881,SE 110A,A00,182651,Staff,28,0,28,0
1681933849906,SE 130A,A00,182652,Staff,38,0,40,2
1681933850931,SIO 46GS,A00,182636,Cook; Geoffrey W,24,0,28,4
1681933851954,SIO 109R,A00,194459,Staff,0,2,20,20
1681933852976,SIO 121GS,A00,182639,Cook; Geoffrey W,24,0,28,4
1681933853998,SIO 132,A01,182642,Staff,30,0,40,10
1681933855022,SIO 139,A00,182644,Kacev; David,36,0,40,4
1681933856048,SOCI 2,A01,258404,Staff,33,0,36,3
1681933856048,SOCI 2,A02,258405,Staff,35,0,36,1
1681933857072,SOCI 60,A01,258408,Staff,29,0,30,1
1681933857072,SOCI 60,A02,258413,Staff,30,0,30,0
1681933858104,SOCI 100,A01,258415,Staff,28,0,30,2
1681933858104,SOCI 100,A02,258416,Staff,28,0,30,2
1681933864260,SOCI 127,A00,258421,Staff,18,0,30,12
1681933865286,SOCI 132,A00,258422,Staff,42,0,50,8
1681933866314,SOCI 133,A00,258423,Staff,26,0,30,4
1681933867337,SOCI 138GS,A00,258424,Staff,15,0,15,0
1681933868362,SOCI 145,A00,258425,Staff,23,0,30,7
1681933869387,SOCI 148,A00,258426,Staff,23,0,30,7
1681933870409,SOCI 153,A00,199217,Staff,29,0,30,1
1681933871441,SOCI 160,A00,258427,Staff,27,0,30,3
1681933872463,SOCI 160E,A00,258435,Staff,55,0,60,5
1681933873489,SOCI 189GS,A00,258436,Staff,15,0,15,0
1681933874514,SOCI 190GS,A00,258437,Staff,15,0,15,0
1681933875536,SYN 2,001,182658,Staff,8,0,16,8
1681933875536,SYN 2,002,201439,Staff,13,0,16,3
1681933875536,SYN 2,003,201443,Staff,16,0,16,0
1681933876561,SYN 100,A01,182657,Staff,11,0,20,9
1681933877583,TDAC 1,A00,184381,Salovey; Todd,16,0,20,4
1681933877583,TDAC 1,B00,184385,Harting; Carla Kelso,19,0,20,1
1681933877583,TDAC 1,C00,184394,Staff,18,0,20,2
1681933878617,TDAC 101,A00,184483,Harting; Carla Kelso,19,0,20,1
1681933879639,TDDE 111,A00,184496,Staff,14,0,15,1
1681933880662,TDDE 131,A00,184504,Staff,20,0,20,0
1681933880662,TDDE 131,B00,184505,Staff,17,0,18,1
1681933880662,TDDE 131,C00,184534,Staff,49,0,50,1
1681933880662,TDDE 131,D00,184564,Staff,15,0,15,0
1681933880662,TDDE 131,E00,204725,Staff,18,0,20,2
1681933881687,TDGE 1,A01,184414,Salovey; Todd,34,0,50,16
1681933882712,TDGE 5,A01,184419,Staff,23,0,24,1
1681933883740,TDGE 10,A00,184428,Fulton; Julia,27,0,50,23
1681933884764,TDGE 124,A00,184565,Fulton; Julia,0,4,50,50
1681933885788,TDGE 125,B00,184567,Meyer; Ursula,7,0,25,18
1681933886814,TDHT 101,A00,184568,Staff,21,0,25,4
1681933886814,TDHT 101,B00,184569,Staff,20,0,20,0
1681933887850,TDHT 114,A00,184570,Staff,48,0,50,2
1681933888885,TDMV 1,A00,184437,Arcidiacono; Kristin,21,0,30,9
1681933888885,TDMV 1,B00,184448,Caligagan; Maria T.,23,0,30,7
1681933889917,TDMV 2,A00,184449,Weinberg; Sadie,26,0,30,4
1681933889917,TDMV 2,B00,184453,Arcidiacono; Kristin,29,0,30,1
1681933890939,TDMV 110,A00,184571,Weinberg; Sadie,30,0,30,0
1681933891962,TDMV 142,A00,184572,Caligagan; Tony,26,0,30,4
1681933891962,TDMV 142,B00,184573,Caligagan; Maria T.,26,0,30,4
1681933892992,TDTR 20,A00,184482,Jun; Grace Shin Hae,25,0,25,0
1681933894015,USP 2,A01,184290,Hinds; Juli Beth,23,0,25,2
1681933895037,USP 3,A01,184295,Staff,20,0,25,5
1681933896062,USP 4,A00,184304,McTague; Sarah,13,0,25,12
1681933897086,USP 100,A00,184315,Staff,16,0,25,9
1681933898109,USP 105,A00,184326,Staff,21,0,25,4
1681933899134,USP 151,A00,184327,Staff,17,0,25,8
1681933900156,USP 170,A00,184380,Hinds; Juli Beth,12,0,25,13
1681933901183,VIS 21B,A01,182660,Staff,28,0,31,3
1681933901183,VIS 21B,A02,182662,Staff,30,0,31,1
1681933902208,VIS 103D,A00,182663,Staff,74,0,75,1
1681933903237,VIS 105D,A00,182667,Li; Huai,14,0,22,8
1681933904262,VIS 122GS,A00,182668,Herbst; Matthew,20,0,20,0
1681933905284,VIS 128C,A00,182673,Staff,68,0,75,7
1681933906309,VIS 130,A00,182675,Staff,19,0,22,3
1681933907330,VIS 160A,A00,182678,Stalbaum; Brett,4,0,10,6
1681933909382,WCWP 10B,A00,201679,Staff,15,0,15,0
1681933909382,WCWP 10B,B00,201695,Staff,15,0,15,0
1681933910405,WCWP 100,A00,201716,Staff,12,0,15,3
1681933910405,WCWP 100,B00,201717,Staff,0,0,15,15
1681933912464,ANSC 105GS,A00,258289,Staff,0,0,0,0
1681933913487,ANSC 125GS,A00,258295,Staff,0,0,0,0
1681933914518,ANSC 150,A00,258267,Staff,27,0,40,13
1681933915541,ANSC 190GS,A00,258280,Staff,0,0,0,2
1681933916572,ANTH 1,A00,258264,Staff,38,0,40,2
1681933917596,ANTH 2,A01,258259,Staff,72,0,76,4
1681933918626,ANTH 23,A01,258228,Staff,35,0,40,5
1681933919648,ANTH 101,A01,258236,Staff,38,0,40,2
1681933920671,ANTH 102,A00,258272,Staff,59,0,60,1
1681933921695,ANTH 105,A00,258244,Staff,28,0,35,7
1681933922717,BENG 130,A00,253975,Staff,37,0,40,3
1681933923739,BIBC 102,A01,191866,Flagg; Matthew Paul,16,0,32,16
1681933923739,BIBC 102,A02,191867,Flagg; Matthew Paul,21,0,32,11
1681933923739,BIBC 102,A03,191868,Flagg; Matthew Paul,27,0,32,5
1681933923739,BIBC 102,A04,191936,Flagg; Matthew Paul,19,0,32,13
1681933923739,BIBC 102,A05,191937,Flagg; Matthew Paul,0,0,32,32
1681933924768,BICD 100,A01,191939,Cooper; Andrew Michael,27,0,32,5
1681933924768,BICD 100,A02,191940,Cooper; Andrew Michael,32,0,32,0
1681933924768,BICD 100,A03,191941,Cooper; Andrew Michael,32,0,32,0
1681933924768,BICD 100,A04,191942,Cooper; Andrew Michael,32,0,32,0
1681933924768,BICD 100,A05,191943,Cooper; Andrew Michael,32,0,32,0
1681933925791,BIEB 126,A01,191945,Cleland; Elsa Eleanor,0,5,32,32
1681933925791,BIEB 126,A02,191946,Cleland; Elsa Eleanor,26,0,32,6
1681933925791,BIEB 126,A03,191947,Cleland; Elsa Eleanor,29,0,32,3
1681933925791,BIEB 126,A04,191948,Cleland; Elsa Eleanor,15,0,32,17
1681933925791,BIEB 126,A05,191996,Cleland; Elsa Eleanor,28,0,32,4
1681933926813,BIEB 136GS,A00,191997,Shurin; Jonathan & Holway; David A.,0,0,0,9
1681933927839,BIEB 137GS,A01,191999,Shurin; Jonathan & Holway; David A.,0,0,0,8
1681933928871,BILD 1,A01,205385,Staff,30,0,32,2
1681933928871,BILD 1,A02,205386,Staff,30,0,32,2
1681933928871,BILD 1,A03,205387,Staff,31,0,32,1
1681933928871,BILD 1,A04,205388,Staff,25,0,32,7
1681933929894,BILD 2,A01,191774,Staff,26,0,32,6
1681933929894,BILD 2,A02,191775,Staff,30,0,32,2
1681933929894,BILD 2,A03,191777,Staff,29,0,32,3
1681933929894,BILD 2,A04,191856,Staff,30,0,32,2
1681933929894,BILD 2,A05,191857,Staff,31,0,32,1
1681933929894,BILD 2,A06,191858,Staff,32,0,32,0
1681933929894,BILD 2,A07,191859,Staff,31,0,32,1
1681933930922,BILD 3,A01,205391,Staff,27,0,32,5
1681933930922,BILD 3,A02,205393,Staff,32,0,32,0
1681933930922,BILD 3,A03,205394,Staff,26,0,32,6
1681933930922,BILD 3,A04,205395,Staff,32,0,32,0
1681933931946,BILD 20,A01,191861,Staff,32,0,32,0
1681933931946,BILD 20,A02,191862,Staff,32,0,32,0
1681933932969,BILD 30,A01,191864,Staff,31,0,32,1
1681933933994,BIMM 100,A01,192019,Staff,0,0,32,32
1681933933994,BIMM 100,A02,192020,Staff,12,0,32,20
1681933933994,BIMM 100,A03,192035,Staff,18,0,32,14
1681933935021,BIMM 110,A01,192037,Tat; John,0,0,32,32
1681933935021,BIMM 110,A02,192038,Tat; John,4,0,32,28
1681933936122,BIMM 120,A01,192040,Pickett; Brooke Elizabeth,0,0,32,32
1681933936122,BIMM 120,A02,192041,Pickett; Brooke Elizabeth,7,0,32,25
1681933936122,BIMM 120,A03,192042,Pickett; Brooke Elizabeth,14,0,32,18
1681933937146,BIPN 100,A01,192044,Armour; Jon Christopher,23,0,32,9
1681933937146,BIPN 100,A02,192059,Armour; Jon Christopher,30,0,32,2
1681933937146,BIPN 100,A03,192064,Armour; Jon Christopher,30,0,32,2
1681933937146,BIPN 100,A04,192073,Armour; Jon Christopher,26,0,32,6
1681933938169,BIPN 148,A01,205411,Leutgeb; Jill K.,14,0,32,18
1681933938169,BIPN 148,A02,205412,Leutgeb; Jill K.,31,0,32,1
1681933938169,BIPN 148,A03,205413,Leutgeb; Jill K.,29,0,32,3
1681933938169,BIPN 148,A04,205414,Leutgeb; Jill K.,30,0,32,2
1681933939204,BIPN 160,A01,192115,Marino; Marc J,15,0,32,17
1681933939204,BIPN 160,A02,192148,Marino; Marc J,27,0,32,5
1681933939204,BIPN 160,A03,192158,Marino; Marc J,31,0,32,1
1681933939204,BIPN 160,A04,192190,Marino; Marc J,32,0,32,0
1681933939204,BIPN 160,A05,192287,Marino; Marc J,32,0,32,0
1681933939204,BIPN 160,A06,192288,Marino; Marc J,32,0,32,0
1681933940227,BIPN 194,A00,206038,Leutgeb; Stefan,28,0,32,4
1681933941249,BISP 194,A00,192289,Nieh; James Charles,8,0,32,24
1681933941249,BISP 194,B00,245332,Staff,26,0,32,6
1681933942276,CAT 124,A01,202247,Staff,15,0,15,0
1681933943298,CAT 125,A00,202248,Staff,18,0,20,2
1681933943298,CAT 125,B00,202253,Staff,20,0,20,0
1681933943298,CAT 125,C00,202257,Staff,18,0,20,2
1681933944323,CAT 125GS,A01,202273,Bronstein; Phoebe Malan,20,0,20,0
1681933945347,CAT 125R,A00,202284,Staff,17,0,20,3
1681933945347,CAT 125R,C00,202286,Staff,3,0,20,17
1681933945347,CAT 125R,D00,202291,Staff,15,0,20,5
1681933945347,CAT 125R,E00,202295,Staff,13,0,20,7
1681933945347,CAT 125R,F00,202302,Staff,6,0,20,14
1681933946371,CENG 100,A00,204724,Opatkiewicz; Justin Paul,23,0,25,2
1681933947394,CGS 2A,A01,180420,Staff,29,0,36,7
1681933948416,CGS 101,A00,180421,Staff,14,0,20,6
1681933949450,CGS 112,A00,180422,Staff,8,0,16,8
1681933950480,CGS 113,A00,180423,Staff,18,0,20,2
1681933951512,CGS 137,A00,180424,Staff,12,0,12,0
1681933952533,CGS 147,A00,180425,Staff,10,0,10,0
1681933953560,CHEM 6A,A01,179556,Staff,92,0,100,8
1681933953560,CHEM 6A,A02,179558,Staff,0,0,0,0
1681933954586,CHEM 6B,A01,179560,Staff,100,0,100,0
1681933955608,CHEM 6C,A01,179565,Jazzar; Rodolphe,90,0,100,10
1681933956632,CHEM 7L,A01,179586,Schurmeier; Kimberly,10,0,24,14
1681933956632,CHEM 7L,A02,179587,Schurmeier; Kimberly,22,0,24,2
1681933956632,CHEM 7L,A03,179590,Schurmeier; Kimberly,22,0,24,2
1681933956632,CHEM 7L,A04,179591,Schurmeier; Kimberly,22,0,24,2
1681933956632,CHEM 7L,B01,179598,Schurmeier; Kimberly,14,0,24,10
1681933956632,CHEM 7L,B02,179599,Schurmeier; Kimberly,23,0,24,1
1681933956632,CHEM 7L,B03,179606,Schurmeier; Kimberly,22,0,24,2
1681933956632,CHEM 7L,B04,179607,Schurmeier; Kimberly,22,0,24,2
1681933957658,CHEM 11,A01,179609,Stallings; Dontarie M,86,0,100,14
1681933958687,CHEM 40A,A01,179621,Staff,37,0,50,13
1681933958687,CHEM 40A,A02,179622,Staff,44,0,50,6
1681933959714,CHEM 40B,A01,179630,Weizman; Haim,45,0,50,5
1681933959714,CHEM 40B,A02,179631,Weizman; Haim,43,0,50,7
1681933960741,CHEM 41A,A01,179660,Klosterman; Jeremy K,90,0,100,10
1681933961765,CHEM 43A,A01,179683,Klosterman; Jeremy K,0,0,24,24
1681933961765,CHEM 43A,A02,179688,Klosterman; Jeremy K,5,0,24,19
1681933961765,CHEM 43A,A03,179689,Klosterman; Jeremy K,16,0,24,8
1681933961765,CHEM 43A,A04,179691,Klosterman; Jeremy K,17,0,24,7
1681933962790,CHEM 114A,A01,179693,Stallings; Dontarie M,63,0,100,37
1681933963818,CHEM 143B,A01,179698,Weizman; Haim,16,0,24,8
1681933963818,CHEM 143B,A02,179700,Weizman; Haim,23,0,24,1
1681933964844,CHIN 169A,A00,179701,Wang; Xiao,20,0,20,0
1681933965870,COGS 2,A01,179750,Boyle; Mary E. T.,16,0,30,14
1681933966897,COGS 9,A01,179759,Jones; Cameron Robert,40,0,50,10
1681933967922,COGS 14A,A01,179854,Staff,6,0,50,44
1681933968944,COGS 14B,A01,179856,Staff,49,0,60,11
1681933969967,COGS 17,A01,179874,Staff,69,0,75,6
1681933970993,COGS 18,A01,179884,Staff,59,0,80,21
1681933972019,COGS 100,A01,179886,Staff,27,0,60,33
1681933973045,COGS 101B,A01,179892,Staff,0,4,30,30
1681933974070,COGS 101C,A01,179894,Staff,26,0,30,4
1681933975096,COGS 107A,A01,179896,Boyle; Mary E. T.,28,0,40,12
1681933976119,COGS 108,A01,179898,Simpkins; Charles Alexander,0,35,60,60
1681933977144,COGS 109,A01,179900,Staff,32,0,40,8
1681933978168,COGS 118A,A01,179946,Staff,3,0,40,37
1681933979190,COGS 153,A00,179978,Staff,0,7,30,30
1681933980216,COGS 156,A01,179981,Staff,19,0,30,11
1681933982274,COGS 172,A01,179987,Staff,8,0,30,22
1681933984328,COGS 186,A01,179991,Staff,11,0,30,19
1681933985352,COMM 10,A01,180001,Staff,11,0,25,14
1681933985352,COMM 10,A02,180004,Staff,20,0,25,5
1681933986380,COMM 100A,A01,180016,Staff,13,0,25,12
1681933986380,COMM 100A,A02,180020,Staff,24,0,25,1
1681933987404,COMM 101T,A00,180029,Halm; Gavin Patrick,15,0,35,20
1681933988428,COMM 106V,A00,180043,Staff,34,0,35,1
1681933989450,COMM 109P,A00,180044,Staff,29,0,35,6
1681933990472,COMM 113T,A00,180045,Havis; Allan,35,0,45,10
1681933991494,COMM 132,A00,180046,McKenna; Denise,16,0,30,14
1681933992517,COMM 143,A00,180047,Staff,15,0,30,15
1681933993540,COMM 190,A00,180048,Conner; Thomas Hartnell,15,0,23,8
1681933994563,CSE 8A,A50,180053,Cao; Yingjun,19,0,50,31
1681933994563,CSE 8A,B50,180180,Staff,50,0,50,0
1681933995590,CSE 11,A01,180190,Cao; Yingjun,18,0,50,32
1681933996626,CSE 20,A01,180192,Briones; Jor-el Thomas Caparas,20,0,30,10
1681933997652,CSE 21,A01,194538,Briones; Jor-el Thomas Caparas,49,0,60,11
1681933998677,CSE 30,A01,180324,Eldon; John,71,0,100,29
1681933999700,CSE 101,A01,201353,Staff,0,32,40,40
1681934000722,CSE 134B,A01,180326,Powell; Thomas Allan,69,0,100,31
1681934001748,CSE 140,A01,180328,Staff,20,0,75,55
1681934002777,CSE 140L,A01,180344,Eldon; John,45,0,100,55
1681934003799,CSE 150A,A01,180411,Staff,0,21,50,50
1681934004821,CSE 151A,A01,180414,Staff,0,16,50,50
1681934005846,CSE 175,A01,222521,Kumar; Rakesh,50,0,50,0
1681934006876,CSE 190,A00,201419,Staff,42,0,49,7
1681934007898,CSS 1,A01,194536,Staff,31,0,50,19
1681934008921,DSC 30,A01,202385,Staff,48,0,50,2
1681934009947,DSC 40A,A01,202387,Albuyeh; Rod,50,0,50,0
1681934010971,DSC 190,A01,202389,Silberman; Jack,21,0,21,0
1681934011999,DSGN 100,A01,179993,Staff,13,0,30,17
1681934013023,ECE 65,A50,180708,Staff,10,0,20,10
1681934013023,ECE 65,A51,180739,Staff,19,0,20,1
1681934014052,ECON 1,A01,180427,Famulari; Melissa,65,0,70,5
1681934015075,ECON 2,A01,180450,Levkoff; Steven B.,62,0,70,8
1681934016096,ECON 4,A01,203351,Anderson; John Charles,6,0,10,4
1681934017122,ECON 100A,A01,180472,Famulari; Melissa,59,0,70,11
1681934018147,ECON 120A,A01,180549,Staff,60,0,70,10
1681934019169,ECON 120B,A01,180655,Ma; Xinwei,33,0,70,37
1681934020193,ECON 129,A00,203333,Eckert; Fabian Paul,6,0,35,29
1681934021220,ECON 131,A00,180656,Staff,0,4,35,35
1681934022249,ECON 172B,A01,180672,Levkoff; Steven B.,30,0,35,5
1681934023273,ECON 178,A01,203342,Zhu; Ying,2,0,35,33
1681934024298,EDS 108GS,A00,202383,Wishard Guerra; Alison G.,20,0,20,0
1681934025321,EDS 111GS,A00,202347,Wishard Guerra; Alison G.,20,0,20,0
1681934026345,EDS 112,A01,202323,Staff,53,0,60,7
1681934027370,EDS 113,A00,202340,Staff,31,0,35,4
1681934028410,EDS 118,A00,201231,Staff,19,0,30,11
1681934029433,EDS 119,A00,204994,Staff,8,0,10,2
1681934030464,EDS 124BR,A00,202324,Eguchi; Emi,0,2,25,25
1681934031488,EDS 126,A01,203208,Jones; Makeba,26,0,30,4
1681934032512,EDS 135,A01,202333,Staff,17,0,20,3
1681934033539,EDS 180,A00,202311,Staff,47,0,50,3
1681934034562,ERC 190GS,A01,253747,Staff,28,0,28,0
1681934035587,ETHN 104,A00,180742,Staff,20,0,35,15
1681934036610,ETHN 118,A00,180745,Staff,26,0,35,9
1681934037633,ETHN 127,A00,180747,Staff,8,0,16,8
1681934038674,ETHN 137,A00,180880,Staff,11,0,12,1
1681934039776,ETHN 147,A00,180890,Staff,8,0,10,2
1681934040800,ETHN 154,A00,180891,Staff,4,0,8,4
1681934041827,ETHN 168,A00,180892,Staff,9,0,10,1
1681934042849,GLBH 20,A00,201051,Hannah; Seth Donal,0,7,0,1
1681934043875,GLBH 111,A01,209338,Burgos; Jose L.,0,0,0,0
1681934044898,GLBH 150,A00,258300,Staff,0,4,0,0
1681934045922,GLBH 181,A00,201207,Staff,4,0,40,36
1681934046944,HIEU 109,A00,180898,Staff,19,0,20,1
1681934047970,HIEU 111,A00,180899,Staff,0,2,20,20
1681934048994,HIEU 124,A00,180900,Staff,16,0,20,4
1681934050023,HILA 122,A00,180901,Staff,17,0,20,3
1681934051049,HILA 132,A00,180902,Vitz; Matthew,0,3,20,20
1681934052072,HILD 10,A01,180896,Staff,11,0,20,9
1681934053094,HILD 30GS,A00,180897,Edington; Claire Ellen,0,0,0,0
1681934054124,HISC 105,A00,180903,Staff,20,0,20,0
1681934055151,HISC 117,A00,180904,Staff,10,0,20,10
1681934056176,HIUS 108B,A00,181005,Staff,18,0,20,2
1681934057198,HIUS 113,A00,181093,Staff,0,0,20,20
1681934058224,HUM 3,A01,181190,Patterson; Patrick H.,33,0,50,17
1681934058224,HUM 3,B01,181195,Staff,44,0,50,6
1681934059249,HUM 3GS,A00,181196,Herbst; Matthew,0,0,0,0
1681934060271,HUM 4,A01,181227,West; Geoffrey Scott,33,0,50,17
1681934060271,HUM 4,B01,181282,Staff,41,0,50,9
1681934061293,HUM 4GS,A00,181377,Lyon; Antony J.,0,0,0,0
1681934062316,HUM 5,A01,181536,Zavodny; Tatiana Sophia,22,0,50,28
1681934062316,HUM 5,B01,181908,Staff,32,0,50,18
1681934063344,INTL 190,A00,181909,Segui; Alan S,0,0,0,8
1681934063344,INTL 190,B00,181961,Segui; Alan S,0,0,0,7
1681934064366,JAPN 20AR,A01,182113,Ross; Kayoko F,15,0,20,5
1681934065390,LATI 50,A01,202391,Martin-Cabrera; Luis,16,0,30,14
1681934065390,LATI 50,A02,202392,Martin-Cabrera; Luis,26,0,30,4
1681934066419,LATI 180,A00,202393,Kokinis; Troy Andreas,24,0,25,1
1681934067451,LIFR 1A,A00,182119,Staff,13,0,14,1
1681934068473,LIFR 1AX,A00,182324,Staff,13,0,14,1
1681934069495,LIFR 1B,A00,182259,Staff,11,0,14,3
1681934070516,LIFR 1BX,A00,182273,Staff,11,0,14,3
1681934071546,LIGN 8,A00,182330,Staff,124,0,150,26
1681934072577,LIGN 9GS,A00,182362,Staff,14,0,20,6
1681934073603,LIGN 119,A00,204992,Takahashi; Maho,11,0,15,4
1681934074625,LIGN 130,A01,182384,Staff,47,0,50,3
1681934075648,LIGN 149GS,A00,182390,Staff,14,0,20,6
1681934076673,LIGN 170,A00,182404,Staff,23,0,30,7
1681934077698,LISP 1D,A00,182281,Staff,6,0,14,8
1681934077698,LISP 1D,B00,182287,Staff,13,0,14,1
1681934077698,LISP 1D,C00,182295,Staff,10,0,14,4
1681934077698,LISP 1D,D00,182301,Staff,14,0,14,0
1681934078722,LISP 1DX,A00,182309,Staff,18,0,28,10
1681934078722,LISP 1DX,B00,182316,Staff,25,0,28,3
1681934079754,LTAF 120GS,A00,182412,Zhiri; Oumelbanine,20,0,20,0
1681934080776,LTCS 172GS,A00,182437,Bronstein; Phoebe Malan,20,0,20,0
1681934081800,LTEA 138,A00,182457,Staff,15,0,40,25
1681934082826,LTEN 114,A01,182490,Staff,23,0,25,2
1681934083853,LTEN 130GS,A00,182491,Lyon; Antony J.,20,0,20,0
1681934084875,LTEN 169,A00,182493,Cuong; Marisol,17,0,25,8
1681934085900,LTEN 178,A00,182501,Staff,14,0,15,1
1681934086924,LTEN 181,A00,182515,Staff,19,0,25,6
1681934087949,LTEN 185GS,A00,197655,Forbes; Camille,20,0,20,0
1681934088972,LTSP 100B,A00,202208,Bessett; Ryan Matthew,24,0,25,1
1681934089995,LTWL 100,A00,182516,Myerston Santana; Jacobo,19,0,30,11
1681934091017,LTWR 100GS,A00,182518,Forbes; Camille,20,0,20,0
1681934092042,LTWR 102,A00,182522,Staff,15,0,15,0
1681934092042,LTWR 102,B00,182525,Staff,14,0,15,1
1681934093065,LTWR 115,A00,182526,Staff,10,0,15,5
1681934094088,MAE 8,A01,182528,Pham; Hieu Tan,66,0,70,4
1681934095111,MAE 11,A00,182529,Bahadori; Mohammad Yousef,88,0,100,12
1681934096137,MAE 20,A00,182530,Evdokimenko; Ekaterina,67,0,70,3
1681934097159,MAE 30A,A00,182532,Staff,44,0,45,1
1681934098186,MAE 101A,A00,182533,Bahadori; Mohammad Yousef,93,0,100,7
1681934099215,MAE 101C,A00,182538,Staff,62,0,70,8
1681934100239,MAE 104,A00,182539,Staff,44,0,50,6
1681934101264,MAE 131A,A00,182540,Ghazinejad; Maziar,40,0,45,5
1681934102288,MAE 143A,A00,182548,Bewley; Thomas R,42,0,50,8
1681934103310,MAE 150,A00,182549,Staff,28,0,40,12
1681934104336,MAE 160,A00,182550,Evdokimenko; Ekaterina,38,0,60,22
1681934105362,MATH 3C,A01,182725,Staff,24,0,30,6
1681934106394,MATH 10A,A01,182729,Staff,24,0,30,6
1681934106394,MATH 10A,B01,182732,Staff,25,0,30,5
1681934107418,MATH 10B,A01,182737,Staff,15,0,30,15
1681934107418,MATH 10B,A02,182738,Staff,24,0,30,6
1681934107418,MATH 10B,B01,182744,Staff,24,0,30,6
1681934107418,MATH 10B,B02,182745,Staff,27,0,30,3
1681934108444,MATH 18,A01,182750,Anzaldo; Leesa B,28,0,30,2
1681934108444,MATH 18,A02,182751,Anzaldo; Leesa B,28,0,30,2
1681934108444,MATH 18,A03,182753,Anzaldo; Leesa B,27,0,30,3
1681934108444,MATH 18,A04,182757,Anzaldo; Leesa B,29,0,30,1
1681934108444,MATH 18,B01,182761,Anzaldo; Leesa B,26,0,30,4
1681934108444,MATH 18,B02,182764,Anzaldo; Leesa B,27,0,30,3
1681934108444,MATH 18,B03,182765,Anzaldo; Leesa B,29,0,30,1
1681934108444,MATH 18,B04,182766,Anzaldo; Leesa B,30,0,30,0
1681934109471,MATH 20A,A01,182771,Suk; Andrew Hoon,27,0,30,3
1681934110496,MATH 20B,A01,182775,Bach; Quang Tran,30,0,30,0
1681934110496,MATH 20B,A02,182777,Bach; Quang Tran,29,0,30,1
1681934110496,MATH 20B,B01,182780,Bach; Quang Tran,26,0,30,4
1681934110496,MATH 20B,B02,182782,Bach; Quang Tran,30,0,30,0
1681934111520,MATH 20C,A01,182787,Staff,24,0,30,6
1681934111520,MATH 20C,A02,182790,Staff,29,0,30,1
1681934111520,MATH 20C,B01,182792,Staff,23,0,30,7
1681934111520,MATH 20C,B02,182796,Staff,26,0,30,4
1681934112542,MATH 20D,A01,182799,Staff,27,0,30,3
1681934112542,MATH 20D,A02,182802,Staff,29,0,30,1
1681934112542,MATH 20D,A03,182803,Staff,30,0,30,0
1681934113578,MATH 20E,A01,182809,Verstraete; Jacques Allan,18,0,30,12
1681934113578,MATH 20E,A02,182811,Verstraete; Jacques Allan,27,0,30,3
1681934113578,MATH 20E,B01,182814,Verstraete; Jacques Allan,21,0,30,9
1681934113578,MATH 20E,B02,182815,Verstraete; Jacques Allan,27,0,30,3
1681934114601,MATH 103A,A01,182820,Staff,3,0,30,27
1681934114601,MATH 103A,A02,182821,Staff,26,0,30,4
1681934114601,MATH 103A,A03,182822,Staff,20,0,30,10
1681934114601,MATH 103A,B01,182825,Staff,21,0,30,9
1681934114601,MATH 103A,B02,182826,Staff,30,0,30,0
1681934114601,MATH 103A,B03,182830,Staff,30,0,30,0
1681934115625,MATH 109,A01,182836,Chow; Bennett,23,0,30,7
1681934115625,MATH 109,A02,182838,Chow; Bennett,27,0,30,3
1681934115625,MATH 109,A03,182894,Chow; Bennett,29,0,30,1
1681934115625,MATH 109,B01,182908,Chow; Bennett,26,0,30,4
1681934115625,MATH 109,B02,182909,Chow; Bennett,30,0,30,0
1681934115625,MATH 109,B03,182910,Chow; Bennett,26,0,30,4
1681934116649,MATH 142A,A01,182925,Staff,3,0,30,27
1681934116649,MATH 142A,A02,182935,Staff,23,0,30,7
1681934116649,MATH 142A,A03,182967,Staff,24,0,30,6
1681934116649,MATH 142A,B01,183125,Staff,22,0,30,8
1681934116649,MATH 142A,B02,183157,Staff,26,0,30,4
1681934116649,MATH 142A,B03,183158,Staff,29,0,30,1
1681934117676,MATH 183,A01,183160,Arias-Castro; Ery,22,0,30,8
1681934117676,MATH 183,A02,183161,Arias-Castro; Ery,28,0,30,2
1681934117676,MATH 183,B01,183163,Arias-Castro; Ery,26,0,30,4
1681934117676,MATH 183,B02,183164,Arias-Castro; Ery,28,0,30,2
1681934118708,MATH 193A,A01,183167,Staff,0,1,35,35
1681934118708,MATH 193A,A02,183168,Staff,22,0,35,13
1681934118708,MATH 193A,A03,183169,Staff,33,0,35,2
1681934118708,MATH 193A,A04,183170,Staff,26,0,35,9
1681934119730,MGT 4,A01,202395,Anderson; John Charles,76,0,80,4
1681934120752,MGT 5,A00,202396,Houskeeper; Robert,78,0,90,12
1681934121781,MGT 103,A00,202397,Eberhard; Craig A,46,0,90,44
1681934122806,MGT 131A,A00,202398,Houskeeper; Robert,81,0,90,9
1681934123835,MGT 135,A00,202399,Anderson; John Charles,81,0,90,9
1681934124860,MGT 162R,A00,202403,Gneezy; Uri,114,0,200,86
1681934125885,MGT 172,A00,202404,Hedges; Kathleen,21,0,90,69
1681934126917,MGT 181,A00,202405,Dunn; Louis Jean,76,0,90,14
1681934127943,MMW 14,A01,183200,Staff,0,0,28,28
1681934127943,MMW 14,A02,183201,Staff,25,0,28,3
1681934127943,MMW 14,A03,183202,Staff,24,0,28,4
1681934127943,MMW 14,A04,183203,Staff,25,0,28,3
1681934127943,MMW 14,A05,183204,Staff,26,0,28,2
1681934127943,MMW 14,A06,183205,Staff,27,0,28,1
1681934127943,MMW 14,B01,183207,Staff,26,0,28,2
1681934127943,MMW 14,B02,183208,Staff,28,0,28,0
1681934127943,MMW 14,B03,183209,Staff,28,0,28,0
1681934127943,MMW 14,B04,183210,Staff,28,0,28,0
1681934127943,MMW 14,B05,183211,Staff,28,0,28,0
1681934127943,MMW 14,B06,183212,Staff,27,0,28,1
1681934128966,MMW 14GS,A00,183213,Zhiri; Oumelbanine,28,0,28,0
1681934129992,MMW 15GS,B00,183215,Rahimi; Babak,28,0,28,0
1681934131020,MMW 121,A01,183217,Patterson; Patrick H.,7,0,28,21
1681934131020,MMW 121,A02,183218,Patterson; Patrick H.,25,0,28,3
1681934132043,MUS 1A,A01,182554,Staff,0,1,35,35
1681934133066,MUS 5,A01,182558,Staff,16,0,35,19
1681934134096,MUS 6,A01,182562,Staff,22,0,35,13
1681934135119,MUS 8GS,A00,182563,Borgo; David Garcia,25,0,25,0
1681934136141,MUS 13,A01,182567,Staff,23,0,25,2
1681934137172,MUS 15,A01,182570,Staff,31,0,35,4
1681934137172,MUS 15,B01,182575,Staff,6,0,35,29
1681934138199,MUS 80,A00,182578,Staff,22,0,25,3
1681934138199,MUS 80,B00,182581,Staff,20,0,25,5
1681934139225,MUS 113,A00,182582,Staff,25,0,25,0
1681934140255,MUS 114,A00,182583,Staff,0,1,25,25
1681934141281,MUS 150GS,A01,182588,Borgo; David Garcia,24,0,25,1
1681934142308,PHIL 1,A00,182590,Staff,34,0,40,6
1681934143401,PHIL 10,A01,182596,Grush; Rick Scott,30,0,35,5
1681934143401,PHIL 10,A02,182597,Grush; Rick Scott,33,0,35,2
1681934144423,PHIL 15,A01,182601,Staff,31,0,35,4
1681934144423,PHIL 15,A02,182602,Staff,33,0,35,2
1681934145446,PHIL 27,A01,182604,Staff,25,0,35,10
1681934145446,PHIL 27,A02,182607,Staff,33,0,35,2
1681934146473,PHIL 32,A01,182609,Staff,35,0,35,0
1681934146473,PHIL 32,A02,182612,Staff,35,0,35,0
1681934147500,PHIL 130,A00,182614,Staff,57,0,70,13
1681934148531,PHIL 136,A00,182616,Cohen; Jonathan David,64,0,70,6
1681934149556,PHIL 155,A00,182617,Vargas; Manuel Rogelio,57,0,70,13
1681934150580,PHIL 163,A01,182620,Staff,15,0,20,5
1681934150580,PHIL 163,A02,182624,Staff,10,0,20,10
1681934151603,PHIL 164,A00,182627,Staff,29,0,40,11
1681934152625,PHIL 173,A00,182628,Staff,35,0,40,5
1681934153648,PHYS 1A,A00,183221,Staff,52,0,60,8
1681934154683,PHYS 1AL,001,183222,Staff,24,0,30,6
1681934154683,PHYS 1AL,002,183223,Staff,24,0,30,6
1681934155706,PHYS 1B,A00,183231,Staff,40,0,60,20
1681934156735,PHYS 1BL,001,183232,Staff,15,0,30,15
1681934156735,PHYS 1BL,002,183233,Staff,27,0,30,3
1681934157760,PHYS 1C,A00,183240,Staff,19,0,60,41
1681934158787,PHYS 1CL,001,183241,Staff,8,0,30,22
1681934158787,PHYS 1CL,002,183242,Staff,21,0,30,9
1681934159816,PHYS 2AR,A01,183250,Staff,39,0,50,11
1681934160840,PHYS 2B,A01,183252,Staff,101,0,115,14
1681934161869,PHYS 2BL,A01,183254,Staff,21,0,24,3
1681934161869,PHYS 2BL,A02,183255,Staff,21,0,24,3
1681934162895,PHYS 2C,A01,183522,Staff,100,0,115,15
1681934163932,PHYS 4A,A01,183524,Staff,49,0,50,1
1681934164966,POLI 5,A00,183525,Staff,43,0,50,7
1681934165991,POLI 12,A00,183540,Staff,45,0,50,5
1681934167012,POLI 13R,A00,183541,Forman; Fonna,39,0,50,11
1681934168036,POLI 30,A00,183542,Mignozzetti; Umberto,48,0,50,2
1681934169063,POLI 100A,A00,183543,Staff,43,0,50,7
1681934170090,POLI 100E,A00,223598,Staff,32,0,35,3
1681934171163,POLI 103A,A00,183564,Kousser; Thad,34,0,50,16
1681934172191,POLI 104B,A00,201329,Staff,27,0,35,8
1681934173219,POLI 113BR,A00,183576,Hoston; Germaine,22,0,50,28
1681934174251,POLI 114BR,A00,183588,Staff,26,0,30,4
1681934175288,POLI 117R,A00,183595,Forman; Fonna,3,0,20,17
1681934176312,POLI 120H,A00,183596,Fisk; David Lee,13,0,20,7
1681934177334,POLI 130AA,A00,183597,Staff,13,0,20,7
1681934178356,POLI 134AA,A00,183598,Staff,19,0,20,1
1681934179383,POLI 135,A00,183599,Fisk; David Lee,19,0,25,6
1681934180410,POLI 142P,A00,183623,Staff,37,0,40,3
1681934181433,POLI 144D,A00,183624,Staff,22,0,25,3
1681934182456,POLI 151,A00,183625,Staff,14,0,20,6
1681934183482,POLI 162,A00,183626,Mignozzetti; Umberto,17,0,20,3
1681934184523,PSYC 1,A00,253748,Staff,85,0,90,5
1681934185547,PSYC 2,A00,183627,Moranton; Nirelia Melbina-,22,0,35,13
1681934186569,PSYC 3,A00,183628,Staff,42,0,45,3
1681934188619,PSYC 60,A01,183631,Lowe; Angela Beth,35,0,40,5
1681934189641,PSYC 70,A01,253757,Staff,34,0,45,11
1681934190671,PSYC 101,A00,183632,Heyman; Gail D.,39,0,60,21
1681934191704,PSYC 105,A00,183848,Lowe; Angela Beth,43,0,60,17
1681934192726,PSYC 106,A00,183849,Dobkins; Karen R.,36,0,60,24
1681934193756,PSYC 108,A00,253750,Staff,7,0,60,53
1681934194781,PSYC 114,A01,184275,Winkielman; Piotr,0,8,30,30
1681934195804,PSYC 122,A00,183856,Moranton; Nirelia Melbina-,0,16,30,30
1681934196832,PSYC 124,A00,183865,Chapman; Eddie Nathaniel,41,0,80,39
1681934197858,PSYC 137,A00,183880,Staff,16,0,25,9
1681934199906,PSYC 154,A00,183910,Lacefield; Katharine I,0,32,90,90
1681934201958,PSYC 162,A00,183946,Wixted; John T,38,0,90,52
1681934202981,PSYC 172,A00,183947,Gorman; Michael R.,4,0,30,26
1681934204003,PSYC 178,A00,183963,Glaser; Dale,12,0,40,28
1681934205028,PSYC 181GS,A00,183964,Anagnostaras; Stephan,10,0,10,0
1681934206060,PSYC 186GS,A01,257660,Staff,10,0,10,0
1681934207094,PSYC 193,B00,253749,Staff,22,0,25,3
1681934209139,PSYC 193L,A01,184122,Staff,33,0,35,2
1681934209139,PSYC 193L,C01,184167,Winkielman; Piotr,14,0,30,16
1681934210161,RELI 188GS,A00,182629,Rahimi; Babak,20,0,20,0
1681934211183,SE 101A,A00,182646,Staff,25,0,30,5
1681934212211,SE 101C,A00,182650,Staff,10,0,20,10
1681934213237,SE 110A,A00,182651,Staff,28,0,28,0
1681934214268,SE 130A,A00,182652,Staff,38,0,40,2
1681934215290,SIO 46GS,A00,182636,Cook; Geoffrey W,24,0,28,4
1681934216312,SIO 109R,A00,194459,Staff,0,2,20,20
1681934217334,SIO 121GS,A00,182639,Cook; Geoffrey W,24,0,28,4
1681934218355,SIO 132,A01,182642,Staff,30,0,40,10
1681934219382,SIO 139,A00,182644,Kacev; David,36,0,40,4
1681934220406,SOCI 2,A01,258404,Staff,33,0,36,3
1681934220406,SOCI 2,A02,258405,Staff,35,0,36,1
1681934221429,SOCI 60,A01,258408,Staff,29,0,30,1
1681934221429,SOCI 60,A02,258413,Staff,30,0,30,0
1681934222452,SOCI 100,A01,258415,Staff,28,0,30,2
1681934222452,SOCI 100,A02,258416,Staff,28,0,30,2
1681934228594,SOCI 127,A00,258421,Staff,18,0,30,12
1681934229618,SOCI 132,A00,258422,Staff,42,0,50,8
1681934230640,SOCI 133,A00,258423,Staff,26,0,30,4
1681934231661,SOCI 138GS,A00,258424,Staff,15,0,15,0
1681934232685,SOCI 145,A00,258425,Staff,23,0,30,7
1681934233711,SOCI 148,A00,258426,Staff,23,0,30,7
1681934234732,SOCI 153,A00,199217,Staff,29,0,30,1
1681934235762,SOCI 160,A00,258427,Staff,27,0,30,3
1681934236790,SOCI 160E,A00,258435,Staff,55,0,60,5
1681934237814,SOCI 189GS,A00,258436,Staff,15,0,15,0
1681934238837,SOCI 190GS,A00,258437,Staff,15,0,15,0
1681934239859,SYN 2,001,182658,Staff,8,0,16,8
1681934239859,SYN 2,002,201439,Staff,13,0,16,3
1681934239859,SYN 2,003,201443,Staff,15,0,16,1
1681934240883,SYN 100,A01,182657,Staff,11,0,20,9
1681934241907,TDAC 1,A00,184381,Salovey; Todd,16,0,20,4
1681934241907,TDAC 1,B00,184385,Harting; Carla Kelso,19,0,20,1
1681934241907,TDAC 1,C00,184394,Staff,18,0,20,2
1681934242932,TDAC 101,A00,184483,Harting; Carla Kelso,19,0,20,1
1681934243955,TDDE 111,A00,184496,Staff,14,0,15,1
1681934244986,TDDE 131,A00,184504,Staff,20,0,20,0
1681934244986,TDDE 131,B00,184505,Staff,17,0,18,1
1681934244986,TDDE 131,C00,184534,Staff,49,0,50,1
1681934244986,TDDE 131,D00,184564,Staff,15,0,15,0
1681934244986,TDDE 131,E00,204725,Staff,18,0,20,2
1681934246013,TDGE 1,A01,184414,Salovey; Todd,33,0,50,17
1681934247130,TDGE 5,A01,184419,Staff,23,0,24,1
1681934248152,TDGE 10,A00,184428,Fulton; Julia,27,0,50,23
1681934249177,TDGE 124,A00,184565,Fulton; Julia,0,4,50,50
1681934250205,TDGE 125,B00,184567,Meyer; Ursula,7,0,25,18
1681934251231,TDHT 101,A00,184568,Staff,21,0,25,4
1681934251231,TDHT 101,B00,184569,Staff,20,0,20,0
1681934252254,TDHT 114,A00,184570,Staff,47,0,50,3
1681934253281,TDMV 1,A00,184437,Arcidiacono; Kristin,21,0,30,9
1681934253281,TDMV 1,B00,184448,Caligagan; Maria T.,23,0,30,7
1681934254310,TDMV 2,A00,184449,Weinberg; Sadie,26,0,30,4
1681934254310,TDMV 2,B00,184453,Arcidiacono; Kristin,29,0,30,1
1681934255336,TDMV 110,A00,184571,Weinberg; Sadie,30,0,30,0
1681934256358,TDMV 142,A00,184572,Caligagan; Tony,26,0,30,4
1681934256358,TDMV 142,B00,184573,Caligagan; Maria T.,26,0,30,4
1681934257382,TDTR 20,A00,184482,Jun; Grace Shin Hae,25,0,25,0
1681934258408,USP 2,A01,184290,Hinds; Juli Beth,23,0,25,2
1681934259441,USP 3,A01,184295,Staff,20,0,25,5
1681934260471,USP 4,A00,184304,McTague; Sarah,13,0,25,12
1681934261494,USP 100,A00,184315,Staff,16,0,25,9
1681934262518,USP 105,A00,184326,Staff,21,0,25,4
1681934263554,USP 151,A00,184327,Staff,17,0,25,8
1681934264577,USP 170,A00,184380,Hinds; Juli Beth,12,0,25,13
1681934265598,VIS 21B,A01,182660,Staff,28,0,31,3
1681934265598,VIS 21B,A02,182662,Staff,30,0,31,1
1681934266623,VIS 103D,A00,182663,Staff,73,0,75,2
1681934267645,VIS 105D,A00,182667,Li; Huai,14,0,22,8
1681934268675,VIS 122GS,A00,182668,Herbst; Matthew,20,0,20,0
1681934269704,VIS 128C,A00,182673,Staff,68,0,75,7
1681934270732,VIS 130,A00,182675,Staff,19,0,22,3
1681934271759,VIS 160A,A00,182678,Stalbaum; Brett,4,0,10,6
1681934273811,WCWP 10B,A00,201679,Staff,15,0,15,0
1681934273811,WCWP 10B,B00,201695,Staff,15,0,15,0
1681934274844,WCWP 100,A00,201716,Staff,12,0,15,3
1681934274844,WCWP 100,B00,201717,Staff,0,0,15,15
1681934276907,ANSC 105GS,A00,258289,Staff,0,0,0,0
1681934277933,ANSC 125GS,A00,258295,Staff,0,0,0,0
1681934278956,ANSC 150,A00,258267,Staff,27,0,40,13
1681934279982,ANSC 190GS,A00,258280,Staff,0,0,0,2
1681934281007,ANTH 1,A00,258264,Staff,38,0,40,2
1681934282046,ANTH 2,A01,258259,Staff,72,0,76,4
1681934283072,ANTH 23,A01,258228,Staff,35,0,40,5
1681934284095,ANTH 101,A01,258236,Staff,38,0,40,2
1681934285122,ANTH 102,A00,258272,Staff,59,0,60,1
1681934286146,ANTH 105,A00,258244,Staff,28,0,35,7
1681934287169,BENG 130,A00,253975,Staff,37,0,40,3
1681934288196,BIBC 102,A01,191866,Flagg; Matthew Paul,16,0,32,16
1681934288196,BIBC 102,A02,191867,Flagg; Matthew Paul,20,0,32,12
1681934288196,BIBC 102,A03,191868,Flagg; Matthew Paul,27,0,32,5
1681934288196,BIBC 102,A04,191936,Flagg; Matthew Paul,19,0,32,13
1681934288196,BIBC 102,A05,191937,Flagg; Matthew Paul,0,1,32,32
1681934289219,BICD 100,A01,191939,Cooper; Andrew Michael,27,0,32,5
1681934289219,BICD 100,A02,191940,Cooper; Andrew Michael,32,0,32,0
1681934289219,BICD 100,A03,191941,Cooper; Andrew Michael,32,0,32,0
1681934289219,BICD 100,A04,191942,Cooper; Andrew Michael,32,0,32,0
1681934289219,BICD 100,A05,191943,Cooper; Andrew Michael,32,0,32,0
1681934290245,BIEB 126,A01,191945,Cleland; Elsa Eleanor,0,5,32,32
1681934290245,BIEB 126,A02,191946,Cleland; Elsa Eleanor,26,0,32,6
1681934290245,BIEB 126,A03,191947,Cleland; Elsa Eleanor,29,0,32,3
1681934290245,BIEB 126,A04,191948,Cleland; Elsa Eleanor,15,0,32,17
1681934290245,BIEB 126,A05,191996,Cleland; Elsa Eleanor,28,0,32,4
1681934291276,BIEB 136GS,A00,191997,Shurin; Jonathan & Holway; David A.,0,0,0,9
1681934292302,BIEB 137GS,A01,191999,Shurin; Jonathan & Holway; David A.,0,0,0,8
1681934293325,BILD 1,A01,205385,Staff,30,0,32,2
1681934293325,BILD 1,A02,205386,Staff,30,0,32,2
1681934293325,BILD 1,A03,205387,Staff,31,0,32,1
1681934293325,BILD 1,A04,205388,Staff,25,0,32,7
1681934294353,BILD 2,A01,191774,Staff,26,0,32,6
1681934294353,BILD 2,A02,191775,Staff,30,0,32,2
1681934294353,BILD 2,A03,191777,Staff,29,0,32,3
1681934294353,BILD 2,A04,191856,Staff,30,0,32,2
1681934294353,BILD 2,A05,191857,Staff,31,0,32,1
1681934294353,BILD 2,A06,191858,Staff,32,0,32,0
1681934294353,BILD 2,A07,191859,Staff,31,0,32,1
1681934295380,BILD 3,A01,205391,Staff,27,0,32,5
1681934295380,BILD 3,A02,205393,Staff,32,0,32,0
1681934295380,BILD 3,A03,205394,Staff,26,0,32,6
1681934295380,BILD 3,A04,205395,Staff,32,0,32,0
1681934296407,BILD 20,A01,191861,Staff,32,0,32,0
1681934296407,BILD 20,A02,191862,Staff,32,0,32,0
1681934297444,BILD 30,A01,191864,Staff,31,0,32,1
1681934298475,BIMM 100,A01,192019,Staff,0,0,32,32
1681934298475,BIMM 100,A02,192020,Staff,11,0,32,21
1681934298475,BIMM 100,A03,192035,Staff,18,0,32,14
1681934299506,BIMM 110,A01,192037,Tat; John,0,0,32,32
1681934299506,BIMM 110,A02,192038,Tat; John,4,0,32,28
1681934300543,BIMM 120,A01,192040,Pickett; Brooke Elizabeth,0,0,32,32
1681934300543,BIMM 120,A02,192041,Pickett; Brooke Elizabeth,7,0,32,25
1681934300543,BIMM 120,A03,192042,Pickett; Brooke Elizabeth,14,0,32,18
1681934301567,BIPN 100,A01,192044,Armour; Jon Christopher,23,0,32,9
1681934301567,BIPN 100,A02,192059,Armour; Jon Christopher,30,0,32,2
1681934301567,BIPN 100,A03,192064,Armour; Jon Christopher,30,0,32,2
1681934301567,BIPN 100,A04,192073,Armour; Jon Christopher,26,0,32,6
1681934302590,BIPN 148,A01,205411,Leutgeb; Jill K.,14,0,32,18
1681934302590,BIPN 148,A02,205412,Leutgeb; Jill K.,31,0,32,1
1681934302590,BIPN 148,A03,205413,Leutgeb; Jill K.,29,0,32,3
1681934302590,BIPN 148,A04,205414,Leutgeb; Jill K.,30,0,32,2
1681934303617,BIPN 160,A01,192115,Marino; Marc J,15,0,32,17
1681934303617,BIPN 160,A02,192148,Marino; Marc J,27,0,32,5
1681934303617,BIPN 160,A03,192158,Marino; Marc J,31,0,32,1
1681934303617,BIPN 160,A04,192190,Marino; Marc J,32,0,32,0
1681934303617,BIPN 160,A05,192287,Marino; Marc J,32,0,32,0
1681934303617,BIPN 160,A06,192288,Marino; Marc J,32,0,32,0
1681934304641,BIPN 194,A00,206038,Leutgeb; Stefan,28,0,32,4
1681934305677,BISP 194,A00,192289,Nieh; James Charles,8,0,32,24
1681934305677,BISP 194,B00,245332,Staff,26,0,32,6
1681934306703,CAT 124,A01,202247,Staff,15,0,15,0
1681934307739,CAT 125,A00,202248,Staff,18,0,20,2
1681934307739,CAT 125,B00,202253,Staff,20,0,20,0
1681934307739,CAT 125,C00,202257,Staff,18,0,20,2
1681934308765,CAT 125GS,A01,202273,Bronstein; Phoebe Malan,20,0,20,0
1681934309787,CAT 125R,A00,202284,Staff,17,0,20,3
1681934309787,CAT 125R,C00,202286,Staff,3,0,20,17
1681934309787,CAT 125R,D00,202291,Staff,15,0,20,5
1681934309787,CAT 125R,E00,202295,Staff,13,0,20,7
1681934309787,CAT 125R,F00,202302,Staff,6,0,20,14
1681934310810,CENG 100,A00,204724,Opatkiewicz; Justin Paul,23,0,25,2
1681934311841,CGS 2A,A01,180420,Staff,29,0,36,7
1681934312868,CGS 101,A00,180421,Staff,14,0,20,6
1681934313890,CGS 112,A00,180422,Staff,8,0,16,8
1681934314913,CGS 113,A00,180423,Staff,18,0,20,2
1681934315938,CGS 137,A00,180424,Staff,12,0,12,0
1681934316963,CGS 147,A00,180425,Staff,10,0,10,0
1681934317993,CHEM 6A,A01,179556,Staff,92,0,100,8
1681934317993,CHEM 6A,A02,179558,Staff,0,0,0,0
1681934319017,CHEM 6B,A01,179560,Staff,100,0,100,0
1681934320044,CHEM 6C,A01,179565,Jazzar; Rodolphe,90,0,100,10
1681934321084,CHEM 7L,A01,179586,Schurmeier; Kimberly,9,0,24,15
1681934321084,CHEM 7L,A02,179587,Schurmeier; Kimberly,22,0,24,2
1681934321084,CHEM 7L,A03,179590,Schurmeier; Kimberly,22,0,24,2
1681934321084,CHEM 7L,A04,179591,Schurmeier; Kimberly,22,0,24,2
1681934321084,CHEM 7L,B01,179598,Schurmeier; Kimberly,14,0,24,10
1681934321084,CHEM 7L,B02,179599,Schurmeier; Kimberly,23,0,24,1
1681934321084,CHEM 7L,B03,179606,Schurmeier; Kimberly,22,0,24,2
1681934321084,CHEM 7L,B04,179607,Schurmeier; Kimberly,22,0,24,2
1681934322110,CHEM 11,A01,179609,Stallings; Dontarie M,85,0,100,15
1681934323132,CHEM 40A,A01,179621,Staff,37,0,50,13
1681934323132,CHEM 40A,A02,179622,Staff,44,0,50,6
1681934324166,CHEM 40B,A01,179630,Weizman; Haim,45,0,50,5
1681934324166,CHEM 40B,A02,179631,Weizman; Haim,43,0,50,7
1681934325192,CHEM 41A,A01,179660,Klosterman; Jeremy K,90,0,100,10
1681934326216,CHEM 43A,A01,179683,Klosterman; Jeremy K,0,0,24,24
1681934326216,CHEM 43A,A02,179688,Klosterman; Jeremy K,5,0,24,19
1681934326216,CHEM 43A,A03,179689,Klosterman; Jeremy K,16,0,24,8
1681934326216,CHEM 43A,A04,179691,Klosterman; Jeremy K,17,0,24,7
1681934327239,CHEM 114A,A01,179693,Stallings; Dontarie M,62,0,100,38
1681934328262,CHEM 143B,A01,179698,Weizman; Haim,16,0,24,8
1681934328262,CHEM 143B,A02,179700,Weizman; Haim,23,0,24,1
1681934329286,CHIN 169A,A00,179701,Wang; Xiao,20,0,20,0
1681934330313,COGS 2,A01,179750,Boyle; Mary E. T.,16,0,30,14
1681934331344,COGS 9,A01,179759,Jones; Cameron Robert,40,0,50,10
1681934332370,COGS 14A,A01,179854,Staff,6,0,50,44
1681934333397,COGS 14B,A01,179856,Staff,49,0,60,11
1681934334419,COGS 17,A01,179874,Staff,69,0,75,6
1681934335442,COGS 18,A01,179884,Staff,59,0,80,21
1681934336471,COGS 100,A01,179886,Staff,27,0,60,33
1681934337511,COGS 101B,A01,179892,Staff,0,4,30,30
1681934338533,COGS 101C,A01,179894,Staff,26,0,30,4
1681934339561,COGS 107A,A01,179896,Boyle; Mary E. T.,28,0,40,12
1681934340587,COGS 108,A01,179898,Simpkins; Charles Alexander,0,35,60,60
1681934341610,COGS 109,A01,179900,Staff,32,0,40,8
1681934342632,COGS 118A,A01,179946,Staff,3,0,40,37
1681934343655,COGS 153,A00,179978,Staff,0,7,30,30
1681934344677,COGS 156,A01,179981,Staff,19,0,30,11
1681934346723,COGS 172,A01,179987,Staff,8,0,30,22
1681934348782,COGS 186,A01,179991,Staff,11,0,30,19
1681934349809,COMM 10,A01,180001,Staff,11,0,25,14
1681934349809,COMM 10,A02,180004,Staff,20,0,25,5
1681934350913,COMM 100A,A01,180016,Staff,13,0,25,12
1681934350913,COMM 100A,A02,180020,Staff,24,0,25,1
1681934351938,COMM 101T,A00,180029,Halm; Gavin Patrick,15,0,35,20
1681934352968,COMM 106V,A00,180043,Staff,34,0,35,1
1681934353992,COMM 109P,A00,180044,Staff,29,0,35,6
1681934355015,COMM 113T,A00,180045,Havis; Allan,33,0,45,12
1681934356037,COMM 132,A00,180046,McKenna; Denise,16,0,30,14
1681934357068,COMM 143,A00,180047,Staff,15,0,30,15
1681934358090,COMM 190,A00,180048,Conner; Thomas Hartnell,15,0,23,8
1681934359122,CSE 8A,A50,180053,Cao; Yingjun,19,0,50,31
1681934359122,CSE 8A,B50,180180,Staff,50,0,50,0
1681934360143,CSE 11,A01,180190,Cao; Yingjun,18,0,50,32
1681934361175,CSE 20,A01,180192,Briones; Jor-el Thomas Caparas,20,0,30,10
1681934362197,CSE 21,A01,194538,Briones; Jor-el Thomas Caparas,49,0,60,11
1681934363225,CSE 30,A01,180324,Eldon; John,71,0,100,29
1681934364250,CSE 101,A01,201353,Staff,0,32,40,40
1681934365275,CSE 134B,A01,180326,Powell; Thomas Allan,68,0,100,32
1681934366298,CSE 140,A01,180328,Staff,20,0,75,55
1681934367321,CSE 140L,A01,180344,Eldon; John,45,0,100,55
1681934368343,CSE 150A,A01,180411,Staff,0,21,50,50
1681934369377,CSE 151A,A01,180414,Staff,0,16,50,50
1681934370402,CSE 175,A01,222521,Kumar; Rakesh,50,0,50,0
1681934371427,CSE 190,A00,201419,Staff,42,0,49,7
1681934372452,CSS 1,A01,194536,Staff,31,0,50,19
1681934373482,DSC 30,A01,202385,Staff,48,0,50,2
1681934374514,DSC 40A,A01,202387,Albuyeh; Rod,50,0,50,0
1681934375537,DSC 190,A01,202389,Silberman; Jack,21,0,21,0
1681934376562,DSGN 100,A01,179993,Staff,13,0,30,17
1681934377584,ECE 65,A50,180708,Staff,10,0,20,10
1681934377584,ECE 65,A51,180739,Staff,19,0,20,1
1681934378610,ECON 1,A01,180427,Famulari; Melissa,65,0,70,5
1681934379637,ECON 2,A01,180450,Levkoff; Steven B.,62,0,70,8
1681934380664,ECON 4,A01,203351,Anderson; John Charles,6,0,10,4
1681934381688,ECON 100A,A01,180472,Famulari; Melissa,59,0,70,11
1681934382710,ECON 120A,A01,180549,Staff,60,0,70,10
1681934383734,ECON 120B,A01,180655,Ma; Xinwei,33,0,70,37
1681934384757,ECON 129,A00,203333,Eckert; Fabian Paul,6,0,35,29
1681934385789,ECON 131,A00,180656,Staff,0,4,35,35
1681934386814,ECON 172B,A01,180672,Levkoff; Steven B.,30,0,35,5
1681934387839,ECON 178,A01,203342,Zhu; Ying,2,0,35,33
1681934388864,EDS 108GS,A00,202383,Wishard Guerra; Alison G.,20,0,20,0
1681934389885,EDS 111GS,A00,202347,Wishard Guerra; Alison G.,20,0,20,0
1681934390910,EDS 112,A01,202323,Staff,53,0,60,7
1681934391933,EDS 113,A00,202340,Staff,31,0,35,4
1681934392960,EDS 118,A00,201231,Staff,19,0,30,11
1681934393983,EDS 119,A00,204994,Staff,8,0,10,2
1681934395011,EDS 124BR,A00,202324,Eguchi; Emi,0,2,25,25
1681934396032,EDS 126,A01,203208,Jones; Makeba,26,0,30,4
1681934397057,EDS 135,A01,202333,Staff,17,0,20,3
1681934398082,EDS 180,A00,202311,Staff,47,0,50,3
1681934399104,ERC 190GS,A01,253747,Staff,28,0,28,0
1681934400173,ETHN 104,A00,180742,Staff,20,0,35,15
1681934401207,ETHN 118,A00,180745,Staff,26,0,35,9
1681934402242,ETHN 127,A00,180747,Staff,8,0,16,8
1681934403266,ETHN 137,A00,180880,Staff,11,0,12,1
1681934404288,ETHN 147,A00,180890,Staff,8,0,10,2
1681934405313,ETHN 154,A00,180891,Staff,4,0,8,4
1681934406339,ETHN 168,A00,180892,Staff,9,0,10,1
1681934407377,GLBH 20,A00,201051,Hannah; Seth Donal,0,7,0,1
1681934408402,GLBH 111,A01,209338,Burgos; Jose L.,0,0,0,0
1681934409424,GLBH 150,A00,258300,Staff,0,4,0,0
1681934410450,GLBH 181,A00,201207,Staff,4,0,40,36
1681934411482,HIEU 109,A00,180898,Staff,19,0,20,1
1681934412509,HIEU 111,A00,180899,Staff,0,2,20,20
1681934413538,HIEU 124,A00,180900,Staff,16,0,20,4
1681934414569,HILA 122,A00,180901,Staff,17,0,20,3
1681934415595,HILA 132,A00,180902,Vitz; Matthew,0,3,20,20
1681934416620,HILD 10,A01,180896,Staff,11,0,20,9
1681934417642,HILD 30GS,A00,180897,Edington; Claire Ellen,0,0,0,0
1681934418665,HISC 105,A00,180903,Staff,20,0,20,0
1681934419687,HISC 117,A00,180904,Staff,10,0,20,10
1681934420708,HIUS 108B,A00,181005,Staff,18,0,20,2
1681934421730,HIUS 113,A00,181093,Staff,0,0,20,20
1681934422757,HUM 3,A01,181190,Patterson; Patrick H.,33,0,50,17
1681934422757,HUM 3,B01,181195,Staff,44,0,50,6
1681934423781,HUM 3GS,A00,181196,Herbst; Matthew,0,0,0,0
1681934424818,HUM 4,A01,181227,West; Geoffrey Scott,33,0,50,17
1681934424818,HUM 4,B01,181282,Staff,41,0,50,9
1681934425839,HUM 4GS,A00,181377,Lyon; Antony J.,0,0,0,0
1681934426871,HUM 5,A01,181536,Zavodny; Tatiana Sophia,22,0,50,28
1681934426871,HUM 5,B01,181908,Staff,32,0,50,18
1681934427899,INTL 190,A00,181909,Segui; Alan S,0,0,0,8
1681934427899,INTL 190,B00,181961,Segui; Alan S,0,0,0,7
1681934428925,JAPN 20AR,A01,182113,Ross; Kayoko F,15,0,20,5
1681934429955,LATI 50,A01,202391,Martin-Cabrera; Luis,16,0,30,14
1681934429955,LATI 50,A02,202392,Martin-Cabrera; Luis,26,0,30,4
1681934430977,LATI 180,A00,202393,Kokinis; Troy Andreas,24,0,25,1
1681934432000,LIFR 1A,A00,182119,Staff,13,0,14,1
1681934433036,LIFR 1AX,A00,182324,Staff,13,0,14,1
1681934434060,LIFR 1B,A00,182259,Staff,11,0,14,3
1681934435085,LIFR 1BX,A00,182273,Staff,11,0,14,3
1681934436117,LIGN 8,A00,182330,Staff,124,0,150,26
1681934437141,LIGN 9GS,A00,182362,Staff,14,0,20,6
1681934438168,LIGN 119,A00,204992,Takahashi; Maho,11,0,15,4
1681934439200,LIGN 130,A01,182384,Staff,47,0,50,3
1681934440226,LIGN 149GS,A00,182390,Staff,14,0,20,6
1681934441272,LIGN 170,A00,182404,Staff,23,0,30,7
1681934442300,LISP 1D,A00,182281,Staff,6,0,14,8
1681934442300,LISP 1D,B00,182287,Staff,13,0,14,1
1681934442300,LISP 1D,C00,182295,Staff,10,0,14,4
1681934442300,LISP 1D,D00,182301,Staff,14,0,14,0
1681934443326,LISP 1DX,A00,182309,Staff,18,0,28,10
1681934443326,LISP 1DX,B00,182316,Staff,25,0,28,3
1681934444351,LTAF 120GS,A00,182412,Zhiri; Oumelbanine,20,0,20,0
1681934445375,LTCS 172GS,A00,182437,Bronstein; Phoebe Malan,20,0,20,0
1681934446401,LTEA 138,A00,182457,Staff,15,0,40,25
1681934447422,LTEN 114,A01,182490,Staff,23,0,25,2
1681934448454,LTEN 130GS,A00,182491,Lyon; Antony J.,20,0,20,0
1681934449476,LTEN 169,A00,182493,Cuong; Marisol,17,0,25,8
1681934450514,LTEN 178,A00,182501,Staff,14,0,15,1
1681934451547,LTEN 181,A00,182515,Staff,19,0,25,6
1681934452581,LTEN 185GS,A00,197655,Forbes; Camille,20,0,20,0
1681934453610,LTSP 100B,A00,202208,Bessett; Ryan Matthew,24,0,25,1
1681934454707,LTWL 100,A00,182516,Myerston Santana; Jacobo,19,0,30,11
1681934455730,LTWR 100GS,A00,182518,Forbes; Camille,20,0,20,0
1681934456756,LTWR 102,A00,182522,Staff,15,0,15,0
1681934456756,LTWR 102,B00,182525,Staff,14,0,15,1
1681934457781,LTWR 115,A00,182526,Staff,10,0,15,5
1681934458807,MAE 8,A01,182528,Pham; Hieu Tan,66,0,70,4
1681934459830,MAE 11,A00,182529,Bahadori; Mohammad Yousef,88,0,100,12
1681934460857,MAE 20,A00,182530,Evdokimenko; Ekaterina,67,0,70,3
1681934461888,MAE 30A,A00,182532,Staff,44,0,45,1
1681934462912,MAE 101A,A00,182533,Bahadori; Mohammad Yousef,93,0,100,7
1681934463941,MAE 101C,A00,182538,Staff,62,0,70,8
1681934464969,MAE 104,A00,182539,Staff,44,0,50,6
1681934465996,MAE 131A,A00,182540,Ghazinejad; Maziar,40,0,45,5
1681934467027,MAE 143A,A00,182548,Bewley; Thomas R,42,0,50,8
1681934468051,MAE 150,A00,182549,Staff,28,0,40,12
1681934469076,MAE 160,A00,182550,Evdokimenko; Ekaterina,38,0,60,22
1681934470102,MATH 3C,A01,182725,Staff,24,0,30,6
1681934471138,MATH 10A,A01,182729,Staff,24,0,30,6
1681934471138,MATH 10A,B01,182732,Staff,25,0,30,5
1681934472165,MATH 10B,A01,182737,Staff,15,0,30,15
1681934472165,MATH 10B,A02,182738,Staff,24,0,30,6
1681934472165,MATH 10B,B01,182744,Staff,24,0,30,6
1681934472165,MATH 10B,B02,182745,Staff,27,0,30,3
1681934473204,MATH 18,A01,182750,Anzaldo; Leesa B,28,0,30,2
1681934473204,MATH 18,A02,182751,Anzaldo; Leesa B,28,0,30,2
1681934473204,MATH 18,A03,182753,Anzaldo; Leesa B,27,0,30,3
1681934473204,MATH 18,A04,182757,Anzaldo; Leesa B,29,0,30,1
1681934473204,MATH 18,B01,182761,Anzaldo; Leesa B,26,0,30,4
1681934473204,MATH 18,B02,182764,Anzaldo; Leesa B,27,0,30,3
1681934473204,MATH 18,B03,182765,Anzaldo; Leesa B,29,0,30,1
1681934473204,MATH 18,B04,182766,Anzaldo; Leesa B,30,0,30,0
1681934474227,MATH 20A,A01,182771,Suk; Andrew Hoon,27,0,30,3
1681934475254,MATH 20B,A01,182775,Bach; Quang Tran,30,0,30,0
1681934475254,MATH 20B,A02,182777,Bach; Quang Tran,29,0,30,1
1681934475254,MATH 20B,B01,182780,Bach; Quang Tran,26,0,30,4
1681934475254,MATH 20B,B02,182782,Bach; Quang Tran,30,0,30,0
1681934476280,MATH 20C,A01,182787,Staff,24,0,30,6
1681934476280,MATH 20C,A02,182790,Staff,29,0,30,1
1681934476280,MATH 20C,B01,182792,Staff,23,0,30,7
1681934476280,MATH 20C,B02,182796,Staff,26,0,30,4
1681934477303,MATH 20D,A01,182799,Staff,27,0,30,3
1681934477303,MATH 20D,A02,182802,Staff,29,0,30,1
1681934477303,MATH 20D,A03,182803,Staff,30,0,30,0
1681934478333,MATH 20E,A01,182809,Verstraete; Jacques Allan,18,0,30,12
1681934478333,MATH 20E,A02,182811,Verstraete; Jacques Allan,27,0,30,3
1681934478333,MATH 20E,B01,182814,Verstraete; Jacques Allan,21,0,30,9
1681934478333,MATH 20E,B02,182815,Verstraete; Jacques Allan,27,0,30,3
1681934479358,MATH 103A,A01,182820,Staff,3,0,30,27
1681934479358,MATH 103A,A02,182821,Staff,26,0,30,4
1681934479358,MATH 103A,A03,182822,Staff,19,0,30,11
1681934479358,MATH 103A,B01,182825,Staff,21,0,30,9
1681934479358,MATH 103A,B02,182826,Staff,30,0,30,0
1681934479358,MATH 103A,B03,182830,Staff,30,0,30,0
1681934480382,MATH 109,A01,182836,Chow; Bennett,23,0,30,7
1681934480382,MATH 109,A02,182838,Chow; Bennett,28,0,30,2
1681934480382,MATH 109,A03,182894,Chow; Bennett,29,0,30,1
1681934480382,MATH 109,B01,182908,Chow; Bennett,26,0,30,4
1681934480382,MATH 109,B02,182909,Chow; Bennett,30,0,30,0
1681934480382,MATH 109,B03,182910,Chow; Bennett,26,0,30,4
1681934481409,MATH 142A,A01,182925,Staff,3,0,30,27
1681934481409,MATH 142A,A02,182935,Staff,23,0,30,7
1681934481409,MATH 142A,A03,182967,Staff,24,0,30,6
1681934481409,MATH 142A,B01,183125,Staff,22,0,30,8
1681934481409,MATH 142A,B02,183157,Staff,26,0,30,4
1681934481409,MATH 142A,B03,183158,Staff,29,0,30,1
1681934482433,MATH 183,A01,183160,Arias-Castro; Ery,22,0,30,8
1681934482433,MATH 183,A02,183161,Arias-Castro; Ery,28,0,30,2
1681934482433,MATH 183,B01,183163,Arias-Castro; Ery,26,0,30,4
1681934482433,MATH 183,B02,183164,Arias-Castro; Ery,28,0,30,2
1681934483462,MATH 193A,A01,183167,Staff,0,0,35,35
1681934483462,MATH 193A,A02,183168,Staff,22,0,35,13
1681934483462,MATH 193A,A03,183169,Staff,32,0,35,3
1681934483462,MATH 193A,A04,183170,Staff,26,0,35,9
1681934484488,MGT 4,A01,202395,Anderson; John Charles,76,0,80,4
1681934485513,MGT 5,A00,202396,Houskeeper; Robert,78,0,90,12
1681934486538,MGT 103,A00,202397,Eberhard; Craig A,46,0,90,44
1681934487560,MGT 131A,A00,202398,Houskeeper; Robert,81,0,90,9
1681934488583,MGT 135,A00,202399,Anderson; John Charles,81,0,90,9
1681934489613,MGT 162R,A00,202403,Gneezy; Uri,113,0,200,87
1681934490636,MGT 172,A00,202404,Hedges; Kathleen,21,0,90,69
1681934491681,MGT 181,A00,202405,Dunn; Louis Jean,76,0,90,14
1681934492714,MMW 14,A01,183200,Staff,0,0,28,28
1681934492714,MMW 14,A02,183201,Staff,25,0,28,3
1681934492714,MMW 14,A03,183202,Staff,24,0,28,4
1681934492714,MMW 14,A04,183203,Staff,25,0,28,3
1681934492714,MMW 14,A05,183204,Staff,26,0,28,2
1681934492714,MMW 14,A06,183205,Staff,27,0,28,1
1681934492714,MMW 14,B01,183207,Staff,26,0,28,2
1681934492714,MMW 14,B02,183208,Staff,28,0,28,0
1681934492714,MMW 14,B03,183209,Staff,28,0,28,0
1681934492714,MMW 14,B04,183210,Staff,28,0,28,0
1681934492714,MMW 14,B05,183211,Staff,28,0,28,0
1681934492714,MMW 14,B06,183212,Staff,27,0,28,1
1681934493744,MMW 14GS,A00,183213,Zhiri; Oumelbanine,28,0,28,0
1681934494769,MMW 15GS,B00,183215,Rahimi; Babak,28,0,28,0
1681934495792,MMW 121,A01,183217,Patterson; Patrick H.,6,0,28,22
1681934495792,MMW 121,A02,183218,Patterson; Patrick H.,25,0,28,3
1681934496818,MUS 1A,A01,182554,Staff,0,1,35,35
1681934497842,MUS 5,A01,182558,Staff,16,0,35,19
1681934498868,MUS 6,A01,182562,Staff,22,0,35,13
1681934499894,MUS 8GS,A00,182563,Borgo; David Garcia,25,0,25,0
1681934500917,MUS 13,A01,182567,Staff,23,0,25,2
1681934501942,MUS 15,A01,182570,Staff,31,0,35,4
1681934501942,MUS 15,B01,182575,Staff,6,0,35,29
1681934502968,MUS 80,A00,182578,Staff,22,0,25,3
1681934502968,MUS 80,B00,182581,Staff,20,0,25,5
1681934503997,MUS 113,A00,182582,Staff,25,0,25,0
1681934505021,MUS 114,A00,182583,Staff,0,1,25,25
1681934506049,MUS 150GS,A01,182588,Borgo; David Garcia,24,0,25,1
1681934507077,PHIL 1,A00,182590,Staff,34,0,40,6
1681934508099,PHIL 10,A01,182596,Grush; Rick Scott,30,0,35,5
1681934508099,PHIL 10,A02,182597,Grush; Rick Scott,33,0,35,2
1681934509122,PHIL 15,A01,182601,Staff,31,0,35,4
1681934509122,PHIL 15,A02,182602,Staff,33,0,35,2
1681934510147,PHIL 27,A01,182604,Staff,25,0,35,10
1681934510147,PHIL 27,A02,182607,Staff,33,0,35,2
1681934511174,PHIL 32,A01,182609,Staff,35,0,35,0
1681934511174,PHIL 32,A02,182612,Staff,35,0,35,0
1681934512206,PHIL 130,A00,182614,Staff,57,0,70,13
1681934513230,PHIL 136,A00,182616,Cohen; Jonathan David,64,0,70,6
1681934514255,PHIL 155,A00,182617,Vargas; Manuel Rogelio,57,0,70,13
1681934515281,PHIL 163,A01,182620,Staff,15,0,20,5
1681934515281,PHIL 163,A02,182624,Staff,10,0,20,10
1681934516304,PHIL 164,A00,182627,Staff,29,0,40,11
1681934517327,PHIL 173,A00,182628,Staff,35,0,40,5
1681934518352,PHYS 1A,A00,183221,Staff,52,0,60,8
1681934519381,PHYS 1AL,001,183222,Staff,24,0,30,6
1681934519381,PHYS 1AL,002,183223,Staff,24,0,30,6
1681934520404,PHYS 1B,A00,183231,Staff,40,0,60,20
1681934521431,PHYS 1BL,001,183232,Staff,15,0,30,15
1681934521431,PHYS 1BL,002,183233,Staff,27,0,30,3
1681934522454,PHYS 1C,A00,183240,Staff,20,0,60,40
1681934523478,PHYS 1CL,001,183241,Staff,8,0,30,22
1681934523478,PHYS 1CL,002,183242,Staff,21,0,30,9
1681934524513,PHYS 2AR,A01,183250,Staff,39,0,50,11
1681934525545,PHYS 2B,A01,183252,Staff,101,0,115,14
1681934526574,PHYS 2BL,A01,183254,Staff,21,0,24,3
1681934526574,PHYS 2BL,A02,183255,Staff,21,0,24,3
1681934527598,PHYS 2C,A01,183522,Staff,100,0,115,15
1681934528621,PHYS 4A,A01,183524,Staff,49,0,50,1
1681934529647,POLI 5,A00,183525,Staff,43,0,50,7
1681934530673,POLI 12,A00,183540,Staff,45,0,50,5
1681934531707,POLI 13R,A00,183541,Forman; Fonna,39,0,50,11
1681934532733,POLI 30,A00,183542,Mignozzetti; Umberto,48,0,50,2
1681934533755,POLI 100A,A00,183543,Staff,43,0,50,7
1681934534778,POLI 100E,A00,223598,Staff,32,0,35,3
1681934535813,POLI 103A,A00,183564,Kousser; Thad,34,0,50,16
1681934536843,POLI 104B,A00,201329,Staff,27,0,35,8
1681934537873,POLI 113BR,A00,183576,Hoston; Germaine,22,0,50,28
1681934538896,POLI 114BR,A00,183588,Staff,26,0,30,4
1681934539918,POLI 117R,A00,183595,Forman; Fonna,3,0,20,17
1681934540941,POLI 120H,A00,183596,Fisk; David Lee,13,0,20,7
1681934541968,POLI 130AA,A00,183597,Staff,13,0,20,7
1681934542994,POLI 134AA,A00,183598,Staff,19,0,20,1
1681934544019,POLI 135,A00,183599,Fisk; David Lee,19,0,25,6
1681934545042,POLI 142P,A00,183623,Staff,37,0,40,3
1681934546078,POLI 144D,A00,183624,Staff,22,0,25,3
1681934547106,POLI 151,A00,183625,Staff,14,0,20,6
1681934548130,POLI 162,A00,183626,Mignozzetti; Umberto,17,0,20,3
1681934549153,PSYC 1,A00,253748,Staff,85,0,90,5
1681934550181,PSYC 2,A00,183627,Moranton; Nirelia Melbina-,21,0,35,14
1681934551207,PSYC 3,A00,183628,Staff,42,0,45,3
1681934553270,PSYC 60,A01,183631,Lowe; Angela Beth,34,0,40,6
1681934554296,PSYC 70,A01,253757,Staff,34,0,45,11
1681934555323,PSYC 101,A00,183632,Heyman; Gail D.,39,0,60,21
1681934556346,PSYC 105,A00,183848,Lowe; Angela Beth,43,0,60,17
1681934557374,PSYC 106,A00,183849,Dobkins; Karen R.,36,0,60,24
1681934558470,PSYC 108,A00,253750,Staff,7,0,60,53
1681934559501,PSYC 114,A01,184275,Winkielman; Piotr,0,8,30,30
1681934560523,PSYC 122,A00,183856,Moranton; Nirelia Melbina-,0,16,30,30
1681934561552,PSYC 124,A00,183865,Chapman; Eddie Nathaniel,41,0,80,39
1681934562574,PSYC 137,A00,183880,Staff,16,0,25,9
1681934564623,PSYC 154,A00,183910,Lacefield; Katharine I,0,33,90,90
1681934566668,PSYC 162,A00,183946,Wixted; John T,36,0,90,54
1681934567696,PSYC 172,A00,183947,Gorman; Michael R.,4,0,30,26
1681934568721,PSYC 178,A00,183963,Glaser; Dale,12,0,40,28
1681934569747,PSYC 181GS,A00,183964,Anagnostaras; Stephan,10,0,10,0
1681934570768,PSYC 186GS,A01,257660,Staff,10,0,10,0
1681934571794,PSYC 193,B00,253749,Staff,22,0,25,3
1681934573843,PSYC 193L,A01,184122,Staff,33,0,35,2
1681934573843,PSYC 193L,C01,184167,Winkielman; Piotr,14,0,30,16
1681934574873,RELI 188GS,A00,182629,Rahimi; Babak,20,0,20,0
1681934575898,SE 101A,A00,182646,Staff,25,0,30,5
1681934576925,SE 101C,A00,182650,Staff,9,0,20,11
1681934577948,SE 110A,A00,182651,Staff,28,0,28,0
1681934578978,SE 130A,A00,182652,Staff,37,0,40,3
1681934580004,SIO 46GS,A00,182636,Cook; Geoffrey W,24,0,28,4
1681934581028,SIO 109R,A00,194459,Staff,0,2,20,20
1681934582053,SIO 121GS,A00,182639,Cook; Geoffrey W,24,0,28,4
1681934583077,SIO 132,A01,182642,Staff,30,0,40,10
1681934584104,SIO 139,A00,182644,Kacev; David,36,0,40,4
1681934585131,SOCI 2,A01,258404,Staff,33,0,36,3
1681934585131,SOCI 2,A02,258405,Staff,35,0,36,1
1681934586155,SOCI 60,A01,258408,Staff,29,0,30,1
1681934586155,SOCI 60,A02,258413,Staff,30,0,30,0
1681934587179,SOCI 100,A01,258415,Staff,28,0,30,2
1681934587179,SOCI 100,A02,258416,Staff,28,0,30,2
1681934593363,SOCI 127,A00,258421,Staff,18,0,30,12
1681934594386,SOCI 132,A00,258422,Staff,42,0,50,8
1681934595411,SOCI 133,A00,258423,Staff,26,0,30,4
1681934596443,SOCI 138GS,A00,258424,Staff,15,0,15,0
1681934597468,SOCI 145,A00,258425,Staff,23,0,30,7
1681934598490,SOCI 148,A00,258426,Staff,23,0,30,7
1681934599517,SOCI 153,A00,199217,Staff,29,0,30,1
1681934600540,SOCI 160,A00,258427,Staff,27,0,30,3
1681934601565,SOCI 160E,A00,258435,Staff,55,0,60,5
1681934602587,SOCI 189GS,A00,258436,Staff,15,0,15,0
1681934603612,SOCI 190GS,A00,258437,Staff,15,0,15,0
1681934604639,SYN 2,001,182658,Staff,8,0,16,8
1681934604639,SYN 2,002,201439,Staff,13,0,16,3
1681934604639,SYN 2,003,201443,Staff,15,0,16,1
1681934605661,SYN 100,A01,182657,Staff,10,0,20,10
1681934606685,TDAC 1,A00,184381,Salovey; Todd,16,0,20,4
1681934606685,TDAC 1,B00,184385,Harting; Carla Kelso,19,0,20,1
1681934606685,TDAC 1,C00,184394,Staff,18,0,20,2
1681934607711,TDAC 101,A00,184483,Harting; Carla Kelso,19,0,20,1
1681934608736,TDDE 111,A00,184496,Staff,14,0,15,1
1681934609758,TDDE 131,A00,184504,Staff,20,0,20,0
1681934609758,TDDE 131,B00,184505,Staff,17,0,18,1
1681934609758,TDDE 131,C00,184534,Staff,49,0,50,1
1681934609758,TDDE 131,D00,184564,Staff,15,0,15,0
1681934609758,TDDE 131,E00,204725,Staff,18,0,20,2
1681934610789,TDGE 1,A01,184414,Salovey; Todd,33,0,50,17
1681934611815,TDGE 5,A01,184419,Staff,23,0,24,1
1681934612838,TDGE 10,A00,184428,Fulton; Julia,27,0,50,23
1681934613860,TDGE 124,A00,184565,Fulton; Julia,0,4,50,50
1681934614882,TDGE 125,B00,184567,Meyer; Ursula,7,0,25,18
1681934615905,TDHT 101,A00,184568,Staff,21,0,25,4
1681934615905,TDHT 101,B00,184569,Staff,20,0,20,0
1681934616936,TDHT 114,A00,184570,Staff,47,0,50,3
1681934617959,TDMV 1,A00,184437,Arcidiacono; Kristin,21,0,30,9
1681934617959,TDMV 1,B00,184448,Caligagan; Maria T.,23,0,30,7
1681934618995,TDMV 2,A00,184449,Weinberg; Sadie,26,0,30,4
1681934618995,TDMV 2,B00,184453,Arcidiacono; Kristin,29,0,30,1
1681934620030,TDMV 110,A00,184571,Weinberg; Sadie,30,0,30,0
1681934621053,TDMV 142,A00,184572,Caligagan; Tony,26,0,30,4
1681934621053,TDMV 142,B00,184573,Caligagan; Maria T.,26,0,30,4
1681934622078,TDTR 20,A00,184482,Jun; Grace Shin Hae,25,0,25,0
1681934623104,USP 2,A01,184290,Hinds; Juli Beth,23,0,25,2
1681934624137,USP 3,A01,184295,Staff,20,0,25,5
1681934625173,USP 4,A00,184304,McTague; Sarah,13,0,25,12
1681934626208,USP 100,A00,184315,Staff,16,0,25,9
1681934627231,USP 105,A00,184326,Staff,21,0,25,4
1681934628271,USP 151,A00,184327,Staff,17,0,25,8
1681934629299,USP 170,A00,184380,Hinds; Juli Beth,12,0,25,13
1681934630322,VIS 21B,A01,182660,Staff,28,0,31,3
1681934630322,VIS 21B,A02,182662,Staff,30,0,31,1
1681934631345,VIS 103D,A00,182663,Staff,73,0,75,2
1681934632367,VIS 105D,A00,182667,Li; Huai,14,0,22,8
1681934633392,VIS 122GS,A00,182668,Herbst; Matthew,20,0,20,0
1681934634417,VIS 128C,A00,182673,Staff,68,0,75,7
1681934635441,VIS 130,A00,182675,Staff,19,0,22,3
1681934636466,VIS 160A,A00,182678,Stalbaum; Brett,4,0,10,6
1681934638513,WCWP 10B,A00,201679,Staff,15,0,15,0
1681934638513,WCWP 10B,B00,201695,Staff,15,0,15,0
1681934639538,WCWP 100,A00,201716,Staff,12,0,15,3
1681934639538,WCWP 100,B00,201717,Staff,0,0,15,15
1681934641608,ANSC 105GS,A00,258289,Staff,0,0,0,0
1681934642633,ANSC 125GS,A00,258295,Staff,0,0,0,0
1681934643655,ANSC 150,A00,258267,Staff,27,0,40,13
1681934644679,ANSC 190GS,A00,258280,Staff,0,0,0,2
1681934645703,ANTH 1,A00,258264,Staff,38,0,40,2
1681934646729,ANTH 2,A01,258259,Staff,72,0,76,4
1681934647761,ANTH 23,A01,258228,Staff,35,0,40,5
1681934648785,ANTH 101,A01,258236,Staff,38,0,40,2
1681934649811,ANTH 102,A00,258272,Staff,59,0,60,1
1681934650834,ANTH 105,A00,258244,Staff,28,0,35,7
1681934651859,BENG 130,A00,253975,Staff,37,0,40,3
1681934652887,BIBC 102,A01,191866,Flagg; Matthew Paul,16,0,32,16
1681934652887,BIBC 102,A02,191867,Flagg; Matthew Paul,20,0,32,12
1681934652887,BIBC 102,A03,191868,Flagg; Matthew Paul,27,0,32,5
1681934652887,BIBC 102,A04,191936,Flagg; Matthew Paul,19,0,32,13
1681934652887,BIBC 102,A05,191937,Flagg; Matthew Paul,0,1,32,32
1681934653911,BICD 100,A01,191939,Cooper; Andrew Michael,27,0,32,5
1681934653911,BICD 100,A02,191940,Cooper; Andrew Michael,32,0,32,0
1681934653911,BICD 100,A03,191941,Cooper; Andrew Michael,32,0,32,0
1681934653911,BICD 100,A04,191942,Cooper; Andrew Michael,32,0,32,0
1681934653911,BICD 100,A05,191943,Cooper; Andrew Michael,32,0,32,0
1681934654933,BIEB 126,A01,191945,Cleland; Elsa Eleanor,0,5,32,32
1681934654933,BIEB 126,A02,191946,Cleland; Elsa Eleanor,26,0,32,6
1681934654933,BIEB 126,A03,191947,Cleland; Elsa Eleanor,29,0,32,3
1681934654933,BIEB 126,A04,191948,Cleland; Elsa Eleanor,15,0,32,17
1681934654933,BIEB 126,A05,191996,Cleland; Elsa Eleanor,28,0,32,4
1681934655956,BIEB 136GS,A00,191997,Shurin; Jonathan & Holway; David A.,0,0,0,9
1681934656978,BIEB 137GS,A01,191999,Shurin; Jonathan & Holway; David A.,0,0,0,8
1681934658007,BILD 1,A01,205385,Staff,30,0,32,2
1681934658007,BILD 1,A02,205386,Staff,30,0,32,2
1681934658007,BILD 1,A03,205387,Staff,31,0,32,1
1681934658007,BILD 1,A04,205388,Staff,25,0,32,7
1681934659040,BILD 2,A01,191774,Staff,25,0,32,7
1681934659040,BILD 2,A02,191775,Staff,29,0,32,3
1681934659040,BILD 2,A03,191777,Staff,29,0,32,3
1681934659040,BILD 2,A04,191856,Staff,30,0,32,2
1681934659040,BILD 2,A05,191857,Staff,31,0,32,1
1681934659040,BILD 2,A06,191858,Staff,32,0,32,0
1681934659040,BILD 2,A07,191859,Staff,31,0,32,1
1681934660063,BILD 3,A01,205391,Staff,26,0,32,6
1681934660063,BILD 3,A02,205393,Staff,32,0,32,0
1681934660063,BILD 3,A03,205394,Staff,26,0,32,6
1681934660063,BILD 3,A04,205395,Staff,32,0,32,0
1681934661086,BILD 20,A01,191861,Staff,32,0,32,0
1681934661086,BILD 20,A02,191862,Staff,32,0,32,0
1681934662186,BILD 30,A01,191864,Staff,31,0,32,1
1681934663212,BIMM 100,A01,192019,Staff,0,0,32,32
1681934663212,BIMM 100,A02,192020,Staff,11,0,32,21
1681934663212,BIMM 100,A03,192035,Staff,18,0,32,14
1681934664247,BIMM 110,A01,192037,Tat; John,0,0,32,32
1681934664247,BIMM 110,A02,192038,Tat; John,4,0,32,28
1681934665278,BIMM 120,A01,192040,Pickett; Brooke Elizabeth,0,0,32,32
1681934665278,BIMM 120,A02,192041,Pickett; Brooke Elizabeth,7,0,32,25
1681934665278,BIMM 120,A03,192042,Pickett; Brooke Elizabeth,14,0,32,18
1681934666309,BIPN 100,A01,192044,Armour; Jon Christopher,23,0,32,9
1681934666309,BIPN 100,A02,192059,Armour; Jon Christopher,30,0,32,2
1681934666309,BIPN 100,A03,192064,Armour; Jon Christopher,30,0,32,2
1681934666309,BIPN 100,A04,192073,Armour; Jon Christopher,26,0,32,6
1681934667335,BIPN 148,A01,205411,Leutgeb; Jill K.,14,0,32,18
1681934667335,BIPN 148,A02,205412,Leutgeb; Jill K.,31,0,32,1
1681934667335,BIPN 148,A03,205413,Leutgeb; Jill K.,29,0,32,3
1681934667335,BIPN 148,A04,205414,Leutgeb; Jill K.,30,0,32,2
1681934668361,BIPN 160,A01,192115,Marino; Marc J,15,0,32,17
1681934668361,BIPN 160,A02,192148,Marino; Marc J,27,0,32,5
1681934668361,BIPN 160,A03,192158,Marino; Marc J,31,0,32,1
1681934668361,BIPN 160,A04,192190,Marino; Marc J,32,0,32,0
1681934668361,BIPN 160,A05,192287,Marino; Marc J,32,0,32,0
1681934668361,BIPN 160,A06,192288,Marino; Marc J,32,0,32,0
1681934669389,BIPN 194,A00,206038,Leutgeb; Stefan,28,0,32,4
1681934670415,BISP 194,A00,192289,Nieh; James Charles,8,0,32,24
1681934670415,BISP 194,B00,245332,Staff,26,0,32,6
1681934671439,CAT 124,A01,202247,Staff,15,0,15,0
1681934672465,CAT 125,A00,202248,Staff,18,0,20,2
1681934672465,CAT 125,B00,202253,Staff,20,0,20,0
1681934672465,CAT 125,C00,202257,Staff,18,0,20,2
1681934673488,CAT 125GS,A01,202273,Bronstein; Phoebe Malan,20,0,20,0
1681934674520,CAT 125R,A00,202284,Staff,17,0,20,3
1681934674520,CAT 125R,C00,202286,Staff,3,0,20,17
1681934674520,CAT 125R,D00,202291,Staff,15,0,20,5
1681934674520,CAT 125R,E00,202295,Staff,13,0,20,7
1681934674520,CAT 125R,F00,202302,Staff,5,0,20,15
1681934675543,CENG 100,A00,204724,Opatkiewicz; Justin Paul,23,0,25,2
1681934676569,CGS 2A,A01,180420,Staff,29,0,36,7
1681934677592,CGS 101,A00,180421,Staff,14,0,20,6
1681934678617,CGS 112,A00,180422,Staff,8,0,16,8
1681934679649,CGS 113,A00,180423,Staff,18,0,20,2
1681934680675,CGS 137,A00,180424,Staff,12,0,12,0
1681934681701,CGS 147,A00,180425,Staff,10,0,10,0
1681934682727,CHEM 6A,A01,179556,Staff,92,0,100,8
1681934682727,CHEM 6A,A02,179558,Staff,0,0,0,0
1681934683751,CHEM 6B,A01,179560,Staff,100,0,100,0
1681934684774,CHEM 6C,A01,179565,Jazzar; Rodolphe,90,0,100,10
1681934685812,CHEM 7L,A01,179586,Schurmeier; Kimberly,9,0,24,15
1681934685812,CHEM 7L,A02,179587,Schurmeier; Kimberly,22,0,24,2
1681934685812,CHEM 7L,A03,179590,Schurmeier; Kimberly,22,0,24,2
1681934685812,CHEM 7L,A04,179591,Schurmeier; Kimberly,22,0,24,2
1681934685812,CHEM 7L,B01,179598,Schurmeier; Kimberly,13,0,24,11
1681934685812,CHEM 7L,B02,179599,Schurmeier; Kimberly,23,0,24,1
1681934685812,CHEM 7L,B03,179606,Schurmeier; Kimberly,22,0,24,2
1681934685812,CHEM 7L,B04,179607,Schurmeier; Kimberly,22,0,24,2
1681934686835,CHEM 11,A01,179609,Stallings; Dontarie M,85,0,100,15
1681934687859,CHEM 40A,A01,179621,Staff,37,0,50,13
1681934687859,CHEM 40A,A02,179622,Staff,44,0,50,6
1681934688882,CHEM 40B,A01,179630,Weizman; Haim,45,0,50,5
1681934688882,CHEM 40B,A02,179631,Weizman; Haim,42,0,50,8
1681934689906,CHEM 41A,A01,179660,Klosterman; Jeremy K,90,0,100,10
1681934690930,CHEM 43A,A01,179683,Klosterman; Jeremy K,0,0,24,24
1681934690930,CHEM 43A,A02,179688,Klosterman; Jeremy K,5,0,24,19
1681934690930,CHEM 43A,A03,179689,Klosterman; Jeremy K,16,0,24,8
1681934690930,CHEM 43A,A04,179691,Klosterman; Jeremy K,17,0,24,7
1681934691956,CHEM 114A,A01,179693,Stallings; Dontarie M,61,0,100,39
1681934692986,CHEM 143B,A01,179698,Weizman; Haim,16,0,24,8
1681934692986,CHEM 143B,A02,179700,Weizman; Haim,23,0,24,1
1681934694012,CHIN 169A,A00,179701,Wang; Xiao,20,0,20,0
1681934695040,COGS 2,A01,179750,Boyle; Mary E. T.,16,0,30,14
1681934696064,COGS 9,A01,179759,Jones; Cameron Robert,40,0,50,10
1681934697088,COGS 14A,A01,179854,Staff,6,0,50,44
1681934698120,COGS 14B,A01,179856,Staff,49,0,60,11
1681934699144,COGS 17,A01,179874,Staff,69,0,75,6
1681934700173,COGS 18,A01,179884,Staff,57,0,80,23
1681934701203,COGS 100,A01,179886,Staff,26,0,60,34
1681934702244,COGS 101B,A01,179892,Staff,0,4,30,30
1681934703267,COGS 101C,A01,179894,Staff,26,0,30,4
1681934704309,COGS 107A,A01,179896,Boyle; Mary E. T.,28,0,40,12
1681934705333,COGS 108,A01,179898,Simpkins; Charles Alexander,0,35,60,60
1681934706355,COGS 109,A01,179900,Staff,32,0,40,8
1681934707383,COGS 118A,A01,179946,Staff,3,0,40,37
1681934708407,COGS 153,A00,179978,Staff,0,7,30,30
1681934709431,COGS 156,A01,179981,Staff,19,0,30,11
1681934711481,COGS 172,A01,179987,Staff,8,0,30,22
1681934713541,COGS 186,A01,179991,Staff,10,0,30,20
1681934714563,COMM 10,A01,180001,Staff,11,0,25,14
1681934714563,COMM 10,A02,180004,Staff,20,0,25,5
1681934715595,COMM 100A,A01,180016,Staff,13,0,25,12
1681934715595,COMM 100A,A02,180020,Staff,24,0,25,1
1681934716617,COMM 101T,A00,180029,Halm; Gavin Patrick,14,0,35,21
1681934717643,COMM 106V,A00,180043,Staff,34,0,35,1
1681934718669,COMM 109P,A00,180044,Staff,29,0,35,6
1681934719708,COMM 113T,A00,180045,Havis; Allan,33,0,45,12
1681934720731,COMM 132,A00,180046,McKenna; Denise,16,0,30,14
1681934721754,COMM 143,A00,180047,Staff,14,0,30,16
1681934722776,COMM 190,A00,180048,Conner; Thomas Hartnell,14,0,23,9
1681934723802,CSE 8A,A50,180053,Cao; Yingjun,19,0,50,31
1681934723802,CSE 8A,B50,180180,Staff,50,0,50,0
1681934724825,CSE 11,A01,180190,Cao; Yingjun,17,0,50,33
1681934725849,CSE 20,A01,180192,Briones; Jor-el Thomas Caparas,20,0,30,10
1681934726881,CSE 21,A01,194538,Briones; Jor-el Thomas Caparas,49,0,60,11
1681934727908,CSE 30,A01,180324,Eldon; John,70,0,100,30
1681934728933,CSE 101,A01,201353,Staff,0,33,40,40
1681934729957,CSE 134B,A01,180326,Powell; Thomas Allan,68,0,100,32
1681934730982,CSE 140,A01,180328,Staff,18,0,75,57
1681934732005,CSE 140L,A01,180344,Eldon; John,44,0,100,56
1681934733028,CSE 150A,A01,180411,Staff,0,20,50,50
1681934734050,CSE 151A,A01,180414,Staff,0,15,50,50
1681934735072,CSE 175,A01,222521,Kumar; Rakesh,50,0,50,0
1681934736094,CSE 190,A00,201419,Staff,42,0,49,7
1681934737125,CSS 1,A01,194536,Staff,31,0,50,19
1681934738148,DSC 30,A01,202385,Staff,48,0,50,2
1681934739171,DSC 40A,A01,202387,Albuyeh; Rod,50,0,50,0
1681934740203,DSC 190,A01,202389,Silberman; Jack,21,0,21,0
1681934741235,DSGN 100,A01,179993,Staff,12,0,30,18
1681934742259,ECE 65,A50,180708,Staff,10,0,20,10
1681934742259,ECE 65,A51,180739,Staff,19,0,20,1
1681934743286,ECON 1,A01,180427,Famulari; Melissa,65,0,70,5
1681934744308,ECON 2,A01,180450,Levkoff; Steven B.,62,0,70,8
1681934745330,ECON 4,A01,203351,Anderson; John Charles,6,0,10,4
1681934746359,ECON 100A,A01,180472,Famulari; Melissa,59,0,70,11
1681934747382,ECON 120A,A01,180549,Staff,60,0,70,10
1681934748405,ECON 120B,A01,180655,Ma; Xinwei,33,0,70,37
1681934749444,ECON 129,A00,203333,Eckert; Fabian Paul,6,0,35,29
1681934750468,ECON 131,A00,180656,Staff,0,4,35,35
1681934751494,ECON 172B,A01,180672,Levkoff; Steven B.,30,0,35,5
1681934752517,ECON 178,A01,203342,Zhu; Ying,2,0,35,33
1681934753542,EDS 108GS,A00,202383,Wishard Guerra; Alison G.,20,0,20,0
1681934754564,EDS 111GS,A00,202347,Wishard Guerra; Alison G.,20,0,20,0
1681934755592,EDS 112,A01,202323,Staff,53,0,60,7
1681934756614,EDS 113,A00,202340,Staff,31,0,35,4
1681934757636,EDS 118,A00,201231,Staff,19,0,30,11
1681934758659,EDS 119,A00,204994,Staff,8,0,10,2
1681934759692,EDS 124BR,A00,202324,Eguchi; Emi,0,2,25,25
1681934760717,EDS 126,A01,203208,Jones; Makeba,26,0,30,4
1681934761739,EDS 135,A01,202333,Staff,17,0,20,3
1681934762761,EDS 180,A00,202311,Staff,47,0,50,3
1681934763793,ERC 190GS,A01,253747,Staff,28,0,28,0
1681934764820,ETHN 104,A00,180742,Staff,20,0,35,15
1681934765934,ETHN 118,A00,180745,Staff,26,0,35,9
1681934766957,ETHN 127,A00,180747,Staff,8,0,16,8
1681934767978,ETHN 137,A00,180880,Staff,11,0,12,1
1681934769001,ETHN 147,A00,180890,Staff,8,0,10,2
1681934770031,ETHN 154,A00,180891,Staff,4,0,8,4
1681934771055,ETHN 168,A00,180892,Staff,9,0,10,1
1681934772079,GLBH 20,A00,201051,Hannah; Seth Donal,0,7,0,1
1681934773107,GLBH 111,A01,209338,Burgos; Jose L.,0,0,0,0
1681934774138,GLBH 150,A00,258300,Staff,0,4,0,0
1681934775159,GLBH 181,A00,201207,Staff,3,0,40,37
1681934776183,HIEU 109,A00,180898,Staff,19,0,20,1
1681934777206,HIEU 111,A00,180899,Staff,0,2,20,20
1681934778232,HIEU 124,A00,180900,Staff,16,0,20,4
1681934779256,HILA 122,A00,180901,Staff,17,0,20,3
1681934780278,HILA 132,A00,180902,Vitz; Matthew,0,3,20,20
1681934781310,HILD 10,A01,180896,Staff,11,0,20,9
1681934782335,HILD 30GS,A00,180897,Edington; Claire Ellen,0,0,0,0
1681934783365,HISC 105,A00,180903,Staff,20,0,20,0
1681934784388,HISC 117,A00,180904,Staff,10,0,20,10
1681934785417,HIUS 108B,A00,181005,Staff,18,0,20,2
1681934786444,HIUS 113,A00,181093,Staff,0,0,20,20
1681934787472,HUM 3,A01,181190,Patterson; Patrick H.,33,0,50,17
1681934787472,HUM 3,B01,181195,Staff,43,0,50,7
1681934788497,HUM 3GS,A00,181196,Herbst; Matthew,0,0,0,0
1681934789518,HUM 4,A01,181227,West; Geoffrey Scott,33,0,50,17
1681934789518,HUM 4,B01,181282,Staff,41,0,50,9
1681934790549,HUM 4GS,A00,181377,Lyon; Antony J.,0,0,0,0
1681934791582,HUM 5,A01,181536,Zavodny; Tatiana Sophia,22,0,50,28
1681934791582,HUM 5,B01,181908,Staff,32,0,50,18
1681934792606,INTL 190,A00,181909,Segui; Alan S,0,0,0,8
1681934792606,INTL 190,B00,181961,Segui; Alan S,0,0,0,7
1681934793632,JAPN 20AR,A01,182113,Ross; Kayoko F,15,0,20,5
1681934794659,LATI 50,A01,202391,Martin-Cabrera; Luis,16,0,30,14
1681934794659,LATI 50,A02,202392,Martin-Cabrera; Luis,26,0,30,4
1681934795681,LATI 180,A00,202393,Kokinis; Troy Andreas,24,0,25,1
1681934796705,LIFR 1A,A00,182119,Staff,13,0,14,1
1681934797729,LIFR 1AX,A00,182324,Staff,13,0,14,1
1681934798753,LIFR 1B,A00,182259,Staff,11,0,14,3
1681934799779,LIFR 1BX,A00,182273,Staff,11,0,14,3
1681934800814,LIGN 8,A00,182330,Staff,124,0,150,26
1681934801850,LIGN 9GS,A00,182362,Staff,14,0,20,6
1681934802874,LIGN 119,A00,204992,Takahashi; Maho,11,0,15,4
1681934803898,LIGN 130,A01,182384,Staff,47,0,50,3
1681934804928,LIGN 149GS,A00,182390,Staff,14,0,20,6
1681934805962,LIGN 170,A00,182404,Staff,23,0,30,7
1681934806985,LISP 1D,A00,182281,Staff,6,0,14,8
1681934806985,LISP 1D,B00,182287,Staff,13,0,14,1
1681934806985,LISP 1D,C00,182295,Staff,10,0,14,4
1681934806985,LISP 1D,D00,182301,Staff,14,0,14,0
1681934808010,LISP 1DX,A00,182309,Staff,18,0,28,10
1681934808010,LISP 1DX,B00,182316,Staff,25,0,28,3
1681934809032,LTAF 120GS,A00,182412,Zhiri; Oumelbanine,20,0,20,0
1681934810058,LTCS 172GS,A00,182437,Bronstein; Phoebe Malan,20,0,20,0
1681934811082,LTEA 138,A00,182457,Staff,15,0,40,25
1681934812104,LTEN 114,A01,182490,Staff,23,0,25,2
1681934813126,LTEN 130GS,A00,182491,Lyon; Antony J.,20,0,20,0
1681934814155,LTEN 169,A00,182493,Cuong; Marisol,17,0,25,8
1681934815178,LTEN 178,A00,182501,Staff,14,0,15,1
1681934816205,LTEN 181,A00,182515,Staff,19,0,25,6
1681934817228,LTEN 185GS,A00,197655,Forbes; Camille,20,0,20,0
1681934818251,LTSP 100B,A00,202208,Bessett; Ryan Matthew,24,0,25,1
1681934819274,LTWL 100,A00,182516,Myerston Santana; Jacobo,19,0,30,11
1681934820296,LTWR 100GS,A00,182518,Forbes; Camille,20,0,20,0
1681934821325,LTWR 102,A00,182522,Staff,15,0,15,0
1681934821325,LTWR 102,B00,182525,Staff,14,0,15,1
1681934822348,LTWR 115,A00,182526,Staff,10,0,15,5
1681934823370,MAE 8,A01,182528,Pham; Hieu Tan,66,0,70,4
1681934824393,MAE 11,A00,182529,Bahadori; Mohammad Yousef,88,0,100,12
1681934825417,MAE 20,A00,182530,Evdokimenko; Ekaterina,67,0,70,3
1681934826440,MAE 30A,A00,182532,Staff,44,0,45,1
1681934827462,MAE 101A,A00,182533,Bahadori; Mohammad Yousef,93,0,100,7
1681934828484,MAE 101C,A00,182538,Staff,62,0,70,8
1681934829511,MAE 104,A00,182539,Staff,44,0,50,6
1681934830535,MAE 131A,A00,182540,Ghazinejad; Maziar,40,0,45,5
1681934831563,MAE 143A,A00,182548,Bewley; Thomas R,42,0,50,8
1681934832589,MAE 150,A00,182549,Staff,28,0,40,12
1681934833614,MAE 160,A00,182550,Evdokimenko; Ekaterina,38,0,60,22
1681934834638,MATH 3C,A01,182725,Staff,24,0,30,6
1681934835667,MATH 10A,A01,182729,Staff,24,0,30,6
1681934835667,MATH 10A,B01,182732,Staff,25,0,30,5
1681934836693,MATH 10B,A01,182737,Staff,15,0,30,15
1681934836693,MATH 10B,A02,182738,Staff,24,0,30,6
1681934836693,MATH 10B,B01,182744,Staff,24,0,30,6
1681934836693,MATH 10B,B02,182745,Staff,27,0,30,3
1681934837717,MATH 18,A01,182750,Anzaldo; Leesa B,28,0,30,2
1681934837717,MATH 18,A02,182751,Anzaldo; Leesa B,28,0,30,2
1681934837717,MATH 18,A03,182753,Anzaldo; Leesa B,27,0,30,3
1681934837717,MATH 18,A04,182757,Anzaldo; Leesa B,29,0,30,1
1681934837717,MATH 18,B01,182761,Anzaldo; Leesa B,26,0,30,4
1681934837717,MATH 18,B02,182764,Anzaldo; Leesa B,27,0,30,3
1681934837717,MATH 18,B03,182765,Anzaldo; Leesa B,29,0,30,1
1681934837717,MATH 18,B04,182766,Anzaldo; Leesa B,30,0,30,0
1681934838741,MATH 20A,A01,182771,Suk; Andrew Hoon,27,0,30,3
1681934839764,MATH 20B,A01,182775,Bach; Quang Tran,30,0,30,0
1681934839764,MATH 20B,A02,182777,Bach; Quang Tran,29,0,30,1
1681934839764,MATH 20B,B01,182780,Bach; Quang Tran,26,0,30,4
1681934839764,MATH 20B,B02,182782,Bach; Quang Tran,30,0,30,0
1681934840790,MATH 20C,A01,182787,Staff,24,0,30,6
1681934840790,MATH 20C,A02,182790,Staff,29,0,30,1
1681934840790,MATH 20C,B01,182792,Staff,23,0,30,7
1681934840790,MATH 20C,B02,182796,Staff,26,0,30,4
1681934841813,MATH 20D,A01,182799,Staff,27,0,30,3
1681934841813,MATH 20D,A02,182802,Staff,29,0,30,1
1681934841813,MATH 20D,A03,182803,Staff,30,0,30,0
1681934842836,MATH 20E,A01,182809,Verstraete; Jacques Allan,18,0,30,12
1681934842836,MATH 20E,A02,182811,Verstraete; Jacques Allan,26,0,30,4
1681934842836,MATH 20E,B01,182814,Verstraete; Jacques Allan,21,0,30,9
1681934842836,MATH 20E,B02,182815,Verstraete; Jacques Allan,27,0,30,3
1681934843865,MATH 103A,A01,182820,Staff,2,0,30,28
1681934843865,MATH 103A,A02,182821,Staff,26,0,30,4
1681934843865,MATH 103A,A03,182822,Staff,19,0,30,11
1681934843865,MATH 103A,B01,182825,Staff,21,0,30,9
1681934843865,MATH 103A,B02,182826,Staff,30,0,30,0
1681934843865,MATH 103A,B03,182830,Staff,30,0,30,0
1681934844893,MATH 109,A01,182836,Chow; Bennett,23,0,30,7
1681934844893,MATH 109,A02,182838,Chow; Bennett,27,0,30,3
1681934844893,MATH 109,A03,182894,Chow; Bennett,29,0,30,1
1681934844893,MATH 109,B01,182908,Chow; Bennett,26,0,30,4
1681934844893,MATH 109,B02,182909,Chow; Bennett,30,0,30,0
1681934844893,MATH 109,B03,182910,Chow; Bennett,26,0,30,4
1681934845920,MATH 142A,A01,182925,Staff,3,0,30,27
1681934845920,MATH 142A,A02,182935,Staff,23,0,30,7
1681934845920,MATH 142A,A03,182967,Staff,24,0,30,6
1681934845920,MATH 142A,B01,183125,Staff,22,0,30,8
1681934845920,MATH 142A,B02,183157,Staff,26,0,30,4
1681934845920,MATH 142A,B03,183158,Staff,29,0,30,1
1681934846947,MATH 183,A01,183160,Arias-Castro; Ery,22,0,30,8
1681934846947,MATH 183,A02,183161,Arias-Castro; Ery,28,0,30,2
1681934846947,MATH 183,B01,183163,Arias-Castro; Ery,26,0,30,4
1681934846947,MATH 183,B02,183164,Arias-Castro; Ery,28,0,30,2
1681934847973,MATH 193A,A01,183167,Staff,0,0,35,35
1681934847973,MATH 193A,A02,183168,Staff,22,0,35,13
1681934847973,MATH 193A,A03,183169,Staff,32,0,35,3
1681934847973,MATH 193A,A04,183170,Staff,26,0,35,9
1681934848999,MGT 4,A01,202395,Anderson; John Charles,76,0,80,4
1681934850022,MGT 5,A00,202396,Houskeeper; Robert,78,0,90,12
1681934851046,MGT 103,A00,202397,Eberhard; Craig A,46,0,90,44
1681934852073,MGT 131A,A00,202398,Houskeeper; Robert,81,0,90,9
1681934853096,MGT 135,A00,202399,Anderson; John Charles,81,0,90,9
1681934854122,MGT 162R,A00,202403,Gneezy; Uri,113,0,200,87
1681934855147,MGT 172,A00,202404,Hedges; Kathleen,21,0,90,69
1681934856172,MGT 181,A00,202405,Dunn; Louis Jean,76,0,90,14
1681934857195,MMW 14,A01,183200,Staff,0,0,28,28
1681934857195,MMW 14,A02,183201,Staff,25,0,28,3
1681934857195,MMW 14,A03,183202,Staff,24,0,28,4
1681934857195,MMW 14,A04,183203,Staff,25,0,28,3
1681934857195,MMW 14,A05,183204,Staff,26,0,28,2
1681934857195,MMW 14,A06,183205,Staff,27,0,28,1
1681934857195,MMW 14,B01,183207,Staff,26,0,28,2
1681934857195,MMW 14,B02,183208,Staff,28,0,28,0
1681934857195,MMW 14,B03,183209,Staff,28,0,28,0
1681934857195,MMW 14,B04,183210,Staff,28,0,28,0
1681934857195,MMW 14,B05,183211,Staff,28,0,28,0
1681934857195,MMW 14,B06,183212,Staff,27,0,28,1
1681934858218,MMW 14GS,A00,183213,Zhiri; Oumelbanine,28,0,28,0
1681934859248,MMW 15GS,B00,183215,Rahimi; Babak,28,0,28,0
1681934860274,MMW 121,A01,183217,Patterson; Patrick H.,6,0,28,22
1681934860274,MMW 121,A02,183218,Patterson; Patrick H.,25,0,28,3
1681934861301,MUS 1A,A01,182554,Staff,0,1,35,35
1681934862327,MUS 5,A01,182558,Staff,16,0,35,19
1681934863350,MUS 6,A01,182562,Staff,22,0,35,13
1681934864371,MUS 8GS,A00,182563,Borgo; David Garcia,25,0,25,0
1681934865392,MUS 13,A01,182567,Staff,23,0,25,2
1681934866415,MUS 15,A01,182570,Staff,31,0,35,4
1681934866415,MUS 15,B01,182575,Staff,6,0,35,29
1681934867440,MUS 80,A00,182578,Staff,22,0,25,3
1681934867440,MUS 80,B00,182581,Staff,20,0,25,5
1681934868462,MUS 113,A00,182582,Staff,25,0,25,0
1681934869558,MUS 114,A00,182583,Staff,0,1,25,25
1681934870590,MUS 150GS,A01,182588,Borgo; David Garcia,24,0,25,1
1681934871615,PHIL 1,A00,182590,Staff,34,0,40,6
1681934872637,PHIL 10,A01,182596,Grush; Rick Scott,30,0,35,5
1681934872637,PHIL 10,A02,182597,Grush; Rick Scott,33,0,35,2
1681934873660,PHIL 15,A01,182601,Staff,31,0,35,4
1681934873660,PHIL 15,A02,182602,Staff,33,0,35,2
1681934874689,PHIL 27,A01,182604,Staff,25,0,35,10
1681934874689,PHIL 27,A02,182607,Staff,33,0,35,2
1681934875712,PHIL 32,A01,182609,Staff,35,0,35,0
1681934875712,PHIL 32,A02,182612,Staff,35,0,35,0
1681934876737,PHIL 130,A00,182614,Staff,57,0,70,13
1681934877763,PHIL 136,A00,182616,Cohen; Jonathan David,64,0,70,6
1681934878786,PHIL 155,A00,182617,Vargas; Manuel Rogelio,57,0,70,13
1681934879815,PHIL 163,A01,182620,Staff,15,0,20,5
1681934879815,PHIL 163,A02,182624,Staff,10,0,20,10
1681934880840,PHIL 164,A00,182627,Staff,29,0,40,11
1681934881866,PHIL 173,A00,182628,Staff,35,0,40,5
1681934882894,PHYS 1A,A00,183221,Staff,52,0,60,8
1681934883917,PHYS 1AL,001,183222,Staff,24,0,30,6
1681934883917,PHYS 1AL,002,183223,Staff,24,0,30,6
1681934884939,PHYS 1B,A00,183231,Staff,40,0,60,20
1681934885963,PHYS 1BL,001,183232,Staff,15,0,30,15
1681934885963,PHYS 1BL,002,183233,Staff,27,0,30,3
1681934886986,PHYS 1C,A00,183240,Staff,19,0,60,41
1681934888009,PHYS 1CL,001,183241,Staff,7,0,30,23
1681934888009,PHYS 1CL,002,183242,Staff,21,0,30,9
1681934889032,PHYS 2AR,A01,183250,Staff,39,0,50,11
1681934890058,PHYS 2B,A01,183252,Staff,101,0,115,14
1681934891082,PHYS 2BL,A01,183254,Staff,21,0,24,3
1681934891082,PHYS 2BL,A02,183255,Staff,21,0,24,3
1681934892105,PHYS 2C,A01,183522,Staff,100,0,115,15
1681934893129,PHYS 4A,A01,183524,Staff,49,0,50,1
1681934894153,POLI 5,A00,183525,Staff,43,0,50,7
1681934895177,POLI 12,A00,183540,Staff,45,0,50,5
1681934896202,POLI 13R,A00,183541,Forman; Fonna,39,0,50,11
1681934897229,POLI 30,A00,183542,Mignozzetti; Umberto,48,0,50,2
1681934898255,POLI 100A,A00,183543,Staff,43,0,50,7
1681934899278,POLI 100E,A00,223598,Staff,32,0,35,3
1681934900305,POLI 103A,A00,183564,Kousser; Thad,35,0,50,15
1681934901328,POLI 104B,A00,201329,Staff,27,0,35,8
1681934902356,POLI 113BR,A00,183576,Hoston; Germaine,22,0,50,28
1681934903379,POLI 114BR,A00,183588,Staff,26,0,30,4
1681934904404,POLI 117R,A00,183595,Forman; Fonna,3,0,20,17
1681934905431,POLI 120H,A00,183596,Fisk; David Lee,13,0,20,7
1681934906455,POLI 130AA,A00,183597,Staff,13,0,20,7
1681934907491,POLI 134AA,A00,183598,Staff,19,0,20,1
1681934908513,POLI 135,A00,183599,Fisk; David Lee,19,0,25,6
1681934909535,POLI 142P,A00,183623,Staff,37,0,40,3
1681934910560,POLI 144D,A00,183624,Staff,22,0,25,3
1681934911583,POLI 151,A00,183625,Staff,14,0,20,6
1681934912606,POLI 162,A00,183626,Mignozzetti; Umberto,17,0,20,3
1681934913629,PSYC 1,A00,253748,Staff,85,0,90,5
1681934914652,PSYC 2,A00,183627,Moranton; Nirelia Melbina-,22,0,35,13
1681934915675,PSYC 3,A00,183628,Staff,42,0,45,3
1681934917725,PSYC 60,A01,183631,Lowe; Angela Beth,34,0,40,6
1681934918846,PSYC 70,A01,253757,Staff,34,0,45,11
1681934919871,PSYC 101,A00,183632,Heyman; Gail D.,39,0,60,21
1681934920893,PSYC 105,A00,183848,Lowe; Angela Beth,42,0,60,18
1681934921916,PSYC 106,A00,183849,Dobkins; Karen R.,36,0,60,24
1681934922938,PSYC 108,A00,253750,Staff,7,0,60,53
1681934923961,PSYC 114,A01,184275,Winkielman; Piotr,0,8,30,30
1681934924986,PSYC 122,A00,183856,Moranton; Nirelia Melbina-,0,16,30,30
1681934926011,PSYC 124,A00,183865,Chapman; Eddie Nathaniel,41,0,80,39
1681934927034,PSYC 137,A00,183880,Staff,16,0,25,9
1681934929083,PSYC 154,A00,183910,Lacefield; Katharine I,0,33,90,90
1681934931130,PSYC 162,A00,183946,Wixted; John T,36,0,90,54
1681934932163,PSYC 172,A00,183947,Gorman; Michael R.,4,0,30,26
1681934933186,PSYC 178,A00,183963,Glaser; Dale,11,0,40,29
1681934934211,PSYC 181GS,A00,183964,Anagnostaras; Stephan,10,0,10,0
1681934935238,PSYC 186GS,A01,257660,Staff,10,0,10,0
1681934936267,PSYC 193,B00,253749,Staff,22,0,25,3
1681934938314,PSYC 193L,A01,184122,Staff,33,0,35,2
1681934938314,PSYC 193L,C01,184167,Winkielman; Piotr,14,0,30,16
1681934939337,RELI 188GS,A00,182629,Rahimi; Babak,20,0,20,0
1681934940360,SE 101A,A00,182646,Staff,25,0,30,5
1681934941422,SE 101C,A00,182650,Staff,9,0,20,11
1681934942446,SE 110A,A00,182651,Staff,28,0,28,0
1681934943468,SE 130A,A00,182652,Staff,37,0,40,3
1681934944490,SIO 46GS,A00,182636,Cook; Geoffrey W,24,0,28,4
1681934945513,SIO 109R,A00,194459,Staff,0,2,20,20
1681934946544,SIO 121GS,A00,182639,Cook; Geoffrey W,24,0,28,4
1681934947568,SIO 132,A01,182642,Staff,30,0,40,10
1681934948603,SIO 139,A00,182644,Kacev; David,36,0,40,4
1681934949629,SOCI 2,A01,258404,Staff,33,0,36,3
1681934949629,SOCI 2,A02,258405,Staff,35,0,36,1
1681934950661,SOCI 60,A01,258408,Staff,29,0,30,1
1681934950661,SOCI 60,A02,258413,Staff,30,0,30,0
1681934951683,SOCI 100,A01,258415,Staff,28,0,30,2
1681934951683,SOCI 100,A02,258416,Staff,28,0,30,2
1681934957846,SOCI 127,A00,258421,Staff,18,0,30,12
1681934958870,SOCI 132,A00,258422,Staff,42,0,50,8
1681934959896,SOCI 133,A00,258423,Staff,26,0,30,4
1681934960924,SOCI 138GS,A00,258424,Staff,15,0,15,0
1681934961950,SOCI 145,A00,258425,Staff,23,0,30,7
1681934962976,SOCI 148,A00,258426,Staff,23,0,30,7
1681934964004,SOCI 153,A00,199217,Staff,30,0,30,0
1681934965029,SOCI 160,A00,258427,Staff,26,0,30,4
1681934966054,SOCI 160E,A00,258435,Staff,55,0,60,5
1681934967076,SOCI 189GS,A00,258436,Staff,15,0,15,0
1681934968101,SOCI 190GS,A00,258437,Staff,15,0,15,0
1681934969124,SYN 2,001,182658,Staff,8,0,16,8
1681934969124,SYN 2,002,201439,Staff,13,0,16,3
1681934969124,SYN 2,003,201443,Staff,15,0,16,1
1681934970149,SYN 100,A01,182657,Staff,10,0,20,10
1681934971172,TDAC 1,A00,184381,Salovey; Todd,16,0,20,4
1681934971172,TDAC 1,B00,184385,Harting; Carla Kelso,19,0,20,1
1681934971172,TDAC 1,C00,184394,Staff,18,0,20,2
1681934972196,TDAC 101,A00,184483,Harting; Carla Kelso,19,0,20,1
1681934973298,TDDE 111,A00,184496,Staff,14,0,15,1
1681934974337,TDDE 131,A00,184504,Staff,20,0,20,0
1681934974337,TDDE 131,B00,184505,Staff,17,0,18,1
1681934974337,TDDE 131,C00,184534,Staff,49,0,50,1
1681934974337,TDDE 131,D00,184564,Staff,15,0,15,0
1681934974337,TDDE 131,E00,204725,Staff,18,0,20,2
1681934975362,TDGE 1,A01,184414,Salovey; Todd,33,0,50,17
1681934976385,TDGE 5,A01,184419,Staff,23,0,24,1
1681934977412,TDGE 10,A00,184428,Fulton; Julia,27,0,50,23
1681934978439,TDGE 124,A00,184565,Fulton; Julia,0,4,50,50
1681934979462,TDGE 125,B00,184567,Meyer; Ursula,7,0,25,18
1681934980492,TDHT 101,A00,184568,Staff,21,0,25,4
1681934980492,TDHT 101,B00,184569,Staff,20,0,20,0
1681934981516,TDHT 114,A00,184570,Staff,47,0,50,3
1681934982542,TDMV 1,A00,184437,Arcidiacono; Kristin,21,0,30,9
1681934982542,TDMV 1,B00,184448,Caligagan; Maria T.,23,0,30,7
1681934983567,TDMV 2,A00,184449,Weinberg; Sadie,26,0,30,4
1681934983567,TDMV 2,B00,184453,Arcidiacono; Kristin,29,0,30,1
1681934984589,TDMV 110,A00,184571,Weinberg; Sadie,30,0,30,0
1681934985615,TDMV 142,A00,184572,Caligagan; Tony,26,0,30,4
1681934985615,TDMV 142,B00,184573,Caligagan; Maria T.,26,0,30,4
1681934986643,TDTR 20,A00,184482,Jun; Grace Shin Hae,25,0,25,0
1681934987666,USP 2,A01,184290,Hinds; Juli Beth,23,0,25,2
1681934988690,USP 3,A01,184295,Staff,20,0,25,5
1681934989716,USP 4,A00,184304,McTague; Sarah,13,0,25,12
1681934990743,USP 100,A00,184315,Staff,16,0,25,9
1681934991768,USP 105,A00,184326,Staff,21,0,25,4
1681934992807,USP 151,A00,184327,Staff,17,0,25,8
1681934993831,USP 170,A00,184380,Hinds; Juli Beth,12,0,25,13
1681934994855,VIS 21B,A01,182660,Staff,28,0,31,3
1681934994855,VIS 21B,A02,182662,Staff,30,0,31,1
1681934995879,VIS 103D,A00,182663,Staff,73,0,75,2
1681934996903,VIS 105D,A00,182667,Li; Huai,14,0,22,8
1681934997931,VIS 122GS,A00,182668,Herbst; Matthew,20,0,20,0
1681934998965,VIS 128C,A00,182673,Staff,68,0,75,7
1681934999990,VIS 130,A00,182675,Staff,19,0,22,3
1681935001013,VIS 160A,A00,182678,Stalbaum; Brett,4,0,10,6
1681935003069,WCWP 10B,A00,201679,Staff,15,0,15,0
1681935003069,WCWP 10B,B00,201695,Staff,15,0,15,0
1681935004092,WCWP 100,A00,201716,Staff,12,0,15,3
1681935004092,WCWP 100,B00,201717,Staff,0,1,15,15
1681935006164,ANSC 105GS,A00,258289,Staff,0,0,0,0
1681935007187,ANSC 125GS,A00,258295,Staff,0,0,0,0
1681935008216,ANSC 150,A00,258267,Staff,27,0,40,13
1681935009239,ANSC 190GS,A00,258280,Staff,0,0,0,2
1681935010266,ANTH 1,A00,258264,Staff,38,0,40,2
1681935011293,ANTH 2,A01,258259,Staff,72,0,76,4
1681935012318,ANTH 23,A01,258228,Staff,35,0,40,5
1681935013342,ANTH 101,A01,258236,Staff,38,0,40,2
1681935014364,ANTH 102,A00,258272,Staff,59,0,60,1
1681935015387,ANTH 105,A00,258244,Staff,28,0,35,7
1681935016413,BENG 130,A00,253975,Staff,37,0,40,3
1681935017441,BIBC 102,A01,191866,Flagg; Matthew Paul,16,0,32,16
1681935017441,BIBC 102,A02,191867,Flagg; Matthew Paul,20,0,32,12
1681935017441,BIBC 102,A03,191868,Flagg; Matthew Paul,27,0,32,5
1681935017441,BIBC 102,A04,191936,Flagg; Matthew Paul,19,0,32,13
1681935017441,BIBC 102,A05,191937,Flagg; Matthew Paul,0,1,32,32
1681935018470,BICD 100,A01,191939,Cooper; Andrew Michael,27,0,32,5
1681935018470,BICD 100,A02,191940,Cooper; Andrew Michael,32,0,32,0
1681935018470,BICD 100,A03,191941,Cooper; Andrew Michael,32,0,32,0
1681935018470,BICD 100,A04,191942,Cooper; Andrew Michael,32,0,32,0
1681935018470,BICD 100,A05,191943,Cooper; Andrew Michael,32,0,32,0
1681935019497,BIEB 126,A01,191945,Cleland; Elsa Eleanor,0,5,32,32
1681935019497,BIEB 126,A02,191946,Cleland; Elsa Eleanor,26,0,32,6
1681935019497,BIEB 126,A03,191947,Cleland; Elsa Eleanor,29,0,32,3
1681935019497,BIEB 126,A04,191948,Cleland; Elsa Eleanor,15,0,32,17
1681935019497,BIEB 126,A05,191996,Cleland; Elsa Eleanor,28,0,32,4
1681935020519,BIEB 136GS,A00,191997,Shurin; Jonathan & Holway; David A.,0,0,0,9
1681935021546,BIEB 137GS,A01,191999,Shurin; Jonathan & Holway; David A.,0,0,0,8
1681935022570,BILD 1,A01,205385,Staff,29,0,32,3
1681935022570,BILD 1,A02,205386,Staff,30,0,32,2
1681935022570,BILD 1,A03,205387,Staff,31,0,32,1
1681935022570,BILD 1,A04,205388,Staff,25,0,32,7
1681935023593,BILD 2,A01,191774,Staff,25,0,32,7
1681935023593,BILD 2,A02,191775,Staff,29,0,32,3
1681935023593,BILD 2,A03,191777,Staff,29,0,32,3
1681935023593,BILD 2,A04,191856,Staff,30,0,32,2
1681935023593,BILD 2,A05,191857,Staff,31,0,32,1
1681935023593,BILD 2,A06,191858,Staff,32,0,32,0
1681935023593,BILD 2,A07,191859,Staff,31,0,32,1
1681935024617,BILD 3,A01,205391,Staff,26,0,32,6
1681935024617,BILD 3,A02,205393,Staff,32,0,32,0
1681935024617,BILD 3,A03,205394,Staff,26,0,32,6
1681935024617,BILD 3,A04,205395,Staff,32,0,32,0
1681935025647,BILD 20,A01,191861,Staff,32,0,32,0
1681935025647,BILD 20,A02,191862,Staff,32,0,32,0
1681935026678,BILD 30,A01,191864,Staff,31,0,32,1
1681935027715,BIMM 100,A01,192019,Staff,0,0,32,32
1681935027715,BIMM 100,A02,192020,Staff,10,0,32,22
1681935027715,BIMM 100,A03,192035,Staff,18,0,32,14
1681935028739,BIMM 110,A01,192037,Tat; John,0,0,32,32
1681935028739,BIMM 110,A02,192038,Tat; John,4,0,32,28
1681935029767,BIMM 120,A01,192040,Pickett; Brooke Elizabeth,0,0,32,32
1681935029767,BIMM 120,A02,192041,Pickett; Brooke Elizabeth,7,0,32,25
1681935029767,BIMM 120,A03,192042,Pickett; Brooke Elizabeth,14,0,32,18
1681935030798,BIPN 100,A01,192044,Armour; Jon Christopher,23,0,32,9
1681935030798,BIPN 100,A02,192059,Armour; Jon Christopher,30,0,32,2
1681935030798,BIPN 100,A03,192064,Armour; Jon Christopher,30,0,32,2
1681935030798,BIPN 100,A04,192073,Armour; Jon Christopher,26,0,32,6
1681935031822,BIPN 148,A01,205411,Leutgeb; Jill K.,14,0,32,18
1681935031822,BIPN 148,A02,205412,Leutgeb; Jill K.,31,0,32,1
1681935031822,BIPN 148,A03,205413,Leutgeb; Jill K.,29,0,32,3
1681935031822,BIPN 148,A04,205414,Leutgeb; Jill K.,30,0,32,2
1681935032845,BIPN 160,A01,192115,Marino; Marc J,15,0,32,17
1681935032845,BIPN 160,A02,192148,Marino; Marc J,27,0,32,5
1681935032845,BIPN 160,A03,192158,Marino; Marc J,31,0,32,1
1681935032845,BIPN 160,A04,192190,Marino; Marc J,32,0,32,0
1681935032845,BIPN 160,A05,192287,Marino; Marc J,32,0,32,0
1681935032845,BIPN 160,A06,192288,Marino; Marc J,32,0,32,0
1681935033880,BIPN 194,A00,206038,Leutgeb; Stefan,28,0,32,4
1681935034907,BISP 194,A00,192289,Nieh; James Charles,8,0,32,24
1681935034907,BISP 194,B00,245332,Staff,26,0,32,6
1681935035931,CAT 124,A01,202247,Staff,15,0,15,0
1681935036954,CAT 125,A00,202248,Staff,18,0,20,2
1681935036954,CAT 125,B00,202253,Staff,20,0,20,0
1681935036954,CAT 125,C00,202257,Staff,18,0,20,2
1681935037981,CAT 125GS,A01,202273,Bronstein; Phoebe Malan,20,0,20,0
1681935039009,CAT 125R,A00,202284,Staff,17,0,20,3
1681935039009,CAT 125R,C00,202286,Staff,3,0,20,17
1681935039009,CAT 125R,D00,202291,Staff,15,0,20,5
1681935039009,CAT 125R,E00,202295,Staff,13,0,20,7
1681935039009,CAT 125R,F00,202302,Staff,5,0,20,15
1681935040032,CENG 100,A00,204724,Opatkiewicz; Justin Paul,23,0,25,2
1681935041056,CGS 2A,A01,180420,Staff,29,0,36,7
1681935042081,CGS 101,A00,180421,Staff,14,0,20,6
1681935043102,CGS 112,A00,180422,Staff,8,0,16,8
1681935044125,CGS 113,A00,180423,Staff,18,0,20,2
1681935045149,CGS 137,A00,180424,Staff,12,0,12,0
1681935046171,CGS 147,A00,180425,Staff,10,0,10,0
1681935047197,CHEM 6A,A01,179556,Staff,92,0,100,8
1681935047197,CHEM 6A,A02,179558,Staff,0,0,0,0
1681935048226,CHEM 6B,A01,179560,Staff,100,0,100,0
1681935049253,CHEM 6C,A01,179565,Jazzar; Rodolphe,90,0,100,10
1681935050275,CHEM 7L,A01,179586,Schurmeier; Kimberly,9,0,24,15
1681935050275,CHEM 7L,A02,179587,Schurmeier; Kimberly,22,0,24,2
1681935050275,CHEM 7L,A03,179590,Schurmeier; Kimberly,22,0,24,2
1681935050275,CHEM 7L,A04,179591,Schurmeier; Kimberly,22,0,24,2
1681935050275,CHEM 7L,B01,179598,Schurmeier; Kimberly,13,0,24,11
1681935050275,CHEM 7L,B02,179599,Schurmeier; Kimberly,23,0,24,1
1681935050275,CHEM 7L,B03,179606,Schurmeier; Kimberly,22,0,24,2
1681935050275,CHEM 7L,B04,179607,Schurmeier; Kimberly,22,0,24,2
1681935051306,CHEM 11,A01,179609,Stallings; Dontarie M,85,0,100,15
1681935052335,CHEM 40A,A01,179621,Staff,37,0,50,13
1681935052335,CHEM 40A,A02,179622,Staff,44,0,50,6
1681935053359,CHEM 40B,A01,179630,Weizman; Haim,45,0,50,5
1681935053359,CHEM 40B,A02,179631,Weizman; Haim,42,0,50,8
1681935054385,CHEM 41A,A01,179660,Klosterman; Jeremy K,90,0,100,10
1681935055423,CHEM 43A,A01,179683,Klosterman; Jeremy K,0,0,24,24
1681935055423,CHEM 43A,A02,179688,Klosterman; Jeremy K,5,0,24,19
1681935055423,CHEM 43A,A03,179689,Klosterman; Jeremy K,16,0,24,8
1681935055423,CHEM 43A,A04,179691,Klosterman; Jeremy K,17,0,24,7
1681935056448,CHEM 114A,A01,179693,Stallings; Dontarie M,61,0,100,39
1681935057474,CHEM 143B,A01,179698,Weizman; Haim,16,0,24,8
1681935057474,CHEM 143B,A02,179700,Weizman; Haim,23,0,24,1
1681935058499,CHIN 169A,A00,179701,Wang; Xiao,20,0,20,0
1681935059524,COGS 2,A01,179750,Boyle; Mary E. T.,16,0,30,14
1681935060557,COGS 9,A01,179759,Jones; Cameron Robert,40,0,50,10
1681935061589,COGS 14A,A01,179854,Staff,6,0,50,44
1681935062614,COGS 14B,A01,179856,Staff,49,0,60,11
1681935063644,COGS 17,A01,179874,Staff,69,0,75,6
1681935064665,COGS 18,A01,179884,Staff,57,0,80,23
1681935065688,COGS 100,A01,179886,Staff,26,0,60,34
1681935066711,COGS 101B,A01,179892,Staff,0,4,30,30
1681935067737,COGS 101C,A01,179894,Staff,25,0,30,5
1681935068763,COGS 107A,A01,179896,Boyle; Mary E. T.,28,0,40,12
1681935069787,COGS 108,A01,179898,Simpkins; Charles Alexander,0,35,60,60
1681935070810,COGS 109,A01,179900,Staff,32,0,40,8
1681935071836,COGS 118A,A01,179946,Staff,3,0,40,37
1681935072870,COGS 153,A00,179978,Staff,0,7,30,30
1681935073894,COGS 156,A01,179981,Staff,19,0,30,11
1681935075946,COGS 172,A01,179987,Staff,8,0,30,22
1681935078079,COGS 186,A01,179991,Staff,9,0,30,21
1681935079109,COMM 10,A01,180001,Staff,11,0,25,14
1681935079109,COMM 10,A02,180004,Staff,20,0,25,5
1681935080134,COMM 100A,A01,180016,Staff,12,0,25,13
1681935080134,COMM 100A,A02,180020,Staff,24,0,25,1
1681935081160,COMM 101T,A00,180029,Halm; Gavin Patrick,14,0,35,21
1681935082184,COMM 106V,A00,180043,Staff,33,0,35,2
1681935083219,COMM 109P,A00,180044,Staff,29,0,35,6
1681935084242,COMM 113T,A00,180045,Havis; Allan,32,0,45,13
1681935085264,COMM 132,A00,180046,McKenna; Denise,16,0,30,14
1681935086291,COMM 143,A00,180047,Staff,14,0,30,16
1681935087315,COMM 190,A00,180048,Conner; Thomas Hartnell,13,0,23,10
1681935088344,CSE 8A,A50,180053,Cao; Yingjun,19,0,50,31
1681935088344,CSE 8A,B50,180180,Staff,49,0,50,1
1681935089367,CSE 11,A01,180190,Cao; Yingjun,17,0,50,33
1681935090389,CSE 20,A01,180192,Briones; Jor-el Thomas Caparas,20,0,30,10
1681935091411,CSE 21,A01,194538,Briones; Jor-el Thomas Caparas,49,0,60,11
1681935092434,CSE 30,A01,180324,Eldon; John,69,0,100,31
1681935093461,CSE 101,A01,201353,Staff,0,33,40,40
1681935094487,CSE 134B,A01,180326,Powell; Thomas Allan,68,0,100,32
1681935095508,CSE 140,A01,180328,Staff,18,0,75,57
1681935096540,CSE 140L,A01,180344,Eldon; John,44,0,100,56
1681935097563,CSE 150A,A01,180411,Staff,0,20,50,50
1681935098587,CSE 151A,A01,180414,Staff,0,15,50,50
1681935099613,CSE 175,A01,222521,Kumar; Rakesh,50,0,50,0
1681935100635,CSE 190,A00,201419,Staff,42,0,49,7
1681935101656,CSS 1,A01,194536,Staff,31,0,50,19
1681935102686,DSC 30,A01,202385,Staff,48,0,50,2
1681935103714,DSC 40A,A01,202387,Albuyeh; Rod,50,0,50,0
1681935104741,DSC 190,A01,202389,Silberman; Jack,21,0,21,0
1681935105780,DSGN 100,A01,179993,Staff,12,0,30,18
1681935106810,ECE 65,A50,180708,Staff,10,0,20,10
1681935106810,ECE 65,A51,180739,Staff,19,0,20,1
1681935107832,ECON 1,A01,180427,Famulari; Melissa,65,0,70,5
1681935108859,ECON 2,A01,180450,Levkoff; Steven B.,62,0,70,8
1681935109886,ECON 4,A01,203351,Anderson; John Charles,6,0,10,4
1681935110914,ECON 100A,A01,180472,Famulari; Melissa,59,0,70,11
1681935111938,ECON 120A,A01,180549,Staff,60,0,70,10
1681935112964,ECON 120B,A01,180655,Ma; Xinwei,31,0,70,39
1681935113997,ECON 129,A00,203333,Eckert; Fabian Paul,5,0,35,30
1681935115021,ECON 131,A00,180656,Staff,0,4,35,35
1681935116047,ECON 172B,A01,180672,Levkoff; Steven B.,30,0,35,5
1681935117069,ECON 178,A01,203342,Zhu; Ying,2,0,35,33
1681935118097,EDS 108GS,A00,202383,Wishard Guerra; Alison G.,20,0,20,0
1681935119129,EDS 111GS,A00,202347,Wishard Guerra; Alison G.,20,0,20,0
1681935120151,EDS 112,A01,202323,Staff,53,0,60,7
1681935121179,EDS 113,A00,202340,Staff,31,0,35,4
1681935122213,EDS 118,A00,201231,Staff,19,0,30,11
1681935123236,EDS 119,A00,204994,Staff,8,0,10,2
1681935124260,EDS 124BR,A00,202324,Eguchi; Emi,0,2,25,25
1681935125286,EDS 126,A01,203208,Jones; Makeba,26,0,30,4
1681935126308,EDS 135,A01,202333,Staff,17,0,20,3
1681935127335,EDS 180,A00,202311,Staff,47,0,50,3
1681935128359,ERC 190GS,A01,253747,Staff,28,0,28,0
1681935129386,ETHN 104,A00,180742,Staff,20,0,35,15
1681935130409,ETHN 118,A00,180745,Staff,26,0,35,9
1681935131435,ETHN 127,A00,180747,Staff,8,0,16,8
1681935132467,ETHN 137,A00,180880,Staff,11,0,12,1
1681935133496,ETHN 147,A00,180890,Staff,8,0,10,2
1681935134531,ETHN 154,A00,180891,Staff,4,0,8,4
1681935135557,ETHN 168,A00,180892,Staff,9,0,10,1
1681935136584,GLBH 20,A00,201051,Hannah; Seth Donal,0,7,0,1
1681935137606,GLBH 111,A01,209338,Burgos; Jose L.,0,0,0,0
1681935138628,GLBH 150,A00,258300,Staff,0,4,0,0
1681935139653,GLBH 181,A00,201207,Staff,2,0,40,38
1681935140677,HIEU 109,A00,180898,Staff,19,0,20,1
1681935141703,HIEU 111,A00,180899,Staff,0,2,20,20
1681935142727,HIEU 124,A00,180900,Staff,16,0,20,4
1681935143751,HILA 122,A00,180901,Staff,17,0,20,3
1681935144774,HILA 132,A00,180902,Vitz; Matthew,0,3,20,20
1681935145803,HILD 10,A01,180896,Staff,11,0,20,9
1681935146828,HILD 30GS,A00,180897,Edington; Claire Ellen,0,0,0,0
1681935147849,HISC 105,A00,180903,Staff,20,0,20,0
1681935148872,HISC 117,A00,180904,Staff,10,0,20,10
1681935149902,HIUS 108B,A00,181005,Staff,18,0,20,2
1681935150928,HIUS 113,A00,181093,Staff,0,0,20,20
1681935151951,HUM 3,A01,181190,Patterson; Patrick H.,33,0,50,17
1681935151951,HUM 3,B01,181195,Staff,43,0,50,7
1681935152974,HUM 3GS,A00,181196,Herbst; Matthew,0,0,0,0
1681935154000,HUM 4,A01,181227,West; Geoffrey Scott,33,0,50,17
1681935154000,HUM 4,B01,181282,Staff,41,0,50,9
1681935155023,HUM 4GS,A00,181377,Lyon; Antony J.,0,0,0,0
1681935156056,HUM 5,A01,181536,Zavodny; Tatiana Sophia,22,0,50,28
1681935156056,HUM 5,B01,181908,Staff,31,0,50,19
1681935157085,INTL 190,A00,181909,Segui; Alan S,0,0,0,8
1681935157085,INTL 190,B00,181961,Segui; Alan S,0,0,0,7
1681935158107,JAPN 20AR,A01,182113,Ross; Kayoko F,15,0,20,5
1681935159141,LATI 50,A01,202391,Martin-Cabrera; Luis,15,0,30,15
1681935159141,LATI 50,A02,202392,Martin-Cabrera; Luis,26,0,30,4
1681935160165,LATI 180,A00,202393,Kokinis; Troy Andreas,24,0,25,1
1681935161194,LIFR 1A,A00,182119,Staff,13,0,14,1
1681935162219,LIFR 1AX,A00,182324,Staff,13,0,14,1
1681935163248,LIFR 1B,A00,182259,Staff,11,0,14,3
1681935164273,LIFR 1BX,A00,182273,Staff,11,0,14,3
1681935165298,LIGN 8,A00,182330,Staff,124,0,150,26
1681935166329,LIGN 9GS,A00,182362,Staff,14,0,20,6
1681935167352,LIGN 119,A00,204992,Takahashi; Maho,11,0,15,4
1681935168374,LIGN 130,A01,182384,Staff,47,0,50,3
1681935169398,LIGN 149GS,A00,182390,Staff,14,0,20,6
1681935170423,LIGN 170,A00,182404,Staff,23,0,30,7
1681935171448,LISP 1D,A00,182281,Staff,6,0,14,8
1681935171448,LISP 1D,B00,182287,Staff,13,0,14,1
1681935171448,LISP 1D,C00,182295,Staff,10,0,14,4
1681935171448,LISP 1D,D00,182301,Staff,14,0,14,0
1681935172473,LISP 1DX,A00,182309,Staff,18,0,28,10
1681935172473,LISP 1DX,B00,182316,Staff,25,0,28,3
1681935173498,LTAF 120GS,A00,182412,Zhiri; Oumelbanine,20,0,20,0
1681935174532,LTCS 172GS,A00,182437,Bronstein; Phoebe Malan,20,0,20,0
1681935175562,LTEA 138,A00,182457,Staff,15,0,40,25
1681935176586,LTEN 114,A01,182490,Staff,23,0,25,2
1681935177609,LTEN 130GS,A00,182491,Lyon; Antony J.,20,0,20,0
1681935178638,LTEN 169,A00,182493,Cuong; Marisol,17,0,25,8
1681935179670,LTEN 178,A00,182501,Staff,14,0,15,1
1681935180770,LTEN 181,A00,182515,Staff,19,0,25,6
1681935181793,LTEN 185GS,A00,197655,Forbes; Camille,20,0,20,0
1681935182815,LTSP 100B,A00,202208,Bessett; Ryan Matthew,24,0,25,1
1681935183837,LTWL 100,A00,182516,Myerston Santana; Jacobo,19,0,30,11
1681935184865,LTWR 100GS,A00,182518,Forbes; Camille,20,0,20,0
1681935185888,LTWR 102,A00,182522,Staff,15,0,15,0
1681935185888,LTWR 102,B00,182525,Staff,14,0,15,1
1681935186913,LTWR 115,A00,182526,Staff,10,0,15,5
1681935187939,MAE 8,A01,182528,Pham; Hieu Tan,65,0,70,5
1681935188964,MAE 11,A00,182529,Bahadori; Mohammad Yousef,88,0,100,12
1681935189989,MAE 20,A00,182530,Evdokimenko; Ekaterina,67,0,70,3
1681935191014,MAE 30A,A00,182532,Staff,44,0,45,1
1681935192037,MAE 101A,A00,182533,Bahadori; Mohammad Yousef,93,0,100,7
1681935193060,MAE 101C,A00,182538,Staff,62,0,70,8
1681935194090,MAE 104,A00,182539,Staff,44,0,50,6
1681935195114,MAE 131A,A00,182540,Ghazinejad; Maziar,40,0,45,5
1681935196146,MAE 143A,A00,182548,Bewley; Thomas R,42,0,50,8
1681935197171,MAE 150,A00,182549,Staff,28,0,40,12
1681935198196,MAE 160,A00,182550,Evdokimenko; Ekaterina,37,0,60,23
1681935199223,MATH 3C,A01,182725,Staff,24,0,30,6
1681935200249,MATH 10A,A01,182729,Staff,24,0,30,6
1681935200249,MATH 10A,B01,182732,Staff,25,0,30,5
1681935201274,MATH 10B,A01,182737,Staff,15,0,30,15
1681935201274,MATH 10B,A02,182738,Staff,24,0,30,6
1681935201274,MATH 10B,B01,182744,Staff,24,0,30,6
1681935201274,MATH 10B,B02,182745,Staff,27,0,30,3
1681935202303,MATH 18,A01,182750,Anzaldo; Leesa B,28,0,30,2
1681935202303,MATH 18,A02,182751,Anzaldo; Leesa B,28,0,30,2
1681935202303,MATH 18,A03,182753,Anzaldo; Leesa B,27,0,30,3
1681935202303,MATH 18,A04,182757,Anzaldo; Leesa B,29,0,30,1
1681935202303,MATH 18,B01,182761,Anzaldo; Leesa B,26,0,30,4
1681935202303,MATH 18,B02,182764,Anzaldo; Leesa B,26,0,30,4
1681935202303,MATH 18,B03,182765,Anzaldo; Leesa B,29,0,30,1
1681935202303,MATH 18,B04,182766,Anzaldo; Leesa B,30,0,30,0
1681935203331,MATH 20A,A01,182771,Suk; Andrew Hoon,27,0,30,3
1681935204359,MATH 20B,A01,182775,Bach; Quang Tran,30,0,30,0
1681935204359,MATH 20B,A02,182777,Bach; Quang Tran,29,0,30,1
1681935204359,MATH 20B,B01,182780,Bach; Quang Tran,26,0,30,4
1681935204359,MATH 20B,B02,182782,Bach; Quang Tran,30,0,30,0
1681935205385,MATH 20C,A01,182787,Staff,24,0,30,6
1681935205385,MATH 20C,A02,182790,Staff,29,0,30,1
1681935205385,MATH 20C,B01,182792,Staff,23,0,30,7
1681935205385,MATH 20C,B02,182796,Staff,26,0,30,4
1681935206408,MATH 20D,A01,182799,Staff,26,0,30,4
1681935206408,MATH 20D,A02,182802,Staff,29,0,30,1
1681935206408,MATH 20D,A03,182803,Staff,30,0,30,0
1681935207441,MATH 20E,A01,182809,Verstraete; Jacques Allan,18,0,30,12
1681935207441,MATH 20E,A02,182811,Verstraete; Jacques Allan,26,0,30,4
1681935207441,MATH 20E,B01,182814,Verstraete; Jacques Allan,21,0,30,9
1681935207441,MATH 20E,B02,182815,Verstraete; Jacques Allan,27,0,30,3
1681935208464,MATH 103A,A01,182820,Staff,2,0,30,28
1681935208464,MATH 103A,A02,182821,Staff,26,0,30,4
1681935208464,MATH 103A,A03,182822,Staff,18,0,30,12
1681935208464,MATH 103A,B01,182825,Staff,21,0,30,9
1681935208464,MATH 103A,B02,182826,Staff,30,0,30,0
1681935208464,MATH 103A,B03,182830,Staff,30,0,30,0
1681935209493,MATH 109,A01,182836,Chow; Bennett,23,0,30,7
1681935209493,MATH 109,A02,182838,Chow; Bennett,27,0,30,3
1681935209493,MATH 109,A03,182894,Chow; Bennett,29,0,30,1
1681935209493,MATH 109,B01,182908,Chow; Bennett,26,0,30,4
1681935209493,MATH 109,B02,182909,Chow; Bennett,30,0,30,0
1681935209493,MATH 109,B03,182910,Chow; Bennett,26,0,30,4
1681935210517,MATH 142A,A01,182925,Staff,3,0,30,27
1681935210517,MATH 142A,A02,182935,Staff,23,0,30,7
1681935210517,MATH 142A,A03,182967,Staff,23,0,30,7
1681935210517,MATH 142A,B01,183125,Staff,22,0,30,8
1681935210517,MATH 142A,B02,183157,Staff,26,0,30,4
1681935210517,MATH 142A,B03,183158,Staff,29,0,30,1
1681935211551,MATH 183,A01,183160,Arias-Castro; Ery,22,0,30,8
1681935211551,MATH 183,A02,183161,Arias-Castro; Ery,28,0,30,2
1681935211551,MATH 183,B01,183163,Arias-Castro; Ery,26,0,30,4
1681935211551,MATH 183,B02,183164,Arias-Castro; Ery,28,0,30,2
1681935212573,MATH 193A,A01,183167,Staff,0,0,35,35
1681935212573,MATH 193A,A02,183168,Staff,21,0,35,14
1681935212573,MATH 193A,A03,183169,Staff,32,0,35,3
1681935212573,MATH 193A,A04,183170,Staff,26,0,35,9
1681935213662,MGT 4,A01,202395,Anderson; John Charles,76,0,80,4
1681935214686,MGT 5,A00,202396,Houskeeper; Robert,78,0,90,12
1681935215715,MGT 103,A00,202397,Eberhard; Craig A,45,0,90,45
1681935216740,MGT 131A,A00,202398,Houskeeper; Robert,81,0,90,9
1681935217770,MGT 135,A00,202399,Anderson; John Charles,81,0,90,9
1681935218798,MGT 162R,A00,202403,Gneezy; Uri,111,0,200,89
1681935219821,MGT 172,A00,202404,Hedges; Kathleen,20,0,90,70
1681935220844,MGT 181,A00,202405,Dunn; Louis Jean,74,0,90,16
1681935221872,MMW 14,A01,183200,Staff,0,0,28,28
1681935221872,MMW 14,A02,183201,Staff,25,0,28,3
1681935221872,MMW 14,A03,183202,Staff,24,0,28,4
1681935221872,MMW 14,A04,183203,Staff,25,0,28,3
1681935221872,MMW 14,A05,183204,Staff,26,0,28,2
1681935221872,MMW 14,A06,183205,Staff,27,0,28,1
1681935221872,MMW 14,B01,183207,Staff,26,0,28,2
1681935221872,MMW 14,B02,183208,Staff,28,0,28,0
1681935221872,MMW 14,B03,183209,Staff,28,0,28,0
1681935221872,MMW 14,B04,183210,Staff,28,0,28,0
1681935221872,MMW 14,B05,183211,Staff,28,0,28,0
1681935221872,MMW 14,B06,183212,Staff,27,0,28,1
1681935222896,MMW 14GS,A00,183213,Zhiri; Oumelbanine,28,0,28,0
1681935223926,MMW 15GS,B00,183215,Rahimi; Babak,27,0,28,1
1681935224953,MMW 121,A01,183217,Patterson; Patrick H.,5,0,28,23
1681935224953,MMW 121,A02,183218,Patterson; Patrick H.,25,0,28,3
1681935225978,MUS 1A,A01,182554,Staff,0,1,35,35
1681935227003,MUS 5,A01,182558,Staff,16,0,35,19
1681935228029,MUS 6,A01,182562,Staff,22,0,35,13
1681935229054,MUS 8GS,A00,182563,Borgo; David Garcia,25,0,25,0
1681935230077,MUS 13,A01,182567,Staff,23,0,25,2
1681935231104,MUS 15,A01,182570,Staff,31,0,35,4
1681935231104,MUS 15,B01,182575,Staff,6,0,35,29
1681935232126,MUS 80,A00,182578,Staff,22,0,25,3
1681935232126,MUS 80,B00,182581,Staff,20,0,25,5
1681935233152,MUS 113,A00,182582,Staff,25,0,25,0
1681935234176,MUS 114,A00,182583,Staff,0,2,25,25
1681935235198,MUS 150GS,A01,182588,Borgo; David Garcia,24,0,25,1
1681935236230,PHIL 1,A00,182590,Staff,34,0,40,6
1681935237253,PHIL 10,A01,182596,Grush; Rick Scott,30,0,35,5
1681935237253,PHIL 10,A02,182597,Grush; Rick Scott,33,0,35,2
1681935238279,PHIL 15,A01,182601,Staff,31,0,35,4
1681935238279,PHIL 15,A02,182602,Staff,33,0,35,2
1681935239305,PHIL 27,A01,182604,Staff,23,0,35,12
1681935239305,PHIL 27,A02,182607,Staff,33,0,35,2
1681935240334,PHIL 32,A01,182609,Staff,35,0,35,0
1681935240334,PHIL 32,A02,182612,Staff,35,0,35,0
1681935241359,PHIL 130,A00,182614,Staff,57,0,70,13
1681935242394,PHIL 136,A00,182616,Cohen; Jonathan David,64,0,70,6
1681935243418,PHIL 155,A00,182617,Vargas; Manuel Rogelio,57,0,70,13
1681935244450,PHIL 163,A01,182620,Staff,15,0,20,5
1681935244450,PHIL 163,A02,182624,Staff,10,0,20,10
1681935245471,PHIL 164,A00,182627,Staff,29,0,40,11
1681935246496,PHIL 173,A00,182628,Staff,35,0,40,5
1681935247519,PHYS 1A,A00,183221,Staff,52,0,60,8
1681935248541,PHYS 1AL,001,183222,Staff,24,0,30,6
1681935248541,PHYS 1AL,002,183223,Staff,24,0,30,6
1681935249564,PHYS 1B,A00,183231,Staff,40,0,60,20
1681935250586,PHYS 1BL,001,183232,Staff,15,0,30,15
1681935250586,PHYS 1BL,002,183233,Staff,27,0,30,3
1681935251607,PHYS 1C,A00,183240,Staff,19,0,60,41
1681935252630,PHYS 1CL,001,183241,Staff,7,0,30,23
1681935252630,PHYS 1CL,002,183242,Staff,21,0,30,9
1681935253652,PHYS 2AR,A01,183250,Staff,39,0,50,11
1681935254682,PHYS 2B,A01,183252,Staff,101,0,115,14
1681935255708,PHYS 2BL,A01,183254,Staff,21,0,24,3
1681935255708,PHYS 2BL,A02,183255,Staff,21,0,24,3
1681935256734,PHYS 2C,A01,183522,Staff,100,0,115,15
1681935257761,PHYS 4A,A01,183524,Staff,49,0,50,1
1681935258796,POLI 5,A00,183525,Staff,43,0,50,7
1681935259822,POLI 12,A00,183540,Staff,45,0,50,5
1681935260847,POLI 13R,A00,183541,Forman; Fonna,39,0,50,11
1681935261873,POLI 30,A00,183542,Mignozzetti; Umberto,48,0,50,2
1681935262900,POLI 100A,A00,183543,Staff,43,0,50,7
1681935263925,POLI 100E,A00,223598,Staff,32,0,35,3
1681935264949,POLI 103A,A00,183564,Kousser; Thad,35,0,50,15
1681935265971,POLI 104B,A00,201329,Staff,27,0,35,8
1681935266994,POLI 113BR,A00,183576,Hoston; Germaine,22,0,50,28
1681935268019,POLI 114BR,A00,183588,Staff,26,0,30,4
1681935269047,POLI 117R,A00,183595,Forman; Fonna,3,0,20,17
1681935270074,POLI 120H,A00,183596,Fisk; David Lee,13,0,20,7
1681935271102,POLI 130AA,A00,183597,Staff,13,0,20,7
1681935272132,POLI 134AA,A00,183598,Staff,19,0,20,1
1681935273158,POLI 135,A00,183599,Fisk; David Lee,19,0,25,6
1681935274188,POLI 142P,A00,183623,Staff,37,0,40,3
1681935275216,POLI 144D,A00,183624,Staff,22,0,25,3
1681935276242,POLI 151,A00,183625,Staff,14,0,20,6
1681935277264,POLI 162,A00,183626,Mignozzetti; Umberto,17,0,20,3
1681935278287,PSYC 1,A00,253748,Staff,85,0,90,5
1681935279309,PSYC 2,A00,183627,Moranton; Nirelia Melbina-,22,0,35,13
1681935280339,PSYC 3,A00,183628,Staff,42,0,45,3
1681935282393,PSYC 60,A01,183631,Lowe; Angela Beth,34,0,40,6
1681935283415,PSYC 70,A01,253757,Staff,34,0,45,11
1681935284537,PSYC 101,A00,183632,Heyman; Gail D.,39,0,60,21
1681935285563,PSYC 105,A00,183848,Lowe; Angela Beth,41,0,60,19
1681935286586,PSYC 106,A00,183849,Dobkins; Karen R.,34,0,60,26
1681935287612,PSYC 108,A00,253750,Staff,5,0,60,55
1681935288637,PSYC 114,A01,184275,Winkielman; Piotr,0,8,30,30
1681935289659,PSYC 122,A00,183856,Moranton; Nirelia Melbina-,0,17,30,30
1681935290681,PSYC 124,A00,183865,Chapman; Eddie Nathaniel,41,0,80,39
1681935291704,PSYC 137,A00,183880,Staff,15,0,25,10
1681935293751,PSYC 154,A00,183910,Lacefield; Katharine I,0,33,90,90
1681935295812,PSYC 162,A00,183946,Wixted; John T,35,0,90,55
1681935296838,PSYC 172,A00,183947,Gorman; Michael R.,3,0,30,27
1681935297861,PSYC 178,A00,183963,Glaser; Dale,10,0,40,30
1681935298884,PSYC 181GS,A00,183964,Anagnostaras; Stephan,10,0,10,0
1681935299910,PSYC 186GS,A01,257660,Staff,10,0,10,0
1681935300938,PSYC 193,B00,253749,Staff,22,0,25,3
1681935302983,PSYC 193L,A01,184122,Staff,33,0,35,2
1681935302983,PSYC 193L,C01,184167,Winkielman; Piotr,14,0,30,16
1681935304011,RELI 188GS,A00,182629,Rahimi; Babak,20,0,20,0
1681935305041,SE 101A,A00,182646,Staff,25,0,30,5
1681935306070,SE 101C,A00,182650,Staff,9,0,20,11
1681935307093,SE 110A,A00,182651,Staff,28,0,28,0
1681935308116,SE 130A,A00,182652,Staff,37,0,40,3
1681935309148,SIO 46GS,A00,182636,Cook; Geoffrey W,24,0,28,4
1681935310176,SIO 109R,A00,194459,Staff,0,2,20,20
1681935311221,SIO 121GS,A00,182639,Cook; Geoffrey W,24,0,28,4
1681935312246,SIO 132,A01,182642,Staff,30,0,40,10
1681935313270,SIO 139,A00,182644,Kacev; David,36,0,40,4
1681935314298,SOCI 2,A01,258404,Staff,33,0,36,3
1681935314298,SOCI 2,A02,258405,Staff,35,0,36,1
1681935315324,SOCI 60,A01,258408,Staff,29,0,30,1
1681935315324,SOCI 60,A02,258413,Staff,30,0,30,0
1681935316348,SOCI 100,A01,258415,Staff,28,0,30,2
1681935316348,SOCI 100,A02,258416,Staff,28,0,30,2
1681935322505,SOCI 127,A00,258421,Staff,18,0,30,12
1681935323527,SOCI 132,A00,258422,Staff,42,0,50,8
1681935324549,SOCI 133,A00,258423,Staff,26,0,30,4
1681935325571,SOCI 138GS,A00,258424,Staff,15,0,15,0
1681935326604,SOCI 145,A00,258425,Staff,23,0,30,7
1681935327640,SOCI 148,A00,258426,Staff,23,0,30,7
1681935328668,SOCI 153,A00,199217,Staff,30,0,30,0
1681935329689,SOCI 160,A00,258427,Staff,26,0,30,4
1681935330715,SOCI 160E,A00,258435,Staff,55,0,60,5
1681935331743,SOCI 189GS,A00,258436,Staff,15,0,15,0
1681935332769,SOCI 190GS,A00,258437,Staff,15,0,15,0
1681935333792,SYN 2,001,182658,Staff,7,0,16,9
1681935333792,SYN 2,002,201439,Staff,13,0,16,3
1681935333792,SYN 2,003,201443,Staff,15,0,16,1
1681935334825,SYN 100,A01,182657,Staff,10,0,20,10
1681935335848,TDAC 1,A00,184381,Salovey; Todd,16,0,20,4
1681935335848,TDAC 1,B00,184385,Harting; Carla Kelso,19,0,20,1
1681935335848,TDAC 1,C00,184394,Staff,18,0,20,2
1681935336874,TDAC 101,A00,184483,Harting; Carla Kelso,19,0,20,1
1681935337899,TDDE 111,A00,184496,Staff,14,0,15,1
1681935338933,TDDE 131,A00,184504,Staff,20,0,20,0
1681935338933,TDDE 131,B00,184505,Staff,17,0,18,1
1681935338933,TDDE 131,C00,184534,Staff,49,0,50,1
1681935338933,TDDE 131,D00,184564,Staff,15,0,15,0
1681935338933,TDDE 131,E00,204725,Staff,18,0,20,2
1681935339957,TDGE 1,A01,184414,Salovey; Todd,33,0,50,17
1681935340983,TDGE 5,A01,184419,Staff,23,0,24,1
1681935342011,TDGE 10,A00,184428,Fulton; Julia,27,0,50,23
1681935343034,TDGE 124,A00,184565,Fulton; Julia,0,5,50,50
1681935344057,TDGE 125,B00,184567,Meyer; Ursula,7,0,25,18
1681935345083,TDHT 101,A00,184568,Staff,21,0,25,4
1681935345083,TDHT 101,B00,184569,Staff,20,0,20,0
1681935346104,TDHT 114,A00,184570,Staff,47,0,50,3
1681935347126,TDMV 1,A00,184437,Arcidiacono; Kristin,21,0,30,9
1681935347126,TDMV 1,B00,184448,Caligagan; Maria T.,23,0,30,7
1681935348154,TDMV 2,A00,184449,Weinberg; Sadie,26,0,30,4
1681935348154,TDMV 2,B00,184453,Arcidiacono; Kristin,29,0,30,1
1681935349178,TDMV 110,A00,184571,Weinberg; Sadie,30,0,30,0
1681935350206,TDMV 142,A00,184572,Caligagan; Tony,26,0,30,4
1681935350206,TDMV 142,B00,184573,Caligagan; Maria T.,26,0,30,4
1681935351236,TDTR 20,A00,184482,Jun; Grace Shin Hae,25,0,25,0
1681935352265,USP 2,A01,184290,Hinds; Juli Beth,23,0,25,2
1681935353292,USP 3,A01,184295,Staff,19,0,25,6
1681935354315,USP 4,A00,184304,McTague; Sarah,11,0,25,14
1681935355343,USP 100,A00,184315,Staff,16,0,25,9
1681935356373,USP 105,A00,184326,Staff,21,0,25,4
1681935357397,USP 151,A00,184327,Staff,16,0,25,9
1681935358427,USP 170,A00,184380,Hinds; Juli Beth,12,0,25,13
1681935359449,VIS 21B,A01,182660,Staff,28,0,31,3
1681935359449,VIS 21B,A02,182662,Staff,30,0,31,1
1681935360472,VIS 103D,A00,182663,Staff,73,0,75,2
1681935361501,VIS 105D,A00,182667,Li; Huai,14,0,22,8
1681935362523,VIS 122GS,A00,182668,Herbst; Matthew,20,0,20,0
1681935363547,VIS 128C,A00,182673,Staff,68,0,75,7
1681935364569,VIS 130,A00,182675,Staff,19,0,22,3
1681935365594,VIS 160A,A00,182678,Stalbaum; Brett,4,0,10,6
1681935367642,WCWP 10B,A00,201679,Staff,15,0,15,0
1681935367642,WCWP 10B,B00,201695,Staff,15,0,15,0
1681935368665,WCWP 100,A00,201716,Staff,12,0,15,3
1681935368665,WCWP 100,B00,201717,Staff,0,1,15,15
1681935370760,ANSC 105GS,A00,258289,Staff,0,0,0,0
1681935371784,ANSC 125GS,A00,258295,Staff,0,0,0,0
1681935372810,ANSC 150,A00,258267,Staff,27,0,40,13
1681935373842,ANSC 190GS,A00,258280,Staff,0,0,0,2
1681935374865,ANTH 1,A00,258264,Staff,38,0,40,2
1681935375887,ANTH 2,A01,258259,Staff,72,0,76,4
1681935376913,ANTH 23,A01,258228,Staff,35,0,40,5
1681935377936,ANTH 101,A01,258236,Staff,38,0,40,2
1681935378965,ANTH 102,A00,258272,Staff,59,0,60,1
1681935379993,ANTH 105,A00,258244,Staff,28,0,35,7
1681935381026,BENG 130,A00,253975,Staff,37,0,40,3
1681935382050,BIBC 102,A01,191866,Flagg; Matthew Paul,16,0,32,16
1681935382050,BIBC 102,A02,191867,Flagg; Matthew Paul,20,0,32,12
1681935382050,BIBC 102,A03,191868,Flagg; Matthew Paul,27,0,32,5
1681935382050,BIBC 102,A04,191936,Flagg; Matthew Paul,19,0,32,13
1681935382050,BIBC 102,A05,191937,Flagg; Matthew Paul,0,1,32,32
1681935383074,BICD 100,A01,191939,Cooper; Andrew Michael,27,0,32,5
1681935383074,BICD 100,A02,191940,Cooper; Andrew Michael,32,0,32,0
1681935383074,BICD 100,A03,191941,Cooper; Andrew Michael,32,0,32,0
1681935383074,BICD 100,A04,191942,Cooper; Andrew Michael,32,0,32,0
1681935383074,BICD 100,A05,191943,Cooper; Andrew Michael,32,0,32,0
1681935384101,BIEB 126,A01,191945,Cleland; Elsa Eleanor,0,5,32,32
1681935384101,BIEB 126,A02,191946,Cleland; Elsa Eleanor,26,0,32,6
1681935384101,BIEB 126,A03,191947,Cleland; Elsa Eleanor,29,0,32,3
1681935384101,BIEB 126,A04,191948,Cleland; Elsa Eleanor,15,0,32,17
1681935384101,BIEB 126,A05,191996,Cleland; Elsa Eleanor,28,0,32,4
1681935385124,BIEB 136GS,A00,191997,Shurin; Jonathan & Holway; David A.,0,0,0,9
1681935386147,BIEB 137GS,A01,191999,Shurin; Jonathan & Holway; David A.,0,0,0,8
1681935387169,BILD 1,A01,205385,Staff,29,0,32,3
1681935387169,BILD 1,A02,205386,Staff,30,0,32,2
1681935387169,BILD 1,A03,205387,Staff,31,0,32,1
1681935387169,BILD 1,A04,205388,Staff,25,0,32,7
1681935388266,BILD 2,A01,191774,Staff,24,0,32,8
1681935388266,BILD 2,A02,191775,Staff,29,0,32,3
1681935388266,BILD 2,A03,191777,Staff,29,0,32,3
1681935388266,BILD 2,A04,191856,Staff,30,0,32,2
1681935388266,BILD 2,A05,191857,Staff,31,0,32,1
1681935388266,BILD 2,A06,191858,Staff,32,0,32,0
1681935388266,BILD 2,A07,191859,Staff,31,0,32,1
1681935389299,BILD 3,A01,205391,Staff,26,0,32,6
1681935389299,BILD 3,A02,205393,Staff,32,0,32,0
1681935389299,BILD 3,A03,205394,Staff,26,0,32,6
1681935389299,BILD 3,A04,205395,Staff,32,0,32,0
1681935390321,BILD 20,A01,191861,Staff,32,0,32,0
1681935390321,BILD 20,A02,191862,Staff,32,0,32,0
1681935391343,BILD 30,A01,191864,Staff,31,0,32,1
1681935392380,BIMM 100,A01,192019,Staff,0,0,32,32
1681935392380,BIMM 100,A02,192020,Staff,9,0,32,23
1681935392380,BIMM 100,A03,192035,Staff,18,0,32,14
1681935393403,BIMM 110,A01,192037,Tat; John,0,0,32,32
1681935393403,BIMM 110,A02,192038,Tat; John,4,0,32,28
1681935394432,BIMM 120,A01,192040,Pickett; Brooke Elizabeth,0,0,32,32
1681935394432,BIMM 120,A02,192041,Pickett; Brooke Elizabeth,7,0,32,25
1681935394432,BIMM 120,A03,192042,Pickett; Brooke Elizabeth,14,0,32,18
1681935395456,BIPN 100,A01,192044,Armour; Jon Christopher,23,0,32,9
1681935395456,BIPN 100,A02,192059,Armour; Jon Christopher,30,0,32,2
1681935395456,BIPN 100,A03,192064,Armour; Jon Christopher,30,0,32,2
1681935395456,BIPN 100,A04,192073,Armour; Jon Christopher,26,0,32,6
1681935396486,BIPN 148,A01,205411,Leutgeb; Jill K.,14,0,32,18
1681935396486,BIPN 148,A02,205412,Leutgeb; Jill K.,31,0,32,1
1681935396486,BIPN 148,A03,205413,Leutgeb; Jill K.,29,0,32,3
1681935396486,BIPN 148,A04,205414,Leutgeb; Jill K.,30,0,32,2
1681935397511,BIPN 160,A01,192115,Marino; Marc J,15,0,32,17
1681935397511,BIPN 160,A02,192148,Marino; Marc J,27,0,32,5
1681935397511,BIPN 160,A03,192158,Marino; Marc J,31,0,32,1
1681935397511,BIPN 160,A04,192190,Marino; Marc J,32,0,32,0
1681935397511,BIPN 160,A05,192287,Marino; Marc J,32,0,32,0
1681935397511,BIPN 160,A06,192288,Marino; Marc J,32,0,32,0
1681935398541,BIPN 194,A00,206038,Leutgeb; Stefan,28,0,32,4
1681935399571,BISP 194,A00,192289,Nieh; James Charles,8,0,32,24
1681935399571,BISP 194,B00,245332,Staff,26,0,32,6
1681935400596,CAT 124,A01,202247,Staff,15,0,15,0
1681935401619,CAT 125,A00,202248,Staff,18,0,20,2
1681935401619,CAT 125,B00,202253,Staff,20,0,20,0
1681935401619,CAT 125,C00,202257,Staff,17,0,20,3
1681935402646,CAT 125GS,A01,202273,Bronstein; Phoebe Malan,20,0,20,0
1681935403674,CAT 125R,A00,202284,Staff,17,0,20,3
1681935403674,CAT 125R,C00,202286,Staff,3,0,20,17
1681935403674,CAT 125R,D00,202291,Staff,15,0,20,5
1681935403674,CAT 125R,E00,202295,Staff,13,0,20,7
1681935403674,CAT 125R,F00,202302,Staff,5,0,20,15
1681935404697,CENG 100,A00,204724,Opatkiewicz; Justin Paul,23,0,25,2
1681935405719,CGS 2A,A01,180420,Staff,29,0,36,7
1681935406741,CGS 101,A00,180421,Staff,14,0,20,6
1681935407771,CGS 112,A00,180422,Staff,7,0,16,9
1681935408800,CGS 113,A00,180423,Staff,18,0,20,2
1681935409831,CGS 137,A00,180424,Staff,12,0,12,0
1681935410864,CGS 147,A00,180425,Staff,10,0,10,0
1681935411887,CHEM 6A,A01,179556,Staff,92,0,100,8
1681935411887,CHEM 6A,A02,179558,Staff,0,0,0,0
1681935412908,CHEM 6B,A01,179560,Staff,100,0,100,0
1681935413940,CHEM 6C,A01,179565,Jazzar; Rodolphe,90,0,100,10
1681935414964,CHEM 7L,A01,179586,Schurmeier; Kimberly,9,0,24,15
1681935414964,CHEM 7L,A02,179587,Schurmeier; Kimberly,22,0,24,2
1681935414964,CHEM 7L,A03,179590,Schurmeier; Kimberly,22,0,24,2
1681935414964,CHEM 7L,A04,179591,Schurmeier; Kimberly,22,0,24,2
1681935414964,CHEM 7L,B01,179598,Schurmeier; Kimberly,13,0,24,11
1681935414964,CHEM 7L,B02,179599,Schurmeier; Kimberly,23,0,24,1
1681935414964,CHEM 7L,B03,179606,Schurmeier; Kimberly,22,0,24,2
1681935414964,CHEM 7L,B04,179607,Schurmeier; Kimberly,22,0,24,2
1681935415990,CHEM 11,A01,179609,Stallings; Dontarie M,85,0,100,15
1681935417022,CHEM 40A,A01,179621,Staff,37,0,50,13
1681935417022,CHEM 40A,A02,179622,Staff,44,0,50,6
1681935418048,CHEM 40B,A01,179630,Weizman; Haim,45,0,50,5
1681935418048,CHEM 40B,A02,179631,Weizman; Haim,42,0,50,8
1681935419071,CHEM 41A,A01,179660,Klosterman; Jeremy K,90,0,100,10
1681935420094,CHEM 43A,A01,179683,Klosterman; Jeremy K,0,0,24,24
1681935420094,CHEM 43A,A02,179688,Klosterman; Jeremy K,5,0,24,19
1681935420094,CHEM 43A,A03,179689,Klosterman; Jeremy K,16,0,24,8
1681935420094,CHEM 43A,A04,179691,Klosterman; Jeremy K,17,0,24,7
1681935421129,CHEM 114A,A01,179693,Stallings; Dontarie M,61,0,100,39
1681935422154,CHEM 143B,A01,179698,Weizman; Haim,16,0,24,8
1681935422154,CHEM 143B,A02,179700,Weizman; Haim,23,0,24,1
1681935423181,CHIN 169A,A00,179701,Wang; Xiao,20,0,20,0
1681935424204,COGS 2,A01,179750,Boyle; Mary E. T.,16,0,30,14
1681935425230,COGS 9,A01,179759,Jones; Cameron Robert,40,0,50,10
1681935426252,COGS 14A,A01,179854,Staff,5,0,50,45
1681935427280,COGS 14B,A01,179856,Staff,49,0,60,11
1681935428308,COGS 17,A01,179874,Staff,69,0,75,6
1681935429333,COGS 18,A01,179884,Staff,57,0,80,23
1681935430357,COGS 100,A01,179886,Staff,26,0,60,34
1681935431379,COGS 101B,A01,179892,Staff,0,4,30,30
1681935432404,COGS 101C,A01,179894,Staff,25,0,30,5
1681935433433,COGS 107A,A01,179896,Boyle; Mary E. T.,28,0,40,12
1681935434455,COGS 108,A01,179898,Simpkins; Charles Alexander,0,35,60,60
1681935435478,COGS 109,A01,179900,Staff,32,0,40,8
1681935436502,COGS 118A,A01,179946,Staff,3,0,40,37
1681935437524,COGS 153,A00,179978,Staff,0,7,30,30
1681935438547,COGS 156,A01,179981,Staff,19,0,30,11
1681935440590,COGS 172,A01,179987,Staff,8,0,30,22
1681935442641,COGS 186,A01,179991,Staff,9,0,30,21
1681935443668,COMM 10,A01,180001,Staff,11,0,25,14
1681935443668,COMM 10,A02,180004,Staff,20,0,25,5
1681935444700,COMM 100A,A01,180016,Staff,12,0,25,13
1681935444700,COMM 100A,A02,180020,Staff,24,0,25,1
1681935445726,COMM 101T,A00,180029,Halm; Gavin Patrick,14,0,35,21
1681935446748,COMM 106V,A00,180043,Staff,33,0,35,2
1681935447770,COMM 109P,A00,180044,Staff,29,0,35,6
1681935448793,COMM 113T,A00,180045,Havis; Allan,32,0,45,13
1681935449828,COMM 132,A00,180046,McKenna; Denise,16,0,30,14
1681935450852,COMM 143,A00,180047,Staff,14,0,30,16
1681935451875,COMM 190,A00,180048,Conner; Thomas Hartnell,13,0,23,10
1681935452898,CSE 8A,A50,180053,Cao; Yingjun,19,0,50,31
1681935452898,CSE 8A,B50,180180,Staff,49,0,50,1
1681935453921,CSE 11,A01,180190,Cao; Yingjun,15,0,50,35
1681935454950,CSE 20,A01,180192,Briones; Jor-el Thomas Caparas,20,0,30,10
1681935455977,CSE 21,A01,194538,Briones; Jor-el Thomas Caparas,49,0,60,11
1681935456999,CSE 30,A01,180324,Eldon; John,69,0,100,31
1681935458031,CSE 101,A01,201353,Staff,0,34,40,40
1681935459058,CSE 134B,A01,180326,Powell; Thomas Allan,68,0,100,32
1681935460084,CSE 140,A01,180328,Staff,17,0,75,58
1681935461113,CSE 140L,A01,180344,Eldon; John,43,0,100,57
1681935462136,CSE 150A,A01,180411,Staff,0,20,50,50
1681935463158,CSE 151A,A01,180414,Staff,0,15,50,50
1681935464184,CSE 175,A01,222521,Kumar; Rakesh,50,0,50,0
1681935465207,CSE 190,A00,201419,Staff,42,0,49,7
1681935466232,CSS 1,A01,194536,Staff,31,0,50,19
1681935467258,DSC 30,A01,202385,Staff,48,0,50,2
1681935468280,DSC 40A,A01,202387,Albuyeh; Rod,50,0,50,0
1681935469306,DSC 190,A01,202389,Silberman; Jack,21,0,21,0
1681935470331,DSGN 100,A01,179993,Staff,12,0,30,18
1681935471357,ECE 65,A50,180708,Staff,10,0,20,10
1681935471357,ECE 65,A51,180739,Staff,19,0,20,1
1681935472382,ECON 1,A01,180427,Famulari; Melissa,65,0,70,5
1681935473404,ECON 2,A01,180450,Levkoff; Steven B.,62,0,70,8
1681935474427,ECON 4,A01,203351,Anderson; John Charles,6,0,10,4
1681935475454,ECON 100A,A01,180472,Famulari; Melissa,59,0,70,11
1681935476482,ECON 120A,A01,180549,Staff,60,0,70,10
1681935477514,ECON 120B,A01,180655,Ma; Xinwei,31,0,70,39
1681935478539,ECON 129,A00,203333,Eckert; Fabian Paul,5,0,35,30
1681935479565,ECON 131,A00,180656,Staff,0,4,35,35
1681935480588,ECON 172B,A01,180672,Levkoff; Steven B.,30,0,35,5
1681935481616,ECON 178,A01,203342,Zhu; Ying,2,0,35,33
1681935482648,EDS 108GS,A00,202383,Wishard Guerra; Alison G.,20,0,20,0
1681935483670,EDS 111GS,A00,202347,Wishard Guerra; Alison G.,20,0,20,0
1681935484703,EDS 112,A01,202323,Staff,53,0,60,7
1681935485736,EDS 113,A00,202340,Staff,31,0,35,4
1681935486762,EDS 118,A00,201231,Staff,19,0,30,11
1681935487791,EDS 119,A00,204994,Staff,8,0,10,2
1681935488815,EDS 124BR,A00,202324,Eguchi; Emi,0,3,25,25
1681935489846,EDS 126,A01,203208,Jones; Makeba,26,0,30,4
1681935490878,EDS 135,A01,202333,Staff,17,0,20,3
1681935491977,EDS 180,A00,202311,Staff,47,0,50,3
1681935493001,ERC 190GS,A01,253747,Staff,28,0,28,0
1681935494023,ETHN 104,A00,180742,Staff,20,0,35,15
1681935495052,ETHN 118,A00,180745,Staff,26,0,35,9
1681935496078,ETHN 127,A00,180747,Staff,8,0,16,8
1681935497110,ETHN 137,A00,180880,Staff,11,0,12,1
1681935498139,ETHN 147,A00,180890,Staff,8,0,10,2
1681935499165,ETHN 154,A00,180891,Staff,4,0,8,4
1681935500194,ETHN 168,A00,180892,Staff,9,0,10,1
1681935501233,GLBH 20,A00,201051,Hannah; Seth Donal,0,7,0,1
1681935502254,GLBH 111,A01,209338,Burgos; Jose L.,0,0,0,0
1681935503279,GLBH 150,A00,258300,Staff,0,4,0,0
1681935504308,GLBH 181,A00,201207,Staff,2,0,40,38
1681935505331,HIEU 109,A00,180898,Staff,19,0,20,1
1681935506357,HIEU 111,A00,180899,Staff,0,2,20,20
1681935507389,HIEU 124,A00,180900,Staff,16,0,20,4
1681935508411,HILA 122,A00,180901,Staff,17,0,20,3
1681935509437,HILA 132,A00,180902,Vitz; Matthew,0,3,20,20
1681935510477,HILD 10,A01,180896,Staff,11,0,20,9
1681935511508,HILD 30GS,A00,180897,Edington; Claire Ellen,0,0,0,0
1681935512532,HISC 105,A00,180903,Staff,20,0,20,0
1681935513555,HISC 117,A00,180904,Staff,10,0,20,10
1681935514577,HIUS 108B,A00,181005,Staff,17,0,20,3
1681935515599,HIUS 113,A00,181093,Staff,0,1,20,20
1681935516625,HUM 3,A01,181190,Patterson; Patrick H.,33,0,50,17
1681935516625,HUM 3,B01,181195,Staff,43,0,50,7
1681935517651,HUM 3GS,A00,181196,Herbst; Matthew,0,0,0,0
1681935518685,HUM 4,A01,181227,West; Geoffrey Scott,33,0,50,17
1681935518685,HUM 4,B01,181282,Staff,41,0,50,9
1681935519714,HUM 4GS,A00,181377,Lyon; Antony J.,0,0,0,0
1681935520737,HUM 5,A01,181536,Zavodny; Tatiana Sophia,22,0,50,28
1681935520737,HUM 5,B01,181908,Staff,31,0,50,19
1681935521762,INTL 190,A00,181909,Segui; Alan S,0,0,0,8
1681935521762,INTL 190,B00,181961,Segui; Alan S,0,0,0,7
1681935522800,JAPN 20AR,A01,182113,Ross; Kayoko F,15,0,20,5
1681935523823,LATI 50,A01,202391,Martin-Cabrera; Luis,15,0,30,15
1681935523823,LATI 50,A02,202392,Martin-Cabrera; Luis,26,0,30,4
1681935524849,LATI 180,A00,202393,Kokinis; Troy Andreas,24,0,25,1
1681935525877,LIFR 1A,A00,182119,Staff,13,0,14,1
1681935526904,LIFR 1AX,A00,182324,Staff,13,0,14,1
1681935527941,LIFR 1B,A00,182259,Staff,11,0,14,3
1681935528963,LIFR 1BX,A00,182273,Staff,11,0,14,3
1681935529993,LIGN 8,A00,182330,Staff,124,0,150,26
1681935531016,LIGN 9GS,A00,182362,Staff,14,0,20,6
1681935532045,LIGN 119,A00,204992,Takahashi; Maho,11,0,15,4
1681935533067,LIGN 130,A01,182384,Staff,47,0,50,3
1681935534091,LIGN 149GS,A00,182390,Staff,14,0,20,6
1681935535114,LIGN 170,A00,182404,Staff,23,0,30,7
1681935536141,LISP 1D,A00,182281,Staff,6,0,14,8
1681935536141,LISP 1D,B00,182287,Staff,13,0,14,1
1681935536141,LISP 1D,C00,182295,Staff,10,0,14,4
1681935536141,LISP 1D,D00,182301,Staff,14,0,14,0
1681935537166,LISP 1DX,A00,182309,Staff,18,0,28,10
1681935537166,LISP 1DX,B00,182316,Staff,25,0,28,3
1681935538197,LTAF 120GS,A00,182412,Zhiri; Oumelbanine,20,0,20,0
1681935539220,LTCS 172GS,A00,182437,Bronstein; Phoebe Malan,20,0,20,0
1681935540248,LTEA 138,A00,182457,Staff,13,0,40,27
1681935541271,LTEN 114,A01,182490,Staff,23,0,25,2
1681935542297,LTEN 130GS,A00,182491,Lyon; Antony J.,20,0,20,0
1681935543322,LTEN 169,A00,182493,Cuong; Marisol,17,0,25,8
1681935544347,LTEN 178,A00,182501,Staff,14,0,15,1
1681935545369,LTEN 181,A00,182515,Staff,19,0,25,6
1681935546392,LTEN 185GS,A00,197655,Forbes; Camille,20,0,20,0
1681935547413,LTSP 100B,A00,202208,Bessett; Ryan Matthew,24,0,25,1
1681935548441,LTWL 100,A00,182516,Myerston Santana; Jacobo,19,0,30,11
1681935549472,LTWR 100GS,A00,182518,Forbes; Camille,20,0,20,0
1681935550495,LTWR 102,A00,182522,Staff,15,0,15,0
1681935550495,LTWR 102,B00,182525,Staff,14,0,15,1
1681935551516,LTWR 115,A00,182526,Staff,10,0,15,5
1681935552547,MAE 8,A01,182528,Pham; Hieu Tan,65,0,70,5
1681935553570,MAE 11,A00,182529,Bahadori; Mohammad Yousef,88,0,100,12
1681935554592,MAE 20,A00,182530,Evdokimenko; Ekaterina,67,0,70,3
1681935555622,MAE 30A,A00,182532,Staff,44,0,45,1
1681935556645,MAE 101A,A00,182533,Bahadori; Mohammad Yousef,93,0,100,7
1681935557676,MAE 101C,A00,182538,Staff,62,0,70,8
1681935558700,MAE 104,A00,182539,Staff,44,0,50,6
1681935559732,MAE 131A,A00,182540,Ghazinejad; Maziar,40,0,45,5
1681935560756,MAE 143A,A00,182548,Bewley; Thomas R,42,0,50,8
1681935561779,MAE 150,A00,182549,Staff,28,0,40,12
1681935562802,MAE 160,A00,182550,Evdokimenko; Ekaterina,37,0,60,23
1681935563828,MATH 3C,A01,182725,Staff,24,0,30,6
1681935564851,MATH 10A,A01,182729,Staff,24,0,30,6
1681935564851,MATH 10A,B01,182732,Staff,25,0,30,5
1681935565875,MATH 10B,A01,182737,Staff,15,0,30,15
1681935565875,MATH 10B,A02,182738,Staff,24,0,30,6
1681935565875,MATH 10B,B01,182744,Staff,24,0,30,6
1681935565875,MATH 10B,B02,182745,Staff,27,0,30,3
1681935566909,MATH 18,A01,182750,Anzaldo; Leesa B,28,0,30,2
1681935566909,MATH 18,A02,182751,Anzaldo; Leesa B,28,0,30,2
1681935566909,MATH 18,A03,182753,Anzaldo; Leesa B,27,0,30,3
1681935566909,MATH 18,A04,182757,Anzaldo; Leesa B,29,0,30,1
1681935566909,MATH 18,B01,182761,Anzaldo; Leesa B,26,0,30,4
1681935566909,MATH 18,B02,182764,Anzaldo; Leesa B,26,0,30,4
1681935566909,MATH 18,B03,182765,Anzaldo; Leesa B,29,0,30,1
1681935566909,MATH 18,B04,182766,Anzaldo; Leesa B,30,0,30,0
1681935567933,MATH 20A,A01,182771,Suk; Andrew Hoon,27,0,30,3
1681935568956,MATH 20B,A01,182775,Bach; Quang Tran,30,0,30,0
1681935568956,MATH 20B,A02,182777,Bach; Quang Tran,29,0,30,1
1681935568956,MATH 20B,B01,182780,Bach; Quang Tran,26,0,30,4
1681935568956,MATH 20B,B02,182782,Bach; Quang Tran,30,0,30,0
1681935569979,MATH 20C,A01,182787,Staff,23,0,30,7
1681935569979,MATH 20C,A02,182790,Staff,29,0,30,1
1681935569979,MATH 20C,B01,182792,Staff,23,0,30,7
1681935569979,MATH 20C,B02,182796,Staff,26,0,30,4
1681935571009,MATH 20D,A01,182799,Staff,26,0,30,4
1681935571009,MATH 20D,A02,182802,Staff,29,0,30,1
1681935571009,MATH 20D,A03,182803,Staff,30,0,30,0
1681935572041,MATH 20E,A01,182809,Verstraete; Jacques Allan,18,0,30,12
1681935572041,MATH 20E,A02,182811,Verstraete; Jacques Allan,26,0,30,4
1681935572041,MATH 20E,B01,182814,Verstraete; Jacques Allan,20,0,30,10
1681935572041,MATH 20E,B02,182815,Verstraete; Jacques Allan,27,0,30,3
1681935573068,MATH 103A,A01,182820,Staff,2,0,30,28
1681935573068,MATH 103A,A02,182821,Staff,26,0,30,4
1681935573068,MATH 103A,A03,182822,Staff,19,0,30,11
1681935573068,MATH 103A,B01,182825,Staff,21,0,30,9
1681935573068,MATH 103A,B02,182826,Staff,30,0,30,0
1681935573068,MATH 103A,B03,182830,Staff,30,0,30,0
1681935574092,MATH 109,A01,182836,Chow; Bennett,23,0,30,7
1681935574092,MATH 109,A02,182838,Chow; Bennett,27,0,30,3
1681935574092,MATH 109,A03,182894,Chow; Bennett,29,0,30,1
1681935574092,MATH 109,B01,182908,Chow; Bennett,26,0,30,4
1681935574092,MATH 109,B02,182909,Chow; Bennett,30,0,30,0
1681935574092,MATH 109,B03,182910,Chow; Bennett,26,0,30,4
1681935575123,MATH 142A,A01,182925,Staff,3,0,30,27
1681935575123,MATH 142A,A02,182935,Staff,23,0,30,7
1681935575123,MATH 142A,A03,182967,Staff,23,0,30,7
1681935575123,MATH 142A,B01,183125,Staff,22,0,30,8
1681935575123,MATH 142A,B02,183157,Staff,26,0,30,4
1681935575123,MATH 142A,B03,183158,Staff,29,0,30,1
1681935576151,MATH 183,A01,183160,Arias-Castro; Ery,22,0,30,8
1681935576151,MATH 183,A02,183161,Arias-Castro; Ery,28,0,30,2
1681935576151,MATH 183,B01,183163,Arias-Castro; Ery,26,0,30,4
1681935576151,MATH 183,B02,183164,Arias-Castro; Ery,28,0,30,2
1681935577182,MATH 193A,A01,183167,Staff,0,0,35,35
1681935577182,MATH 193A,A02,183168,Staff,21,0,35,14
1681935577182,MATH 193A,A03,183169,Staff,32,0,35,3
1681935577182,MATH 193A,A04,183170,Staff,26,0,35,9
1681935578207,MGT 4,A01,202395,Anderson; John Charles,76,0,80,4
1681935579233,MGT 5,A00,202396,Houskeeper; Robert,78,0,90,12
1681935580254,MGT 103,A00,202397,Eberhard; Craig A,45,0,90,45
1681935581277,MGT 131A,A00,202398,Houskeeper; Robert,81,0,90,9
1681935582300,MGT 135,A00,202399,Anderson; John Charles,81,0,90,9
1681935583326,MGT 162R,A00,202403,Gneezy; Uri,111,0,200,89
1681935584348,MGT 172,A00,202404,Hedges; Kathleen,20,0,90,70
1681935585381,MGT 181,A00,202405,Dunn; Louis Jean,74,0,90,16
1681935586405,MMW 14,A01,183200,Staff,0,0,28,28
1681935586405,MMW 14,A02,183201,Staff,25,0,28,3
1681935586405,MMW 14,A03,183202,Staff,23,0,28,5
1681935586405,MMW 14,A04,183203,Staff,25,0,28,3
1681935586405,MMW 14,A05,183204,Staff,26,0,28,2
1681935586405,MMW 14,A06,183205,Staff,27,0,28,1
1681935586405,MMW 14,B01,183207,Staff,26,0,28,2
1681935586405,MMW 14,B02,183208,Staff,28,0,28,0
1681935586405,MMW 14,B03,183209,Staff,28,0,28,0
1681935586405,MMW 14,B04,183210,Staff,28,0,28,0
1681935586405,MMW 14,B05,183211,Staff,28,0,28,0
1681935586405,MMW 14,B06,183212,Staff,27,0,28,1
1681935587427,MMW 14GS,A00,183213,Zhiri; Oumelbanine,28,0,28,0
1681935588457,MMW 15GS,B00,183215,Rahimi; Babak,27,0,28,1
1681935589479,MMW 121,A01,183217,Patterson; Patrick H.,5,0,28,23
1681935589479,MMW 121,A02,183218,Patterson; Patrick H.,25,0,28,3
1681935590501,MUS 1A,A01,182554,Staff,0,1,35,35
1681935591537,MUS 5,A01,182558,Staff,16,0,35,19
1681935592561,MUS 6,A01,182562,Staff,22,0,35,13
1681935593584,MUS 8GS,A00,182563,Borgo; David Garcia,25,0,25,0
1681935594608,MUS 13,A01,182567,Staff,23,0,25,2
1681935595722,MUS 15,A01,182570,Staff,31,0,35,4
1681935595722,MUS 15,B01,182575,Staff,6,0,35,29
1681935596744,MUS 80,A00,182578,Staff,22,0,25,3
1681935596744,MUS 80,B00,182581,Staff,20,0,25,5
1681935597769,MUS 113,A00,182582,Staff,25,0,25,0
1681935598792,MUS 114,A00,182583,Staff,0,2,25,25
1681935599817,MUS 150GS,A01,182588,Borgo; David Garcia,24,0,25,1
1681935600841,PHIL 1,A00,182590,Staff,34,0,40,6
1681935601874,PHIL 10,A01,182596,Grush; Rick Scott,30,0,35,5
1681935601874,PHIL 10,A02,182597,Grush; Rick Scott,33,0,35,2
1681935602901,PHIL 15,A01,182601,Staff,31,0,35,4
1681935602901,PHIL 15,A02,182602,Staff,33,0,35,2
1681935603932,PHIL 27,A01,182604,Staff,23,0,35,12
1681935603932,PHIL 27,A02,182607,Staff,33,0,35,2
1681935604956,PHIL 32,A01,182609,Staff,35,0,35,0
1681935604956,PHIL 32,A02,182612,Staff,35,0,35,0
1681935605979,PHIL 130,A00,182614,Staff,57,0,70,13
1681935607004,PHIL 136,A00,182616,Cohen; Jonathan David,63,0,70,7
1681935608029,PHIL 155,A00,182617,Vargas; Manuel Rogelio,56,0,70,14
1681935609057,PHIL 163,A01,182620,Staff,15,0,20,5
1681935609057,PHIL 163,A02,182624,Staff,10,0,20,10
1681935610080,PHIL 164,A00,182627,Staff,29,0,40,11
1681935611107,PHIL 173,A00,182628,Staff,35,0,40,5
1681935612132,PHYS 1A,A00,183221,Staff,52,0,60,8
1681935613155,PHYS 1AL,001,183222,Staff,24,0,30,6
1681935613155,PHYS 1AL,002,183223,Staff,24,0,30,6
1681935614186,PHYS 1B,A00,183231,Staff,40,0,60,20
1681935615211,PHYS 1BL,001,183232,Staff,15,0,30,15
1681935615211,PHYS 1BL,002,183233,Staff,27,0,30,3
1681935616234,PHYS 1C,A00,183240,Staff,19,0,60,41
1681935617256,PHYS 1CL,001,183241,Staff,7,0,30,23
1681935617256,PHYS 1CL,002,183242,Staff,21,0,30,9
1681935618282,PHYS 2AR,A01,183250,Staff,39,0,50,11
1681935619306,PHYS 2B,A01,183252,Staff,101,0,115,14
1681935620330,PHYS 2BL,A01,183254,Staff,21,0,24,3
1681935620330,PHYS 2BL,A02,183255,Staff,21,0,24,3
1681935621355,PHYS 2C,A01,183522,Staff,100,0,115,15
1681935622391,PHYS 4A,A01,183524,Staff,49,0,50,1
1681935623417,POLI 5,A00,183525,Staff,43,0,50,7
1681935624449,POLI 12,A00,183540,Staff,45,0,50,5
1681935625472,POLI 13R,A00,183541,Forman; Fonna,39,0,50,11
1681935626506,POLI 30,A00,183542,Mignozzetti; Umberto,48,0,50,2
1681935627529,POLI 100A,A00,183543,Staff,43,0,50,7
1681935628562,POLI 100E,A00,223598,Staff,32,0,35,3
1681935629591,POLI 103A,A00,183564,Kousser; Thad,35,0,50,15
1681935630615,POLI 104B,A00,201329,Staff,27,0,35,8
1681935631637,POLI 113BR,A00,183576,Hoston; Germaine,22,0,50,28
1681935632658,POLI 114BR,A00,183588,Staff,26,0,30,4
1681935633681,POLI 117R,A00,183595,Forman; Fonna,3,0,20,17
1681935634711,POLI 120H,A00,183596,Fisk; David Lee,13,0,20,7
1681935635733,POLI 130AA,A00,183597,Staff,13,0,20,7
1681935636795,POLI 134AA,A00,183598,Staff,19,0,20,1
1681935637818,POLI 135,A00,183599,Fisk; David Lee,19,0,25,6
1681935638841,POLI 142P,A00,183623,Staff,37,0,40,3
1681935639864,POLI 144D,A00,183624,Staff,22,0,25,3
1681935640901,POLI 151,A00,183625,Staff,14,0,20,6
1681935641925,POLI 162,A00,183626,Mignozzetti; Umberto,17,0,20,3
1681935642953,PSYC 1,A00,253748,Staff,85,0,90,5
1681935643976,PSYC 2,A00,183627,Moranton; Nirelia Melbina-,22,0,35,13
1681935644999,PSYC 3,A00,183628,Staff,42,0,45,3
1681935647050,PSYC 60,A01,183631,Lowe; Angela Beth,34,0,40,6
1681935648074,PSYC 70,A01,253757,Staff,34,0,45,11
1681935649096,PSYC 101,A00,183632,Heyman; Gail D.,39,0,60,21
1681935650130,PSYC 105,A00,183848,Lowe; Angela Beth,41,0,60,19
1681935651153,PSYC 106,A00,183849,Dobkins; Karen R.,33,0,60,27
1681935652176,PSYC 108,A00,253750,Staff,5,0,60,55
1681935653198,PSYC 114,A01,184275,Winkielman; Piotr,0,8,30,30
1681935654221,PSYC 122,A00,183856,Moranton; Nirelia Melbina-,0,17,30,30
1681935655244,PSYC 124,A00,183865,Chapman; Eddie Nathaniel,41,0,80,39
1681935656274,PSYC 137,A00,183880,Staff,15,0,25,10
1681935658328,PSYC 154,A00,183910,Lacefield; Katharine I,0,33,90,90
1681935660376,PSYC 162,A00,183946,Wixted; John T,34,0,90,56
1681935661424,PSYC 172,A00,183947,Gorman; Michael R.,3,0,30,27
1681935662446,PSYC 178,A00,183963,Glaser; Dale,10,0,40,30
1681935663473,PSYC 181GS,A00,183964,Anagnostaras; Stephan,10,0,10,0
1681935664503,PSYC 186GS,A01,257660,Staff,10,0,10,0
1681935665525,PSYC 193,B00,253749,Staff,22,0,25,3
1681935667581,PSYC 193L,A01,184122,Staff,33,0,35,2
1681935667581,PSYC 193L,C01,184167,Winkielman; Piotr,14,0,30,16
1681935668604,RELI 188GS,A00,182629,Rahimi; Babak,20,0,20,0
1681935669628,SE 101A,A00,182646,Staff,25,0,30,5
1681935670650,SE 101C,A00,182650,Staff,9,0,20,11
1681935671673,SE 110A,A00,182651,Staff,28,0,28,0
1681935672700,SE 130A,A00,182652,Staff,37,0,40,3
1681935673723,SIO 46GS,A00,182636,Cook; Geoffrey W,23,0,28,5
1681935674753,SIO 109R,A00,194459,Staff,0,2,20,20
1681935675776,SIO 121GS,A00,182639,Cook; Geoffrey W,23,0,28,5
1681935676798,SIO 132,A01,182642,Staff,30,0,40,10
1681935677822,SIO 139,A00,182644,Kacev; David,36,0,40,4
1681935678845,SOCI 2,A01,258404,Staff,33,0,36,3
1681935678845,SOCI 2,A02,258405,Staff,35,0,36,1
1681935679868,SOCI 60,A01,258408,Staff,29,0,30,1
1681935679868,SOCI 60,A02,258413,Staff,30,0,30,0
1681935680910,SOCI 100,A01,258415,Staff,28,0,30,2
1681935680910,SOCI 100,A02,258416,Staff,28,0,30,2
1681935687068,SOCI 127,A00,258421,Staff,18,0,30,12
1681935688092,SOCI 132,A00,258422,Staff,41,0,50,9
1681935689114,SOCI 133,A00,258423,Staff,26,0,30,4
1681935690142,SOCI 138GS,A00,258424,Staff,15,0,15,0
1681935691173,SOCI 145,A00,258425,Staff,23,0,30,7
1681935692200,SOCI 148,A00,258426,Staff,23,0,30,7
1681935693226,SOCI 153,A00,199217,Staff,30,0,30,0
1681935694249,SOCI 160,A00,258427,Staff,26,0,30,4
1681935695275,SOCI 160E,A00,258435,Staff,55,0,60,5
1681935696307,SOCI 189GS,A00,258436,Staff,15,0,15,0
1681935697332,SOCI 190GS,A00,258437,Staff,15,0,15,0
1681935698358,SYN 2,001,182658,Staff,7,0,16,9
1681935698358,SYN 2,002,201439,Staff,13,0,16,3
1681935698358,SYN 2,003,201443,Staff,15,0,16,1
1681935699453,SYN 100,A01,182657,Staff,10,0,20,10
1681935700477,TDAC 1,A00,184381,Salovey; Todd,16,0,20,4
1681935700477,TDAC 1,B00,184385,Harting; Carla Kelso,19,0,20,1
1681935700477,TDAC 1,C00,184394,Staff,18,0,20,2
1681935701499,TDAC 101,A00,184483,Harting; Carla Kelso,19,0,20,1
1681935702524,TDDE 111,A00,184496,Staff,14,0,15,1
1681935703548,TDDE 131,A00,184504,Staff,20,0,20,0
1681935703548,TDDE 131,B00,184505,Staff,17,0,18,1
1681935703548,TDDE 131,C00,184534,Staff,49,0,50,1
1681935703548,TDDE 131,D00,184564,Staff,15,0,15,0
1681935703548,TDDE 131,E00,204725,Staff,18,0,20,2
1681935704571,TDGE 1,A01,184414,Salovey; Todd,33,0,50,17
1681935705594,TDGE 5,A01,184419,Staff,23,0,24,1
1681935706619,TDGE 10,A00,184428,Fulton; Julia,27,0,50,23
1681935707644,TDGE 124,A00,184565,Fulton; Julia,0,5,50,50
1681935708665,TDGE 125,B00,184567,Meyer; Ursula,6,0,25,19
1681935709691,TDHT 101,A00,184568,Staff,21,0,25,4
1681935709691,TDHT 101,B00,184569,Staff,20,0,20,0
1681935710712,TDHT 114,A00,184570,Staff,47,0,50,3
1681935711737,TDMV 1,A00,184437,Arcidiacono; Kristin,21,0,30,9
1681935711737,TDMV 1,B00,184448,Caligagan; Maria T.,23,0,30,7
1681935712765,TDMV 2,A00,184449,Weinberg; Sadie,26,0,30,4
1681935712765,TDMV 2,B00,184453,Arcidiacono; Kristin,29,0,30,1
1681935713791,TDMV 110,A00,184571,Weinberg; Sadie,30,0,30,0
1681935714820,TDMV 142,A00,184572,Caligagan; Tony,26,0,30,4
1681935714820,TDMV 142,B00,184573,Caligagan; Maria T.,26,0,30,4
1681935715842,TDTR 20,A00,184482,Jun; Grace Shin Hae,25,0,25,0
1681935716868,USP 2,A01,184290,Hinds; Juli Beth,23,0,25,2
1681935717905,USP 3,A01,184295,Staff,19,0,25,6
1681935718928,USP 4,A00,184304,McTague; Sarah,11,0,25,14
1681935719951,USP 100,A00,184315,Staff,16,0,25,9
1681935720977,USP 105,A00,184326,Staff,21,0,25,4
1681935722005,USP 151,A00,184327,Staff,15,0,25,10
1681935723028,USP 170,A00,184380,Hinds; Juli Beth,12,0,25,13
1681935724057,VIS 21B,A01,182660,Staff,28,0,31,3
1681935724057,VIS 21B,A02,182662,Staff,30,0,31,1
1681935725080,VIS 103D,A00,182663,Staff,73,0,75,2
1681935726108,VIS 105D,A00,182667,Li; Huai,14,0,22,8
1681935727131,VIS 122GS,A00,182668,Herbst; Matthew,20,0,20,0
1681935728153,VIS 128C,A00,182673,Staff,68,0,75,7
1681935729188,VIS 130,A00,182675,Staff,19,0,22,3
1681935730213,VIS 160A,A00,182678,Stalbaum; Brett,4,0,10,6
1681935732262,WCWP 10B,A00,201679,Staff,15,0,15,0
1681935732262,WCWP 10B,B00,201695,Staff,15,0,15,0
1681935733284,WCWP 100,A00,201716,Staff,12,0,15,3
1681935733284,WCWP 100,B00,201717,Staff,0,1,15,15
1681935735393,ANSC 105GS,A00,258289,Staff,0,0,0,0
1681935736416,ANSC 125GS,A00,258295,Staff,0,0,0,0
1681935737438,ANSC 150,A00,258267,Staff,27,0,40,13
1681935738463,ANSC 190GS,A00,258280,Staff,0,0,0,2
1681935739488,ANTH 1,A00,258264,Staff,38,0,40,2
1681935740515,ANTH 2,A01,258259,Staff,72,0,76,4
1681935741539,ANTH 23,A01,258228,Staff,35,0,40,5
1681935742562,ANTH 101,A01,258236,Staff,38,0,40,2
1681935743586,ANTH 102,A00,258272,Staff,59,0,60,1
1681935744614,ANTH 105,A00,258244,Staff,28,0,35,7
1681935745642,BENG 130,A00,253975,Staff,37,0,40,3
1681935746667,BIBC 102,A01,191866,Flagg; Matthew Paul,16,0,32,16
1681935746667,BIBC 102,A02,191867,Flagg; Matthew Paul,20,0,32,12
1681935746667,BIBC 102,A03,191868,Flagg; Matthew Paul,27,0,32,5
1681935746667,BIBC 102,A04,191936,Flagg; Matthew Paul,19,0,32,13
1681935746667,BIBC 102,A05,191937,Flagg; Matthew Paul,0,1,32,32
1681935747695,BICD 100,A01,191939,Cooper; Andrew Michael,27,0,32,5
1681935747695,BICD 100,A02,191940,Cooper; Andrew Michael,32,0,32,0
1681935747695,BICD 100,A03,191941,Cooper; Andrew Michael,32,0,32,0
1681935747695,BICD 100,A04,191942,Cooper; Andrew Michael,32,0,32,0
1681935747695,BICD 100,A05,191943,Cooper; Andrew Michael,32,0,32,0
1681935748729,BIEB 126,A01,191945,Cleland; Elsa Eleanor,0,5,32,32
1681935748729,BIEB 126,A02,191946,Cleland; Elsa Eleanor,25,0,32,7
1681935748729,BIEB 126,A03,191947,Cleland; Elsa Eleanor,29,0,32,3
1681935748729,BIEB 126,A04,191948,Cleland; Elsa Eleanor,15,0,32,17
1681935748729,BIEB 126,A05,191996,Cleland; Elsa Eleanor,28,0,32,4
1681935749769,BIEB 136GS,A00,191997,Shurin; Jonathan & Holway; David A.,0,0,0,9
1681935750793,BIEB 137GS,A01,191999,Shurin; Jonathan & Holway; David A.,0,0,0,8
1681935751829,BILD 1,A01,205385,Staff,29,0,32,3
1681935751829,BILD 1,A02,205386,Staff,30,0,32,2
1681935751829,BILD 1,A03,205387,Staff,31,0,32,1
1681935751829,BILD 1,A04,205388,Staff,25,0,32,7
1681935752853,BILD 2,A01,191774,Staff,24,0,32,8
1681935752853,BILD 2,A02,191775,Staff,29,0,32,3
1681935752853,BILD 2,A03,191777,Staff,29,0,32,3
1681935752853,BILD 2,A04,191856,Staff,30,0,32,2
1681935752853,BILD 2,A05,191857,Staff,31,0,32,1
1681935752853,BILD 2,A06,191858,Staff,32,0,32,0
1681935752853,BILD 2,A07,191859,Staff,31,0,32,1
1681935753881,BILD 3,A01,205391,Staff,26,0,32,6
1681935753881,BILD 3,A02,205393,Staff,32,0,32,0
1681935753881,BILD 3,A03,205394,Staff,26,0,32,6
1681935753881,BILD 3,A04,205395,Staff,32,0,32,0
1681935754912,BILD 20,A01,191861,Staff,32,0,32,0
1681935754912,BILD 20,A02,191862,Staff,32,0,32,0
1681935755935,BILD 30,A01,191864,Staff,31,0,32,1
1681935756963,BIMM 100,A01,192019,Staff,0,0,32,32
1681935756963,BIMM 100,A02,192020,Staff,9,0,32,23
1681935756963,BIMM 100,A03,192035,Staff,17,0,32,15
1681935757998,BIMM 110,A01,192037,Tat; John,0,0,32,32
1681935757998,BIMM 110,A02,192038,Tat; John,4,0,32,28
1681935759033,BIMM 120,A01,192040,Pickett; Brooke Elizabeth,0,0,32,32
1681935759033,BIMM 120,A02,192041,Pickett; Brooke Elizabeth,7,0,32,25
1681935759033,BIMM 120,A03,192042,Pickett; Brooke Elizabeth,14,0,32,18
1681935760061,BIPN 100,A01,192044,Armour; Jon Christopher,23,0,32,9
1681935760061,BIPN 100,A02,192059,Armour; Jon Christopher,30,0,32,2
1681935760061,BIPN 100,A03,192064,Armour; Jon Christopher,30,0,32,2
1681935760061,BIPN 100,A04,192073,Armour; Jon Christopher,26,0,32,6
1681935761086,BIPN 148,A01,205411,Leutgeb; Jill K.,14,0,32,18
1681935761086,BIPN 148,A02,205412,Leutgeb; Jill K.,31,0,32,1
1681935761086,BIPN 148,A03,205413,Leutgeb; Jill K.,29,0,32,3
1681935761086,BIPN 148,A04,205414,Leutgeb; Jill K.,30,0,32,2
1681935762114,BIPN 160,A01,192115,Marino; Marc J,15,0,32,17
1681935762114,BIPN 160,A02,192148,Marino; Marc J,27,0,32,5
1681935762114,BIPN 160,A03,192158,Marino; Marc J,31,0,32,1
1681935762114,BIPN 160,A04,192190,Marino; Marc J,32,0,32,0
1681935762114,BIPN 160,A05,192287,Marino; Marc J,32,0,32,0
1681935762114,BIPN 160,A06,192288,Marino; Marc J,32,0,32,0
1681935763148,BIPN 194,A00,206038,Leutgeb; Stefan,28,0,32,4
1681935764171,BISP 194,A00,192289,Nieh; James Charles,8,0,32,24
1681935764171,BISP 194,B00,245332,Staff,26,0,32,6
1681935765208,CAT 124,A01,202247,Staff,15,0,15,0
1681935766234,CAT 125,A00,202248,Staff,18,0,20,2
1681935766234,CAT 125,B00,202253,Staff,20,0,20,0
1681935766234,CAT 125,C00,202257,Staff,17,0,20,3
1681935767264,CAT 125GS,A01,202273,Bronstein; Phoebe Malan,20,0,20,0
1681935768292,CAT 125R,A00,202284,Staff,17,0,20,3
1681935768292,CAT 125R,C00,202286,Staff,3,0,20,17
1681935768292,CAT 125R,D00,202291,Staff,15,0,20,5
1681935768292,CAT 125R,E00,202295,Staff,13,0,20,7
1681935768292,CAT 125R,F00,202302,Staff,5,0,20,15
1681935769315,CENG 100,A00,204724,Opatkiewicz; Justin Paul,23,0,25,2
1681935770337,CGS 2A,A01,180420,Staff,29,0,36,7
1681935771363,CGS 101,A00,180421,Staff,14,0,20,6
1681935772388,CGS 112,A00,180422,Staff,7,0,16,9
1681935773410,CGS 113,A00,180423,Staff,18,0,20,2
1681935774437,CGS 137,A00,180424,Staff,12,0,12,0
1681935775463,CGS 147,A00,180425,Staff,10,0,10,0
1681935776486,CHEM 6A,A01,179556,Staff,92,0,100,8
1681935776486,CHEM 6A,A02,179558,Staff,0,0,0,0
1681935777520,CHEM 6B,A01,179560,Staff,100,0,100,0
1681935778562,CHEM 6C,A01,179565,Jazzar; Rodolphe,90,0,100,10
1681935779592,CHEM 7L,A01,179586,Schurmeier; Kimberly,9,0,24,15
1681935779592,CHEM 7L,A02,179587,Schurmeier; Kimberly,22,0,24,2
1681935779592,CHEM 7L,A03,179590,Schurmeier; Kimberly,22,0,24,2
1681935779592,CHEM 7L,A04,179591,Schurmeier; Kimberly,22,0,24,2
1681935779592,CHEM 7L,B01,179598,Schurmeier; Kimberly,13,0,24,11
1681935779592,CHEM 7L,B02,179599,Schurmeier; Kimberly,23,0,24,1
1681935779592,CHEM 7L,B03,179606,Schurmeier; Kimberly,22,0,24,2
1681935779592,CHEM 7L,B04,179607,Schurmeier; Kimberly,22,0,24,2
1681935780623,CHEM 11,A01,179609,Stallings; Dontarie M,85,0,100,15
1681935781649,CHEM 40A,A01,179621,Staff,37,0,50,13
1681935781649,CHEM 40A,A02,179622,Staff,44,0,50,6
1681935782677,CHEM 40B,A01,179630,Weizman; Haim,45,0,50,5
1681935782677,CHEM 40B,A02,179631,Weizman; Haim,42,0,50,8
1681935783712,CHEM 41A,A01,179660,Klosterman; Jeremy K,90,0,100,10
1681935784735,CHEM 43A,A01,179683,Klosterman; Jeremy K,0,0,24,24
1681935784735,CHEM 43A,A02,179688,Klosterman; Jeremy K,5,0,24,19
1681935784735,CHEM 43A,A03,179689,Klosterman; Jeremy K,16,0,24,8
1681935784735,CHEM 43A,A04,179691,Klosterman; Jeremy K,17,0,24,7
1681935785760,CHEM 114A,A01,179693,Stallings; Dontarie M,61,0,100,39
1681935786783,CHEM 143B,A01,179698,Weizman; Haim,16,0,24,8
1681935786783,CHEM 143B,A02,179700,Weizman; Haim,23,0,24,1
1681935787809,CHIN 169A,A00,179701,Wang; Xiao,20,0,20,0
1681935788832,COGS 2,A01,179750,Boyle; Mary E. T.,16,0,30,14
1681935789857,COGS 9,A01,179759,Jones; Cameron Robert,40,0,50,10
1681935790889,COGS 14A,A01,179854,Staff,5,0,50,45
1681935791912,COGS 14B,A01,179856,Staff,49,0,60,11
1681935792937,COGS 17,A01,179874,Staff,69,0,75,6
1681935793962,COGS 18,A01,179884,Staff,57,0,80,23
1681935794988,COGS 100,A01,179886,Staff,26,0,60,34
1681935796014,COGS 101B,A01,179892,Staff,0,5,30,30
1681935797047,COGS 101C,A01,179894,Staff,25,0,30,5
1681935798072,COGS 107A,A01,179896,Boyle; Mary E. T.,28,0,40,12
1681935799103,COGS 108,A01,179898,Simpkins; Charles Alexander,0,35,60,60
1681935800129,COGS 109,A01,179900,Staff,32,0,40,8
1681935801154,COGS 118A,A01,179946,Staff,2,0,40,38
1681935802180,COGS 153,A00,179978,Staff,0,7,30,30
1681935803280,COGS 156,A01,179981,Staff,19,0,30,11
1681935805335,COGS 172,A01,179987,Staff,6,0,30,24
1681935807389,COGS 186,A01,179991,Staff,9,0,30,21
1681935808413,COMM 10,A01,180001,Staff,11,0,25,14
1681935808413,COMM 10,A02,180004,Staff,20,0,25,5
1681935809439,COMM 100A,A01,180016,Staff,12,0,25,13
1681935809439,COMM 100A,A02,180020,Staff,24,0,25,1
1681935810467,COMM 101T,A00,180029,Halm; Gavin Patrick,13,0,35,22
1681935811490,COMM 106V,A00,180043,Staff,33,0,35,2
1681935812513,COMM 109P,A00,180044,Staff,29,0,35,6
1681935813538,COMM 113T,A00,180045,Havis; Allan,31,0,45,14
1681935814564,COMM 132,A00,180046,McKenna; Denise,16,0,30,14
1681935815585,COMM 143,A00,180047,Staff,14,0,30,16
1681935816618,COMM 190,A00,180048,Conner; Thomas Hartnell,13,0,23,10
1681935817645,CSE 8A,A50,180053,Cao; Yingjun,19,0,50,31
1681935817645,CSE 8A,B50,180180,Staff,49,0,50,1
1681935818670,CSE 11,A01,180190,Cao; Yingjun,15,0,50,35
1681935819698,CSE 20,A01,180192,Briones; Jor-el Thomas Caparas,20,0,30,10
1681935820726,CSE 21,A01,194538,Briones; Jor-el Thomas Caparas,49,0,60,11
1681935821756,CSE 30,A01,180324,Eldon; John,69,0,100,31
1681935822787,CSE 101,A01,201353,Staff,0,34,40,40
1681935823814,CSE 134B,A01,180326,Powell; Thomas Allan,68,0,100,32
1681935824850,CSE 140,A01,180328,Staff,17,0,75,58
1681935825876,CSE 140L,A01,180344,Eldon; John,43,0,100,57
1681935826906,CSE 150A,A01,180411,Staff,0,20,50,50
1681935827931,CSE 151A,A01,180414,Staff,0,17,50,50
1681935828962,CSE 175,A01,222521,Kumar; Rakesh,50,0,50,0
1681935829989,CSE 190,A00,201419,Staff,42,0,49,7
1681935831012,CSS 1,A01,194536,Staff,30,0,50,20
1681935832039,DSC 30,A01,202385,Staff,48,0,50,2
1681935833066,DSC 40A,A01,202387,Albuyeh; Rod,50,0,50,0
1681935834104,DSC 190,A01,202389,Silberman; Jack,21,0,21,0
1681935835133,DSGN 100,A01,179993,Staff,12,0,30,18
1681935836155,ECE 65,A50,180708,Staff,10,0,20,10
1681935836155,ECE 65,A51,180739,Staff,19,0,20,1
1681935837179,ECON 1,A01,180427,Famulari; Melissa,65,0,70,5
1681935838209,ECON 2,A01,180450,Levkoff; Steven B.,62,0,70,8
1681935839232,ECON 4,A01,203351,Anderson; John Charles,6,0,10,4
1681935840270,ECON 100A,A01,180472,Famulari; Melissa,59,0,70,11
1681935841294,ECON 120A,A01,180549,Staff,59,0,70,11
1681935842320,ECON 120B,A01,180655,Ma; Xinwei,31,0,70,39
1681935843343,ECON 129,A00,203333,Eckert; Fabian Paul,5,0,35,30
1681935844365,ECON 131,A00,180656,Staff,0,4,35,35
1681935845389,ECON 172B,A01,180672,Levkoff; Steven B.,30,0,35,5
1681935846414,ECON 178,A01,203342,Zhu; Ying,2,0,35,33
1681935847439,EDS 108GS,A00,202383,Wishard Guerra; Alison G.,20,0,20,0
1681935848464,EDS 111GS,A00,202347,Wishard Guerra; Alison G.,20,0,20,0
1681935849488,EDS 112,A01,202323,Staff,52,0,60,8
1681935850521,EDS 113,A00,202340,Staff,31,0,35,4
1681935851547,EDS 118,A00,201231,Staff,19,0,30,11
1681935852570,EDS 119,A00,204994,Staff,8,0,10,2
1681935853603,EDS 124BR,A00,202324,Eguchi; Emi,0,4,25,25
1681935854627,EDS 126,A01,203208,Jones; Makeba,26,0,30,4
1681935855652,EDS 135,A01,202333,Staff,17,0,20,3
1681935856675,EDS 180,A00,202311,Staff,47,0,50,3
1681935857700,ERC 190GS,A01,253747,Staff,28,0,28,0
1681935858723,ETHN 104,A00,180742,Staff,20,0,35,15
1681935859748,ETHN 118,A00,180745,Staff,26,0,35,9
1681935860772,ETHN 127,A00,180747,Staff,8,0,16,8
1681935861797,ETHN 137,A00,180880,Staff,11,0,12,1
1681935862820,ETHN 147,A00,180890,Staff,8,0,10,2
1681935863847,ETHN 154,A00,180891,Staff,4,0,8,4
1681935864869,ETHN 168,A00,180892,Staff,9,0,10,1
1681935865895,GLBH 20,A00,201051,Hannah; Seth Donal,0,7,0,1
1681935866921,GLBH 111,A01,209338,Burgos; Jose L.,0,0,0,0
1681935867947,GLBH 150,A00,258300,Staff,0,4,0,0
1681935869021,GLBH 181,A00,201207,Staff,2,0,40,38
1681935870046,HIEU 109,A00,180898,Staff,19,0,20,1
1681935871069,HIEU 111,A00,180899,Staff,0,2,20,20
1681935872095,HIEU 124,A00,180900,Staff,16,0,20,4
1681935873120,HILA 122,A00,180901,Staff,17,0,20,3
1681935874143,HILA 132,A00,180902,Vitz; Matthew,0,3,20,20
1681935875166,HILD 10,A01,180896,Staff,11,0,20,9
1681935876188,HILD 30GS,A00,180897,Edington; Claire Ellen,0,0,0,0
1681935877223,HISC 105,A00,180903,Staff,20,0,20,0
1681935878248,HISC 117,A00,180904,Staff,10,0,20,10
1681935879271,HIUS 108B,A00,181005,Staff,17,0,20,3
1681935880296,HIUS 113,A00,181093,Staff,0,1,20,20
1681935881330,HUM 3,A01,181190,Patterson; Patrick H.,33,0,50,17
1681935881330,HUM 3,B01,181195,Staff,43,0,50,7
1681935882356,HUM 3GS,A00,181196,Herbst; Matthew,0,0,0,0
1681935883378,HUM 4,A01,181227,West; Geoffrey Scott,33,0,50,17
1681935883378,HUM 4,B01,181282,Staff,41,0,50,9
1681935884404,HUM 4GS,A00,181377,Lyon; Antony J.,0,0,0,0
1681935885426,HUM 5,A01,181536,Zavodny; Tatiana Sophia,22,0,50,28
1681935885426,HUM 5,B01,181908,Staff,31,0,50,19
1681935886453,INTL 190,A00,181909,Segui; Alan S,0,0,0,8
1681935886453,INTL 190,B00,181961,Segui; Alan S,0,0,0,7
1681935887476,JAPN 20AR,A01,182113,Ross; Kayoko F,15,0,20,5
1681935888502,LATI 50,A01,202391,Martin-Cabrera; Luis,15,0,30,15
1681935888502,LATI 50,A02,202392,Martin-Cabrera; Luis,26,0,30,4
1681935889538,LATI 180,A00,202393,Kokinis; Troy Andreas,24,0,25,1
1681935890562,LIFR 1A,A00,182119,Staff,13,0,14,1
1681935891585,LIFR 1AX,A00,182324,Staff,13,0,14,1
1681935892607,LIFR 1B,A00,182259,Staff,11,0,14,3
1681935893632,LIFR 1BX,A00,182273,Staff,11,0,14,3
1681935894655,LIGN 8,A00,182330,Staff,123,0,150,27
1681935895687,LIGN 9GS,A00,182362,Staff,14,0,20,6
1681935896712,LIGN 119,A00,204992,Takahashi; Maho,11,0,15,4
1681935897737,LIGN 130,A01,182384,Staff,47,0,50,3
1681935898763,LIGN 149GS,A00,182390,Staff,14,0,20,6
1681935899800,LIGN 170,A00,182404,Staff,23,0,30,7
1681935900828,LISP 1D,A00,182281,Staff,6,0,14,8
1681935900828,LISP 1D,B00,182287,Staff,13,0,14,1
1681935900828,LISP 1D,C00,182295,Staff,10,0,14,4
1681935900828,LISP 1D,D00,182301,Staff,14,0,14,0
1681935901851,LISP 1DX,A00,182309,Staff,18,0,28,10
1681935901851,LISP 1DX,B00,182316,Staff,25,0,28,3
1681935902877,LTAF 120GS,A00,182412,Zhiri; Oumelbanine,20,0,20,0
1681935903900,LTCS 172GS,A00,182437,Bronstein; Phoebe Malan,20,0,20,0
1681935904925,LTEA 138,A00,182457,Staff,13,0,40,27
1681935905951,LTEN 114,A01,182490,Staff,23,0,25,2
1681935907061,LTEN 130GS,A00,182491,Lyon; Antony J.,20,0,20,0
1681935908087,LTEN 169,A00,182493,Cuong; Marisol,17,0,25,8
1681935909122,LTEN 178,A00,182501,Staff,14,0,15,1
1681935910144,LTEN 181,A00,182515,Staff,19,0,25,6
1681935911173,LTEN 185GS,A00,197655,Forbes; Camille,20,0,20,0
1681935912194,LTSP 100B,A00,202208,Bessett; Ryan Matthew,24,0,25,1
1681935913232,LTWL 100,A00,182516,Myerston Santana; Jacobo,19,0,30,11
1681935914255,LTWR 100GS,A00,182518,Forbes; Camille,20,0,20,0
1681935915278,LTWR 102,A00,182522,Staff,15,0,15,0
1681935915278,LTWR 102,B00,182525,Staff,14,0,15,1
1681935916300,LTWR 115,A00,182526,Staff,9,0,15,6
1681935917324,MAE 8,A01,182528,Pham; Hieu Tan,65,0,70,5
1681935918350,MAE 11,A00,182529,Bahadori; Mohammad Yousef,88,0,100,12
1681935919377,MAE 20,A00,182530,Evdokimenko; Ekaterina,66,0,70,4
1681935920399,MAE 30A,A00,182532,Staff,44,0,45,1
1681935921435,MAE 101A,A00,182533,Bahadori; Mohammad Yousef,93,0,100,7
1681935922459,MAE 101C,A00,182538,Staff,62,0,70,8
1681935923485,MAE 104,A00,182539,Staff,44,0,50,6
1681935924524,MAE 131A,A00,182540,Ghazinejad; Maziar,40,0,45,5
1681935925556,MAE 143A,A00,182548,Bewley; Thomas R,42,0,50,8
1681935926578,MAE 150,A00,182549,Staff,28,0,40,12
1681935927611,MAE 160,A00,182550,Evdokimenko; Ekaterina,37,0,60,23
1681935928637,MATH 3C,A01,182725,Staff,24,0,30,6
1681935929658,MATH 10A,A01,182729,Staff,24,0,30,6
1681935929658,MATH 10A,B01,182732,Staff,25,0,30,5
1681935930681,MATH 10B,A01,182737,Staff,15,0,30,15
1681935930681,MATH 10B,A02,182738,Staff,24,0,30,6
1681935930681,MATH 10B,B01,182744,Staff,24,0,30,6
1681935930681,MATH 10B,B02,182745,Staff,27,0,30,3
1681935931704,MATH 18,A01,182750,Anzaldo; Leesa B,28,0,30,2
1681935931704,MATH 18,A02,182751,Anzaldo; Leesa B,28,0,30,2
1681935931704,MATH 18,A03,182753,Anzaldo; Leesa B,27,0,30,3
1681935931704,MATH 18,A04,182757,Anzaldo; Leesa B,29,0,30,1
1681935931704,MATH 18,B01,182761,Anzaldo; Leesa B,26,0,30,4
1681935931704,MATH 18,B02,182764,Anzaldo; Leesa B,26,0,30,4
1681935931704,MATH 18,B03,182765,Anzaldo; Leesa B,29,0,30,1
1681935931704,MATH 18,B04,182766,Anzaldo; Leesa B,30,0,30,0
1681935932727,MATH 20A,A01,182771,Suk; Andrew Hoon,27,0,30,3
1681935933751,MATH 20B,A01,182775,Bach; Quang Tran,30,0,30,0
1681935933751,MATH 20B,A02,182777,Bach; Quang Tran,29,0,30,1
1681935933751,MATH 20B,B01,182780,Bach; Quang Tran,26,0,30,4
1681935933751,MATH 20B,B02,182782,Bach; Quang Tran,30,0,30,0
1681935934776,MATH 20C,A01,182787,Staff,23,0,30,7
1681935934776,MATH 20C,A02,182790,Staff,29,0,30,1
1681935934776,MATH 20C,B01,182792,Staff,23,0,30,7
1681935934776,MATH 20C,B02,182796,Staff,26,0,30,4
1681935935808,MATH 20D,A01,182799,Staff,26,0,30,4
1681935935808,MATH 20D,A02,182802,Staff,29,0,30,1
1681935935808,MATH 20D,A03,182803,Staff,30,0,30,0
1681935936832,MATH 20E,A01,182809,Verstraete; Jacques Allan,18,0,30,12
1681935936832,MATH 20E,A02,182811,Verstraete; Jacques Allan,26,0,30,4
1681935936832,MATH 20E,B01,182814,Verstraete; Jacques Allan,20,0,30,10
1681935936832,MATH 20E,B02,182815,Verstraete; Jacques Allan,27,0,30,3
1681935937856,MATH 103A,A01,182820,Staff,2,0,30,28
1681935937856,MATH 103A,A02,182821,Staff,26,0,30,4
1681935937856,MATH 103A,A03,182822,Staff,18,0,30,12
1681935937856,MATH 103A,B01,182825,Staff,21,0,30,9
1681935937856,MATH 103A,B02,182826,Staff,30,0,30,0
1681935937856,MATH 103A,B03,182830,Staff,30,0,30,0
1681935938895,MATH 109,A01,182836,Chow; Bennett,23,0,30,7
1681935938895,MATH 109,A02,182838,Chow; Bennett,27,0,30,3
1681935938895,MATH 109,A03,182894,Chow; Bennett,29,0,30,1
1681935938895,MATH 109,B01,182908,Chow; Bennett,26,0,30,4
1681935938895,MATH 109,B02,182909,Chow; Bennett,30,0,30,0
1681935938895,MATH 109,B03,182910,Chow; Bennett,26,0,30,4
1681935939923,MATH 142A,A01,182925,Staff,3,0,30,27
1681935939923,MATH 142A,A02,182935,Staff,23,0,30,7
1681935939923,MATH 142A,A03,182967,Staff,22,0,30,8
1681935939923,MATH 142A,B01,183125,Staff,22,0,30,8
1681935939923,MATH 142A,B02,183157,Staff,26,0,30,4
1681935939923,MATH 142A,B03,183158,Staff,29,0,30,1
1681935940947,MATH 183,A01,183160,Arias-Castro; Ery,22,0,30,8
1681935940947,MATH 183,A02,183161,Arias-Castro; Ery,28,0,30,2
1681935940947,MATH 183,B01,183163,Arias-Castro; Ery,26,0,30,4
1681935940947,MATH 183,B02,183164,Arias-Castro; Ery,28,0,30,2
1681935941972,MATH 193A,A01,183167,Staff,0,0,35,35
1681935941972,MATH 193A,A02,183168,Staff,20,0,35,15
1681935941972,MATH 193A,A03,183169,Staff,32,0,35,3
1681935941972,MATH 193A,A04,183170,Staff,26,0,35,9
1681935942995,MGT 4,A01,202395,Anderson; John Charles,76,0,80,4
1681935944025,MGT 5,A00,202396,Houskeeper; Robert,78,0,90,12
1681935945056,MGT 103,A00,202397,Eberhard; Craig A,45,0,90,45
1681935946086,MGT 131A,A00,202398,Houskeeper; Robert,81,0,90,9
1681935947110,MGT 135,A00,202399,Anderson; John Charles,81,0,90,9
1681935948136,MGT 162R,A00,202403,Gneezy; Uri,111,0,200,89
1681935949160,MGT 172,A00,202404,Hedges; Kathleen,18,0,90,72
1681935950193,MGT 181,A00,202405,Dunn; Louis Jean,74,0,90,16
1681935951216,MMW 14,A01,183200,Staff,0,0,28,28
1681935951216,MMW 14,A02,183201,Staff,25,0,28,3
1681935951216,MMW 14,A03,183202,Staff,23,0,28,5
1681935951216,MMW 14,A04,183203,Staff,25,0,28,3
1681935951216,MMW 14,A05,183204,Staff,25,0,28,3
1681935951216,MMW 14,A06,183205,Staff,27,0,28,1
1681935951216,MMW 14,B01,183207,Staff,26,0,28,2
1681935951216,MMW 14,B02,183208,Staff,28,0,28,0
1681935951216,MMW 14,B03,183209,Staff,28,0,28,0
1681935951216,MMW 14,B04,183210,Staff,28,0,28,0
1681935951216,MMW 14,B05,183211,Staff,28,0,28,0
1681935951216,MMW 14,B06,183212,Staff,27,0,28,1
1681935952243,MMW 14GS,A00,183213,Zhiri; Oumelbanine,28,0,28,0
1681935953265,MMW 15GS,B00,183215,Rahimi; Babak,27,0,28,1
1681935954289,MMW 121,A01,183217,Patterson; Patrick H.,5,0,28,23
1681935954289,MMW 121,A02,183218,Patterson; Patrick H.,25,0,28,3
1681935955311,MUS 1A,A01,182554,Staff,0,1,35,35
1681935956334,MUS 5,A01,182558,Staff,14,0,35,21
1681935957356,MUS 6,A01,182562,Staff,21,0,35,14
1681935958382,MUS 8GS,A00,182563,Borgo; David Garcia,25,0,25,0
1681935959415,MUS 13,A01,182567,Staff,23,0,25,2
1681935960445,MUS 15,A01,182570,Staff,31,0,35,4
1681935960445,MUS 15,B01,182575,Staff,6,0,35,29
1681935961470,MUS 80,A00,182578,Staff,22,0,25,3
1681935961470,MUS 80,B00,182581,Staff,20,0,25,5
1681935962492,MUS 113,A00,182582,Staff,25,0,25,0
1681935963517,MUS 114,A00,182583,Staff,0,2,25,25
1681935964542,MUS 150GS,A01,182588,Borgo; David Garcia,24,0,25,1
1681935965566,PHIL 1,A00,182590,Staff,34,0,40,6
1681935966599,PHIL 10,A01,182596,Grush; Rick Scott,30,0,35,5
1681935966599,PHIL 10,A02,182597,Grush; Rick Scott,33,0,35,2
1681935967624,PHIL 15,A01,182601,Staff,31,0,35,4
1681935967624,PHIL 15,A02,182602,Staff,33,0,35,2
1681935968658,PHIL 27,A01,182604,Staff,23,0,35,12
1681935968658,PHIL 27,A02,182607,Staff,33,0,35,2
1681935969681,PHIL 32,A01,182609,Staff,35,0,35,0
1681935969681,PHIL 32,A02,182612,Staff,35,0,35,0
1681935970710,PHIL 130,A00,182614,Staff,57,0,70,13
1681935971746,PHIL 136,A00,182616,Cohen; Jonathan David,63,0,70,7
1681935972774,PHIL 155,A00,182617,Vargas; Manuel Rogelio,56,0,70,14
1681935973801,PHIL 163,A01,182620,Staff,15,0,20,5
1681935973801,PHIL 163,A02,182624,Staff,10,0,20,10
1681935974824,PHIL 164,A00,182627,Staff,29,0,40,11
1681935975848,PHIL 173,A00,182628,Staff,35,0,40,5
1681935976881,PHYS 1A,A00,183221,Staff,52,0,60,8
1681935977906,PHYS 1AL,001,183222,Staff,24,0,30,6
1681935977906,PHYS 1AL,002,183223,Staff,24,0,30,6
1681935978933,PHYS 1B,A00,183231,Staff,39,0,60,21
1681935979957,PHYS 1BL,001,183232,Staff,15,0,30,15
1681935979957,PHYS 1BL,002,183233,Staff,27,0,30,3
1681935980980,PHYS 1C,A00,183240,Staff,19,0,60,41
1681935982006,PHYS 1CL,001,183241,Staff,7,0,30,23
1681935982006,PHYS 1CL,002,183242,Staff,21,0,30,9
1681935983033,PHYS 2AR,A01,183250,Staff,39,0,50,11
1681935984060,PHYS 2B,A01,183252,Staff,101,0,115,14
1681935985089,PHYS 2BL,A01,183254,Staff,21,0,24,3
1681935985089,PHYS 2BL,A02,183255,Staff,21,0,24,3
1681935986112,PHYS 2C,A01,183522,Staff,100,0,115,15
1681935987135,PHYS 4A,A01,183524,Staff,49,0,50,1
1681935988162,POLI 5,A00,183525,Staff,43,0,50,7
1681935989191,POLI 12,A00,183540,Staff,45,0,50,5
1681935990213,POLI 13R,A00,183541,Forman; Fonna,39,0,50,11
1681935991248,POLI 30,A00,183542,Mignozzetti; Umberto,48,0,50,2
1681935992271,POLI 100A,A00,183543,Staff,43,0,50,7
1681935993293,POLI 100E,A00,223598,Staff,32,0,35,3
1681935994315,POLI 103A,A00,183564,Kousser; Thad,35,0,50,15
1681935995346,POLI 104B,A00,201329,Staff,27,0,35,8
1681935996369,POLI 113BR,A00,183576,Hoston; Germaine,21,0,50,29
1681935997390,POLI 114BR,A00,183588,Staff,26,0,30,4
1681935998412,POLI 117R,A00,183595,Forman; Fonna,2,0,20,18
1681935999444,POLI 120H,A00,183596,Fisk; David Lee,12,0,20,8
1681936000467,POLI 130AA,A00,183597,Staff,13,0,20,7
1681936001491,POLI 134AA,A00,183598,Staff,19,0,20,1
1681936002516,POLI 135,A00,183599,Fisk; David Lee,18,0,25,7
1681936003542,POLI 142P,A00,183623,Staff,37,0,40,3
1681936004564,POLI 144D,A00,183624,Staff,22,0,25,3
1681936005597,POLI 151,A00,183625,Staff,14,0,20,6
1681936006621,POLI 162,A00,183626,Mignozzetti; Umberto,17,0,20,3
1681936007644,PSYC 1,A00,253748,Staff,85,0,90,5
1681936008681,PSYC 2,A00,183627,Moranton; Nirelia Melbina-,22,0,35,13
1681936009706,PSYC 3,A00,183628,Staff,42,0,45,3
1681936011834,PSYC 60,A01,183631,Lowe; Angela Beth,34,0,40,6
1681936012860,PSYC 70,A01,253757,Staff,33,0,45,12
1681936013885,PSYC 101,A00,183632,Heyman; Gail D.,39,0,60,21
1681936014908,PSYC 105,A00,183848,Lowe; Angela Beth,41,0,60,19
1681936015931,PSYC 106,A00,183849,Dobkins; Karen R.,33,0,60,27
1681936016972,PSYC 108,A00,253750,Staff,5,0,60,55
1681936017994,PSYC 114,A01,184275,Winkielman; Piotr,0,8,30,30
1681936019016,PSYC 122,A00,183856,Moranton; Nirelia Melbina-,0,17,30,30
1681936020037,PSYC 124,A00,183865,Chapman; Eddie Nathaniel,40,0,80,40
1681936021065,PSYC 137,A00,183880,Staff,15,0,25,10
1681936023112,PSYC 154,A00,183910,Lacefield; Katharine I,0,33,90,90
1681936025159,PSYC 162,A00,183946,Wixted; John T,34,0,90,56
1681936026184,PSYC 172,A00,183947,Gorman; Michael R.,3,0,30,27
1681936027208,PSYC 178,A00,183963,Glaser; Dale,10,0,40,30
1681936028234,PSYC 181GS,A00,183964,Anagnostaras; Stephan,10,0,10,0
1681936029259,PSYC 186GS,A01,257660,Staff,10,0,10,0
1681936030286,PSYC 193,B00,253749,Staff,22,0,25,3
1681936032338,PSYC 193L,A01,184122,Staff,33,0,35,2
1681936032338,PSYC 193L,C01,184167,Winkielman; Piotr,14,0,30,16
1681936033360,RELI 188GS,A00,182629,Rahimi; Babak,20,0,20,0
1681936034403,SE 101A,A00,182646,Staff,25,0,30,5
1681936035425,SE 101C,A00,182650,Staff,9,0,20,11
1681936036448,SE 110A,A00,182651,Staff,28,0,28,0
1681936037486,SE 130A,A00,182652,Staff,37,0,40,3
1681936038510,SIO 46GS,A00,182636,Cook; Geoffrey W,23,0,28,5
1681936039536,SIO 109R,A00,194459,Staff,0,2,20,20
1681936040559,SIO 121GS,A00,182639,Cook; Geoffrey W,23,0,28,5
1681936041581,SIO 132,A01,182642,Staff,30,0,40,10
1681936042604,SIO 139,A00,182644,Kacev; David,36,0,40,4
1681936043627,SOCI 2,A01,258404,Staff,33,0,36,3
1681936043627,SOCI 2,A02,258405,Staff,35,0,36,1
1681936044653,SOCI 60,A01,258408,Staff,29,0,30,1
1681936044653,SOCI 60,A02,258413,Staff,30,0,30,0
1681936045687,SOCI 100,A01,258415,Staff,28,0,30,2
1681936045687,SOCI 100,A02,258416,Staff,28,0,30,2
1681936051851,SOCI 127,A00,258421,Staff,18,0,30,12
1681936052874,SOCI 132,A00,258422,Staff,41,0,50,9
1681936053900,SOCI 133,A00,258423,Staff,26,0,30,4
1681936054925,SOCI 138GS,A00,258424,Staff,15,0,15,0
1681936055952,SOCI 145,A00,258425,Staff,23,0,30,7
1681936056976,SOCI 148,A00,258426,Staff,23,0,30,7
1681936058010,SOCI 153,A00,199217,Staff,30,0,30,0
1681936059034,SOCI 160,A00,258427,Staff,26,0,30,4
1681936060057,SOCI 160E,A00,258435,Staff,55,0,60,5
1681936061080,SOCI 189GS,A00,258436,Staff,15,0,15,0
1681936062102,SOCI 190GS,A00,258437,Staff,15,0,15,0
1681936063125,SYN 2,001,182658,Staff,7,0,16,9
1681936063125,SYN 2,002,201439,Staff,13,0,16,3
1681936063125,SYN 2,003,201443,Staff,15,0,16,1
1681936064148,SYN 100,A01,182657,Staff,9,0,20,11
1681936065174,TDAC 1,A00,184381,Salovey; Todd,16,0,20,4
1681936065174,TDAC 1,B00,184385,Harting; Carla Kelso,19,0,20,1
1681936065174,TDAC 1,C00,184394,Staff,18,0,20,2
1681936066197,TDAC 101,A00,184483,Harting; Carla Kelso,19,0,20,1
1681936067220,TDDE 111,A00,184496,Staff,14,0,15,1
1681936068243,TDDE 131,A00,184504,Staff,20,0,20,0
1681936068243,TDDE 131,B00,184505,Staff,17,0,18,1
1681936068243,TDDE 131,C00,184534,Staff,49,0,50,1
1681936068243,TDDE 131,D00,184564,Staff,15,0,15,0
1681936068243,TDDE 131,E00,204725,Staff,18,0,20,2
1681936069276,TDGE 1,A01,184414,Salovey; Todd,33,0,50,17
1681936070299,TDGE 5,A01,184419,Staff,23,0,24,1
1681936071327,TDGE 10,A00,184428,Fulton; Julia,27,0,50,23
1681936072349,TDGE 124,A00,184565,Fulton; Julia,0,6,50,50
1681936073376,TDGE 125,B00,184567,Meyer; Ursula,6,0,25,19
1681936074402,TDHT 101,A00,184568,Staff,21,0,25,4
1681936074402,TDHT 101,B00,184569,Staff,20,0,20,0
1681936075425,TDHT 114,A00,184570,Staff,47,0,50,3
1681936076450,TDMV 1,A00,184437,Arcidiacono; Kristin,21,0,30,9
1681936076450,TDMV 1,B00,184448,Caligagan; Maria T.,23,0,30,7
1681936077479,TDMV 2,A00,184449,Weinberg; Sadie,26,0,30,4
1681936077479,TDMV 2,B00,184453,Arcidiacono; Kristin,29,0,30,1
1681936078505,TDMV 110,A00,184571,Weinberg; Sadie,30,0,30,0
1681936079527,TDMV 142,A00,184572,Caligagan; Tony,26,0,30,4
1681936079527,TDMV 142,B00,184573,Caligagan; Maria T.,26,0,30,4
1681936080552,TDTR 20,A00,184482,Jun; Grace Shin Hae,25,0,25,0
1681936081576,USP 2,A01,184290,Hinds; Juli Beth,23,0,25,2
1681936082612,USP 3,A01,184295,Staff,19,0,25,6
1681936083636,USP 4,A00,184304,McTague; Sarah,11,0,25,14
1681936084670,USP 100,A00,184315,Staff,16,0,25,9
1681936085694,USP 105,A00,184326,Staff,21,0,25,4
1681936086719,USP 151,A00,184327,Staff,15,0,25,10
1681936087742,USP 170,A00,184380,Hinds; Juli Beth,12,0,25,13
1681936088765,VIS 21B,A01,182660,Staff,28,0,31,3
1681936088765,VIS 21B,A02,182662,Staff,30,0,31,1
1681936089790,VIS 103D,A00,182663,Staff,73,0,75,2
1681936090814,VIS 105D,A00,182667,Li; Huai,14,0,22,8
1681936091837,VIS 122GS,A00,182668,Herbst; Matthew,20,0,20,0
1681936092860,VIS 128C,A00,182673,Staff,68,0,75,7
1681936093893,VIS 130,A00,182675,Staff,19,0,22,3
1681936094916,VIS 160A,A00,182678,Stalbaum; Brett,4,0,10,6
1681936096974,WCWP 10B,A00,201679,Staff,15,0,15,0
1681936096974,WCWP 10B,B00,201695,Staff,15,0,15,0
1681936098001,WCWP 100,A00,201716,Staff,12,0,15,3
1681936098001,WCWP 100,B00,201717,Staff,0,1,15,15
1681936100063,ANSC 105GS,A00,258289,Staff,0,0,0,0
1681936101087,ANSC 125GS,A00,258295,Staff,0,0,0,0
1681936102112,ANSC 150,A00,258267,Staff,27,0,40,13
1681936103145,ANSC 190GS,A00,258280,Staff,0,0,0,2
1681936104168,ANTH 1,A00,258264,Staff,38,0,40,2
1681936105191,ANTH 2,A01,258259,Staff,72,0,76,4
1681936106222,ANTH 23,A01,258228,Staff,35,0,40,5
1681936107247,ANTH 101,A01,258236,Staff,38,0,40,2
1681936108277,ANTH 102,A00,258272,Staff,59,0,60,1
1681936109304,ANTH 105,A00,258244,Staff,28,0,35,7
1681936110332,BENG 130,A00,253975,Staff,37,0,40,3
1681936111356,BIBC 102,A01,191866,Flagg; Matthew Paul,16,0,32,16
1681936111356,BIBC 102,A02,191867,Flagg; Matthew Paul,20,0,32,12
1681936111356,BIBC 102,A03,191868,Flagg; Matthew Paul,27,0,32,5
1681936111356,BIBC 102,A04,191936,Flagg; Matthew Paul,19,0,32,13
1681936111356,BIBC 102,A05,191937,Flagg; Matthew Paul,0,1,32,32
1681936112383,BICD 100,A01,191939,Cooper; Andrew Michael,27,0,32,5
1681936112383,BICD 100,A02,191940,Cooper; Andrew Michael,32,0,32,0
1681936112383,BICD 100,A03,191941,Cooper; Andrew Michael,32,0,32,0
1681936112383,BICD 100,A04,191942,Cooper; Andrew Michael,32,0,32,0
1681936112383,BICD 100,A05,191943,Cooper; Andrew Michael,32,0,32,0
1681936113411,BIEB 126,A01,191945,Cleland; Elsa Eleanor,0,5,32,32
1681936113411,BIEB 126,A02,191946,Cleland; Elsa Eleanor,25,0,32,7
1681936113411,BIEB 126,A03,191947,Cleland; Elsa Eleanor,29,0,32,3
1681936113411,BIEB 126,A04,191948,Cleland; Elsa Eleanor,15,0,32,17
1681936113411,BIEB 126,A05,191996,Cleland; Elsa Eleanor,28,0,32,4
1681936114509,BIEB 136GS,A00,191997,Shurin; Jonathan & Holway; David A.,0,0,0,9
1681936115532,BIEB 137GS,A01,191999,Shurin; Jonathan & Holway; David A.,0,0,0,8
1681936116559,BILD 1,A01,205385,Staff,29,0,32,3
1681936116559,BILD 1,A02,205386,Staff,30,0,32,2
1681936116559,BILD 1,A03,205387,Staff,31,0,32,1
1681936116559,BILD 1,A04,205388,Staff,25,0,32,7
1681936117598,BILD 2,A01,191774,Staff,24,0,32,8
1681936117598,BILD 2,A02,191775,Staff,29,0,32,3
1681936117598,BILD 2,A03,191777,Staff,29,0,32,3
1681936117598,BILD 2,A04,191856,Staff,30,0,32,2
1681936117598,BILD 2,A05,191857,Staff,31,0,32,1
1681936117598,BILD 2,A06,191858,Staff,32,0,32,0
1681936117598,BILD 2,A07,191859,Staff,31,0,32,1
1681936118624,BILD 3,A01,205391,Staff,26,0,32,6
1681936118624,BILD 3,A02,205393,Staff,32,0,32,0
1681936118624,BILD 3,A03,205394,Staff,26,0,32,6
1681936118624,BILD 3,A04,205395,Staff,32,0,32,0
1681936119650,BILD 20,A01,191861,Staff,32,0,32,0
1681936119650,BILD 20,A02,191862,Staff,32,0,32,0
1681936120689,BILD 30,A01,191864,Staff,31,0,32,1
1681936121722,BIMM 100,A01,192019,Staff,0,0,32,32
1681936121722,BIMM 100,A02,192020,Staff,9,0,32,23
1681936121722,BIMM 100,A03,192035,Staff,17,0,32,15
1681936122745,BIMM 110,A01,192037,Tat; John,0,0,32,32
1681936122745,BIMM 110,A02,192038,Tat; John,4,0,32,28
1681936123767,BIMM 120,A01,192040,Pickett; Brooke Elizabeth,0,0,32,32
1681936123767,BIMM 120,A02,192041,Pickett; Brooke Elizabeth,7,0,32,25
1681936123767,BIMM 120,A03,192042,Pickett; Brooke Elizabeth,14,0,32,18
1681936124791,BIPN 100,A01,192044,Armour; Jon Christopher,23,0,32,9
1681936124791,BIPN 100,A02,192059,Armour; Jon Christopher,30,0,32,2
1681936124791,BIPN 100,A03,192064,Armour; Jon Christopher,29,0,32,3
1681936124791,BIPN 100,A04,192073,Armour; Jon Christopher,26,0,32,6
1681936125819,BIPN 148,A01,205411,Leutgeb; Jill K.,14,0,32,18
1681936125819,BIPN 148,A02,205412,Leutgeb; Jill K.,31,0,32,1
1681936125819,BIPN 148,A03,205413,Leutgeb; Jill K.,29,0,32,3
1681936125819,BIPN 148,A04,205414,Leutgeb; Jill K.,30,0,32,2
1681936126847,BIPN 160,A01,192115,Marino; Marc J,15,0,32,17
1681936126847,BIPN 160,A02,192148,Marino; Marc J,27,0,32,5
1681936126847,BIPN 160,A03,192158,Marino; Marc J,31,0,32,1
1681936126847,BIPN 160,A04,192190,Marino; Marc J,32,0,32,0
1681936126847,BIPN 160,A05,192287,Marino; Marc J,32,0,32,0
1681936126847,BIPN 160,A06,192288,Marino; Marc J,32,0,32,0
1681936127871,BIPN 194,A00,206038,Leutgeb; Stefan,28,0,32,4
1681936128897,BISP 194,A00,192289,Nieh; James Charles,8,0,32,24
1681936128897,BISP 194,B00,245332,Staff,26,0,32,6
1681936129922,CAT 124,A01,202247,Staff,15,0,15,0
1681936130949,CAT 125,A00,202248,Staff,18,0,20,2
1681936130949,CAT 125,B00,202253,Staff,20,0,20,0
1681936130949,CAT 125,C00,202257,Staff,17,0,20,3
1681936131980,CAT 125GS,A01,202273,Bronstein; Phoebe Malan,20,0,20,0
1681936133003,CAT 125R,A00,202284,Staff,16,0,20,4
1681936133003,CAT 125R,C00,202286,Staff,4,0,20,16
1681936133003,CAT 125R,D00,202291,Staff,14,0,20,6
1681936133003,CAT 125R,E00,202295,Staff,13,0,20,7
1681936133003,CAT 125R,F00,202302,Staff,4,0,20,16
1681936134029,CENG 100,A00,204724,Opatkiewicz; Justin Paul,23,0,25,2
1681936135052,CGS 2A,A01,180420,Staff,29,0,36,7
1681936136075,CGS 101,A00,180421,Staff,14,0,20,6
1681936137099,CGS 112,A00,180422,Staff,7,0,16,9
1681936138124,CGS 113,A00,180423,Staff,18,0,20,2
1681936139150,CGS 137,A00,180424,Staff,12,0,12,0
1681936140177,CGS 147,A00,180425,Staff,10,0,10,0
1681936141202,CHEM 6A,A01,179556,Staff,92,0,100,8
1681936141202,CHEM 6A,A02,179558,Staff,0,0,0,0
1681936142226,CHEM 6B,A01,179560,Staff,100,0,100,0
1681936143254,CHEM 6C,A01,179565,Jazzar; Rodolphe,90,0,100,10
1681936144297,CHEM 7L,A01,179586,Schurmeier; Kimberly,9,0,24,15
1681936144297,CHEM 7L,A02,179587,Schurmeier; Kimberly,22,0,24,2
1681936144297,CHEM 7L,A03,179590,Schurmeier; Kimberly,22,0,24,2
1681936144297,CHEM 7L,A04,179591,Schurmeier; Kimberly,22,0,24,2
1681936144297,CHEM 7L,B01,179598,Schurmeier; Kimberly,13,0,24,11
1681936144297,CHEM 7L,B02,179599,Schurmeier; Kimberly,23,0,24,1
1681936144297,CHEM 7L,B03,179606,Schurmeier; Kimberly,22,0,24,2
1681936144297,CHEM 7L,B04,179607,Schurmeier; Kimberly,22,0,24,2
1681936145321,CHEM 11,A01,179609,Stallings; Dontarie M,85,0,100,15
1681936146343,CHEM 40A,A01,179621,Staff,37,0,50,13
1681936146343,CHEM 40A,A02,179622,Staff,44,0,50,6
1681936147370,CHEM 40B,A01,179630,Weizman; Haim,45,0,50,5
1681936147370,CHEM 40B,A02,179631,Weizman; Haim,42,0,50,8
1681936148394,CHEM 41A,A01,179660,Klosterman; Jeremy K,90,0,100,10
1681936149422,CHEM 43A,A01,179683,Klosterman; Jeremy K,0,0,24,24
1681936149422,CHEM 43A,A02,179688,Klosterman; Jeremy K,5,0,24,19
1681936149422,CHEM 43A,A03,179689,Klosterman; Jeremy K,16,0,24,8
1681936149422,CHEM 43A,A04,179691,Klosterman; Jeremy K,17,0,24,7
1681936150444,CHEM 114A,A01,179693,Stallings; Dontarie M,61,0,100,39
1681936151466,CHEM 143B,A01,179698,Weizman; Haim,16,0,24,8
1681936151466,CHEM 143B,A02,179700,Weizman; Haim,23,0,24,1
1681936152489,CHIN 169A,A00,179701,Wang; Xiao,20,0,20,0
1681936153511,COGS 2,A01,179750,Boyle; Mary E. T.,16,0,30,14
1681936154533,COGS 9,A01,179759,Jones; Cameron Robert,40,0,50,10
1681936155557,COGS 14A,A01,179854,Staff,5,0,50,45
1681936156582,COGS 14B,A01,179856,Staff,49,0,60,11
1681936157613,COGS 17,A01,179874,Staff,69,0,75,6
1681936158641,COGS 18,A01,179884,Staff,57,0,80,23
1681936159663,COGS 100,A01,179886,Staff,25,0,60,35
1681936160692,COGS 101B,A01,179892,Staff,0,6,30,30
1681936161722,COGS 101C,A01,179894,Staff,25,0,30,5
1681936162752,COGS 107A,A01,179896,Boyle; Mary E. T.,28,0,40,12
1681936163779,COGS 108,A01,179898,Simpkins; Charles Alexander,0,35,60,60
1681936164802,COGS 109,A01,179900,Staff,32,0,40,8
1681936165827,COGS 118A,A01,179946,Staff,2,0,40,38
1681936166848,COGS 153,A00,179978,Staff,0,7,30,30
1681936167870,COGS 156,A01,179981,Staff,19,0,30,11
1681936169922,COGS 172,A01,179987,Staff,6,0,30,24
1681936171968,COGS 186,A01,179991,Staff,9,0,30,21
1681936172997,COMM 10,A01,180001,Staff,10,0,25,15
1681936172997,COMM 10,A02,180004,Staff,20,0,25,5
1681936174022,COMM 100A,A01,180016,Staff,12,0,25,13
1681936174022,COMM 100A,A02,180020,Staff,24,0,25,1
1681936175045,COMM 101T,A00,180029,Halm; Gavin Patrick,13,0,35,22
1681936176067,COMM 106V,A00,180043,Staff,33,0,35,2
1681936177090,COMM 109P,A00,180044,Staff,29,0,35,6
1681936178119,COMM 113T,A00,180045,Havis; Allan,32,0,45,13
1681936179146,COMM 132,A00,180046,McKenna; Denise,16,0,30,14
1681936180170,COMM 143,A00,180047,Staff,14,0,30,16
1681936181192,COMM 190,A00,180048,Conner; Thomas Hartnell,13,0,23,10
1681936182214,CSE 8A,A50,180053,Cao; Yingjun,19,0,50,31
1681936182214,CSE 8A,B50,180180,Staff,49,0,50,1
1681936183238,CSE 11,A01,180190,Cao; Yingjun,15,0,50,35
1681936184283,CSE 20,A01,180192,Briones; Jor-el Thomas Caparas,20,0,30,10
1681936185311,CSE 21,A01,194538,Briones; Jor-el Thomas Caparas,49,0,60,11
1681936186337,CSE 30,A01,180324,Eldon; John,69,0,100,31
1681936187361,CSE 101,A01,201353,Staff,0,34,40,40
1681936188384,CSE 134B,A01,180326,Powell; Thomas Allan,68,0,100,32
1681936189413,CSE 140,A01,180328,Staff,17,0,75,58
1681936190435,CSE 140L,A01,180344,Eldon; John,43,0,100,57
1681936191459,CSE 150A,A01,180411,Staff,0,20,50,50
1681936192482,CSE 151A,A01,180414,Staff,0,17,50,50
1681936193509,CSE 175,A01,222521,Kumar; Rakesh,50,0,50,0
1681936194543,CSE 190,A00,201419,Staff,42,0,49,7
1681936195568,CSS 1,A01,194536,Staff,30,0,50,20
1681936196593,DSC 30,A01,202385,Staff,48,0,50,2
1681936197617,DSC 40A,A01,202387,Albuyeh; Rod,50,0,50,0
1681936198643,DSC 190,A01,202389,Silberman; Jack,21,0,21,0
1681936199665,DSGN 100,A01,179993,Staff,12,0,30,18
1681936200688,ECE 65,A50,180708,Staff,10,0,20,10
1681936200688,ECE 65,A51,180739,Staff,19,0,20,1
1681936201715,ECON 1,A01,180427,Famulari; Melissa,65,0,70,5
1681936202745,ECON 2,A01,180450,Levkoff; Steven B.,62,0,70,8
1681936203770,ECON 4,A01,203351,Anderson; John Charles,6,0,10,4
1681936204795,ECON 100A,A01,180472,Famulari; Melissa,59,0,70,11
1681936205818,ECON 120A,A01,180549,Staff,59,0,70,11
1681936206839,ECON 120B,A01,180655,Ma; Xinwei,30,0,70,40
1681936207861,ECON 129,A00,203333,Eckert; Fabian Paul,5,0,35,30
1681936208886,ECON 131,A00,180656,Staff,0,4,35,35
1681936209913,ECON 172B,A01,180672,Levkoff; Steven B.,30,0,35,5
1681936210934,ECON 178,A01,203342,Zhu; Ying,2,0,35,33
1681936211962,EDS 108GS,A00,202383,Wishard Guerra; Alison G.,20,0,20,0
1681936212989,EDS 111GS,A00,202347,Wishard Guerra; Alison G.,20,0,20,0
1681936214033,EDS 112,A01,202323,Staff,52,0,60,8
1681936215065,EDS 113,A00,202340,Staff,31,0,35,4
1681936216090,EDS 118,A00,201231,Staff,19,0,30,11
1681936217114,EDS 119,A00,204994,Staff,8,0,10,2
1681936218220,EDS 124BR,A00,202324,Eguchi; Emi,0,4,25,25
1681936219251,EDS 126,A01,203208,Jones; Makeba,26,0,30,4
1681936220288,EDS 135,A01,202333,Staff,17,0,20,3
1681936221311,EDS 180,A00,202311,Staff,47,0,50,3
1681936222344,ERC 190GS,A01,253747,Staff,28,0,28,0
1681936223373,ETHN 104,A00,180742,Staff,20,0,35,15
1681936224399,ETHN 118,A00,180745,Staff,26,0,35,9
1681936225426,ETHN 127,A00,180747,Staff,8,0,16,8
1681936226449,ETHN 137,A00,180880,Staff,11,0,12,1
1681936227474,ETHN 147,A00,180890,Staff,8,0,10,2
1681936228497,ETHN 154,A00,180891,Staff,4,0,8,4
1681936229524,ETHN 168,A00,180892,Staff,9,0,10,1
1681936230555,GLBH 20,A00,201051,Hannah; Seth Donal,0,7,0,1
1681936231579,GLBH 111,A01,209338,Burgos; Jose L.,0,0,0,0
1681936232603,GLBH 150,A00,258300,Staff,0,4,0,0
1681936233627,GLBH 181,A00,201207,Staff,2,0,40,38
1681936234654,HIEU 109,A00,180898,Staff,19,0,20,1
1681936235683,HIEU 111,A00,180899,Staff,0,2,20,20
1681936236709,HIEU 124,A00,180900,Staff,16,0,20,4
1681936237735,HILA 122,A00,180901,Staff,17,0,20,3
1681936238758,HILA 132,A00,180902,Vitz; Matthew,0,3,20,20
1681936239781,HILD 10,A01,180896,Staff,11,0,20,9
1681936240802,HILD 30GS,A00,180897,Edington; Claire Ellen,0,0,0,0
1681936241824,HISC 105,A00,180903,Staff,20,0,20,0
1681936242849,HISC 117,A00,180904,Staff,10,0,20,10
1681936243877,HIUS 108B,A00,181005,Staff,17,0,20,3
1681936244902,HIUS 113,A00,181093,Staff,0,1,20,20
1681936245924,HUM 3,A01,181190,Patterson; Patrick H.,33,0,50,17
1681936245924,HUM 3,B01,181195,Staff,43,0,50,7
1681936246953,HUM 3GS,A00,181196,Herbst; Matthew,0,0,0,0
1681936247977,HUM 4,A01,181227,West; Geoffrey Scott,33,0,50,17
1681936247977,HUM 4,B01,181282,Staff,41,0,50,9
1681936249001,HUM 4GS,A00,181377,Lyon; Antony J.,0,0,0,0
1681936250026,HUM 5,A01,181536,Zavodny; Tatiana Sophia,22,0,50,28
1681936250026,HUM 5,B01,181908,Staff,31,0,50,19
1681936251055,INTL 190,A00,181909,Segui; Alan S,0,0,0,8
1681936251055,INTL 190,B00,181961,Segui; Alan S,0,0,0,7
1681936252138,JAPN 20AR,A01,182113,Ross; Kayoko F,15,0,20,5
1681936253164,LATI 50,A01,202391,Martin-Cabrera; Luis,15,0,30,15
1681936253164,LATI 50,A02,202392,Martin-Cabrera; Luis,26,0,30,4
1681936254193,LATI 180,A00,202393,Kokinis; Troy Andreas,24,0,25,1
1681936255216,LIFR 1A,A00,182119,Staff,13,0,14,1
1681936256245,LIFR 1AX,A00,182324,Staff,13,0,14,1
1681936257276,LIFR 1B,A00,182259,Staff,11,0,14,3
1681936258299,LIFR 1BX,A00,182273,Staff,11,0,14,3
1681936259325,LIGN 8,A00,182330,Staff,123,0,150,27
1681936260349,LIGN 9GS,A00,182362,Staff,14,0,20,6
1681936261453,LIGN 119,A00,204992,Takahashi; Maho,11,0,15,4
1681936262476,LIGN 130,A01,182384,Staff,47,0,50,3
1681936263501,LIGN 149GS,A00,182390,Staff,14,0,20,6
1681936264523,LIGN 170,A00,182404,Staff,23,0,30,7
1681936265549,LISP 1D,A00,182281,Staff,6,0,14,8
1681936265549,LISP 1D,B00,182287,Staff,13,0,14,1
1681936265549,LISP 1D,C00,182295,Staff,10,0,14,4
1681936265549,LISP 1D,D00,182301,Staff,14,0,14,0
1681936266575,LISP 1DX,A00,182309,Staff,18,0,28,10
1681936266575,LISP 1DX,B00,182316,Staff,25,0,28,3
1681936267607,LTAF 120GS,A00,182412,Zhiri; Oumelbanine,20,0,20,0
1681936268639,LTCS 172GS,A00,182437,Bronstein; Phoebe Malan,20,0,20,0
1681936269666,LTEA 138,A00,182457,Staff,13,0,40,27
1681936270689,LTEN 114,A01,182490,Staff,23,0,25,2
1681936271714,LTEN 130GS,A00,182491,Lyon; Antony J.,20,0,20,0
1681936272750,LTEN 169,A00,182493,Cuong; Marisol,17,0,25,8
1681936273776,LTEN 178,A00,182501,Staff,14,0,15,1
1681936274804,LTEN 181,A00,182515,Staff,19,0,25,6
1681936275827,LTEN 185GS,A00,197655,Forbes; Camille,20,0,20,0
1681936276855,LTSP 100B,A00,202208,Bessett; Ryan Matthew,24,0,25,1
1681936277882,LTWL 100,A00,182516,Myerston Santana; Jacobo,19,0,30,11
1681936278915,LTWR 100GS,A00,182518,Forbes; Camille,20,0,20,0
1681936279936,LTWR 102,A00,182522,Staff,15,0,15,0
1681936279936,LTWR 102,B00,182525,Staff,14,0,15,1
1681936280958,LTWR 115,A00,182526,Staff,9,0,15,6
1681936281982,MAE 8,A01,182528,Pham; Hieu Tan,65,0,70,5
1681936283010,MAE 11,A00,182529,Bahadori; Mohammad Yousef,88,0,100,12
1681936284036,MAE 20,A00,182530,Evdokimenko; Ekaterina,66,0,70,4
1681936285059,MAE 30A,A00,182532,Staff,44,0,45,1
1681936286082,MAE 101A,A00,182533,Bahadori; Mohammad Yousef,93,0,100,7
1681936287104,MAE 101C,A00,182538,Staff,62,0,70,8
1681936288130,MAE 104,A00,182539,Staff,44,0,50,6
1681936289153,MAE 131A,A00,182540,Ghazinejad; Maziar,40,0,45,5
1681936290175,MAE 143A,A00,182548,Bewley; Thomas R,42,0,50,8
1681936291208,MAE 150,A00,182549,Staff,28,0,40,12
1681936292231,MAE 160,A00,182550,Evdokimenko; Ekaterina,37,0,60,23
1681936293253,MATH 3C,A01,182725,Staff,24,0,30,6
1681936294276,MATH 10A,A01,182729,Staff,24,0,30,6
1681936294276,MATH 10A,B01,182732,Staff,25,0,30,5
1681936295300,MATH 10B,A01,182737,Staff,15,0,30,15
1681936295300,MATH 10B,A02,182738,Staff,24,0,30,6
1681936295300,MATH 10B,B01,182744,Staff,24,0,30,6
1681936295300,MATH 10B,B02,182745,Staff,27,0,30,3
1681936296324,MATH 18,A01,182750,Anzaldo; Leesa B,28,0,30,2
1681936296324,MATH 18,A02,182751,Anzaldo; Leesa B,28,0,30,2
1681936296324,MATH 18,A03,182753,Anzaldo; Leesa B,27,0,30,3
1681936296324,MATH 18,A04,182757,Anzaldo; Leesa B,29,0,30,1
1681936296324,MATH 18,B01,182761,Anzaldo; Leesa B,26,0,30,4
1681936296324,MATH 18,B02,182764,Anzaldo; Leesa B,25,0,30,5
1681936296324,MATH 18,B03,182765,Anzaldo; Leesa B,29,0,30,1
1681936296324,MATH 18,B04,182766,Anzaldo; Leesa B,30,0,30,0
1681936297361,MATH 20A,A01,182771,Suk; Andrew Hoon,27,0,30,3
1681936298386,MATH 20B,A01,182775,Bach; Quang Tran,30,0,30,0
1681936298386,MATH 20B,A02,182777,Bach; Quang Tran,29,0,30,1
1681936298386,MATH 20B,B01,182780,Bach; Quang Tran,26,0,30,4
1681936298386,MATH 20B,B02,182782,Bach; Quang Tran,30,0,30,0
1681936299420,MATH 20C,A01,182787,Staff,23,0,30,7
1681936299420,MATH 20C,A02,182790,Staff,29,0,30,1
1681936299420,MATH 20C,B01,182792,Staff,23,0,30,7
1681936299420,MATH 20C,B02,182796,Staff,26,0,30,4
1681936300443,MATH 20D,A01,182799,Staff,26,0,30,4
1681936300443,MATH 20D,A02,182802,Staff,29,0,30,1
1681936300443,MATH 20D,A03,182803,Staff,29,0,30,1
1681936301466,MATH 20E,A01,182809,Verstraete; Jacques Allan,18,0,30,12
1681936301466,MATH 20E,A02,182811,Verstraete; Jacques Allan,26,0,30,4
1681936301466,MATH 20E,B01,182814,Verstraete; Jacques Allan,20,0,30,10
1681936301466,MATH 20E,B02,182815,Verstraete; Jacques Allan,27,0,30,3
1681936302494,MATH 103A,A01,182820,Staff,2,0,30,28
1681936302494,MATH 103A,A02,182821,Staff,26,0,30,4
1681936302494,MATH 103A,A03,182822,Staff,18,0,30,12
1681936302494,MATH 103A,B01,182825,Staff,21,0,30,9
1681936302494,MATH 103A,B02,182826,Staff,30,0,30,0
1681936302494,MATH 103A,B03,182830,Staff,30,0,30,0
1681936303518,MATH 109,A01,182836,Chow; Bennett,23,0,30,7
1681936303518,MATH 109,A02,182838,Chow; Bennett,27,0,30,3
1681936303518,MATH 109,A03,182894,Chow; Bennett,29,0,30,1
1681936303518,MATH 109,B01,182908,Chow; Bennett,26,0,30,4
1681936303518,MATH 109,B02,182909,Chow; Bennett,30,0,30,0
1681936303518,MATH 109,B03,182910,Chow; Bennett,26,0,30,4
1681936304544,MATH 142A,A01,182925,Staff,3,0,30,27
1681936304544,MATH 142A,A02,182935,Staff,23,0,30,7
1681936304544,MATH 142A,A03,182967,Staff,22,0,30,8
1681936304544,MATH 142A,B01,183125,Staff,22,0,30,8
1681936304544,MATH 142A,B02,183157,Staff,26,0,30,4
1681936304544,MATH 142A,B03,183158,Staff,29,0,30,1
1681936305576,MATH 183,A01,183160,Arias-Castro; Ery,22,0,30,8
1681936305576,MATH 183,A02,183161,Arias-Castro; Ery,28,0,30,2
1681936305576,MATH 183,B01,183163,Arias-Castro; Ery,26,0,30,4
1681936305576,MATH 183,B02,183164,Arias-Castro; Ery,28,0,30,2
1681936306598,MATH 193A,A01,183167,Staff,0,0,35,35
1681936306598,MATH 193A,A02,183168,Staff,20,0,35,15
1681936306598,MATH 193A,A03,183169,Staff,32,0,35,3
1681936306598,MATH 193A,A04,183170,Staff,26,0,35,9
1681936307621,MGT 4,A01,202395,Anderson; John Charles,76,0,80,4
1681936308645,MGT 5,A00,202396,Houskeeper; Robert,78,0,90,12
1681936309668,MGT 103,A00,202397,Eberhard; Craig A,45,0,90,45
1681936310691,MGT 131A,A00,202398,Houskeeper; Robert,81,0,90,9
1681936311720,MGT 135,A00,202399,Anderson; John Charles,81,0,90,9
1681936312752,MGT 162R,A00,202403,Gneezy; Uri,110,0,200,90
1681936313773,MGT 172,A00,202404,Hedges; Kathleen,18,0,90,72
1681936314798,MGT 181,A00,202405,Dunn; Louis Jean,74,0,90,16
1681936315824,MMW 14,A01,183200,Staff,1,0,28,27
1681936315824,MMW 14,A02,183201,Staff,24,0,28,4
1681936315824,MMW 14,A03,183202,Staff,23,0,28,5
1681936315824,MMW 14,A04,183203,Staff,25,0,28,3
1681936315824,MMW 14,A05,183204,Staff,25,0,28,3
1681936315824,MMW 14,A06,183205,Staff,26,0,28,2
1681936315824,MMW 14,B01,183207,Staff,26,0,28,2
1681936315824,MMW 14,B02,183208,Staff,28,0,28,0
1681936315824,MMW 14,B03,183209,Staff,28,0,28,0
1681936315824,MMW 14,B04,183210,Staff,28,0,28,0
1681936315824,MMW 14,B05,183211,Staff,28,0,28,0
1681936315824,MMW 14,B06,183212,Staff,27,0,28,1
1681936316847,MMW 14GS,A00,183213,Zhiri; Oumelbanine,28,0,28,0
1681936317878,MMW 15GS,B00,183215,Rahimi; Babak,27,0,28,1
1681936318899,MMW 121,A01,183217,Patterson; Patrick H.,5,0,28,23
1681936318899,MMW 121,A02,183218,Patterson; Patrick H.,25,0,28,3
1681936319933,MUS 1A,A01,182554,Staff,0,1,35,35
1681936320956,MUS 5,A01,182558,Staff,13,0,35,22
1681936322056,MUS 6,A01,182562,Staff,21,0,35,14
1681936323094,MUS 8GS,A00,182563,Borgo; David Garcia,25,0,25,0
1681936324116,MUS 13,A01,182567,Staff,23,0,25,2
1681936325139,MUS 15,A01,182570,Staff,31,0,35,4
1681936325139,MUS 15,B01,182575,Staff,5,0,35,30
1681936326168,MUS 80,A00,182578,Staff,22,0,25,3
1681936326168,MUS 80,B00,182581,Staff,20,0,25,5
1681936327192,MUS 113,A00,182582,Staff,25,0,25,0
1681936328222,MUS 114,A00,182583,Staff,0,2,25,25
1681936329249,MUS 150GS,A01,182588,Borgo; David Garcia,24,0,25,1
1681936330291,PHIL 1,A00,182590,Staff,34,0,40,6
1681936331314,PHIL 10,A01,182596,Grush; Rick Scott,30,0,35,5
1681936331314,PHIL 10,A02,182597,Grush; Rick Scott,33,0,35,2
1681936332339,PHIL 15,A01,182601,Staff,31,0,35,4
1681936332339,PHIL 15,A02,182602,Staff,33,0,35,2
1681936333367,PHIL 27,A01,182604,Staff,23,0,35,12
1681936333367,PHIL 27,A02,182607,Staff,33,0,35,2
1681936334405,PHIL 32,A01,182609,Staff,35,0,35,0
1681936334405,PHIL 32,A02,182612,Staff,35,0,35,0
1681936335429,PHIL 130,A00,182614,Staff,57,0,70,13
1681936336466,PHIL 136,A00,182616,Cohen; Jonathan David,63,0,70,7
1681936337490,PHIL 155,A00,182617,Vargas; Manuel Rogelio,56,0,70,14
1681936338515,PHIL 163,A01,182620,Staff,15,0,20,5
1681936338515,PHIL 163,A02,182624,Staff,10,0,20,10
1681936339542,PHIL 164,A00,182627,Staff,29,0,40,11
1681936340566,PHIL 173,A00,182628,Staff,35,0,40,5
1681936341597,PHYS 1A,A00,183221,Staff,52,0,60,8
1681936342619,PHYS 1AL,001,183222,Staff,24,0,30,6
1681936342619,PHYS 1AL,002,183223,Staff,23,0,30,7
1681936343644,PHYS 1B,A00,183231,Staff,39,0,60,21
1681936344669,PHYS 1BL,001,183232,Staff,15,0,30,15
1681936344669,PHYS 1BL,002,183233,Staff,27,0,30,3
1681936345700,PHYS 1C,A00,183240,Staff,19,0,60,41
1681936346725,PHYS 1CL,001,183241,Staff,7,0,30,23
1681936346725,PHYS 1CL,002,183242,Staff,21,0,30,9
1681936347752,PHYS 2AR,A01,183250,Staff,39,0,50,11
1681936348778,PHYS 2B,A01,183252,Staff,101,0,115,14
1681936349805,PHYS 2BL,A01,183254,Staff,21,0,24,3
1681936349805,PHYS 2BL,A02,183255,Staff,21,0,24,3
1681936350836,PHYS 2C,A01,183522,Staff,100,0,115,15
1681936351862,PHYS 4A,A01,183524,Staff,49,0,50,1
1681936352885,POLI 5,A00,183525,Staff,43,0,50,7
1681936353915,POLI 12,A00,183540,Staff,45,0,50,5
1681936354945,POLI 13R,A00,183541,Forman; Fonna,39,0,50,11
1681936355973,POLI 30,A00,183542,Mignozzetti; Umberto,48,0,50,2
1681936356998,POLI 100A,A00,183543,Staff,43,0,50,7
1681936358021,POLI 100E,A00,223598,Staff,32,0,35,3
1681936359044,POLI 103A,A00,183564,Kousser; Thad,35,0,50,15
1681936360066,POLI 104B,A00,201329,Staff,27,0,35,8
1681936361089,POLI 113BR,A00,183576,Hoston; Germaine,21,0,50,29
1681936362111,POLI 114BR,A00,183588,Staff,26,0,30,4
1681936363133,POLI 117R,A00,183595,Forman; Fonna,2,0,20,18
1681936364165,POLI 120H,A00,183596,Fisk; David Lee,12,0,20,8
1681936365187,POLI 130AA,A00,183597,Staff,13,0,20,7
1681936366211,POLI 134AA,A00,183598,Staff,19,0,20,1
1681936367235,POLI 135,A00,183599,Fisk; David Lee,18,0,25,7
1681936368264,POLI 142P,A00,183623,Staff,37,0,40,3
1681936369290,POLI 144D,A00,183624,Staff,22,0,25,3
1681936370324,POLI 151,A00,183625,Staff,14,0,20,6
1681936371349,POLI 162,A00,183626,Mignozzetti; Umberto,17,0,20,3
1681936372371,PSYC 1,A00,253748,Staff,85,0,90,5
1681936373397,PSYC 2,A00,183627,Moranton; Nirelia Melbina-,22,0,35,13
1681936374445,PSYC 3,A00,183628,Staff,42,0,45,3
1681936376491,PSYC 60,A01,183631,Lowe; Angela Beth,34,0,40,6
1681936377514,PSYC 70,A01,253757,Staff,33,0,45,12
1681936378539,PSYC 101,A00,183632,Heyman; Gail D.,39,0,60,21
1681936379565,PSYC 105,A00,183848,Lowe; Angela Beth,40,0,60,20
1681936380588,PSYC 106,A00,183849,Dobkins; Karen R.,33,0,60,27
1681936381612,PSYC 108,A00,253750,Staff,4,0,60,56
1681936382634,PSYC 114,A01,184275,Winkielman; Piotr,0,8,30,30
1681936383661,PSYC 122,A00,183856,Moranton; Nirelia Melbina-,0,16,30,30
1681936384683,PSYC 124,A00,183865,Chapman; Eddie Nathaniel,40,0,80,40
1681936385709,PSYC 137,A00,183880,Staff,14,0,25,11
1681936387761,PSYC 154,A00,183910,Lacefield; Katharine I,0,34,90,90
1681936389806,PSYC 162,A00,183946,Wixted; John T,34,0,90,56
1681936390831,PSYC 172,A00,183947,Gorman; Michael R.,2,0,30,28
1681936391854,PSYC 178,A00,183963,Glaser; Dale,10,0,40,30
1681936392883,PSYC 181GS,A00,183964,Anagnostaras; Stephan,10,0,10,0
1681936393910,PSYC 186GS,A01,257660,Staff,10,0,10,0
1681936394941,PSYC 193,B00,253749,Staff,22,0,25,3
1681936396998,PSYC 193L,A01,184122,Staff,33,0,35,2
1681936396998,PSYC 193L,C01,184167,Winkielman; Piotr,14,0,30,16
1681936398021,RELI 188GS,A00,182629,Rahimi; Babak,20,0,20,0
1681936399043,SE 101A,A00,182646,Staff,25,0,30,5
1681936400066,SE 101C,A00,182650,Staff,9,0,20,11
1681936401089,SE 110A,A00,182651,Staff,28,0,28,0
1681936402111,SE 130A,A00,182652,Staff,37,0,40,3
1681936403172,SIO 46GS,A00,182636,Cook; Geoffrey W,23,0,28,5
1681936404209,SIO 109R,A00,194459,Staff,0,2,20,20
1681936405241,SIO 121GS,A00,182639,Cook; Geoffrey W,23,0,28,5
1681936406266,SIO 132,A01,182642,Staff,30,0,40,10
1681936407293,SIO 139,A00,182644,Kacev; David,36,0,40,4
1681936408323,SOCI 2,A01,258404,Staff,33,0,36,3
1681936408323,SOCI 2,A02,258405,Staff,34,0,36,2
1681936409346,SOCI 60,A01,258408,Staff,29,0,30,1
1681936409346,SOCI 60,A02,258413,Staff,30,0,30,0
1681936410372,SOCI 100,A01,258415,Staff,28,0,30,2
1681936410372,SOCI 100,A02,258416,Staff,28,0,30,2
1681936416525,SOCI 127,A00,258421,Staff,18,0,30,12
1681936417551,SOCI 132,A00,258422,Staff,41,0,50,9
1681936418574,SOCI 133,A00,258423,Staff,26,0,30,4
1681936419595,SOCI 138GS,A00,258424,Staff,15,0,15,0
1681936420620,SOCI 145,A00,258425,Staff,23,0,30,7
1681936421649,SOCI 148,A00,258426,Staff,23,0,30,7
1681936422674,SOCI 153,A00,199217,Staff,30,0,30,0
1681936423698,SOCI 160,A00,258427,Staff,26,0,30,4
1681936424724,SOCI 160E,A00,258435,Staff,55,0,60,5
1681936425822,SOCI 189GS,A00,258436,Staff,15,0,15,0
1681936426843,SOCI 190GS,A00,258437,Staff,15,0,15,0
1681936427866,SYN 2,001,182658,Staff,7,0,16,9
1681936427866,SYN 2,002,201439,Staff,13,0,16,3
1681936427866,SYN 2,003,201443,Staff,15,0,16,1
1681936428898,SYN 100,A01,182657,Staff,8,0,20,12
1681936429922,TDAC 1,A00,184381,Salovey; Todd,16,0,20,4
1681936429922,TDAC 1,B00,184385,Harting; Carla Kelso,19,0,20,1
1681936429922,TDAC 1,C00,184394,Staff,18,0,20,2
1681936430945,TDAC 101,A00,184483,Harting; Carla Kelso,19,0,20,1
1681936431970,TDDE 111,A00,184496,Staff,14,0,15,1
1681936432997,TDDE 131,A00,184504,Staff,20,0,20,0
1681936432997,TDDE 131,B00,184505,Staff,17,0,18,1
1681936432997,TDDE 131,C00,184534,Staff,49,0,50,1
1681936432997,TDDE 131,D00,184564,Staff,15,0,15,0
1681936432997,TDDE 131,E00,204725,Staff,18,0,20,2
1681936434031,TDGE 1,A01,184414,Salovey; Todd,33,0,50,17
1681936435150,TDGE 5,A01,184419,Staff,23,0,24,1
1681936436173,TDGE 10,A00,184428,Fulton; Julia,27,0,50,23
1681936437202,TDGE 124,A00,184565,Fulton; Julia,0,5,50,50
1681936438223,TDGE 125,B00,184567,Meyer; Ursula,6,0,25,19
1681936439249,TDHT 101,A00,184568,Staff,21,0,25,4
1681936439249,TDHT 101,B00,184569,Staff,20,0,20,0
1681936440283,TDHT 114,A00,184570,Staff,47,0,50,3
1681936441308,TDMV 1,A00,184437,Arcidiacono; Kristin,21,0,30,9
1681936441308,TDMV 1,B00,184448,Caligagan; Maria T.,23,0,30,7
1681936442335,TDMV 2,A00,184449,Weinberg; Sadie,26,0,30,4
1681936442335,TDMV 2,B00,184453,Arcidiacono; Kristin,29,0,30,1
1681936443360,TDMV 110,A00,184571,Weinberg; Sadie,30,0,30,0
1681936444393,TDMV 142,A00,184572,Caligagan; Tony,26,0,30,4
1681936444393,TDMV 142,B00,184573,Caligagan; Maria T.,26,0,30,4
1681936445416,TDTR 20,A00,184482,Jun; Grace Shin Hae,25,0,25,0
1681936446450,USP 2,A01,184290,Hinds; Juli Beth,23,0,25,2
1681936447479,USP 3,A01,184295,Staff,19,0,25,6
1681936448500,USP 4,A00,184304,McTague; Sarah,11,0,25,14
1681936449524,USP 100,A00,184315,Staff,16,0,25,9
1681936450547,USP 105,A00,184326,Staff,21,0,25,4
1681936451581,USP 151,A00,184327,Staff,15,0,25,10
1681936452605,USP 170,A00,184380,Hinds; Juli Beth,12,0,25,13
1681936453636,VIS 21B,A01,182660,Staff,28,0,31,3
1681936453636,VIS 21B,A02,182662,Staff,30,0,31,1
1681936454673,VIS 103D,A00,182663,Staff,73,0,75,2
1681936455702,VIS 105D,A00,182667,Li; Huai,14,0,22,8
1681936456723,VIS 122GS,A00,182668,Herbst; Matthew,20,0,20,0
1681936457748,VIS 128C,A00,182673,Staff,68,0,75,7
1681936458774,VIS 130,A00,182675,Staff,19,0,22,3
1681936459797,VIS 160A,A00,182678,Stalbaum; Brett,4,0,10,6
1681936461855,WCWP 10B,A00,201679,Staff,15,0,15,0
1681936461855,WCWP 10B,B00,201695,Staff,15,0,15,0
1681936462889,WCWP 100,A00,201716,Staff,12,0,15,3
1681936462889,WCWP 100,B00,201717,Staff,0,1,15,15
1681936464981,ANSC 105GS,A00,258289,Staff,0,0,0,0
1681936466013,ANSC 125GS,A00,258295,Staff,0,0,0,0
1681936467039,ANSC 150,A00,258267,Staff,26,0,40,14
1681936468062,ANSC 190GS,A00,258280,Staff,0,0,0,2
1681936469086,ANTH 1,A00,258264,Staff,38,0,40,2
1681936470110,ANTH 2,A01,258259,Staff,72,0,76,4
1681936471133,ANTH 23,A01,258228,Staff,35,0,40,5
1681936472159,ANTH 101,A01,258236,Staff,38,0,40,2
1681936473181,ANTH 102,A00,258272,Staff,59,0,60,1
1681936474203,ANTH 105,A00,258244,Staff,28,0,35,7
1681936475225,BENG 130,A00,253975,Staff,37,0,40,3
1681936476252,BIBC 102,A01,191866,Flagg; Matthew Paul,15,0,32,17
1681936476252,BIBC 102,A02,191867,Flagg; Matthew Paul,20,0,32,12
1681936476252,BIBC 102,A03,191868,Flagg; Matthew Paul,26,0,32,6
1681936476252,BIBC 102,A04,191936,Flagg; Matthew Paul,19,0,32,13
1681936476252,BIBC 102,A05,191937,Flagg; Matthew Paul,0,1,32,32
1681936477279,BICD 100,A01,191939,Cooper; Andrew Michael,27,0,32,5
1681936477279,BICD 100,A02,191940,Cooper; Andrew Michael,32,0,32,0
1681936477279,BICD 100,A03,191941,Cooper; Andrew Michael,32,0,32,0
1681936477279,BICD 100,A04,191942,Cooper; Andrew Michael,32,0,32,0
1681936477279,BICD 100,A05,191943,Cooper; Andrew Michael,32,0,32,0
1681936478302,BIEB 126,A01,191945,Cleland; Elsa Eleanor,0,5,32,32
1681936478302,BIEB 126,A02,191946,Cleland; Elsa Eleanor,24,0,32,8
1681936478302,BIEB 126,A03,191947,Cleland; Elsa Eleanor,29,0,32,3
1681936478302,BIEB 126,A04,191948,Cleland; Elsa Eleanor,15,0,32,17
1681936478302,BIEB 126,A05,191996,Cleland; Elsa Eleanor,28,0,32,4
1681936479333,BIEB 136GS,A00,191997,Shurin; Jonathan & Holway; David A.,0,0,0,9
1681936480366,BIEB 137GS,A01,191999,Shurin; Jonathan & Holway; David A.,0,0,0,8
1681936481391,BILD 1,A01,205385,Staff,29,0,32,3
1681936481391,BILD 1,A02,205386,Staff,30,0,32,2
1681936481391,BILD 1,A03,205387,Staff,31,0,32,1
1681936481391,BILD 1,A04,205388,Staff,25,0,32,7
1681936482425,BILD 2,A01,191774,Staff,24,0,32,8
1681936482425,BILD 2,A02,191775,Staff,29,0,32,3
1681936482425,BILD 2,A03,191777,Staff,29,0,32,3
1681936482425,BILD 2,A04,191856,Staff,30,0,32,2
1681936482425,BILD 2,A05,191857,Staff,31,0,32,1
1681936482425,BILD 2,A06,191858,Staff,32,0,32,0
1681936482425,BILD 2,A07,191859,Staff,31,0,32,1
1681936483451,BILD 3,A01,205391,Staff,26,0,32,6
1681936483451,BILD 3,A02,205393,Staff,32,0,32,0
1681936483451,BILD 3,A03,205394,Staff,26,0,32,6
1681936483451,BILD 3,A04,205395,Staff,32,0,32,0
1681936484477,BILD 20,A01,191861,Staff,32,0,32,0
1681936484477,BILD 20,A02,191862,Staff,32,0,32,0
1681936485500,BILD 30,A01,191864,Staff,31,0,32,1
1681936486530,BIMM 100,A01,192019,Staff,0,0,32,32
1681936486530,BIMM 100,A02,192020,Staff,9,0,32,23
1681936486530,BIMM 100,A03,192035,Staff,17,0,32,15
1681936487552,BIMM 110,A01,192037,Tat; John,0,0,32,32
1681936487552,BIMM 110,A02,192038,Tat; John,4,0,32,28
1681936488577,BIMM 120,A01,192040,Pickett; Brooke Elizabeth,0,0,32,32
1681936488577,BIMM 120,A02,192041,Pickett; Brooke Elizabeth,7,0,32,25
1681936488577,BIMM 120,A03,192042,Pickett; Brooke Elizabeth,14,0,32,18
1681936489600,BIPN 100,A01,192044,Armour; Jon Christopher,23,0,32,9
1681936489600,BIPN 100,A02,192059,Armour; Jon Christopher,30,0,32,2
1681936489600,BIPN 100,A03,192064,Armour; Jon Christopher,29,0,32,3
1681936489600,BIPN 100,A04,192073,Armour; Jon Christopher,26,0,32,6
1681936490627,BIPN 148,A01,205411,Leutgeb; Jill K.,14,0,32,18
1681936490627,BIPN 148,A02,205412,Leutgeb; Jill K.,31,0,32,1
1681936490627,BIPN 148,A03,205413,Leutgeb; Jill K.,29,0,32,3
1681936490627,BIPN 148,A04,205414,Leutgeb; Jill K.,30,0,32,2
1681936491652,BIPN 160,A01,192115,Marino; Marc J,15,0,32,17
1681936491652,BIPN 160,A02,192148,Marino; Marc J,27,0,32,5
1681936491652,BIPN 160,A03,192158,Marino; Marc J,31,0,32,1
1681936491652,BIPN 160,A04,192190,Marino; Marc J,32,0,32,0
1681936491652,BIPN 160,A05,192287,Marino; Marc J,32,0,32,0
1681936491652,BIPN 160,A06,192288,Marino; Marc J,32,0,32,0
1681936492675,BIPN 194,A00,206038,Leutgeb; Stefan,28,0,32,4
1681936493701,BISP 194,A00,192289,Nieh; James Charles,8,0,32,24
1681936493701,BISP 194,B00,245332,Staff,26,0,32,6
1681936494728,CAT 124,A01,202247,Staff,15,0,15,0
1681936495750,CAT 125,A00,202248,Staff,18,0,20,2
1681936495750,CAT 125,B00,202253,Staff,20,0,20,0
1681936495750,CAT 125,C00,202257,Staff,17,0,20,3
1681936496777,CAT 125GS,A01,202273,Bronstein; Phoebe Malan,20,0,20,0
1681936497809,CAT 125R,A00,202284,Staff,16,0,20,4
1681936497809,CAT 125R,C00,202286,Staff,4,0,20,16
1681936497809,CAT 125R,D00,202291,Staff,14,0,20,6
1681936497809,CAT 125R,E00,202295,Staff,13,0,20,7
1681936497809,CAT 125R,F00,202302,Staff,4,0,20,16
1681936498831,CENG 100,A00,204724,Opatkiewicz; Justin Paul,23,0,25,2
1681936499865,CGS 2A,A01,180420,Staff,29,0,36,7
1681936500889,CGS 101,A00,180421,Staff,14,0,20,6
1681936501911,CGS 112,A00,180422,Staff,7,0,16,9
1681936502938,CGS 113,A00,180423,Staff,18,0,20,2
1681936503960,CGS 137,A00,180424,Staff,12,0,12,0
1681936504990,CGS 147,A00,180425,Staff,10,0,10,0
1681936506020,CHEM 6A,A01,179556,Staff,92,0,100,8
1681936506020,CHEM 6A,A02,179558,Staff,0,0,0,0
1681936507042,CHEM 6B,A01,179560,Staff,100,0,100,0
1681936508068,CHEM 6C,A01,179565,Jazzar; Rodolphe,89,0,100,11
1681936509092,CHEM 7L,A01,179586,Schurmeier; Kimberly,9,0,24,15
1681936509092,CHEM 7L,A02,179587,Schurmeier; Kimberly,22,0,24,2
1681936509092,CHEM 7L,A03,179590,Schurmeier; Kimberly,21,0,24,3
1681936509092,CHEM 7L,A04,179591,Schurmeier; Kimberly,22,0,24,2
1681936509092,CHEM 7L,B01,179598,Schurmeier; Kimberly,13,0,24,11
1681936509092,CHEM 7L,B02,179599,Schurmeier; Kimberly,23,0,24,1
1681936509092,CHEM 7L,B03,179606,Schurmeier; Kimberly,22,0,24,2
1681936509092,CHEM 7L,B04,179607,Schurmeier; Kimberly,22,0,24,2
1681936510118,CHEM 11,A01,179609,Stallings; Dontarie M,85,0,100,15
1681936511141,CHEM 40A,A01,179621,Staff,37,0,50,13
1681936511141,CHEM 40A,A02,179622,Staff,43,0,50,7
1681936512163,CHEM 40B,A01,179630,Weizman; Haim,45,0,50,5
1681936512163,CHEM 40B,A02,179631,Weizman; Haim,42,0,50,8
1681936513195,CHEM 41A,A01,179660,Klosterman; Jeremy K,90,0,100,10
1681936514218,CHEM 43A,A01,179683,Klosterman; Jeremy K,0,0,24,24
1681936514218,CHEM 43A,A02,179688,Klosterman; Jeremy K,5,0,24,19
1681936514218,CHEM 43A,A03,179689,Klosterman; Jeremy K,16,0,24,8
1681936514218,CHEM 43A,A04,179691,Klosterman; Jeremy K,16,0,24,8
1681936515243,CHEM 114A,A01,179693,Stallings; Dontarie M,60,0,100,40
1681936516264,CHEM 143B,A01,179698,Weizman; Haim,16,0,24,8
1681936516264,CHEM 143B,A02,179700,Weizman; Haim,23,0,24,1
1681936517286,CHIN 169A,A00,179701,Wang; Xiao,20,0,20,0
1681936518311,COGS 2,A01,179750,Boyle; Mary E. T.,16,0,30,14
1681936519338,COGS 9,A01,179759,Jones; Cameron Robert,40,0,50,10
1681936520366,COGS 14A,A01,179854,Staff,5,0,50,45
1681936521387,COGS 14B,A01,179856,Staff,49,0,60,11
1681936522410,COGS 17,A01,179874,Staff,69,0,75,6
1681936523435,COGS 18,A01,179884,Staff,56,0,80,24
1681936524462,COGS 100,A01,179886,Staff,25,0,60,35
1681936525490,COGS 101B,A01,179892,Staff,0,6,30,30
1681936526512,COGS 101C,A01,179894,Staff,25,0,30,5
1681936527534,COGS 107A,A01,179896,Boyle; Mary E. T.,28,0,40,12
1681936528559,COGS 108,A01,179898,Simpkins; Charles Alexander,0,35,60,60
1681936529653,COGS 109,A01,179900,Staff,32,0,40,8
1681936530675,COGS 118A,A01,179946,Staff,2,0,40,38
1681936531698,COGS 153,A00,179978,Staff,0,7,30,30
1681936532723,COGS 156,A01,179981,Staff,19,0,30,11
1681936534774,COGS 172,A01,179987,Staff,6,0,30,24
1681936536824,COGS 186,A01,179991,Staff,9,0,30,21
1681936537849,COMM 10,A01,180001,Staff,10,0,25,15
1681936537849,COMM 10,A02,180004,Staff,20,0,25,5
1681936538871,COMM 100A,A01,180016,Staff,12,0,25,13
1681936538871,COMM 100A,A02,180020,Staff,24,0,25,1
1681936539902,COMM 101T,A00,180029,Halm; Gavin Patrick,13,0,35,22
1681936540926,COMM 106V,A00,180043,Staff,33,0,35,2
1681936541953,COMM 109P,A00,180044,Staff,29,0,35,6
1681936542977,COMM 113T,A00,180045,Havis; Allan,31,0,45,14
1681936543999,COMM 132,A00,180046,McKenna; Denise,14,0,30,16
1681936545022,COMM 143,A00,180047,Staff,14,0,30,16
1681936546055,COMM 190,A00,180048,Conner; Thomas Hartnell,13,0,23,10
1681936547086,CSE 8A,A50,180053,Cao; Yingjun,19,0,50,31
1681936547086,CSE 8A,B50,180180,Staff,49,0,50,1
1681936548116,CSE 11,A01,180190,Cao; Yingjun,15,0,50,35
1681936549138,CSE 20,A01,180192,Briones; Jor-el Thomas Caparas,20,0,30,10
1681936550164,CSE 21,A01,194538,Briones; Jor-el Thomas Caparas,49,0,60,11
1681936551187,CSE 30,A01,180324,Eldon; John,69,0,100,31
1681936552208,CSE 101,A01,201353,Staff,0,34,40,40
1681936553231,CSE 134B,A01,180326,Powell; Thomas Allan,68,0,100,32
1681936554259,CSE 140,A01,180328,Staff,17,0,75,58
1681936555281,CSE 140L,A01,180344,Eldon; John,43,0,100,57
1681936556317,CSE 150A,A01,180411,Staff,0,20,50,50
1681936557339,CSE 151A,A01,180414,Staff,0,17,50,50
1681936558376,CSE 175,A01,222521,Kumar; Rakesh,50,0,50,0
1681936559400,CSE 190,A00,201419,Staff,42,0,49,7
1681936560423,CSS 1,A01,194536,Staff,29,0,50,21
1681936561445,DSC 30,A01,202385,Staff,48,0,50,2
1681936562475,DSC 40A,A01,202387,Albuyeh; Rod,50,0,50,0
1681936563500,DSC 190,A01,202389,Silberman; Jack,21,0,21,0
1681936564523,DSGN 100,A01,179993,Staff,12,0,30,18
1681936565557,ECE 65,A50,180708,Staff,10,0,20,10
1681936565557,ECE 65,A51,180739,Staff,19,0,20,1
1681936566583,ECON 1,A01,180427,Famulari; Melissa,65,0,70,5
1681936567608,ECON 2,A01,180450,Levkoff; Steven B.,62,0,70,8
1681936568640,ECON 4,A01,203351,Anderson; John Charles,6,0,10,4
1681936569667,ECON 100A,A01,180472,Famulari; Melissa,59,0,70,11
1681936570691,ECON 120A,A01,180549,Staff,59,0,70,11
1681936571722,ECON 120B,A01,180655,Ma; Xinwei,30,0,70,40
1681936572748,ECON 129,A00,203333,Eckert; Fabian Paul,4,0,35,31
1681936573773,ECON 131,A00,180656,Staff,0,4,35,35
1681936574801,ECON 172B,A01,180672,Levkoff; Steven B.,30,0,35,5
1681936575828,ECON 178,A01,203342,Zhu; Ying,2,0,35,33
1681936576862,EDS 108GS,A00,202383,Wishard Guerra; Alison G.,20,0,20,0
1681936577884,EDS 111GS,A00,202347,Wishard Guerra; Alison G.,20,0,20,0
1681936578907,EDS 112,A01,202323,Staff,51,0,60,9
1681936579931,EDS 113,A00,202340,Staff,30,0,35,5
1681936580957,EDS 118,A00,201231,Staff,19,0,30,11
1681936581982,EDS 119,A00,204994,Staff,8,0,10,2
1681936583007,EDS 124BR,A00,202324,Eguchi; Emi,0,4,25,25
1681936584038,EDS 126,A01,203208,Jones; Makeba,26,0,30,4
1681936585060,EDS 135,A01,202333,Staff,17,0,20,3
1681936586084,EDS 180,A00,202311,Staff,47,0,50,3
1681936587106,ERC 190GS,A01,253747,Staff,28,0,28,0
1681936588128,ETHN 104,A00,180742,Staff,20,0,35,15
1681936589153,ETHN 118,A00,180745,Staff,26,0,35,9
1681936590175,ETHN 127,A00,180747,Staff,8,0,16,8
1681936591197,ETHN 137,A00,180880,Staff,11,0,12,1
1681936592230,ETHN 147,A00,180890,Staff,8,0,10,2
1681936593254,ETHN 154,A00,180891,Staff,4,0,8,4
1681936594276,ETHN 168,A00,180892,Staff,9,0,10,1
1681936595308,GLBH 20,A00,201051,Hannah; Seth Donal,0,7,0,1
1681936596331,GLBH 111,A01,209338,Burgos; Jose L.,0,0,0,0
1681936597358,GLBH 150,A00,258300,Staff,0,4,0,0
1681936598382,GLBH 181,A00,201207,Staff,2,0,40,38
1681936599413,HIEU 109,A00,180898,Staff,19,0,20,1
1681936600435,HIEU 111,A00,180899,Staff,0,2,20,20
1681936601458,HIEU 124,A00,180900,Staff,16,0,20,4
1681936602481,HILA 122,A00,180901,Staff,16,0,20,4
1681936603508,HILA 132,A00,180902,Vitz; Matthew,0,5,20,20
1681936604533,HILD 10,A01,180896,Staff,11,0,20,9
1681936605557,HILD 30GS,A00,180897,Edington; Claire Ellen,0,0,0,0
1681936606605,HISC 105,A00,180903,Staff,20,0,20,0
1681936607628,HISC 117,A00,180904,Staff,10,0,20,10
1681936608650,HIUS 108B,A00,181005,Staff,17,0,20,3
1681936609673,HIUS 113,A00,181093,Staff,0,1,20,20
1681936610696,HUM 3,A01,181190,Patterson; Patrick H.,33,0,50,17
1681936610696,HUM 3,B01,181195,Staff,43,0,50,7
1681936611722,HUM 3GS,A00,181196,Herbst; Matthew,0,0,0,0
1681936612745,HUM 4,A01,181227,West; Geoffrey Scott,33,0,50,17
1681936612745,HUM 4,B01,181282,Staff,41,0,50,9
1681936613768,HUM 4GS,A00,181377,Lyon; Antony J.,0,0,0,0
1681936614791,HUM 5,A01,181536,Zavodny; Tatiana Sophia,22,0,50,28
1681936614791,HUM 5,B01,181908,Staff,30,0,50,20
1681936615814,INTL 190,A00,181909,Segui; Alan S,0,0,0,8
1681936615814,INTL 190,B00,181961,Segui; Alan S,0,0,0,7
1681936616841,JAPN 20AR,A01,182113,Ross; Kayoko F,15,0,20,5
1681936617867,LATI 50,A01,202391,Martin-Cabrera; Luis,15,0,30,15
1681936617867,LATI 50,A02,202392,Martin-Cabrera; Luis,26,0,30,4
1681936618904,LATI 180,A00,202393,Kokinis; Troy Andreas,24,0,25,1
1681936619934,LIFR 1A,A00,182119,Staff,13,0,14,1
1681936620956,LIFR 1AX,A00,182324,Staff,13,0,14,1
1681936621985,LIFR 1B,A00,182259,Staff,11,0,14,3
1681936623008,LIFR 1BX,A00,182273,Staff,11,0,14,3
1681936624030,LIGN 8,A00,182330,Staff,123,0,150,27
1681936625055,LIGN 9GS,A00,182362,Staff,14,0,20,6
1681936626081,LIGN 119,A00,204992,Takahashi; Maho,11,0,15,4
1681936627104,LIGN 130,A01,182384,Staff,47,0,50,3
1681936628130,LIGN 149GS,A00,182390,Staff,14,0,20,6
1681936629155,LIGN 170,A00,182404,Staff,23,0,30,7
1681936630181,LISP 1D,A00,182281,Staff,6,0,14,8
1681936630181,LISP 1D,B00,182287,Staff,13,0,14,1
1681936630181,LISP 1D,C00,182295,Staff,10,0,14,4
1681936630181,LISP 1D,D00,182301,Staff,14,0,14,0
1681936631203,LISP 1DX,A00,182309,Staff,18,0,28,10
1681936631203,LISP 1DX,B00,182316,Staff,25,0,28,3
1681936632227,LTAF 120GS,A00,182412,Zhiri; Oumelbanine,20,0,20,0
1681936633340,LTCS 172GS,A00,182437,Bronstein; Phoebe Malan,20,0,20,0
1681936634362,LTEA 138,A00,182457,Staff,13,0,40,27
1681936635384,LTEN 114,A01,182490,Staff,23,0,25,2
1681936636409,LTEN 130GS,A00,182491,Lyon; Antony J.,20,0,20,0
1681936637434,LTEN 169,A00,182493,Cuong; Marisol,17,0,25,8
1681936638457,LTEN 178,A00,182501,Staff,14,0,15,1
1681936639479,LTEN 181,A00,182515,Staff,19,0,25,6
1681936640507,LTEN 185GS,A00,197655,Forbes; Camille,20,0,20,0
1681936641542,LTSP 100B,A00,202208,Bessett; Ryan Matthew,24,0,25,1
1681936642582,LTWL 100,A00,182516,Myerston Santana; Jacobo,19,0,30,11
1681936643605,LTWR 100GS,A00,182518,Forbes; Camille,20,0,20,0
1681936644631,LTWR 102,A00,182522,Staff,15,0,15,0
1681936644631,LTWR 102,B00,182525,Staff,14,0,15,1
1681936645655,LTWR 115,A00,182526,Staff,9,0,15,6
1681936646680,MAE 8,A01,182528,Pham; Hieu Tan,65,0,70,5
1681936647702,MAE 11,A00,182529,Bahadori; Mohammad Yousef,88,0,100,12
1681936648729,MAE 20,A00,182530,Evdokimenko; Ekaterina,66,0,70,4
1681936649752,MAE 30A,A00,182532,Staff,44,0,45,1
1681936650783,MAE 101A,A00,182533,Bahadori; Mohammad Yousef,93,0,100,7
1681936651808,MAE 101C,A00,182538,Staff,62,0,70,8
1681936652830,MAE 104,A00,182539,Staff,44,0,50,6
1681936653857,MAE 131A,A00,182540,Ghazinejad; Maziar,40,0,45,5
1681936654880,MAE 143A,A00,182548,Bewley; Thomas R,42,0,50,8
1681936655907,MAE 150,A00,182549,Staff,28,0,40,12
1681936656937,MAE 160,A00,182550,Evdokimenko; Ekaterina,36,0,60,24
1681936657967,MATH 3C,A01,182725,Staff,24,0,30,6
1681936658990,MATH 10A,A01,182729,Staff,24,0,30,6
1681936658990,MATH 10A,B01,182732,Staff,25,0,30,5
1681936660014,MATH 10B,A01,182737,Staff,14,0,30,16
1681936660014,MATH 10B,A02,182738,Staff,24,0,30,6
1681936660014,MATH 10B,B01,182744,Staff,24,0,30,6
1681936660014,MATH 10B,B02,182745,Staff,26,0,30,4
1681936661039,MATH 18,A01,182750,Anzaldo; Leesa B,28,0,30,2
1681936661039,MATH 18,A02,182751,Anzaldo; Leesa B,28,0,30,2
1681936661039,MATH 18,A03,182753,Anzaldo; Leesa B,27,0,30,3
1681936661039,MATH 18,A04,182757,Anzaldo; Leesa B,29,0,30,1
1681936661039,MATH 18,B01,182761,Anzaldo; Leesa B,26,0,30,4
1681936661039,MATH 18,B02,182764,Anzaldo; Leesa B,25,0,30,5
1681936661039,MATH 18,B03,182765,Anzaldo; Leesa B,29,0,30,1
1681936661039,MATH 18,B04,182766,Anzaldo; Leesa B,30,0,30,0
1681936662066,MATH 20A,A01,182771,Suk; Andrew Hoon,27,0,30,3
1681936663089,MATH 20B,A01,182775,Bach; Quang Tran,29,0,30,1
1681936663089,MATH 20B,A02,182777,Bach; Quang Tran,29,0,30,1
1681936663089,MATH 20B,B01,182780,Bach; Quang Tran,26,0,30,4
1681936663089,MATH 20B,B02,182782,Bach; Quang Tran,30,0,30,0
1681936664115,MATH 20C,A01,182787,Staff,23,0,30,7
1681936664115,MATH 20C,A02,182790,Staff,29,0,30,1
1681936664115,MATH 20C,B01,182792,Staff,23,0,30,7
1681936664115,MATH 20C,B02,182796,Staff,26,0,30,4
1681936665143,MATH 20D,A01,182799,Staff,26,0,30,4
1681936665143,MATH 20D,A02,182802,Staff,29,0,30,1
1681936665143,MATH 20D,A03,182803,Staff,29,0,30,1
1681936666170,MATH 20E,A01,182809,Verstraete; Jacques Allan,18,0,30,12
1681936666170,MATH 20E,A02,182811,Verstraete; Jacques Allan,26,0,30,4
1681936666170,MATH 20E,B01,182814,Verstraete; Jacques Allan,20,0,30,10
1681936666170,MATH 20E,B02,182815,Verstraete; Jacques Allan,27,0,30,3
1681936667195,MATH 103A,A01,182820,Staff,2,0,30,28
1681936667195,MATH 103A,A02,182821,Staff,26,0,30,4
1681936667195,MATH 103A,A03,182822,Staff,18,0,30,12
1681936667195,MATH 103A,B01,182825,Staff,21,0,30,9
1681936667195,MATH 103A,B02,182826,Staff,30,0,30,0
1681936667195,MATH 103A,B03,182830,Staff,30,0,30,0
1681936668224,MATH 109,A01,182836,Chow; Bennett,23,0,30,7
1681936668224,MATH 109,A02,182838,Chow; Bennett,27,0,30,3
1681936668224,MATH 109,A03,182894,Chow; Bennett,29,0,30,1
1681936668224,MATH 109,B01,182908,Chow; Bennett,26,0,30,4
1681936668224,MATH 109,B02,182909,Chow; Bennett,30,0,30,0
1681936668224,MATH 109,B03,182910,Chow; Bennett,26,0,30,4
1681936669254,MATH 142A,A01,182925,Staff,3,0,30,27
1681936669254,MATH 142A,A02,182935,Staff,23,0,30,7
1681936669254,MATH 142A,A03,182967,Staff,22,0,30,8
1681936669254,MATH 142A,B01,183125,Staff,22,0,30,8
1681936669254,MATH 142A,B02,183157,Staff,26,0,30,4
1681936669254,MATH 142A,B03,183158,Staff,29,0,30,1
1681936670282,MATH 183,A01,183160,Arias-Castro; Ery,22,0,30,8
1681936670282,MATH 183,A02,183161,Arias-Castro; Ery,28,0,30,2
1681936670282,MATH 183,B01,183163,Arias-Castro; Ery,26,0,30,4
1681936670282,MATH 183,B02,183164,Arias-Castro; Ery,28,0,30,2
1681936671304,MATH 193A,A01,183167,Staff,0,0,35,35
1681936671304,MATH 193A,A02,183168,Staff,20,0,35,15
1681936671304,MATH 193A,A03,183169,Staff,32,0,35,3
1681936671304,MATH 193A,A04,183170,Staff,26,0,35,9
1681936672329,MGT 4,A01,202395,Anderson; John Charles,76,0,80,4
1681936673352,MGT 5,A00,202396,Houskeeper; Robert,78,0,90,12
1681936674378,MGT 103,A00,202397,Eberhard; Craig A,45,0,90,45
1681936675402,MGT 131A,A00,202398,Houskeeper; Robert,81,0,90,9
1681936676425,MGT 135,A00,202399,Anderson; John Charles,81,0,90,9
1681936677458,MGT 162R,A00,202403,Gneezy; Uri,109,0,200,91
1681936678482,MGT 172,A00,202404,Hedges; Kathleen,18,0,90,72
1681936679505,MGT 181,A00,202405,Dunn; Louis Jean,74,0,90,16
1681936680531,MMW 14,A01,183200,Staff,1,0,28,27
1681936680531,MMW 14,A02,183201,Staff,24,0,28,4
1681936680531,MMW 14,A03,183202,Staff,23,0,28,5
1681936680531,MMW 14,A04,183203,Staff,25,0,28,3
1681936680531,MMW 14,A05,183204,Staff,25,0,28,3
1681936680531,MMW 14,A06,183205,Staff,26,0,28,2
1681936680531,MMW 14,B01,183207,Staff,26,0,28,2
1681936680531,MMW 14,B02,183208,Staff,28,0,28,0
1681936680531,MMW 14,B03,183209,Staff,28,0,28,0
1681936680531,MMW 14,B04,183210,Staff,28,0,28,0
1681936680531,MMW 14,B05,183211,Staff,28,0,28,0
1681936680531,MMW 14,B06,183212,Staff,27,0,28,1
1681936681566,MMW 14GS,A00,183213,Zhiri; Oumelbanine,28,0,28,0
1681936682593,MMW 15GS,B00,183215,Rahimi; Babak,27,0,28,1
1681936683619,MMW 121,A01,183217,Patterson; Patrick H.,5,0,28,23
1681936683619,MMW 121,A02,183218,Patterson; Patrick H.,25,0,28,3
1681936684641,MUS 1A,A01,182554,Staff,0,1,35,35
1681936685664,MUS 5,A01,182558,Staff,13,0,35,22
1681936686704,MUS 6,A01,182562,Staff,21,0,35,14
1681936687728,MUS 8GS,A00,182563,Borgo; David Garcia,25,0,25,0
1681936688751,MUS 13,A01,182567,Staff,23,0,25,2
1681936689773,MUS 15,A01,182570,Staff,31,0,35,4
1681936689773,MUS 15,B01,182575,Staff,4,0,35,31
1681936690816,MUS 80,A00,182578,Staff,22,0,25,3
1681936690816,MUS 80,B00,182581,Staff,20,0,25,5
1681936691839,MUS 113,A00,182582,Staff,25,0,25,0
1681936692862,MUS 114,A00,182583,Staff,0,3,25,25
1681936693885,MUS 150GS,A01,182588,Borgo; David Garcia,24,0,25,1
1681936694910,PHIL 1,A00,182590,Staff,34,0,40,6
1681936695954,PHIL 10,A01,182596,Grush; Rick Scott,30,0,35,5
1681936695954,PHIL 10,A02,182597,Grush; Rick Scott,33,0,35,2
1681936696976,PHIL 15,A01,182601,Staff,31,0,35,4
1681936696976,PHIL 15,A02,182602,Staff,33,0,35,2
1681936698004,PHIL 27,A01,182604,Staff,23,0,35,12
1681936698004,PHIL 27,A02,182607,Staff,33,0,35,2
1681936699028,PHIL 32,A01,182609,Staff,35,0,35,0
1681936699028,PHIL 32,A02,182612,Staff,35,0,35,0
1681936700055,PHIL 130,A00,182614,Staff,57,0,70,13
1681936701078,PHIL 136,A00,182616,Cohen; Jonathan David,63,0,70,7
1681936702103,PHIL 155,A00,182617,Vargas; Manuel Rogelio,56,0,70,14
1681936703130,PHIL 163,A01,182620,Staff,15,0,20,5
1681936703130,PHIL 163,A02,182624,Staff,9,0,20,11
1681936704159,PHIL 164,A00,182627,Staff,29,0,40,11
1681936705181,PHIL 173,A00,182628,Staff,35,0,40,5
1681936706212,PHYS 1A,A00,183221,Staff,52,0,60,8
1681936707237,PHYS 1AL,001,183222,Staff,24,0,30,6
1681936707237,PHYS 1AL,002,183223,Staff,23,0,30,7
1681936708269,PHYS 1B,A00,183231,Staff,39,0,60,21
1681936709299,PHYS 1BL,001,183232,Staff,15,0,30,15
1681936709299,PHYS 1BL,002,183233,Staff,27,0,30,3
1681936710324,PHYS 1C,A00,183240,Staff,19,0,60,41
1681936711352,PHYS 1CL,001,183241,Staff,7,0,30,23
1681936711352,PHYS 1CL,002,183242,Staff,20,0,30,10
1681936712377,PHYS 2AR,A01,183250,Staff,39,0,50,11
1681936713399,PHYS 2B,A01,183252,Staff,101,0,115,14
1681936714431,PHYS 2BL,A01,183254,Staff,21,0,24,3
1681936714431,PHYS 2BL,A02,183255,Staff,21,0,24,3
1681936715457,PHYS 2C,A01,183522,Staff,100,0,115,15
1681936716492,PHYS 4A,A01,183524,Staff,49,0,50,1
1681936717515,POLI 5,A00,183525,Staff,43,0,50,7
1681936718545,POLI 12,A00,183540,Staff,45,0,50,5
1681936719570,POLI 13R,A00,183541,Forman; Fonna,39,0,50,11
1681936720593,POLI 30,A00,183542,Mignozzetti; Umberto,48,0,50,2
1681936721630,POLI 100A,A00,183543,Staff,43,0,50,7
1681936722654,POLI 100E,A00,223598,Staff,32,0,35,3
1681936723680,POLI 103A,A00,183564,Kousser; Thad,35,0,50,15
1681936724702,POLI 104B,A00,201329,Staff,27,0,35,8
1681936725728,POLI 113BR,A00,183576,Hoston; Germaine,20,0,50,30
1681936726750,POLI 114BR,A00,183588,Staff,26,0,30,4
1681936727775,POLI 117R,A00,183595,Forman; Fonna,2,0,20,18
1681936728801,POLI 120H,A00,183596,Fisk; David Lee,12,0,20,8
1681936729839,POLI 130AA,A00,183597,Staff,13,0,20,7
1681936730861,POLI 134AA,A00,183598,Staff,19,0,20,1
1681936731883,POLI 135,A00,183599,Fisk; David Lee,18,0,25,7
1681936732909,POLI 142P,A00,183623,Staff,37,0,40,3
1681936733933,POLI 144D,A00,183624,Staff,22,0,25,3
1681936734955,POLI 151,A00,183625,Staff,14,0,20,6
1681936735982,POLI 162,A00,183626,Mignozzetti; Umberto,17,0,20,3
1681936737089,PSYC 1,A00,253748,Staff,85,0,90,5
1681936738112,PSYC 2,A00,183627,Moranton; Nirelia Melbina-,22,0,35,13
1681936739136,PSYC 3,A00,183628,Staff,42,0,45,3
1681936741199,PSYC 60,A01,183631,Lowe; Angela Beth,34,0,40,6
1681936742230,PSYC 70,A01,253757,Staff,32,0,45,13
1681936743254,PSYC 101,A00,183632,Heyman; Gail D.,38,0,60,22
1681936744277,PSYC 105,A00,183848,Lowe; Angela Beth,39,0,60,21
1681936745301,PSYC 106,A00,183849,Dobkins; Karen R.,33,0,60,27
1681936746330,PSYC 108,A00,253750,Staff,3,0,60,57
1681936747355,PSYC 114,A01,184275,Winkielman; Piotr,0,8,30,30
1681936748377,PSYC 122,A00,183856,Moranton; Nirelia Melbina-,0,16,30,30
1681936749414,PSYC 124,A00,183865,Chapman; Eddie Nathaniel,39,0,80,41
1681936750437,PSYC 137,A00,183880,Staff,14,0,25,11
1681936752483,PSYC 154,A00,183910,Lacefield; Katharine I,0,34,90,90
1681936754529,PSYC 162,A00,183946,Wixted; John T,32,0,90,58
1681936755558,PSYC 172,A00,183947,Gorman; Michael R.,2,0,30,28
1681936756582,PSYC 178,A00,183963,Glaser; Dale,10,0,40,30
1681936757605,PSYC 181GS,A00,183964,Anagnostaras; Stephan,10,0,10,0
1681936758629,PSYC 186GS,A01,257660,Staff,10,0,10,0
1681936759652,PSYC 193,B00,253749,Staff,22,0,25,3
1681936761713,PSYC 193L,A01,184122,Staff,33,0,35,2
1681936761713,PSYC 193L,C01,184167,Winkielman; Piotr,14,0,30,16
1681936762735,RELI 188GS,A00,182629,Rahimi; Babak,20,0,20,0
1681936763757,SE 101A,A00,182646,Staff,25,0,30,5
1681936764782,SE 101C,A00,182650,Staff,9,0,20,11
1681936765813,SE 110A,A00,182651,Staff,28,0,28,0
1681936766835,SE 130A,A00,182652,Staff,37,0,40,3
1681936767862,SIO 46GS,A00,182636,Cook; Geoffrey W,23,0,28,5
1681936768890,SIO 109R,A00,194459,Staff,0,2,20,20
1681936769913,SIO 121GS,A00,182639,Cook; Geoffrey W,23,0,28,5
1681936770935,SIO 132,A01,182642,Staff,30,0,40,10
1681936771959,SIO 139,A00,182644,Kacev; David,36,0,40,4
1681936772985,SOCI 2,A01,258404,Staff,33,0,36,3
1681936772985,SOCI 2,A02,258405,Staff,34,0,36,2
1681936774019,SOCI 60,A01,258408,Staff,29,0,30,1
1681936774019,SOCI 60,A02,258413,Staff,30,0,30,0
1681936775041,SOCI 100,A01,258415,Staff,28,0,30,2
1681936775041,SOCI 100,A02,258416,Staff,28,0,30,2
1681936781202,SOCI 127,A00,258421,Staff,18,0,30,12
1681936782225,SOCI 132,A00,258422,Staff,41,0,50,9
1681936783260,SOCI 133,A00,258423,Staff,26,0,30,4
1681936784282,SOCI 138GS,A00,258424,Staff,15,0,15,0
1681936785308,SOCI 145,A00,258425,Staff,23,0,30,7
1681936786331,SOCI 148,A00,258426,Staff,23,0,30,7
1681936787356,SOCI 153,A00,199217,Staff,30,0,30,0
1681936788382,SOCI 160,A00,258427,Staff,26,0,30,4
1681936789405,SOCI 160E,A00,258435,Staff,55,0,60,5
1681936790429,SOCI 189GS,A00,258436,Staff,15,0,15,0
1681936791459,SOCI 190GS,A00,258437,Staff,15,0,15,0
1681936792483,SYN 2,001,182658,Staff,7,0,16,9
1681936792483,SYN 2,002,201439,Staff,13,0,16,3
1681936792483,SYN 2,003,201443,Staff,15,0,16,1
1681936793513,SYN 100,A01,182657,Staff,8,0,20,12
1681936794540,TDAC 1,A00,184381,Salovey; Todd,16,0,20,4
1681936794540,TDAC 1,B00,184385,Harting; Carla Kelso,19,0,20,1
1681936794540,TDAC 1,C00,184394,Staff,18,0,20,2
1681936795562,TDAC 101,A00,184483,Harting; Carla Kelso,19,0,20,1
1681936796583,TDDE 111,A00,184496,Staff,14,0,15,1
1681936797610,TDDE 131,A00,184504,Staff,20,0,20,0
1681936797610,TDDE 131,B00,184505,Staff,17,0,18,1
1681936797610,TDDE 131,C00,184534,Staff,49,0,50,1
1681936797610,TDDE 131,D00,184564,Staff,15,0,15,0
1681936797610,TDDE 131,E00,204725,Staff,18,0,20,2
1681936798634,TDGE 1,A01,184414,Salovey; Todd,33,0,50,17
1681936799661,TDGE 5,A01,184419,Staff,23,0,24,1
1681936800686,TDGE 10,A00,184428,Fulton; Julia,27,0,50,23
1681936801719,TDGE 124,A00,184565,Fulton; Julia,0,5,50,50
1681936802745,TDGE 125,B00,184567,Meyer; Ursula,5,0,25,20
1681936803768,TDHT 101,A00,184568,Staff,20,0,25,5
1681936803768,TDHT 101,B00,184569,Staff,20,0,20,0
1681936804793,TDHT 114,A00,184570,Staff,47,0,50,3
1681936805817,TDMV 1,A00,184437,Arcidiacono; Kristin,21,0,30,9
1681936805817,TDMV 1,B00,184448,Caligagan; Maria T.,23,0,30,7
1681936806845,TDMV 2,A00,184449,Weinberg; Sadie,26,0,30,4
1681936806845,TDMV 2,B00,184453,Arcidiacono; Kristin,29,0,30,1
1681936807872,TDMV 110,A00,184571,Weinberg; Sadie,30,0,30,0
1681936808907,TDMV 142,A00,184572,Caligagan; Tony,26,0,30,4
1681936808907,TDMV 142,B00,184573,Caligagan; Maria T.,26,0,30,4
1681936809936,TDTR 20,A00,184482,Jun; Grace Shin Hae,25,0,25,0
1681936810959,USP 2,A01,184290,Hinds; Juli Beth,23,0,25,2
1681936811983,USP 3,A01,184295,Staff,19,0,25,6
1681936813013,USP 4,A00,184304,McTague; Sarah,11,0,25,14
1681936814037,USP 100,A00,184315,Staff,16,0,25,9
1681936815062,USP 105,A00,184326,Staff,21,0,25,4
1681936816084,USP 151,A00,184327,Staff,15,0,25,10
1681936817107,USP 170,A00,184380,Hinds; Juli Beth,12,0,25,13
1681936818129,VIS 21B,A01,182660,Staff,28,0,31,3
1681936818129,VIS 21B,A02,182662,Staff,30,0,31,1
1681936819159,VIS 103D,A00,182663,Staff,73,0,75,2
1681936820185,VIS 105D,A00,182667,Li; Huai,14,0,22,8
1681936821211,VIS 122GS,A00,182668,Herbst; Matthew,20,0,20,0
1681936822234,VIS 128C,A00,182673,Staff,68,0,75,7
1681936823258,VIS 130,A00,182675,Staff,19,0,22,3
1681936824283,VIS 160A,A00,182678,Stalbaum; Brett,4,0,10,6
1681936826336,WCWP 10B,A00,201679,Staff,15,0,15,0
1681936826336,WCWP 10B,B00,201695,Staff,15,0,15,0
1681936827362,WCWP 100,A00,201716,Staff,12,0,15,3
1681936827362,WCWP 100,B00,201717,Staff,0,1,15,15
1681936829420,ANSC 105GS,A00,258289,Staff,0,0,0,0
1681936830453,ANSC 125GS,A00,258295,Staff,0,0,0,0
1681936831476,ANSC 150,A00,258267,Staff,26,0,40,14
1681936832501,ANSC 190GS,A00,258280,Staff,0,0,0,2
1681936833528,ANTH 1,A00,258264,Staff,38,0,40,2
1681936834556,ANTH 2,A01,258259,Staff,72,0,76,4
1681936835578,ANTH 23,A01,258228,Staff,35,0,40,5
1681936836605,ANTH 101,A01,258236,Staff,38,0,40,2
1681936837647,ANTH 102,A00,258272,Staff,59,0,60,1
1681936838673,ANTH 105,A00,258244,Staff,28,0,35,7
1681936839699,BENG 130,A00,253975,Staff,37,0,40,3
1681936840795,BIBC 102,A01,191866,Flagg; Matthew Paul,14,0,32,18
1681936840795,BIBC 102,A02,191867,Flagg; Matthew Paul,20,0,32,12
1681936840795,BIBC 102,A03,191868,Flagg; Matthew Paul,26,0,32,6
1681936840795,BIBC 102,A04,191936,Flagg; Matthew Paul,19,0,32,13
1681936840795,BIBC 102,A05,191937,Flagg; Matthew Paul,0,1,32,32
1681936841819,BICD 100,A01,191939,Cooper; Andrew Michael,27,0,32,5
1681936841819,BICD 100,A02,191940,Cooper; Andrew Michael,32,0,32,0
1681936841819,BICD 100,A03,191941,Cooper; Andrew Michael,32,0,32,0
1681936841819,BICD 100,A04,191942,Cooper; Andrew Michael,32,0,32,0
1681936841819,BICD 100,A05,191943,Cooper; Andrew Michael,32,0,32,0
1681936842843,BIEB 126,A01,191945,Cleland; Elsa Eleanor,0,5,32,32
1681936842843,BIEB 126,A02,191946,Cleland; Elsa Eleanor,24,0,32,8
1681936842843,BIEB 126,A03,191947,Cleland; Elsa Eleanor,29,0,32,3
1681936842843,BIEB 126,A04,191948,Cleland; Elsa Eleanor,15,0,32,17
1681936842843,BIEB 126,A05,191996,Cleland; Elsa Eleanor,28,0,32,4
1681936843866,BIEB 136GS,A00,191997,Shurin; Jonathan & Holway; David A.,0,0,0,9
1681936844888,BIEB 137GS,A01,191999,Shurin; Jonathan & Holway; David A.,0,0,0,8
1681936845911,BILD 1,A01,205385,Staff,29,0,32,3
1681936845911,BILD 1,A02,205386,Staff,30,0,32,2
1681936845911,BILD 1,A03,205387,Staff,31,0,32,1
1681936845911,BILD 1,A04,205388,Staff,25,0,32,7
1681936846937,BILD 2,A01,191774,Staff,24,0,32,8
1681936846937,BILD 2,A02,191775,Staff,29,0,32,3
1681936846937,BILD 2,A03,191777,Staff,29,0,32,3
1681936846937,BILD 2,A04,191856,Staff,30,0,32,2
1681936846937,BILD 2,A05,191857,Staff,31,0,32,1
1681936846937,BILD 2,A06,191858,Staff,32,0,32,0
1681936846937,BILD 2,A07,191859,Staff,31,0,32,1
1681936847962,BILD 3,A01,205391,Staff,26,0,32,6
1681936847962,BILD 3,A02,205393,Staff,32,0,32,0
1681936847962,BILD 3,A03,205394,Staff,26,0,32,6
1681936847962,BILD 3,A04,205395,Staff,32,0,32,0
1681936848985,BILD 20,A01,191861,Staff,32,0,32,0
1681936848985,BILD 20,A02,191862,Staff,32,0,32,0
1681936850011,BILD 30,A01,191864,Staff,31,0,32,1
1681936851040,BIMM 100,A01,192019,Staff,0,0,32,32
1681936851040,BIMM 100,A02,192020,Staff,9,0,32,23
1681936851040,BIMM 100,A03,192035,Staff,17,0,32,15
1681936852066,BIMM 110,A01,192037,Tat; John,0,0,32,32
1681936852066,BIMM 110,A02,192038,Tat; John,4,0,32,28
1681936853090,BIMM 120,A01,192040,Pickett; Brooke Elizabeth,0,0,32,32
1681936853090,BIMM 120,A02,192041,Pickett; Brooke Elizabeth,7,0,32,25
1681936853090,BIMM 120,A03,192042,Pickett; Brooke Elizabeth,14,0,32,18
1681936854114,BIPN 100,A01,192044,Armour; Jon Christopher,23,0,32,9
1681936854114,BIPN 100,A02,192059,Armour; Jon Christopher,30,0,32,2
1681936854114,BIPN 100,A03,192064,Armour; Jon Christopher,29,0,32,3
1681936854114,BIPN 100,A04,192073,Armour; Jon Christopher,26,0,32,6
1681936855140,BIPN 148,A01,205411,Leutgeb; Jill K.,14,0,32,18
1681936855140,BIPN 148,A02,205412,Leutgeb; Jill K.,31,0,32,1
1681936855140,BIPN 148,A03,205413,Leutgeb; Jill K.,29,0,32,3
1681936855140,BIPN 148,A04,205414,Leutgeb; Jill K.,30,0,32,2
1681936856194,BIPN 160,A01,192115,Marino; Marc J,15,0,32,17
1681936856194,BIPN 160,A02,192148,Marino; Marc J,27,0,32,5
1681936856194,BIPN 160,A03,192158,Marino; Marc J,31,0,32,1
1681936856194,BIPN 160,A04,192190,Marino; Marc J,32,0,32,0
1681936856194,BIPN 160,A05,192287,Marino; Marc J,32,0,32,0
1681936856194,BIPN 160,A06,192288,Marino; Marc J,32,0,32,0
1681936857221,BIPN 194,A00,206038,Leutgeb; Stefan,28,0,32,4
1681936858247,BISP 194,A00,192289,Nieh; James Charles,8,0,32,24
1681936858247,BISP 194,B00,245332,Staff,26,0,32,6
1681936859273,CAT 124,A01,202247,Staff,15,0,15,0
1681936860309,CAT 125,A00,202248,Staff,18,0,20,2
1681936860309,CAT 125,B00,202253,Staff,20,0,20,0
1681936860309,CAT 125,C00,202257,Staff,17,0,20,3
1681936861482,CAT 125GS,A01,202273,Bronstein; Phoebe Malan,20,0,20,0
1681936862509,CAT 125R,A00,202284,Staff,16,0,20,4
1681936862509,CAT 125R,C00,202286,Staff,4,0,20,16
1681936862509,CAT 125R,D00,202291,Staff,14,0,20,6
1681936862509,CAT 125R,E00,202295,Staff,13,0,20,7
1681936862509,CAT 125R,F00,202302,Staff,4,0,20,16
1681936863533,CENG 100,A00,204724,Opatkiewicz; Justin Paul,23,0,25,2
1681936864566,CGS 2A,A01,180420,Staff,29,0,36,7
1681936865590,CGS 101,A00,180421,Staff,14,0,20,6
1681936866618,CGS 112,A00,180422,Staff,7,0,16,9
1681936867647,CGS 113,A00,180423,Staff,18,0,20,2
1681936868673,CGS 137,A00,180424,Staff,12,0,12,0
1681936869696,CGS 147,A00,180425,Staff,10,0,10,0
1681936870718,CHEM 6A,A01,179556,Staff,92,0,100,8
1681936870718,CHEM 6A,A02,179558,Staff,0,0,0,0
1681936871750,CHEM 6B,A01,179560,Staff,100,0,100,0
1681936872778,CHEM 6C,A01,179565,Jazzar; Rodolphe,89,0,100,11
1681936873803,CHEM 7L,A01,179586,Schurmeier; Kimberly,9,0,24,15
1681936873803,CHEM 7L,A02,179587,Schurmeier; Kimberly,22,0,24,2
1681936873803,CHEM 7L,A03,179590,Schurmeier; Kimberly,21,0,24,3
1681936873803,CHEM 7L,A04,179591,Schurmeier; Kimberly,22,0,24,2
1681936873803,CHEM 7L,B01,179598,Schurmeier; Kimberly,12,0,24,12
1681936873803,CHEM 7L,B02,179599,Schurmeier; Kimberly,23,0,24,1
1681936873803,CHEM 7L,B03,179606,Schurmeier; Kimberly,22,0,24,2
1681936873803,CHEM 7L,B04,179607,Schurmeier; Kimberly,22,0,24,2
1681936874828,CHEM 11,A01,179609,Stallings; Dontarie M,85,0,100,15
1681936875865,CHEM 40A,A01,179621,Staff,37,0,50,13
1681936875865,CHEM 40A,A02,179622,Staff,43,0,50,7
1681936876893,CHEM 40B,A01,179630,Weizman; Haim,45,0,50,5
1681936876893,CHEM 40B,A02,179631,Weizman; Haim,42,0,50,8
1681936877923,CHEM 41A,A01,179660,Klosterman; Jeremy K,90,0,100,10
1681936889475,CHEM 43A,A01,179683,Klosterman; Jeremy K,0,0,24,24
1681936889475,CHEM 43A,A02,179688,Klosterman; Jeremy K,5,0,24,19
1681936889475,CHEM 43A,A03,179689,Klosterman; Jeremy K,16,0,24,8
1681936889475,CHEM 43A,A04,179691,Klosterman; Jeremy K,16,0,24,8
1681936890503,CHEM 114A,A01,179693,Stallings; Dontarie M,58,0,100,42
1681936891530,CHEM 143B,A01,179698,Weizman; Haim,16,0,24,8
1681936891530,CHEM 143B,A02,179700,Weizman; Haim,23,0,24,1
1681936892552,CHIN 169A,A00,179701,Wang; Xiao,20,0,20,0
1681936893578,COGS 2,A01,179750,Boyle; Mary E. T.,16,0,30,14
1681936894604,COGS 9,A01,179759,Jones; Cameron Robert,39,0,50,11
1681936895630,COGS 14A,A01,179854,Staff,5,0,50,45
1681936896653,COGS 14B,A01,179856,Staff,49,0,60,11
1681936897675,COGS 17,A01,179874,Staff,69,0,75,6
1681936898698,COGS 18,A01,179884,Staff,56,0,80,24
1681936899721,COGS 100,A01,179886,Staff,25,0,60,35
1681936900746,COGS 101B,A01,179892,Staff,0,6,30,30
1681936901771,COGS 101C,A01,179894,Staff,25,0,30,5
1681936902794,COGS 107A,A01,179896,Boyle; Mary E. T.,28,0,40,12
1681936903816,COGS 108,A01,179898,Simpkins; Charles Alexander,0,35,60,60
1681936904841,COGS 109,A01,179900,Staff,32,0,40,8
1681936905865,COGS 118A,A01,179946,Staff,2,0,40,38
1681936906888,COGS 153,A00,179978,Staff,0,7,30,30
1681936907911,COGS 156,A01,179981,Staff,19,0,30,11
1681936909976,COGS 172,A01,179987,Staff,5,0,30,25
1681936912034,COGS 186,A01,179991,Staff,9,0,30,21
1681936913060,COMM 10,A01,180001,Staff,10,0,25,15
1681936913060,COMM 10,A02,180004,Staff,20,0,25,5
1681936914084,COMM 100A,A01,180016,Staff,12,0,25,13
1681936914084,COMM 100A,A02,180020,Staff,24,0,25,1
1681936915115,COMM 101T,A00,180029,Halm; Gavin Patrick,13,0,35,22
1681936916145,COMM 106V,A00,180043,Staff,33,0,35,2
1681936917168,COMM 109P,A00,180044,Staff,29,0,35,6
1681936918191,COMM 113T,A00,180045,Havis; Allan,30,0,45,15
1681936919217,COMM 132,A00,180046,McKenna; Denise,14,0,30,16
1681936920239,COMM 143,A00,180047,Staff,13,0,30,17
1681936921264,COMM 190,A00,180048,Conner; Thomas Hartnell,13,0,23,10
1681936922290,CSE 8A,A50,180053,Cao; Yingjun,19,0,50,31
1681936922290,CSE 8A,B50,180180,Staff,49,0,50,1
1681936923322,CSE 11,A01,180190,Cao; Yingjun,14,0,50,36
1681936924346,CSE 20,A01,180192,Briones; Jor-el Thomas Caparas,20,0,30,10
1681936925369,CSE 21,A01,194538,Briones; Jor-el Thomas Caparas,49,0,60,11
1681936926391,CSE 30,A01,180324,Eldon; John,69,0,100,31
1681936927419,CSE 101,A01,201353,Staff,0,34,40,40
1681936928464,CSE 134B,A01,180326,Powell; Thomas Allan,68,0,100,32
1681936929489,CSE 140,A01,180328,Staff,17,0,75,58
1681936930513,CSE 140L,A01,180344,Eldon; John,43,0,100,57
1681936931541,CSE 150A,A01,180411,Staff,0,20,50,50
1681936932566,CSE 151A,A01,180414,Staff,0,17,50,50
1681936933590,CSE 175,A01,222521,Kumar; Rakesh,50,0,50,0
1681936934611,CSE 190,A00,201419,Staff,42,0,49,7
1681936935652,CSS 1,A01,194536,Staff,29,0,50,21
1681936936678,DSC 30,A01,202385,Staff,48,0,50,2
1681936937703,DSC 40A,A01,202387,Albuyeh; Rod,50,0,50,0
1681936938725,DSC 190,A01,202389,Silberman; Jack,21,0,21,0
1681936939750,DSGN 100,A01,179993,Staff,12,0,30,18
1681936940774,ECE 65,A50,180708,Staff,10,0,20,10
1681936940774,ECE 65,A51,180739,Staff,19,0,20,1
1681936941803,ECON 1,A01,180427,Famulari; Melissa,65,0,70,5
1681936942830,ECON 2,A01,180450,Levkoff; Steven B.,62,0,70,8
1681936943858,ECON 4,A01,203351,Anderson; John Charles,6,0,10,4
1681936944884,ECON 100A,A01,180472,Famulari; Melissa,59,0,70,11
1681936945909,ECON 120A,A01,180549,Staff,59,0,70,11
1681936946946,ECON 120B,A01,180655,Ma; Xinwei,28,0,70,42
1681936947968,ECON 129,A00,203333,Eckert; Fabian Paul,4,0,35,31
1681936948997,ECON 131,A00,180656,Staff,0,4,35,35
1681936950023,ECON 172B,A01,180672,Levkoff; Steven B.,30,0,35,5
1681936951050,ECON 178,A01,203342,Zhu; Ying,2,0,35,33
1681936952073,EDS 108GS,A00,202383,Wishard Guerra; Alison G.,20,0,20,0
1681936953098,EDS 111GS,A00,202347,Wishard Guerra; Alison G.,20,0,20,0
1681936954120,EDS 112,A01,202323,Staff,51,0,60,9
1681936955214,EDS 113,A00,202340,Staff,30,0,35,5
1681936956236,EDS 118,A00,201231,Staff,19,0,30,11
1681936957258,EDS 119,A00,204994,Staff,8,0,10,2
1681936958283,EDS 124BR,A00,202324,Eguchi; Emi,0,4,25,25
1681936959315,EDS 126,A01,203208,Jones; Makeba,26,0,30,4
1681936960338,EDS 135,A01,202333,Staff,17,0,20,3
1681936961363,EDS 180,A00,202311,Staff,47,0,50,3
1681936962392,ERC 190GS,A01,253747,Staff,28,0,28,0
1681936963417,ETHN 104,A00,180742,Staff,20,0,35,15
1681936964448,ETHN 118,A00,180745,Staff,26,0,35,9
1681936965475,ETHN 127,A00,180747,Staff,8,0,16,8
1681936966501,ETHN 137,A00,180880,Staff,11,0,12,1
1681936967526,ETHN 147,A00,180890,Staff,8,0,10,2
1681936968557,ETHN 154,A00,180891,Staff,4,0,8,4
1681936969580,ETHN 168,A00,180892,Staff,9,0,10,1
1681936970605,GLBH 20,A00,201051,Hannah; Seth Donal,0,7,0,1
1681936971633,GLBH 111,A01,209338,Burgos; Jose L.,0,0,0,0
1681936972657,GLBH 150,A00,258300,Staff,0,4,0,0
1681936973687,GLBH 181,A00,201207,Staff,2,0,40,38
1681936974710,HIEU 109,A00,180898,Staff,19,0,20,1
1681936975732,HIEU 111,A00,180899,Staff,0,2,20,20
1681936976754,HIEU 124,A00,180900,Staff,16,0,20,4
1681936977779,HILA 122,A00,180901,Staff,16,0,20,4
1681936978819,HILA 132,A00,180902,Vitz; Matthew,0,5,20,20
1681936979843,HILD 10,A01,180896,Staff,11,0,20,9
1681936980866,HILD 30GS,A00,180897,Edington; Claire Ellen,0,0,0,0
1681936981892,HISC 105,A00,180903,Staff,20,0,20,0
1681936982917,HISC 117,A00,180904,Staff,10,0,20,10
1681936983939,HIUS 108B,A00,181005,Staff,17,0,20,3
1681936984975,HIUS 113,A00,181093,Staff,0,1,20,20
1681936985999,HUM 3,A01,181190,Patterson; Patrick H.,32,0,50,18
1681936985999,HUM 3,B01,181195,Staff,43,0,50,7
1681936987022,HUM 3GS,A00,181196,Herbst; Matthew,0,0,0,0
1681936988044,HUM 4,A01,181227,West; Geoffrey Scott,33,0,50,17
1681936988044,HUM 4,B01,181282,Staff,41,0,50,9
1681936989073,HUM 4GS,A00,181377,Lyon; Antony J.,0,0,0,0
1681936990108,HUM 5,A01,181536,Zavodny; Tatiana Sophia,22,0,50,28
1681936990108,HUM 5,B01,181908,Staff,30,0,50,20
1681936991139,INTL 190,A00,181909,Segui; Alan S,0,0,0,8
1681936991139,INTL 190,B00,181961,Segui; Alan S,0,0,0,7
1681936992162,JAPN 20AR,A01,182113,Ross; Kayoko F,15,0,20,5
1681936993183,LATI 50,A01,202391,Martin-Cabrera; Luis,15,0,30,15
1681936993183,LATI 50,A02,202392,Martin-Cabrera; Luis,26,0,30,4
1681936994226,LATI 180,A00,202393,Kokinis; Troy Andreas,24,0,25,1
1681936995248,LIFR 1A,A00,182119,Staff,13,0,14,1
1681936996273,LIFR 1AX,A00,182324,Staff,13,0,14,1
1681936997295,LIFR 1B,A00,182259,Staff,11,0,14,3
1681936998317,LIFR 1BX,A00,182273,Staff,11,0,14,3
1681936999342,LIGN 8,A00,182330,Staff,122,0,150,28
1681937000364,LIGN 9GS,A00,182362,Staff,14,0,20,6
1681937001390,LIGN 119,A00,204992,Takahashi; Maho,11,0,15,4
1681937002418,LIGN 130,A01,182384,Staff,47,0,50,3
1681937003441,LIGN 149GS,A00,182390,Staff,14,0,20,6
1681937004463,LIGN 170,A00,182404,Staff,23,0,30,7
1681937005487,LISP 1D,A00,182281,Staff,6,0,14,8
1681937005487,LISP 1D,B00,182287,Staff,13,0,14,1
1681937005487,LISP 1D,C00,182295,Staff,10,0,14,4
1681937005487,LISP 1D,D00,182301,Staff,14,0,14,0
1681937006509,LISP 1DX,A00,182309,Staff,18,0,28,10
1681937006509,LISP 1DX,B00,182316,Staff,25,0,28,3
1681937007533,LTAF 120GS,A00,182412,Zhiri; Oumelbanine,20,0,20,0
1681937008555,LTCS 172GS,A00,182437,Bronstein; Phoebe Malan,20,0,20,0
1681937009586,LTEA 138,A00,182457,Staff,13,0,40,27
1681937010611,LTEN 114,A01,182490,Staff,23,0,25,2
1681937011634,LTEN 130GS,A00,182491,Lyon; Antony J.,20,0,20,0
1681937012656,LTEN 169,A00,182493,Cuong; Marisol,17,0,25,8
1681937013685,LTEN 178,A00,182501,Staff,14,0,15,1
1681937014709,LTEN 181,A00,182515,Staff,19,0,25,6
1681937015731,LTEN 185GS,A00,197655,Forbes; Camille,20,0,20,0
1681937016758,LTSP 100B,A00,202208,Bessett; Ryan Matthew,24,0,25,1
1681937017783,LTWL 100,A00,182516,Myerston Santana; Jacobo,19,0,30,11
1681937018811,LTWR 100GS,A00,182518,Forbes; Camille,20,0,20,0
1681937019844,LTWR 102,A00,182522,Staff,15,0,15,0
1681937019844,LTWR 102,B00,182525,Staff,14,0,15,1
1681937020868,LTWR 115,A00,182526,Staff,9,0,15,6
1681937021891,MAE 8,A01,182528,Pham; Hieu Tan,65,0,70,5
1681937022913,MAE 11,A00,182529,Bahadori; Mohammad Yousef,88,0,100,12
1681937023938,MAE 20,A00,182530,Evdokimenko; Ekaterina,66,0,70,4
1681937024962,MAE 30A,A00,182532,Staff,44,0,45,1
1681937025987,MAE 101A,A00,182533,Bahadori; Mohammad Yousef,93,0,100,7
1681937027008,MAE 101C,A00,182538,Staff,62,0,70,8
1681937028034,MAE 104,A00,182539,Staff,44,0,50,6
1681937029062,MAE 131A,A00,182540,Ghazinejad; Maziar,40,0,45,5
1681937030087,MAE 143A,A00,182548,Bewley; Thomas R,42,0,50,8
1681937031120,MAE 150,A00,182549,Staff,28,0,40,12
1681937032149,MAE 160,A00,182550,Evdokimenko; Ekaterina,36,0,60,24
1681937033179,MATH 3C,A01,182725,Staff,24,0,30,6
1681937034208,MATH 10A,A01,182729,Staff,24,0,30,6
1681937034208,MATH 10A,B01,182732,Staff,25,0,30,5
1681937035234,MATH 10B,A01,182737,Staff,14,0,30,16
1681937035234,MATH 10B,A02,182738,Staff,24,0,30,6
1681937035234,MATH 10B,B01,182744,Staff,24,0,30,6
1681937035234,MATH 10B,B02,182745,Staff,26,0,30,4
1681937036258,MATH 18,A01,182750,Anzaldo; Leesa B,28,0,30,2
1681937036258,MATH 18,A02,182751,Anzaldo; Leesa B,28,0,30,2
1681937036258,MATH 18,A03,182753,Anzaldo; Leesa B,27,0,30,3
1681937036258,MATH 18,A04,182757,Anzaldo; Leesa B,29,0,30,1
1681937036258,MATH 18,B01,182761,Anzaldo; Leesa B,26,0,30,4
1681937036258,MATH 18,B02,182764,Anzaldo; Leesa B,25,0,30,5
1681937036258,MATH 18,B03,182765,Anzaldo; Leesa B,29,0,30,1
1681937036258,MATH 18,B04,182766,Anzaldo; Leesa B,30,0,30,0
1681937037281,MATH 20A,A01,182771,Suk; Andrew Hoon,27,0,30,3
1681937038314,MATH 20B,A01,182775,Bach; Quang Tran,29,0,30,1
1681937038314,MATH 20B,A02,182777,Bach; Quang Tran,29,0,30,1
1681937038314,MATH 20B,B01,182780,Bach; Quang Tran,26,0,30,4
1681937038314,MATH 20B,B02,182782,Bach; Quang Tran,30,0,30,0
1681937039338,MATH 20C,A01,182787,Staff,23,0,30,7
1681937039338,MATH 20C,A02,182790,Staff,29,0,30,1
1681937039338,MATH 20C,B01,182792,Staff,23,0,30,7
1681937039338,MATH 20C,B02,182796,Staff,26,0,30,4
1681937040378,MATH 20D,A01,182799,Staff,26,0,30,4
1681937040378,MATH 20D,A02,182802,Staff,29,0,30,1
1681937040378,MATH 20D,A03,182803,Staff,29,0,30,1
1681937041406,MATH 20E,A01,182809,Verstraete; Jacques Allan,18,0,30,12
1681937041406,MATH 20E,A02,182811,Verstraete; Jacques Allan,26,0,30,4
1681937041406,MATH 20E,B01,182814,Verstraete; Jacques Allan,20,0,30,10
1681937041406,MATH 20E,B02,182815,Verstraete; Jacques Allan,27,0,30,3
1681937042433,MATH 103A,A01,182820,Staff,1,0,30,29
1681937042433,MATH 103A,A02,182821,Staff,26,0,30,4
1681937042433,MATH 103A,A03,182822,Staff,18,0,30,12
1681937042433,MATH 103A,B01,182825,Staff,21,0,30,9
1681937042433,MATH 103A,B02,182826,Staff,30,0,30,0
1681937042433,MATH 103A,B03,182830,Staff,30,0,30,0
1681937043460,MATH 109,A01,182836,Chow; Bennett,23,0,30,7
1681937043460,MATH 109,A02,182838,Chow; Bennett,27,0,30,3
1681937043460,MATH 109,A03,182894,Chow; Bennett,29,0,30,1
1681937043460,MATH 109,B01,182908,Chow; Bennett,26,0,30,4
1681937043460,MATH 109,B02,182909,Chow; Bennett,30,0,30,0
1681937043460,MATH 109,B03,182910,Chow; Bennett,26,0,30,4
1681937044495,MATH 142A,A01,182925,Staff,2,0,30,28
1681937044495,MATH 142A,A02,182935,Staff,23,0,30,7
1681937044495,MATH 142A,A03,182967,Staff,22,0,30,8
1681937044495,MATH 142A,B01,183125,Staff,22,0,30,8
1681937044495,MATH 142A,B02,183157,Staff,26,0,30,4
1681937044495,MATH 142A,B03,183158,Staff,29,0,30,1
1681937045520,MATH 183,A01,183160,Arias-Castro; Ery,22,0,30,8
1681937045520,MATH 183,A02,183161,Arias-Castro; Ery,28,0,30,2
1681937045520,MATH 183,B01,183163,Arias-Castro; Ery,26,0,30,4
1681937045520,MATH 183,B02,183164,Arias-Castro; Ery,28,0,30,2
1681937046542,MATH 193A,A01,183167,Staff,0,0,35,35
1681937046542,MATH 193A,A02,183168,Staff,19,0,35,16
1681937046542,MATH 193A,A03,183169,Staff,32,0,35,3
1681937046542,MATH 193A,A04,183170,Staff,26,0,35,9
1681937047565,MGT 4,A01,202395,Anderson; John Charles,76,0,80,4
1681937048587,MGT 5,A00,202396,Houskeeper; Robert,78,0,90,12
1681937049614,MGT 103,A00,202397,Eberhard; Craig A,44,0,90,46
1681937050637,MGT 131A,A00,202398,Houskeeper; Robert,81,0,90,9
1681937051662,MGT 135,A00,202399,Anderson; John Charles,81,0,90,9
1681937052685,MGT 162R,A00,202403,Gneezy; Uri,108,0,200,92
1681937053708,MGT 172,A00,202404,Hedges; Kathleen,16,0,90,74
1681937054731,MGT 181,A00,202405,Dunn; Louis Jean,74,0,90,16
1681937055759,MMW 14,A01,183200,Staff,0,0,28,28
1681937055759,MMW 14,A02,183201,Staff,23,0,28,5
1681937055759,MMW 14,A03,183202,Staff,23,0,28,5
1681937055759,MMW 14,A04,183203,Staff,25,0,28,3
1681937055759,MMW 14,A05,183204,Staff,25,0,28,3
1681937055759,MMW 14,A06,183205,Staff,26,0,28,2
1681937055759,MMW 14,B01,183207,Staff,26,0,28,2
1681937055759,MMW 14,B02,183208,Staff,28,0,28,0
1681937055759,MMW 14,B03,183209,Staff,28,0,28,0
1681937055759,MMW 14,B04,183210,Staff,28,0,28,0
1681937055759,MMW 14,B05,183211,Staff,28,0,28,0
1681937055759,MMW 14,B06,183212,Staff,27,0,28,1
1681937056780,MMW 14GS,A00,183213,Zhiri; Oumelbanine,28,0,28,0
1681937057810,MMW 15GS,B00,183215,Rahimi; Babak,27,0,28,1
1681937058905,MMW 121,A01,183217,Patterson; Patrick H.,5,0,28,23
1681937058905,MMW 121,A02,183218,Patterson; Patrick H.,25,0,28,3
1681937059933,MUS 1A,A01,182554,Staff,0,1,35,35
1681937060959,MUS 5,A01,182558,Staff,13,0,35,22
1681937061989,MUS 6,A01,182562,Staff,21,0,35,14
1681937063014,MUS 8GS,A00,182563,Borgo; David Garcia,25,0,25,0
1681937064042,MUS 13,A01,182567,Staff,23,0,25,2
1681937065064,MUS 15,A01,182570,Staff,31,0,35,4
1681937065064,MUS 15,B01,182575,Staff,5,0,35,30
1681937066087,MUS 80,A00,182578,Staff,22,0,25,3
1681937066087,MUS 80,B00,182581,Staff,20,0,25,5
1681937067114,MUS 113,A00,182582,Staff,25,0,25,0
1681937068137,MUS 114,A00,182583,Staff,0,3,25,25
1681937069163,MUS 150GS,A01,182588,Borgo; David Garcia,24,0,25,1
1681937070193,PHIL 1,A00,182590,Staff,34,0,40,6
1681937071219,PHIL 10,A01,182596,Grush; Rick Scott,30,0,35,5
1681937071219,PHIL 10,A02,182597,Grush; Rick Scott,33,0,35,2
1681937072244,PHIL 15,A01,182601,Staff,31,0,35,4
1681937072244,PHIL 15,A02,182602,Staff,33,0,35,2
1681937073273,PHIL 27,A01,182604,Staff,23,0,35,12
1681937073273,PHIL 27,A02,182607,Staff,33,0,35,2
1681937074295,PHIL 32,A01,182609,Staff,35,0,35,0
1681937074295,PHIL 32,A02,182612,Staff,35,0,35,0
1681937075320,PHIL 130,A00,182614,Staff,57,0,70,13
1681937076343,PHIL 136,A00,182616,Cohen; Jonathan David,63,0,70,7
1681937077368,PHIL 155,A00,182617,Vargas; Manuel Rogelio,56,0,70,14
1681937078396,PHIL 163,A01,182620,Staff,15,0,20,5
1681937078396,PHIL 163,A02,182624,Staff,9,0,20,11
1681937079423,PHIL 164,A00,182627,Staff,29,0,40,11
1681937080447,PHIL 173,A00,182628,Staff,35,0,40,5
1681937081470,PHYS 1A,A00,183221,Staff,52,0,60,8
1681937082494,PHYS 1AL,001,183222,Staff,24,0,30,6
1681937082494,PHYS 1AL,002,183223,Staff,23,0,30,7
1681937083517,PHYS 1B,A00,183231,Staff,39,0,60,21
1681937084543,PHYS 1BL,001,183232,Staff,15,0,30,15
1681937084543,PHYS 1BL,002,183233,Staff,27,0,30,3
1681937085567,PHYS 1C,A00,183240,Staff,19,0,60,41
1681937086591,PHYS 1CL,001,183241,Staff,7,0,30,23
1681937086591,PHYS 1CL,002,183242,Staff,20,0,30,10
1681937087613,PHYS 2AR,A01,183250,Staff,39,0,50,11
1681937088639,PHYS 2B,A01,183252,Staff,101,0,115,14
1681937089662,PHYS 2BL,A01,183254,Staff,21,0,24,3
1681937089662,PHYS 2BL,A02,183255,Staff,21,0,24,3
1681937090689,PHYS 2C,A01,183522,Staff,100,0,115,15
1681937091712,PHYS 4A,A01,183524,Staff,49,0,50,1
1681937092734,POLI 5,A00,183525,Staff,43,0,50,7
1681937093755,POLI 12,A00,183540,Staff,44,0,50,6
1681937094778,POLI 13R,A00,183541,Forman; Fonna,39,0,50,11
1681937095806,POLI 30,A00,183542,Mignozzetti; Umberto,47,0,50,3
1681937096835,POLI 100A,A00,183543,Staff,43,0,50,7
1681937097857,POLI 100E,A00,223598,Staff,32,0,35,3
1681937098880,POLI 103A,A00,183564,Kousser; Thad,34,0,50,16
1681937099905,POLI 104B,A00,201329,Staff,27,0,35,8
1681937100929,POLI 113BR,A00,183576,Hoston; Germaine,20,0,50,30
1681937101958,POLI 114BR,A00,183588,Staff,26,0,30,4
1681937102980,POLI 117R,A00,183595,Forman; Fonna,1,0,20,19
1681937104005,POLI 120H,A00,183596,Fisk; David Lee,11,0,20,9
1681937105028,POLI 130AA,A00,183597,Staff,13,0,20,7
1681937106060,POLI 134AA,A00,183598,Staff,19,0,20,1
1681937107086,POLI 135,A00,183599,Fisk; David Lee,18,0,25,7
1681937108113,POLI 142P,A00,183623,Staff,37,0,40,3
1681937109138,POLI 144D,A00,183624,Staff,22,0,25,3
1681937110161,POLI 151,A00,183625,Staff,14,0,20,6
1681937111187,POLI 162,A00,183626,Mignozzetti; Umberto,17,0,20,3
1681937112213,PSYC 1,A00,253748,Staff,85,0,90,5
1681937113244,PSYC 2,A00,183627,Moranton; Nirelia Melbina-,21,0,35,14
1681937114273,PSYC 3,A00,183628,Staff,42,0,45,3
1681937116319,PSYC 60,A01,183631,Lowe; Angela Beth,34,0,40,6
1681937117341,PSYC 70,A01,253757,Staff,32,0,45,13
1681937118366,PSYC 101,A00,183632,Heyman; Gail D.,38,0,60,22
1681937119389,PSYC 105,A00,183848,Lowe; Angela Beth,39,0,60,21
1681937120412,PSYC 106,A00,183849,Dobkins; Karen R.,33,0,60,27
1681937121434,PSYC 108,A00,253750,Staff,2,0,60,58
1681937122460,PSYC 114,A01,184275,Winkielman; Piotr,0,8,30,30
1681937123485,PSYC 122,A00,183856,Moranton; Nirelia Melbina-,0,16,30,30
1681937124510,PSYC 124,A00,183865,Chapman; Eddie Nathaniel,38,0,80,42
1681937125536,PSYC 137,A00,183880,Staff,14,0,25,11
1681937127595,PSYC 154,A00,183910,Lacefield; Katharine I,0,34,90,90
1681937129641,PSYC 162,A00,183946,Wixted; John T,33,0,90,57
1681937130671,PSYC 172,A00,183947,Gorman; Michael R.,2,0,30,28
1681937131693,PSYC 178,A00,183963,Glaser; Dale,10,0,40,30
1681937132718,PSYC 181GS,A00,183964,Anagnostaras; Stephan,10,0,10,0
1681937133749,PSYC 186GS,A01,257660,Staff,10,0,10,0
1681937134783,PSYC 193,B00,253749,Staff,22,0,25,3
1681937136835,PSYC 193L,A01,184122,Staff,33,0,35,2
1681937136835,PSYC 193L,C01,184167,Winkielman; Piotr,14,0,30,16
1681937137882,RELI 188GS,A00,182629,Rahimi; Babak,20,0,20,0
1681937138906,SE 101A,A00,182646,Staff,25,0,30,5
1681937139932,SE 101C,A00,182650,Staff,8,0,20,12
1681937140954,SE 110A,A00,182651,Staff,28,0,28,0
1681937141977,SE 130A,A00,182652,Staff,37,0,40,3
1681937143000,SIO 46GS,A00,182636,Cook; Geoffrey W,23,0,28,5
1681937144024,SIO 109R,A00,194459,Staff,0,2,20,20
1681937145046,SIO 121GS,A00,182639,Cook; Geoffrey W,23,0,28,5
1681937146070,SIO 132,A01,182642,Staff,30,0,40,10
1681937147093,SIO 139,A00,182644,Kacev; David,36,0,40,4
1681937148116,SOCI 2,A01,258404,Staff,33,0,36,3
1681937148116,SOCI 2,A02,258405,Staff,34,0,36,2
1681937149139,SOCI 60,A01,258408,Staff,29,0,30,1
1681937149139,SOCI 60,A02,258413,Staff,30,0,30,0
1681937150166,SOCI 100,A01,258415,Staff,28,0,30,2
1681937150166,SOCI 100,A02,258416,Staff,28,0,30,2
1681937156352,SOCI 127,A00,258421,Staff,18,0,30,12
1681937157375,SOCI 132,A00,258422,Staff,41,0,50,9
1681937158402,SOCI 133,A00,258423,Staff,26,0,30,4
1681937159426,SOCI 138GS,A00,258424,Staff,15,0,15,0
1681937160449,SOCI 145,A00,258425,Staff,23,0,30,7
1681937161484,SOCI 148,A00,258426,Staff,23,0,30,7
1681937162578,SOCI 153,A00,199217,Staff,30,0,30,0
1681937163600,SOCI 160,A00,258427,Staff,26,0,30,4
1681937164626,SOCI 160E,A00,258435,Staff,55,0,60,5
1681937165656,SOCI 189GS,A00,258436,Staff,15,0,15,0
1681937166687,SOCI 190GS,A00,258437,Staff,15,0,15,0
1681937167711,SYN 2,001,182658,Staff,7,0,16,9
1681937167711,SYN 2,002,201439,Staff,13,0,16,3
1681937167711,SYN 2,003,201443,Staff,15,0,16,1
1681937168736,SYN 100,A01,182657,Staff,7,0,20,13
1681937169762,TDAC 1,A00,184381,Salovey; Todd,16,0,20,4
1681937169762,TDAC 1,B00,184385,Harting; Carla Kelso,19,0,20,1
1681937169762,TDAC 1,C00,184394,Staff,18,0,20,2
1681937170786,TDAC 101,A00,184483,Harting; Carla Kelso,19,0,20,1
1681937171829,TDDE 111,A00,184496,Staff,14,0,15,1
1681937172857,TDDE 131,A00,184504,Staff,20,0,20,0
1681937172857,TDDE 131,B00,184505,Staff,17,0,18,1
1681937172857,TDDE 131,C00,184534,Staff,48,0,50,2
1681937172857,TDDE 131,D00,184564,Staff,15,0,15,0
1681937172857,TDDE 131,E00,204725,Staff,18,0,20,2
1681937173879,TDGE 1,A01,184414,Salovey; Todd,32,0,50,18
1681937174914,TDGE 5,A01,184419,Staff,23,0,24,1
1681937175937,TDGE 10,A00,184428,Fulton; Julia,27,0,50,23
1681937176968,TDGE 124,A00,184565,Fulton; Julia,0,5,50,50
1681937177991,TDGE 125,B00,184567,Meyer; Ursula,5,0,25,20
1681937179013,TDHT 101,A00,184568,Staff,20,0,25,5
1681937179013,TDHT 101,B00,184569,Staff,20,0,20,0
1681937180040,TDHT 114,A00,184570,Staff,47,0,50,3
1681937181065,TDMV 1,A00,184437,Arcidiacono; Kristin,21,0,30,9
1681937181065,TDMV 1,B00,184448,Caligagan; Maria T.,23,0,30,7
1681937182087,TDMV 2,A00,184449,Weinberg; Sadie,26,0,30,4
1681937182087,TDMV 2,B00,184453,Arcidiacono; Kristin,29,0,30,1
1681937183111,TDMV 110,A00,184571,Weinberg; Sadie,30,0,30,0
1681937184141,TDMV 142,A00,184572,Caligagan; Tony,26,0,30,4
1681937184141,TDMV 142,B00,184573,Caligagan; Maria T.,26,0,30,4
1681937185167,TDTR 20,A00,184482,Jun; Grace Shin Hae,25,0,25,0
1681937186217,USP 2,A01,184290,Hinds; Juli Beth,22,0,25,3
1681937187242,USP 3,A01,184295,Staff,19,0,25,6
1681937188269,USP 4,A00,184304,McTague; Sarah,11,0,25,14
1681937189294,USP 100,A00,184315,Staff,16,0,25,9
1681937190324,USP 105,A00,184326,Staff,21,0,25,4
1681937191354,USP 151,A00,184327,Staff,15,0,25,10
1681937192377,USP 170,A00,184380,Hinds; Juli Beth,12,0,25,13
1681937193399,VIS 21B,A01,182660,Staff,28,0,31,3
1681937193399,VIS 21B,A02,182662,Staff,30,0,31,1
1681937194424,VIS 103D,A00,182663,Staff,73,0,75,2
1681937195448,VIS 105D,A00,182667,Li; Huai,14,0,22,8
1681937196470,VIS 122GS,A00,182668,Herbst; Matthew,20,0,20,0
1681937197493,VIS 128C,A00,182673,Staff,68,0,75,7
1681937198516,VIS 130,A00,182675,Staff,19,0,22,3
1681937199542,VIS 160A,A00,182678,Stalbaum; Brett,4,0,10,6
1681937201590,WCWP 10B,A00,201679,Staff,15,0,15,0
1681937201590,WCWP 10B,B00,201695,Staff,15,0,15,0
1681937202612,WCWP 100,A00,201716,Staff,12,0,15,3
1681937202612,WCWP 100,B00,201717,Staff,0,1,15,15
1681937204717,ANSC 105GS,A00,258289,Staff,0,0,0,0
1681937205739,ANSC 125GS,A00,258295,Staff,0,0,0,0
1681937206766,ANSC 150,A00,258267,Staff,25,0,40,15
1681937207788,ANSC 190GS,A00,258280,Staff,0,0,0,3
1681937208813,ANTH 1,A00,258264,Staff,37,0,40,3
1681937209846,ANTH 2,A01,258259,Staff,72,0,76,4
1681937210883,ANTH 23,A01,258228,Staff,35,0,40,5
1681937211909,ANTH 101,A01,258236,Staff,38,0,40,2
1681937212931,ANTH 102,A00,258272,Staff,59,0,60,1
1681937213954,ANTH 105,A00,258244,Staff,27,0,35,8
1681937214984,BENG 130,A00,253975,Staff,37,0,40,3
1681937216007,BIBC 102,A01,191866,Flagg; Matthew Paul,14,0,32,18
1681937216007,BIBC 102,A02,191867,Flagg; Matthew Paul,20,0,32,12
1681937216007,BIBC 102,A03,191868,Flagg; Matthew Paul,26,0,32,6
1681937216007,BIBC 102,A04,191936,Flagg; Matthew Paul,19,0,32,13
1681937216007,BIBC 102,A05,191937,Flagg; Matthew Paul,0,1,32,32
1681937217043,BICD 100,A01,191939,Cooper; Andrew Michael,27,0,32,5
1681937217043,BICD 100,A02,191940,Cooper; Andrew Michael,32,0,32,0
1681937217043,BICD 100,A03,191941,Cooper; Andrew Michael,32,0,32,0
1681937217043,BICD 100,A04,191942,Cooper; Andrew Michael,32,0,32,0
1681937217043,BICD 100,A05,191943,Cooper; Andrew Michael,32,0,32,0
1681937218067,BIEB 126,A01,191945,Cleland; Elsa Eleanor,0,5,32,32
1681937218067,BIEB 126,A02,191946,Cleland; Elsa Eleanor,24,0,32,8
1681937218067,BIEB 126,A03,191947,Cleland; Elsa Eleanor,29,0,32,3
1681937218067,BIEB 126,A04,191948,Cleland; Elsa Eleanor,15,0,32,17
1681937218067,BIEB 126,A05,191996,Cleland; Elsa Eleanor,27,0,32,5
1681937219101,BIEB 136GS,A00,191997,Shurin; Jonathan & Holway; David A.,0,0,0,9
1681937220127,BIEB 137GS,A01,191999,Shurin; Jonathan & Holway; David A.,0,0,0,8
1681937221162,BILD 1,A01,205385,Staff,30,0,32,2
1681937221162,BILD 1,A02,205386,Staff,30,0,32,2
1681937221162,BILD 1,A03,205387,Staff,31,0,32,1
1681937221162,BILD 1,A04,205388,Staff,25,0,32,7
1681937222186,BILD 2,A01,191774,Staff,24,0,32,8
1681937222186,BILD 2,A02,191775,Staff,29,0,32,3
1681937222186,BILD 2,A03,191777,Staff,29,0,32,3
1681937222186,BILD 2,A04,191856,Staff,30,0,32,2
1681937222186,BILD 2,A05,191857,Staff,31,0,32,1
1681937222186,BILD 2,A06,191858,Staff,32,0,32,0
1681937222186,BILD 2,A07,191859,Staff,31,0,32,1
1681937223212,BILD 3,A01,205391,Staff,26,0,32,6
1681937223212,BILD 3,A02,205393,Staff,32,0,32,0
1681937223212,BILD 3,A03,205394,Staff,26,0,32,6
1681937223212,BILD 3,A04,205395,Staff,32,0,32,0
1681937224235,BILD 20,A01,191861,Staff,32,0,32,0
1681937224235,BILD 20,A02,191862,Staff,32,0,32,0
1681937225260,BILD 30,A01,191864,Staff,31,0,32,1
1681937226283,BIMM 100,A01,192019,Staff,0,0,32,32
1681937226283,BIMM 100,A02,192020,Staff,9,0,32,23
1681937226283,BIMM 100,A03,192035,Staff,17,0,32,15
1681937227308,BIMM 110,A01,192037,Tat; John,0,0,32,32
1681937227308,BIMM 110,A02,192038,Tat; John,4,0,32,28
1681937228334,BIMM 120,A01,192040,Pickett; Brooke Elizabeth,0,0,32,32
1681937228334,BIMM 120,A02,192041,Pickett; Brooke Elizabeth,7,0,32,25
1681937228334,BIMM 120,A03,192042,Pickett; Brooke Elizabeth,14,0,32,18
1681937229359,BIPN 100,A01,192044,Armour; Jon Christopher,23,0,32,9
1681937229359,BIPN 100,A02,192059,Armour; Jon Christopher,30,0,32,2
1681937229359,BIPN 100,A03,192064,Armour; Jon Christopher,29,0,32,3
1681937229359,BIPN 100,A04,192073,Armour; Jon Christopher,26,0,32,6
1681937230395,BIPN 148,A01,205411,Leutgeb; Jill K.,14,0,32,18
1681937230395,BIPN 148,A02,205412,Leutgeb; Jill K.,31,0,32,1
1681937230395,BIPN 148,A03,205413,Leutgeb; Jill K.,29,0,32,3
1681937230395,BIPN 148,A04,205414,Leutgeb; Jill K.,30,0,32,2
1681937231419,BIPN 160,A01,192115,Marino; Marc J,15,0,32,17
1681937231419,BIPN 160,A02,192148,Marino; Marc J,27,0,32,5
1681937231419,BIPN 160,A03,192158,Marino; Marc J,31,0,32,1
1681937231419,BIPN 160,A04,192190,Marino; Marc J,32,0,32,0
1681937231419,BIPN 160,A05,192287,Marino; Marc J,32,0,32,0
1681937231419,BIPN 160,A06,192288,Marino; Marc J,32,0,32,0
1681937232442,BIPN 194,A00,206038,Leutgeb; Stefan,28,0,32,4
1681937233465,BISP 194,A00,192289,Nieh; James Charles,8,0,32,24
1681937233465,BISP 194,B00,245332,Staff,26,0,32,6
1681937234487,CAT 124,A01,202247,Staff,15,0,15,0
1681937235513,CAT 125,A00,202248,Staff,18,0,20,2
1681937235513,CAT 125,B00,202253,Staff,20,0,20,0
1681937235513,CAT 125,C00,202257,Staff,17,0,20,3
1681937236535,CAT 125GS,A01,202273,Bronstein; Phoebe Malan,20,0,20,0
1681937237567,CAT 125R,A00,202284,Staff,16,0,20,4
1681937237567,CAT 125R,C00,202286,Staff,4,0,20,16
1681937237567,CAT 125R,D00,202291,Staff,14,0,20,6
1681937237567,CAT 125R,E00,202295,Staff,13,0,20,7
1681937237567,CAT 125R,F00,202302,Staff,4,0,20,16
1681937238594,CENG 100,A00,204724,Opatkiewicz; Justin Paul,23,0,25,2
1681937239617,CGS 2A,A01,180420,Staff,28,0,36,8
1681937240644,CGS 101,A00,180421,Staff,14,0,20,6
1681937241667,CGS 112,A00,180422,Staff,7,0,16,9
1681937242690,CGS 113,A00,180423,Staff,18,0,20,2
1681937243718,CGS 137,A00,180424,Staff,12,0,12,0
1681937244744,CGS 147,A00,180425,Staff,10,0,10,0
1681937245767,CHEM 6A,A01,179556,Staff,92,0,100,8
1681937245767,CHEM 6A,A02,179558,Staff,0,0,0,0
1681937246792,CHEM 6B,A01,179560,Staff,100,0,100,0
1681937247814,CHEM 6C,A01,179565,Jazzar; Rodolphe,89,0,100,11
1681937248840,CHEM 7L,A01,179586,Schurmeier; Kimberly,9,0,24,15
1681937248840,CHEM 7L,A02,179587,Schurmeier; Kimberly,22,0,24,2
1681937248840,CHEM 7L,A03,179590,Schurmeier; Kimberly,21,0,24,3
1681937248840,CHEM 7L,A04,179591,Schurmeier; Kimberly,22,0,24,2
1681937248840,CHEM 7L,B01,179598,Schurmeier; Kimberly,12,0,24,12
1681937248840,CHEM 7L,B02,179599,Schurmeier; Kimberly,23,0,24,1
1681937248840,CHEM 7L,B03,179606,Schurmeier; Kimberly,22,0,24,2
1681937248840,CHEM 7L,B04,179607,Schurmeier; Kimberly,22,0,24,2
1681937249877,CHEM 11,A01,179609,Stallings; Dontarie M,85,0,100,15
1681937250903,CHEM 40A,A01,179621,Staff,37,0,50,13
1681937250903,CHEM 40A,A02,179622,Staff,43,0,50,7
1681937251931,CHEM 40B,A01,179630,Weizman; Haim,45,0,50,5
1681937251931,CHEM 40B,A02,179631,Weizman; Haim,42,0,50,8
1681937252963,CHEM 41A,A01,179660,Klosterman; Jeremy K,90,0,100,10
1681937253991,CHEM 43A,A01,179683,Klosterman; Jeremy K,0,0,24,24
1681937253991,CHEM 43A,A02,179688,Klosterman; Jeremy K,5,0,24,19
1681937253991,CHEM 43A,A03,179689,Klosterman; Jeremy K,16,0,24,8
1681937253991,CHEM 43A,A04,179691,Klosterman; Jeremy K,16,0,24,8
1681937255015,CHEM 114A,A01,179693,Stallings; Dontarie M,58,0,100,42
1681937256042,CHEM 143B,A01,179698,Weizman; Haim,16,0,24,8
1681937256042,CHEM 143B,A02,179700,Weizman; Haim,23,0,24,1
1681937257068,CHIN 169A,A00,179701,Wang; Xiao,20,0,20,0
1681937258105,COGS 2,A01,179750,Boyle; Mary E. T.,16,0,30,14
1681937259137,COGS 9,A01,179759,Jones; Cameron Robert,39,0,50,11
1681937260164,COGS 14A,A01,179854,Staff,3,0,50,47
1681937261189,COGS 14B,A01,179856,Staff,49,0,60,11
1681937262211,COGS 17,A01,179874,Staff,69,0,75,6
1681937263232,COGS 18,A01,179884,Staff,56,0,80,24
1681937264255,COGS 100,A01,179886,Staff,24,0,60,36
1681937265279,COGS 101B,A01,179892,Staff,0,6,30,30
1681937266379,COGS 101C,A01,179894,Staff,25,0,30,5
1681937267406,COGS 107A,A01,179896,Boyle; Mary E. T.,28,0,40,12
1681937268439,COGS 108,A01,179898,Simpkins; Charles Alexander,0,35,60,60
1681937269461,COGS 109,A01,179900,Staff,32,0,40,8
1681937270482,COGS 118A,A01,179946,Staff,2,0,40,38
1681937271506,COGS 153,A00,179978,Staff,0,7,30,30
1681937272528,COGS 156,A01,179981,Staff,19,0,30,11
1681937274583,COGS 172,A01,179987,Staff,4,0,30,26
1681937276645,COGS 186,A01,179991,Staff,9,0,30,21
1681937277670,COMM 10,A01,180001,Staff,10,0,25,15
1681937277670,COMM 10,A02,180004,Staff,20,0,25,5
1681937278693,COMM 100A,A01,180016,Staff,12,0,25,13
1681937278693,COMM 100A,A02,180020,Staff,24,0,25,1
1681937279722,COMM 101T,A00,180029,Halm; Gavin Patrick,13,0,35,22
1681937280756,COMM 106V,A00,180043,Staff,33,0,35,2
1681937281784,COMM 109P,A00,180044,Staff,29,0,35,6
1681937282819,COMM 113T,A00,180045,Havis; Allan,30,0,45,15
1681937283842,COMM 132,A00,180046,McKenna; Denise,14,0,30,16
1681937284877,COMM 143,A00,180047,Staff,13,0,30,17
1681937285902,COMM 190,A00,180048,Conner; Thomas Hartnell,13,0,23,10
1681937286929,CSE 8A,A50,180053,Cao; Yingjun,19,0,50,31
1681937286929,CSE 8A,B50,180180,Staff,49,0,50,1
1681937287980,CSE 11,A01,180190,Cao; Yingjun,14,0,50,36
1681937289005,CSE 20,A01,180192,Briones; Jor-el Thomas Caparas,20,0,30,10
1681937290027,CSE 21,A01,194538,Briones; Jor-el Thomas Caparas,49,0,60,11
1681937291050,CSE 30,A01,180324,Eldon; John,69,0,100,31
1681937292073,CSE 101,A01,201353,Staff,0,34,40,40
1681937293096,CSE 134B,A01,180326,Powell; Thomas Allan,68,0,100,32
1681937294123,CSE 140,A01,180328,Staff,17,0,75,58
1681937295148,CSE 140L,A01,180344,Eldon; John,43,0,100,57
1681937296175,CSE 150A,A01,180411,Staff,0,20,50,50
1681937297197,CSE 151A,A01,180414,Staff,0,17,50,50
1681937298222,CSE 175,A01,222521,Kumar; Rakesh,50,0,50,0
1681937299247,CSE 190,A00,201419,Staff,42,0,49,7
1681937300272,CSS 1,A01,194536,Staff,28,0,50,22
1681937301298,DSC 30,A01,202385,Staff,48,0,50,2
1681937302338,DSC 40A,A01,202387,Albuyeh; Rod,50,0,50,0
1681937303362,DSC 190,A01,202389,Silberman; Jack,21,0,21,0
1681937304385,DSGN 100,A01,179993,Staff,12,0,30,18
1681937305410,ECE 65,A50,180708,Staff,9,0,20,11
1681937305410,ECE 65,A51,180739,Staff,19,0,20,1
1681937306433,ECON 1,A01,180427,Famulari; Melissa,65,0,70,5
1681937307461,ECON 2,A01,180450,Levkoff; Steven B.,62,0,70,8
1681937308497,ECON 4,A01,203351,Anderson; John Charles,6,0,10,4
1681937309525,ECON 100A,A01,180472,Famulari; Melissa,58,0,70,12
1681937310551,ECON 120A,A01,180549,Staff,59,0,70,11
1681937311574,ECON 120B,A01,180655,Ma; Xinwei,28,0,70,42
1681937312597,ECON 129,A00,203333,Eckert; Fabian Paul,4,0,35,31
1681937313619,ECON 131,A00,180656,Staff,0,4,35,35
1681937314643,ECON 172B,A01,180672,Levkoff; Steven B.,30,0,35,5
1681937315666,ECON 178,A01,203342,Zhu; Ying,2,0,35,33
1681937316705,EDS 108GS,A00,202383,Wishard Guerra; Alison G.,20,0,20,0
1681937317727,EDS 111GS,A00,202347,Wishard Guerra; Alison G.,20,0,20,0
1681937318752,EDS 112,A01,202323,Staff,51,0,60,9
1681937319780,EDS 113,A00,202340,Staff,30,0,35,5
1681937320803,EDS 118,A00,201231,Staff,19,0,30,11
1681937321825,EDS 119,A00,204994,Staff,8,0,10,2
1681937322859,EDS 124BR,A00,202324,Eguchi; Emi,0,4,25,25
1681937323882,EDS 126,A01,203208,Jones; Makeba,26,0,30,4
1681937324905,EDS 135,A01,202333,Staff,17,0,20,3
1681937325938,EDS 180,A00,202311,Staff,47,0,50,3
1681937326960,ERC 190GS,A01,253747,Staff,27,0,28,1
1681937327987,ETHN 104,A00,180742,Staff,20,0,35,15
1681937329022,ETHN 118,A00,180745,Staff,26,0,35,9
1681937330046,ETHN 127,A00,180747,Staff,8,0,16,8
1681937331068,ETHN 137,A00,180880,Staff,11,0,12,1
1681937332092,ETHN 147,A00,180890,Staff,8,0,10,2
1681937333119,ETHN 154,A00,180891,Staff,4,0,8,4
1681937334144,ETHN 168,A00,180892,Staff,9,0,10,1
1681937335170,GLBH 20,A00,201051,Hannah; Seth Donal,0,7,0,1
1681937336207,GLBH 111,A01,209338,Burgos; Jose L.,0,0,0,0
1681937337232,GLBH 150,A00,258300,Staff,0,4,0,0
1681937338255,GLBH 181,A00,201207,Staff,2,0,40,38
1681937339281,HIEU 109,A00,180898,Staff,19,0,20,1
1681937340305,HIEU 111,A00,180899,Staff,0,2,20,20
1681937341334,HIEU 124,A00,180900,Staff,16,0,20,4
1681937342357,HILA 122,A00,180901,Staff,16,0,20,4
1681937343381,HILA 132,A00,180902,Vitz; Matthew,0,5,20,20
1681937344404,HILD 10,A01,180896,Staff,11,0,20,9
1681937345430,HILD 30GS,A00,180897,Edington; Claire Ellen,0,0,0,0
1681937346455,HISC 105,A00,180903,Staff,20,0,20,0
1681937347482,HISC 117,A00,180904,Staff,10,0,20,10
1681937348514,HIUS 108B,A00,181005,Staff,17,0,20,3
1681937349536,HIUS 113,A00,181093,Staff,0,1,20,20
1681937350562,HUM 3,A01,181190,Patterson; Patrick H.,32,0,50,18
1681937350562,HUM 3,B01,181195,Staff,43,0,50,7
1681937351586,HUM 3GS,A00,181196,Herbst; Matthew,0,0,0,0
1681937352619,HUM 4,A01,181227,West; Geoffrey Scott,33,0,50,17
1681937352619,HUM 4,B01,181282,Staff,41,0,50,9
1681937353644,HUM 4GS,A00,181377,Lyon; Antony J.,0,0,0,0
1681937354667,HUM 5,A01,181536,Zavodny; Tatiana Sophia,22,0,50,28
1681937354667,HUM 5,B01,181908,Staff,30,0,50,20
1681937355689,INTL 190,A00,181909,Segui; Alan S,0,0,0,8
1681937355689,INTL 190,B00,181961,Segui; Alan S,0,0,0,7
1681937356712,JAPN 20AR,A01,182113,Ross; Kayoko F,15,0,20,5
1681937357736,LATI 50,A01,202391,Martin-Cabrera; Luis,15,0,30,15
1681937357736,LATI 50,A02,202392,Martin-Cabrera; Luis,26,0,30,4
1681937358762,LATI 180,A00,202393,Kokinis; Troy Andreas,24,0,25,1
1681937359785,LIFR 1A,A00,182119,Staff,13,0,14,1
1681937360816,LIFR 1AX,A00,182324,Staff,13,0,14,1
1681937361839,LIFR 1B,A00,182259,Staff,11,0,14,3
1681937362868,LIFR 1BX,A00,182273,Staff,11,0,14,3
1681937363894,LIGN 8,A00,182330,Staff,122,0,150,28
1681937364916,LIGN 9GS,A00,182362,Staff,14,0,20,6
1681937365951,LIGN 119,A00,204992,Takahashi; Maho,11,0,15,4
1681937366974,LIGN 130,A01,182384,Staff,47,0,50,3
1681937367996,LIGN 149GS,A00,182390,Staff,14,0,20,6
1681937369023,LIGN 170,A00,182404,Staff,23,0,30,7
1681937370119,LISP 1D,A00,182281,Staff,6,0,14,8
1681937370119,LISP 1D,B00,182287,Staff,13,0,14,1
1681937370119,LISP 1D,C00,182295,Staff,10,0,14,4
1681937370119,LISP 1D,D00,182301,Staff,14,0,14,0
1681937371144,LISP 1DX,A00,182309,Staff,18,0,28,10
1681937371144,LISP 1DX,B00,182316,Staff,25,0,28,3
1681937372167,LTAF 120GS,A00,182412,Zhiri; Oumelbanine,20,0,20,0
1681937373191,LTCS 172GS,A00,182437,Bronstein; Phoebe Malan,20,0,20,0
1681937374214,LTEA 138,A00,182457,Staff,13,0,40,27
1681937375247,LTEN 114,A01,182490,Staff,23,0,25,2
1681937376278,LTEN 130GS,A00,182491,Lyon; Antony J.,20,0,20,0
1681937377304,LTEN 169,A00,182493,Cuong; Marisol,16,0,25,9
1681937378332,LTEN 178,A00,182501,Staff,14,0,15,1
1681937379358,LTEN 181,A00,182515,Staff,18,0,25,7
1681937380384,LTEN 185GS,A00,197655,Forbes; Camille,20,0,20,0
1681937381420,LTSP 100B,A00,202208,Bessett; Ryan Matthew,24,0,25,1
1681937382446,LTWL 100,A00,182516,Myerston Santana; Jacobo,19,0,30,11
1681937383475,LTWR 100GS,A00,182518,Forbes; Camille,20,0,20,0
1681937384498,LTWR 102,A00,182522,Staff,15,0,15,0
1681937384498,LTWR 102,B00,182525,Staff,14,0,15,1
1681937385523,LTWR 115,A00,182526,Staff,9,0,15,6
1681937386545,MAE 8,A01,182528,Pham; Hieu Tan,65,0,70,5
1681937387578,MAE 11,A00,182529,Bahadori; Mohammad Yousef,88,0,100,12
1681937388604,MAE 20,A00,182530,Evdokimenko; Ekaterina,66,0,70,4
1681937389627,MAE 30A,A00,182532,Staff,44,0,45,1
1681937390651,MAE 101A,A00,182533,Bahadori; Mohammad Yousef,93,0,100,7
1681937391674,MAE 101C,A00,182538,Staff,62,0,70,8
1681937392698,MAE 104,A00,182539,Staff,44,0,50,6
1681937393721,MAE 131A,A00,182540,Ghazinejad; Maziar,40,0,45,5
1681937394751,MAE 143A,A00,182548,Bewley; Thomas R,42,0,50,8
1681937395782,MAE 150,A00,182549,Staff,28,0,40,12
1681937396805,MAE 160,A00,182550,Evdokimenko; Ekaterina,36,0,60,24
1681937397831,MATH 3C,A01,182725,Staff,24,0,30,6
1681937398859,MATH 10A,A01,182729,Staff,24,0,30,6
1681937398859,MATH 10A,B01,182732,Staff,25,0,30,5
1681937399889,MATH 10B,A01,182737,Staff,14,0,30,16
1681937399889,MATH 10B,A02,182738,Staff,24,0,30,6
1681937399889,MATH 10B,B01,182744,Staff,24,0,30,6
1681937399889,MATH 10B,B02,182745,Staff,26,0,30,4
1681937400931,MATH 18,A01,182750,Anzaldo; Leesa B,28,0,30,2
1681937400931,MATH 18,A02,182751,Anzaldo; Leesa B,28,0,30,2
1681937400931,MATH 18,A03,182753,Anzaldo; Leesa B,27,0,30,3
1681937400931,MATH 18,A04,182757,Anzaldo; Leesa B,29,0,30,1
1681937400931,MATH 18,B01,182761,Anzaldo; Leesa B,26,0,30,4
1681937400931,MATH 18,B02,182764,Anzaldo; Leesa B,25,0,30,5
1681937400931,MATH 18,B03,182765,Anzaldo; Leesa B,29,0,30,1
1681937400931,MATH 18,B04,182766,Anzaldo; Leesa B,30,0,30,0
1681937401961,MATH 20A,A01,182771,Suk; Andrew Hoon,27,0,30,3
1681937402988,MATH 20B,A01,182775,Bach; Quang Tran,29,0,30,1
1681937402988,MATH 20B,A02,182777,Bach; Quang Tran,29,0,30,1
1681937402988,MATH 20B,B01,182780,Bach; Quang Tran,26,0,30,4
1681937402988,MATH 20B,B02,182782,Bach; Quang Tran,30,0,30,0
1681937404018,MATH 20C,A01,182787,Staff,23,0,30,7
1681937404018,MATH 20C,A02,182790,Staff,29,0,30,1
1681937404018,MATH 20C,B01,182792,Staff,22,0,30,8
1681937404018,MATH 20C,B02,182796,Staff,26,0,30,4
1681937405041,MATH 20D,A01,182799,Staff,26,0,30,4
1681937405041,MATH 20D,A02,182802,Staff,29,0,30,1
1681937405041,MATH 20D,A03,182803,Staff,29,0,30,1
1681937406064,MATH 20E,A01,182809,Verstraete; Jacques Allan,18,0,30,12
1681937406064,MATH 20E,A02,182811,Verstraete; Jacques Allan,26,0,30,4
1681937406064,MATH 20E,B01,182814,Verstraete; Jacques Allan,20,0,30,10
1681937406064,MATH 20E,B02,182815,Verstraete; Jacques Allan,27,0,30,3
1681937407096,MATH 103A,A01,182820,Staff,1,0,30,29
1681937407096,MATH 103A,A02,182821,Staff,26,0,30,4
1681937407096,MATH 103A,A03,182822,Staff,18,0,30,12
1681937407096,MATH 103A,B01,182825,Staff,21,0,30,9
1681937407096,MATH 103A,B02,182826,Staff,30,0,30,0
1681937407096,MATH 103A,B03,182830,Staff,30,0,30,0
1681937408126,MATH 109,A01,182836,Chow; Bennett,23,0,30,7
1681937408126,MATH 109,A02,182838,Chow; Bennett,27,0,30,3
1681937408126,MATH 109,A03,182894,Chow; Bennett,29,0,30,1
1681937408126,MATH 109,B01,182908,Chow; Bennett,26,0,30,4
1681937408126,MATH 109,B02,182909,Chow; Bennett,30,0,30,0
1681937408126,MATH 109,B03,182910,Chow; Bennett,26,0,30,4
1681937409155,MATH 142A,A01,182925,Staff,2,0,30,28
1681937409155,MATH 142A,A02,182935,Staff,23,0,30,7
1681937409155,MATH 142A,A03,182967,Staff,22,0,30,8
1681937409155,MATH 142A,B01,183125,Staff,22,0,30,8
1681937409155,MATH 142A,B02,183157,Staff,26,0,30,4
1681937409155,MATH 142A,B03,183158,Staff,29,0,30,1
1681937410182,MATH 183,A01,183160,Arias-Castro; Ery,22,0,30,8
1681937410182,MATH 183,A02,183161,Arias-Castro; Ery,28,0,30,2
1681937410182,MATH 183,B01,183163,Arias-Castro; Ery,26,0,30,4
1681937410182,MATH 183,B02,183164,Arias-Castro; Ery,28,0,30,2
1681937411213,MATH 193A,A01,183167,Staff,0,0,35,35
1681937411213,MATH 193A,A02,183168,Staff,19,0,35,16
1681937411213,MATH 193A,A03,183169,Staff,32,0,35,3
1681937411213,MATH 193A,A04,183170,Staff,26,0,35,9
1681937412237,MGT 4,A01,202395,Anderson; John Charles,76,0,80,4
1681937413264,MGT 5,A00,202396,Houskeeper; Robert,78,0,90,12
1681937414291,MGT 103,A00,202397,Eberhard; Craig A,44,0,90,46
1681937415318,MGT 131A,A00,202398,Houskeeper; Robert,81,0,90,9
1681937416342,MGT 135,A00,202399,Anderson; John Charles,81,0,90,9
1681937417370,MGT 162R,A00,202403,Gneezy; Uri,107,0,200,93
1681937418398,MGT 172,A00,202404,Hedges; Kathleen,16,0,90,74
1681937419426,MGT 181,A00,202405,Dunn; Louis Jean,74,0,90,16
1681937420460,MMW 14,A01,183200,Staff,0,0,28,28
1681937420460,MMW 14,A02,183201,Staff,23,0,28,5
1681937420460,MMW 14,A03,183202,Staff,23,0,28,5
1681937420460,MMW 14,A04,183203,Staff,25,0,28,3
1681937420460,MMW 14,A05,183204,Staff,25,0,28,3
1681937420460,MMW 14,A06,183205,Staff,26,0,28,2
1681937420460,MMW 14,B01,183207,Staff,26,0,28,2
1681937420460,MMW 14,B02,183208,Staff,28,0,28,0
1681937420460,MMW 14,B03,183209,Staff,28,0,28,0
1681937420460,MMW 14,B04,183210,Staff,28,0,28,0
1681937420460,MMW 14,B05,183211,Staff,28,0,28,0
1681937420460,MMW 14,B06,183212,Staff,27,0,28,1
1681937421487,MMW 14GS,A00,183213,Zhiri; Oumelbanine,28,0,28,0
1681937422512,MMW 15GS,B00,183215,Rahimi; Babak,27,0,28,1
1681937423541,MMW 121,A01,183217,Patterson; Patrick H.,5,0,28,23
1681937423541,MMW 121,A02,183218,Patterson; Patrick H.,25,0,28,3
1681937424564,MUS 1A,A01,182554,Staff,0,1,35,35
1681937425589,MUS 5,A01,182558,Staff,13,0,35,22
1681937426611,MUS 6,A01,182562,Staff,21,0,35,14
1681937427638,MUS 8GS,A00,182563,Borgo; David Garcia,25,0,25,0
1681937428664,MUS 13,A01,182567,Staff,23,0,25,2
1681937429686,MUS 15,A01,182570,Staff,31,0,35,4
1681937429686,MUS 15,B01,182575,Staff,5,0,35,30
1681937430707,MUS 80,A00,182578,Staff,22,0,25,3
1681937430707,MUS 80,B00,182581,Staff,20,0,25,5
1681937431732,MUS 113,A00,182582,Staff,25,0,25,0
1681937432756,MUS 114,A00,182583,Staff,0,3,25,25
1681937433859,MUS 150GS,A01,182588,Borgo; David Garcia,24,0,25,1
1681937434896,PHIL 1,A00,182590,Staff,34,0,40,6
1681937435919,PHIL 10,A01,182596,Grush; Rick Scott,30,0,35,5
1681937435919,PHIL 10,A02,182597,Grush; Rick Scott,33,0,35,2
1681937436942,PHIL 15,A01,182601,Staff,31,0,35,4
1681937436942,PHIL 15,A02,182602,Staff,33,0,35,2
1681937437964,PHIL 27,A01,182604,Staff,23,0,35,12
1681937437964,PHIL 27,A02,182607,Staff,33,0,35,2
1681937438989,PHIL 32,A01,182609,Staff,35,0,35,0
1681937438989,PHIL 32,A02,182612,Staff,35,0,35,0
1681937440012,PHIL 130,A00,182614,Staff,57,0,70,13
1681937441043,PHIL 136,A00,182616,Cohen; Jonathan David,63,0,70,7
1681937442070,PHIL 155,A00,182617,Vargas; Manuel Rogelio,56,0,70,14
1681937443093,PHIL 163,A01,182620,Staff,15,0,20,5
1681937443093,PHIL 163,A02,182624,Staff,9,0,20,11
1681937444116,PHIL 164,A00,182627,Staff,29,0,40,11
1681937445139,PHIL 173,A00,182628,Staff,35,0,40,5
1681937446162,PHYS 1A,A00,183221,Staff,52,0,60,8
1681937447185,PHYS 1AL,001,183222,Staff,24,0,30,6
1681937447185,PHYS 1AL,002,183223,Staff,23,0,30,7
1681937448210,PHYS 1B,A00,183231,Staff,39,0,60,21
1681937449234,PHYS 1BL,001,183232,Staff,15,0,30,15
1681937449234,PHYS 1BL,002,183233,Staff,27,0,30,3
1681937450263,PHYS 1C,A00,183240,Staff,19,0,60,41
1681937451287,PHYS 1CL,001,183241,Staff,7,0,30,23
1681937451287,PHYS 1CL,002,183242,Staff,20,0,30,10
1681937452321,PHYS 2AR,A01,183250,Staff,39,0,50,11
1681937453346,PHYS 2B,A01,183252,Staff,101,0,115,14
1681937454373,PHYS 2BL,A01,183254,Staff,21,0,24,3
1681937454373,PHYS 2BL,A02,183255,Staff,21,0,24,3
1681937455396,PHYS 2C,A01,183522,Staff,100,0,115,15
1681937456429,PHYS 4A,A01,183524,Staff,49,0,50,1
1681937457460,POLI 5,A00,183525,Staff,43,0,50,7
1681937458484,POLI 12,A00,183540,Staff,44,0,50,6
1681937459516,POLI 13R,A00,183541,Forman; Fonna,40,0,50,10
1681937460539,POLI 30,A00,183542,Mignozzetti; Umberto,47,0,50,3
1681937461562,POLI 100A,A00,183543,Staff,43,0,50,7
1681937462586,POLI 100E,A00,223598,Staff,32,0,35,3
1681937463609,POLI 103A,A00,183564,Kousser; Thad,34,0,50,16
1681937464641,POLI 104B,A00,201329,Staff,27,0,35,8
1681937465666,POLI 113BR,A00,183576,Hoston; Germaine,20,0,50,30
1681937466688,POLI 114BR,A00,183588,Staff,26,0,30,4
1681937467713,POLI 117R,A00,183595,Forman; Fonna,1,0,20,19
1681937468738,POLI 120H,A00,183596,Fisk; David Lee,11,0,20,9
1681937469763,POLI 130AA,A00,183597,Staff,12,0,20,8
1681937470789,POLI 134AA,A00,183598,Staff,19,0,20,1
1681937471811,POLI 135,A00,183599,Fisk; David Lee,18,0,25,7
1681937472834,POLI 142P,A00,183623,Staff,37,0,40,3
1681937473930,POLI 144D,A00,183624,Staff,22,0,25,3
1681937474953,POLI 151,A00,183625,Staff,14,0,20,6
1681937475979,POLI 162,A00,183626,Mignozzetti; Umberto,17,0,20,3
1681937477005,PSYC 1,A00,253748,Staff,85,0,90,5
1681937478027,PSYC 2,A00,183627,Moranton; Nirelia Melbina-,21,0,35,14
1681937479057,PSYC 3,A00,183628,Staff,42,0,45,3
1681937481120,PSYC 60,A01,183631,Lowe; Angela Beth,34,0,40,6
1681937482161,PSYC 70,A01,253757,Staff,32,0,45,13
1681937483189,PSYC 101,A00,183632,Heyman; Gail D.,38,0,60,22
1681937484212,PSYC 105,A00,183848,Lowe; Angela Beth,39,0,60,21
1681937485237,PSYC 106,A00,183849,Dobkins; Karen R.,33,0,60,27
1681937486260,PSYC 108,A00,253750,Staff,2,0,60,58
1681937487291,PSYC 114,A01,184275,Winkielman; Piotr,0,8,30,30
1681937488338,PSYC 122,A00,183856,Moranton; Nirelia Melbina-,0,16,30,30
1681937489367,PSYC 124,A00,183865,Chapman; Eddie Nathaniel,38,0,80,42
1681937490390,PSYC 137,A00,183880,Staff,14,0,25,11
1681937492436,PSYC 154,A00,183910,Lacefield; Katharine I,0,34,90,90
1681937494496,PSYC 162,A00,183946,Wixted; John T,33,0,90,57
1681937495525,PSYC 172,A00,183947,Gorman; Michael R.,2,0,30,28
1681937496551,PSYC 178,A00,183963,Glaser; Dale,10,0,40,30
1681937497575,PSYC 181GS,A00,183964,Anagnostaras; Stephan,10,0,10,0
1681937498599,PSYC 186GS,A01,257660,Staff,10,0,10,0
1681937499633,PSYC 193,B00,253749,Staff,22,0,25,3
1681937501681,PSYC 193L,A01,184122,Staff,33,0,35,2
1681937501681,PSYC 193L,C01,184167,Winkielman; Piotr,14,0,30,16
1681937502707,RELI 188GS,A00,182629,Rahimi; Babak,20,0,20,0
1681937503733,SE 101A,A00,182646,Staff,25,0,30,5
1681937504755,SE 101C,A00,182650,Staff,8,0,20,12
1681937505787,SE 110A,A00,182651,Staff,28,0,28,0
1681937506809,SE 130A,A00,182652,Staff,37,0,40,3
1681937507850,SIO 46GS,A00,182636,Cook; Geoffrey W,23,0,28,5
1681937508877,SIO 109R,A00,194459,Staff,0,2,20,20
1681937509902,SIO 121GS,A00,182639,Cook; Geoffrey W,23,0,28,5
1681937510925,SIO 132,A01,182642,Staff,30,0,40,10
1681937511960,SIO 139,A00,182644,Kacev; David,36,0,40,4
1681937512986,SOCI 2,A01,258404,Staff,33,0,36,3
1681937512986,SOCI 2,A02,258405,Staff,34,0,36,2
1681937514011,SOCI 60,A01,258408,Staff,29,0,30,1
1681937514011,SOCI 60,A02,258413,Staff,30,0,30,0
1681937515035,SOCI 100,A01,258415,Staff,28,0,30,2
1681937515035,SOCI 100,A02,258416,Staff,28,0,30,2
1681937521203,SOCI 127,A00,258421,Staff,18,0,30,12
1681937522226,SOCI 132,A00,258422,Staff,41,0,50,9
1681937523252,SOCI 133,A00,258423,Staff,26,0,30,4
1681937524277,SOCI 138GS,A00,258424,Staff,15,0,15,0
1681937525302,SOCI 145,A00,258425,Staff,23,0,30,7
1681937526327,SOCI 148,A00,258426,Staff,23,0,30,7
1681937527354,SOCI 153,A00,199217,Staff,29,0,30,1
1681937528378,SOCI 160,A00,258427,Staff,25,0,30,5
1681937529402,SOCI 160E,A00,258435,Staff,55,0,60,5
1681937530432,SOCI 189GS,A00,258436,Staff,15,0,15,0
1681937531455,SOCI 190GS,A00,258437,Staff,15,0,15,0
1681937532482,SYN 2,001,182658,Staff,7,0,16,9
1681937532482,SYN 2,002,201439,Staff,13,0,16,3
1681937532482,SYN 2,003,201443,Staff,15,0,16,1
1681937533505,SYN 100,A01,182657,Staff,6,0,20,14
1681937534530,TDAC 1,A00,184381,Salovey; Todd,16,0,20,4
1681937534530,TDAC 1,B00,184385,Harting; Carla Kelso,19,0,20,1
1681937534530,TDAC 1,C00,184394,Staff,18,0,20,2
1681937535553,TDAC 101,A00,184483,Harting; Carla Kelso,19,0,20,1
1681937536576,TDDE 111,A00,184496,Staff,14,0,15,1
1681937537613,TDDE 131,A00,184504,Staff,20,0,20,0
1681937537613,TDDE 131,B00,184505,Staff,17,0,18,1
1681937537613,TDDE 131,C00,184534,Staff,48,0,50,2
1681937537613,TDDE 131,D00,184564,Staff,15,0,15,0
1681937537613,TDDE 131,E00,204725,Staff,18,0,20,2
1681937538638,TDGE 1,A01,184414,Salovey; Todd,32,0,50,18
1681937539660,TDGE 5,A01,184419,Staff,23,0,24,1
1681937540683,TDGE 10,A00,184428,Fulton; Julia,27,0,50,23
1681937541707,TDGE 124,A00,184565,Fulton; Julia,0,5,50,50
1681937542734,TDGE 125,B00,184567,Meyer; Ursula,5,0,25,20
1681937543763,TDHT 101,A00,184568,Staff,20,0,25,5
1681937543763,TDHT 101,B00,184569,Staff,20,0,20,0
1681937544794,TDHT 114,A00,184570,Staff,47,0,50,3
1681937545823,TDMV 1,A00,184437,Arcidiacono; Kristin,21,0,30,9
1681937545823,TDMV 1,B00,184448,Caligagan; Maria T.,23,0,30,7
1681937546849,TDMV 2,A00,184449,Weinberg; Sadie,26,0,30,4
1681937546849,TDMV 2,B00,184453,Arcidiacono; Kristin,29,0,30,1
1681937547875,TDMV 110,A00,184571,Weinberg; Sadie,30,0,30,0
1681937548908,TDMV 142,A00,184572,Caligagan; Tony,26,0,30,4
1681937548908,TDMV 142,B00,184573,Caligagan; Maria T.,26,0,30,4
1681937549931,TDTR 20,A00,184482,Jun; Grace Shin Hae,25,0,25,0
1681937550960,USP 2,A01,184290,Hinds; Juli Beth,22,0,25,3
1681937551990,USP 3,A01,184295,Staff,19,0,25,6
1681937553013,USP 4,A00,184304,McTague; Sarah,11,0,25,14
1681937554035,USP 100,A00,184315,Staff,16,0,25,9
1681937555060,USP 105,A00,184326,Staff,21,0,25,4
1681937556083,USP 151,A00,184327,Staff,15,0,25,10
1681937557108,USP 170,A00,184380,Hinds; Juli Beth,12,0,25,13
1681937558134,VIS 21B,A01,182660,Staff,28,0,31,3
1681937558134,VIS 21B,A02,182662,Staff,30,0,31,1
1681937559156,VIS 103D,A00,182663,Staff,73,0,75,2
1681937560182,VIS 105D,A00,182667,Li; Huai,14,0,22,8
1681937561207,VIS 122GS,A00,182668,Herbst; Matthew,20,0,20,0
1681937562231,VIS 128C,A00,182673,Staff,68,0,75,7
1681937563256,VIS 130,A00,182675,Staff,19,0,22,3
1681937564277,VIS 160A,A00,182678,Stalbaum; Brett,4,0,10,6
1681937566328,WCWP 10B,A00,201679,Staff,15,0,15,0
1681937566328,WCWP 10B,B00,201695,Staff,15,0,15,0
1681937567357,WCWP 100,A00,201716,Staff,12,0,15,3
1681937567357,WCWP 100,B00,201717,Staff,0,1,15,15
